ID,Link,Similarity,Tokens,File 1,File 2,Start 1,End 1,Detected Lines 1,Start 2,End 2,Detected Lines 2
1951,https://htmlpreview.github.io/?https://github.com/Christina96/boilerplate-sample-matches/blob/main/C-beta/Adafruit_nRF52_Arduino-MDEwOlJlcG9zaXRvcnk3NDM1NDcyOQ==-flat-mpu_prototypes.h-PINRemoteImage-MDEwOlJlcG9zaXRvcnkzOTUzNzEwMw==-flat-dec_neon.c.html,0.1450225317492831,10,Adafruit_nRF52_Arduino-MDEwOlJlcG9zaXRvcnk3NDM1NDcyOQ==-flat-mpu_prototypes.h,PINRemoteImage-MDEwOlJlcG9zaXRvcnkzOTUzNzEwMw==-flat-dec_neon.c,48,55,7,81,84,3
3243,https://htmlpreview.github.io/?https://github.com/Christina96/boilerplate-sample-matches/blob/main/C-beta/Adafruit_nRF52_Arduino-MDEwOlJlcG9zaXRvcnk3NDM1NDcyOQ==-flat-BLEClientUart.h-libfuse-MDEwOlJlcG9zaXRvcnk0ODI5NjE3Nw==-flat-fuse_lowlevel.c.html,0.02277294038847957,8,Adafruit_nRF52_Arduino-MDEwOlJlcG9zaXRvcnk3NDM1NDcyOQ==-flat-BLEClientUart.h,libfuse-MDEwOlJlcG9zaXRvcnk0ODI5NjE3Nw==-flat-fuse_lowlevel.c,17,19,2,524,529,5
10126,https://htmlpreview.github.io/?https://github.com/Christina96/boilerplate-sample-matches/blob/main/C-beta/xmrig-MDEwOlJlcG9zaXRvcnk4ODMyNzQwNg==-flat-CudaLib.h-redis-MDEwOlJlcG9zaXRvcnkxMDgxMTA3MDY=-flat-scripting.c.html,0.13135186960690318,12,xmrig-MDEwOlJlcG9zaXRvcnk4ODMyNzQwNg==-flat-CudaLib.h,redis-MDEwOlJlcG9zaXRvcnkxMDgxMTA3MDY=-flat-scripting.c,53,58,5,31,33,2
10433,https://htmlpreview.github.io/?https://github.com/Christina96/boilerplate-sample-matches/blob/main/C-beta/Adafruit_nRF52_Arduino-MDEwOlJlcG9zaXRvcnk3NDM1NDcyOQ==-flat-HardwareSerial.h-redis-MDEwOlJlcG9zaXRvcnkxMDgxMTA3MDY=-flat-dict.h.html,0.25225225225225223,14,Adafruit_nRF52_Arduino-MDEwOlJlcG9zaXRvcnk3NDM1NDcyOQ==-flat-HardwareSerial.h,redis-MDEwOlJlcG9zaXRvcnkxMDgxMTA3MDY=-flat-dict.h,20,23,3,12,14,2
13051,https://htmlpreview.github.io/?https://github.com/Christina96/boilerplate-sample-matches/blob/main/C-beta/Adafruit_nRF52_Arduino-MDEwOlJlcG9zaXRvcnk3NDM1NDcyOQ==-flat-nrf_sdm.h-Adafruit_nRF52_Arduino-MDEwOlJlcG9zaXRvcnk3NDM1NDcyOQ==-flat-nrf_nfct.h.html,0.2336578581363004,9,Adafruit_nRF52_Arduino-MDEwOlJlcG9zaXRvcnk3NDM1NDcyOQ==-flat-nrf_sdm.h,Adafruit_nRF52_Arduino-MDEwOlJlcG9zaXRvcnk3NDM1NDcyOQ==-flat-nrf_nfct.h,88,89,1,249,262,13
16756,https://htmlpreview.github.io/?https://github.com/Christina96/boilerplate-sample-matches/blob/main/C-beta/Adafruit_nRF52_Arduino-MDEwOlJlcG9zaXRvcnk3NDM1NDcyOQ==-flat-BLEClientCharacteristic.h-android-gpuimage-plus-MDEwOlJlcG9zaXRvcnk0NjU0NzQxNw==-flat-cgeThread.h.html,0.27299703264094954,15,Adafruit_nRF52_Arduino-MDEwOlJlcG9zaXRvcnk3NDM1NDcyOQ==-flat-BLEClientCharacteristic.h,android-gpuimage-plus-MDEwOlJlcG9zaXRvcnk0NjU0NzQxNw==-flat-cgeThread.h,17,21,4,109,117,8
18349,https://htmlpreview.github.io/?https://github.com/Christina96/boilerplate-sample-matches/blob/main/C-beta/fftw3-MDEwOlJlcG9zaXRvcnk4ODQzMzg4-flat-dftw-genericbuf.c-PINRemoteImage-MDEwOlJlcG9zaXRvcnkzOTUzNzEwMw==-flat-utils.c.html,0.0708955223880597,10,fftw3-MDEwOlJlcG9zaXRvcnk4ODQzMzg4-flat-dftw-genericbuf.c,PINRemoteImage-MDEwOlJlcG9zaXRvcnkzOTUzNzEwMw==-flat-utils.c,97,103,6,160,164,4
23353,https://htmlpreview.github.io/?https://github.com/Christina96/boilerplate-sample-matches/blob/main/C-beta/xmrig-MDEwOlJlcG9zaXRvcnk4ODMyNzQwNg==-flat-IConfigTransform.h-redis-MDEwOlJlcG9zaXRvcnkxMDgxMTA3MDY=-flat-notify.c.html,0.08648648648648649,8,xmrig-MDEwOlJlcG9zaXRvcnk4ODMyNzQwNg==-flat-IConfigTransform.h,redis-MDEwOlJlcG9zaXRvcnkxMDgxMTA3MDY=-flat-notify.c,12,12,0,44,47,3
25891,https://htmlpreview.github.io/?https://github.com/Christina96/boilerplate-sample-matches/blob/main/C-beta/Adafruit_nRF52_Arduino-MDEwOlJlcG9zaXRvcnk3NDM1NDcyOQ==-flat-ble_gatts_16.h-xmrig-MDEwOlJlcG9zaXRvcnk4ODMyNzQwNg==-flat-schema.h.html,0.0680725120236774,22,Adafruit_nRF52_Arduino-MDEwOlJlcG9zaXRvcnk3NDM1NDcyOQ==-flat-ble_gatts_16.h,xmrig-MDEwOlJlcG9zaXRvcnk4ODMyNzQwNg==-flat-schema.h,96,104,8,286,307,21
29887,https://htmlpreview.github.io/?https://github.com/Christina96/boilerplate-sample-matches/blob/main/C-beta/libtomcrypt-MDEwOlJlcG9zaXRvcnk3NzcwMTE=-flat-s_ocb_done.c-libtomcrypt-MDEwOlJlcG9zaXRvcnk3NzcwMTE=-flat-pbes2.c.html,0.08191126279863481,12,libtomcrypt-MDEwOlJlcG9zaXRvcnk3NzcwMTE=-flat-s_ocb_done.c,libtomcrypt-MDEwOlJlcG9zaXRvcnk3NzcwMTE=-flat-pbes2.c,4,16,12,59,67,8
33322,https://htmlpreview.github.io/?https://github.com/Christina96/boilerplate-sample-matches/blob/main/C-beta/Adafruit_nRF52_Arduino-MDEwOlJlcG9zaXRvcnk3NDM1NDcyOQ==-flat-ble_11.h-PINRemoteImage-MDEwOlJlcG9zaXRvcnkzOTUzNzEwMw==-flat-picture_psnr_enc.c.html,0.1225114854517611,11,Adafruit_nRF52_Arduino-MDEwOlJlcG9zaXRvcnk3NDM1NDcyOQ==-flat-ble_11.h,PINRemoteImage-MDEwOlJlcG9zaXRvcnkzOTUzNzEwMw==-flat-picture_psnr_enc.c,17,19,2,95,99,4
39268,https://htmlpreview.github.io/?https://github.com/Christina96/boilerplate-sample-matches/blob/main/C-beta/android-gpuimage-plus-MDEwOlJlcG9zaXRvcnk0NjU0NzQxNw==-flat-cgeHueAdjust.h-redis-MDEwOlJlcG9zaXRvcnkxMDgxMTA3MDY=-flat-lparser.h.html,0.11428571428571428,8,android-gpuimage-plus-MDEwOlJlcG9zaXRvcnk0NjU0NzQxNw==-flat-cgeHueAdjust.h,redis-MDEwOlJlcG9zaXRvcnkxMDgxMTA3MDY=-flat-lparser.h,15,19,4,29,30,1
44449,https://htmlpreview.github.io/?https://github.com/Christina96/boilerplate-sample-matches/blob/main/C-beta/android-gpuimage-plus-MDEwOlJlcG9zaXRvcnk0NjU0NzQxNw==-flat-cgeFrameRecorderWrapper.h-libpcap-MDEwOlJlcG9zaXRvcnk5NDM1ODg3-flat-usb.h.html,0.49696969696969695,16,android-gpuimage-plus-MDEwOlJlcG9zaXRvcnk0NjU0NzQxNw==-flat-cgeFrameRecorderWrapper.h,libpcap-MDEwOlJlcG9zaXRvcnk5NDM1ODg3-flat-usb.h,8,12,4,31,37,6
47481,https://htmlpreview.github.io/?https://github.com/Christina96/boilerplate-sample-matches/blob/main/C-beta/fftw3-MDEwOlJlcG9zaXRvcnk4ODQzMzg4-flat-problem2.c-PINRemoteImage-MDEwOlJlcG9zaXRvcnkzOTUzNzEwMw==-flat-anim_encode.c.html,0.06588498045784479,8,fftw3-MDEwOlJlcG9zaXRvcnk4ODQzMzg4-flat-problem2.c,PINRemoteImage-MDEwOlJlcG9zaXRvcnkzOTUzNzEwMw==-flat-anim_encode.c,21,27,6,275,280,5
51827,https://htmlpreview.github.io/?https://github.com/Christina96/boilerplate-sample-matches/blob/main/C-beta/xmrig-MDEwOlJlcG9zaXRvcnk4ODMyNzQwNg==-flat-BenchState.h-fftw3-MDEwOlJlcG9zaXRvcnk4ODQzMzg4-flat-genus.c.html,0.11027568922305764,11,xmrig-MDEwOlJlcG9zaXRvcnk4ODMyNzQwNg==-flat-BenchState.h,fftw3-MDEwOlJlcG9zaXRvcnk4ODQzMzg4-flat-genus.c,13,16,3,4,7,3
65075,https://htmlpreview.github.io/?https://github.com/Christina96/boilerplate-sample-matches/blob/main/C-beta/libtomcrypt-MDEwOlJlcG9zaXRvcnk3NzcwMTE=-flat-rsa_set.c-android-gpuimage-plus-MDEwOlJlcG9zaXRvcnk0NjU0NzQxNw==-flat-avstring.h.html,0.16580310880829016,8,libtomcrypt-MDEwOlJlcG9zaXRvcnk3NzcwMTE=-flat-rsa_set.c,android-gpuimage-plus-MDEwOlJlcG9zaXRvcnk0NjU0NzQxNw==-flat-avstring.h,45,50,5,9,11,2
73479,https://htmlpreview.github.io/?https://github.com/Christina96/boilerplate-sample-matches/blob/main/C-beta/android-gpuimage-plus-MDEwOlJlcG9zaXRvcnk0NjU0NzQxNw==-flat-sha.h-fftw3-MDEwOlJlcG9zaXRvcnk4ODQzMzg4-flat-ct.h.html,0.2962962962962963,12,android-gpuimage-plus-MDEwOlJlcG9zaXRvcnk0NjU0NzQxNw==-flat-sha.h,fftw3-MDEwOlJlcG9zaXRvcnk4ODQzMzg4-flat-ct.h,7,16,9,2,7,5
77076,https://htmlpreview.github.io/?https://github.com/Christina96/boilerplate-sample-matches/blob/main/C-beta/fftw3-MDEwOlJlcG9zaXRvcnk4ODQzMzg4-flat-dht-r2hc.c-PINRemoteImage-MDEwOlJlcG9zaXRvcnkzOTUzNzEwMw==-flat-filters_msa.c.html,0.10795454545454546,11,fftw3-MDEwOlJlcG9zaXRvcnk4ODQzMzg4-flat-dht-r2hc.c,PINRemoteImage-MDEwOlJlcG9zaXRvcnkzOTUzNzEwMw==-flat-filters_msa.c,62,68,6,64,70,6
93575,https://htmlpreview.github.io/?https://github.com/Christina96/boilerplate-sample-matches/blob/main/C-beta/fftw3-MDEwOlJlcG9zaXRvcnk4ODQzMzg4-flat-dft-vrank-geq1.c-redis-MDEwOlJlcG9zaXRvcnkxMDgxMTA3MDY=-flat-hiredis.c.html,0.12473423104181432,9,fftw3-MDEwOlJlcG9zaXRvcnk4ODQzMzg4-flat-dft-vrank-geq1.c,redis-MDEwOlJlcG9zaXRvcnkxMDgxMTA3MDY=-flat-hiredis.c,151,156,5,484,489,5
119909,https://htmlpreview.github.io/?https://github.com/Christina96/boilerplate-sample-matches/blob/main/C-beta/Adafruit_nRF52_Arduino-MDEwOlJlcG9zaXRvcnk3NDM1NDcyOQ==-flat-ble_l2cap.h-redis-MDEwOlJlcG9zaXRvcnkxMDgxMTA3MDY=-flat-t_string.c.html,0.04375,14,Adafruit_nRF52_Arduino-MDEwOlJlcG9zaXRvcnk3NDM1NDcyOQ==-flat-ble_l2cap.h,redis-MDEwOlJlcG9zaXRvcnkxMDgxMTA3MDY=-flat-t_string.c,28,30,2,15,16,1
121524,https://htmlpreview.github.io/?https://github.com/Christina96/boilerplate-sample-matches/blob/main/C-beta/PINRemoteImage-MDEwOlJlcG9zaXRvcnkzOTUzNzEwMw==-flat-enc.c-redis-MDEwOlJlcG9zaXRvcnkxMDgxMTA3MDY=-flat-arena.c.html,0.15114873035066506,9,PINRemoteImage-MDEwOlJlcG9zaXRvcnkzOTUzNzEwMw==-flat-enc.c,redis-MDEwOlJlcG9zaXRvcnkxMDgxMTA3MDY=-flat-arena.c,570,576,6,1666,1676,10
132165,https://htmlpreview.github.io/?https://github.com/Christina96/boilerplate-sample-matches/blob/main/C-beta/Adafruit_nRF52_Arduino-MDEwOlJlcG9zaXRvcnk3NDM1NDcyOQ==-flat-debug.h-Adafruit_nRF52_Arduino-MDEwOlJlcG9zaXRvcnk3NDM1NDcyOQ==-flat-nrfbintool.c.html,0.16666666666666666,9,Adafruit_nRF52_Arduino-MDEwOlJlcG9zaXRvcnk3NDM1NDcyOQ==-flat-debug.h,Adafruit_nRF52_Arduino-MDEwOlJlcG9zaXRvcnk3NDM1NDcyOQ==-flat-nrfbintool.c,8,16,8,21,28,7
149046,https://htmlpreview.github.io/?https://github.com/Christina96/boilerplate-sample-matches/blob/main/C-beta/Adafruit_nRF52_Arduino-MDEwOlJlcG9zaXRvcnk3NDM1NDcyOQ==-flat-lfs.c-redis-MDEwOlJlcG9zaXRvcnkxMDgxMTA3MDY=-flat-server.c.html,0.0790273556231003,9,Adafruit_nRF52_Arduino-MDEwOlJlcG9zaXRvcnk3NDM1NDcyOQ==-flat-lfs.c,redis-MDEwOlJlcG9zaXRvcnkxMDgxMTA3MDY=-flat-server.c,51,54,3,466,471,5
157085,https://htmlpreview.github.io/?https://github.com/Christina96/boilerplate-sample-matches/blob/main/C-beta/libtomcrypt-MDEwOlJlcG9zaXRvcnk3NzcwMTE=-flat-whirl.c-redis-MDEwOlJlcG9zaXRvcnkxMDgxMTA3MDY=-flat-arena_inlines_b.h.html,0.050793650793650794,8,libtomcrypt-MDEwOlJlcG9zaXRvcnk3NzcwMTE=-flat-whirl.c,redis-MDEwOlJlcG9zaXRvcnkxMDgxMTA3MDY=-flat-arena_inlines_b.h,180,186,6,157,163,6
158753,https://htmlpreview.github.io/?https://github.com/Christina96/boilerplate-sample-matches/blob/main/C-beta/PINRemoteImage-MDEwOlJlcG9zaXRvcnkzOTUzNzEwMw==-flat-filters_sse2.c-PINRemoteImage-MDEwOlJlcG9zaXRvcnkzOTUzNzEwMw==-flat-lossless_enc_sse2.c.html,0.3430508474576271,11,PINRemoteImage-MDEwOlJlcG9zaXRvcnkzOTUzNzEwMw==-flat-filters_sse2.c,PINRemoteImage-MDEwOlJlcG9zaXRvcnkzOTUzNzEwMw==-flat-lossless_enc_sse2.c,250,259,9,541,550,9
159283,https://htmlpreview.github.io/?https://github.com/Christina96/boilerplate-sample-matches/blob/main/C-beta/xmrig-MDEwOlJlcG9zaXRvcnk4ODMyNzQwNg==-flat-api.c-redis-MDEwOlJlcG9zaXRvcnkxMDgxMTA3MDY=-flat-rax.c.html,0.06454720616570328,9,xmrig-MDEwOlJlcG9zaXRvcnk4ODMyNzQwNg==-flat-api.c,redis-MDEwOlJlcG9zaXRvcnkxMDgxMTA3MDY=-flat-rax.c,75,80,5,648,654,6
160251,https://htmlpreview.github.io/?https://github.com/Christina96/boilerplate-sample-matches/blob/main/C-beta/fftw3-MDEwOlJlcG9zaXRvcnk4ODQzMzg4-flat-transpose.c-PINRemoteImage-MDEwOlJlcG9zaXRvcnkzOTUzNzEwMw==-flat-enc_sse2.c.html,0.04592045920459205,8,fftw3-MDEwOlJlcG9zaXRvcnk4ODQzMzg4-flat-transpose.c,PINRemoteImage-MDEwOlJlcG9zaXRvcnkzOTUzNzEwMw==-flat-enc_sse2.c,49,53,4,520,524,4
160510,https://htmlpreview.github.io/?https://github.com/Christina96/boilerplate-sample-matches/blob/main/C-beta/libpcap-MDEwOlJlcG9zaXRvcnk5NDM1ODg3-flat-pcap-pf.c-small-MDEwOlJlcG9zaXRvcnkyNTY3NjMxNjk=-flat-resolv.c.html,0.08709175738724728,20,libpcap-MDEwOlJlcG9zaXRvcnk5NDM1ODg3-flat-pcap-pf.c,small-MDEwOlJlcG9zaXRvcnkyNTY3NjMxNjk=-flat-resolv.c,37,42,5,38,47,9
161002,https://htmlpreview.github.io/?https://github.com/Christina96/boilerplate-sample-matches/blob/main/C-beta/PINRemoteImage-MDEwOlJlcG9zaXRvcnkzOTUzNzEwMw==-flat-vp8_dec.c-PINRemoteImage-MDEwOlJlcG9zaXRvcnkzOTUzNzEwMw==-flat-lossless_sse2.c.html,0.09217101610216547,8,PINRemoteImage-MDEwOlJlcG9zaXRvcnkzOTUzNzEwMw==-flat-vp8_dec.c,PINRemoteImage-MDEwOlJlcG9zaXRvcnkzOTUzNzEwMw==-flat-lossless_sse2.c,141,145,4,19,24,5
161810,https://htmlpreview.github.io/?https://github.com/Christina96/boilerplate-sample-matches/blob/main/C-beta/PINRemoteImage-MDEwOlJlcG9zaXRvcnkzOTUzNzEwMw==-flat-PINRemoteImageManager+Private.h-PINRemoteImage-MDEwOlJlcG9zaXRvcnkzOTUzNzEwMw==-flat-imageio_util.h.html,0.6923076923076923,9,PINRemoteImage-MDEwOlJlcG9zaXRvcnkzOTUzNzEwMw==-flat-PINRemoteImageManager+Private.h,PINRemoteImage-MDEwOlJlcG9zaXRvcnkzOTUzNzEwMw==-flat-imageio_util.h,4,13,9,8,13,5
163827,https://htmlpreview.github.io/?https://github.com/Christina96/boilerplate-sample-matches/blob/main/C-beta/PINRemoteImage-MDEwOlJlcG9zaXRvcnkzOTUzNzEwMw==-flat-yuv_sse2.c-xmrig-MDEwOlJlcG9zaXRvcnk4ODMyNzQwNg==-flat-crypto-ops.c.html,0.1107107762856207,14,PINRemoteImage-MDEwOlJlcG9zaXRvcnkzOTUzNzEwMw==-flat-yuv_sse2.c,xmrig-MDEwOlJlcG9zaXRvcnk4ODMyNzQwNg==-flat-crypto-ops.c,108,116,8,999,1004,5
182579,https://htmlpreview.github.io/?https://github.com/Christina96/boilerplate-sample-matches/blob/main/C-beta/libtomcrypt-MDEwOlJlcG9zaXRvcnk3NzcwMTE=-flat-padding_test.c-PINRemoteImage-MDEwOlJlcG9zaXRvcnkzOTUzNzEwMw==-flat-vp8l_enc.c.html,0.08428446005267778,13,libtomcrypt-MDEwOlJlcG9zaXRvcnk3NzcwMTE=-flat-padding_test.c,PINRemoteImage-MDEwOlJlcG9zaXRvcnkzOTUzNzEwMw==-flat-vp8l_enc.c,101,106,5,232,237,5
187211,https://htmlpreview.github.io/?https://github.com/Christina96/boilerplate-sample-matches/blob/main/C-beta/libpcap-MDEwOlJlcG9zaXRvcnk5NDM1ODg3-flat-pcap-bt-linux.c-Adafruit_nRF52_Arduino-MDEwOlJlcG9zaXRvcnk3NDM1NDcyOQ==-flat-nrf_radio.h.html,0.09781477627471384,8,libpcap-MDEwOlJlcG9zaXRvcnk5NDM1ODg3-flat-pcap-bt-linux.c,Adafruit_nRF52_Arduino-MDEwOlJlcG9zaXRvcnk3NDM1NDcyOQ==-flat-nrf_radio.h,132,138,6,137,149,12
190936,https://htmlpreview.github.io/?https://github.com/Christina96/boilerplate-sample-matches/blob/main/C-beta/Adafruit_nRF52_Arduino-MDEwOlJlcG9zaXRvcnk3NDM1NDcyOQ==-flat-queue.c-PINRemoteImage-MDEwOlJlcG9zaXRvcnkzOTUzNzEwMw==-flat-enc_neon.c.html,0.15069398545935228,8,Adafruit_nRF52_Arduino-MDEwOlJlcG9zaXRvcnk3NDM1NDcyOQ==-flat-queue.c,PINRemoteImage-MDEwOlJlcG9zaXRvcnkzOTUzNzEwMw==-flat-enc_neon.c,233,239,6,311,319,8
192735,https://htmlpreview.github.io/?https://github.com/Christina96/boilerplate-sample-matches/blob/main/C-beta/xmrig-MDEwOlJlcG9zaXRvcnk4ODMyNzQwNg==-flat-Client.h-small-MDEwOlJlcG9zaXRvcnkyNTY3NjMxNjk=-flat-acl.c.html,0.03758389261744966,14,xmrig-MDEwOlJlcG9zaXRvcnk4ODMyNzQwNg==-flat-Client.h,small-MDEwOlJlcG9zaXRvcnkyNTY3NjMxNjk=-flat-acl.c,91,98,7,26,37,11
204222,https://htmlpreview.github.io/?https://github.com/Christina96/boilerplate-sample-matches/blob/main/C-beta/libpcap-MDEwOlJlcG9zaXRvcnk5NDM1ODg3-flat-pcap_0.h-xmrig-MDEwOlJlcG9zaXRvcnk4ODMyNzQwNg==-flat-topology-windows.c.html,0.12174940898345153,13,libpcap-MDEwOlJlcG9zaXRvcnk5NDM1ODg3-flat-pcap_0.h,xmrig-MDEwOlJlcG9zaXRvcnk4ODMyNzQwNg==-flat-topology-windows.c,65,69,4,615,624,9
206126,https://htmlpreview.github.io/?https://github.com/Christina96/boilerplate-sample-matches/blob/main/C-beta/fftw3-MDEwOlJlcG9zaXRvcnk4ODQzMzg4-flat-transpose.c-redis-MDEwOlJlcG9zaXRvcnkxMDgxMTA3MDY=-flat-hiredis.c.html,0.08112094395280237,10,fftw3-MDEwOlJlcG9zaXRvcnk4ODQzMzg4-flat-transpose.c,redis-MDEwOlJlcG9zaXRvcnkxMDgxMTA3MDY=-flat-hiredis.c,19,25,6,150,153,3
206810,https://htmlpreview.github.io/?https://github.com/Christina96/boilerplate-sample-matches/blob/main/C-beta/libtomcrypt-MDEwOlJlcG9zaXRvcnk3NzcwMTE=-flat-tfm_desc.c-Adafruit_nRF52_Arduino-MDEwOlJlcG9zaXRvcnk3NDM1NDcyOQ==-flat-nrf51_erratas.h.html,0.01033434650455927,9,libtomcrypt-MDEwOlJlcG9zaXRvcnk3NzcwMTE=-flat-tfm_desc.c,Adafruit_nRF52_Arduino-MDEwOlJlcG9zaXRvcnk3NDM1NDcyOQ==-flat-nrf51_erratas.h,448,452,4,6,14,8
210279,https://htmlpreview.github.io/?https://github.com/Christina96/boilerplate-sample-matches/blob/main/C-beta/Adafruit_nRF52_Arduino-MDEwOlJlcG9zaXRvcnk3NDM1NDcyOQ==-flat-nrfx_usbd.h-Adafruit_nRF52_Arduino-MDEwOlJlcG9zaXRvcnk3NDM1NDcyOQ==-flat-nrf_gpio.h.html,0.2866779089376054,44,Adafruit_nRF52_Arduino-MDEwOlJlcG9zaXRvcnk3NDM1NDcyOQ==-flat-nrfx_usbd.h,Adafruit_nRF52_Arduino-MDEwOlJlcG9zaXRvcnk3NDM1NDcyOQ==-flat-nrf_gpio.h,145,186,41,85,122,37
239717,https://htmlpreview.github.io/?https://github.com/Christina96/boilerplate-sample-matches/blob/main/C-beta/xmrig-MDEwOlJlcG9zaXRvcnk4ODMyNzQwNg==-flat-opencl.h-PINRemoteImage-MDEwOlJlcG9zaXRvcnkzOTUzNzEwMw==-flat-webp_enc.c.html,0.07966457023060797,9,xmrig-MDEwOlJlcG9zaXRvcnk4ODMyNzQwNg==-flat-opencl.h,PINRemoteImage-MDEwOlJlcG9zaXRvcnkzOTUzNzEwMw==-flat-webp_enc.c,56,64,8,225,231,6
241932,https://htmlpreview.github.io/?https://github.com/Christina96/boilerplate-sample-matches/blob/main/C-beta/android-gpuimage-plus-MDEwOlJlcG9zaXRvcnk0NjU0NzQxNw==-flat-cgeVideoUtils.h-fftw3-MDEwOlJlcG9zaXRvcnk4ODQzMzg4-flat-conf_3.c.html,0.46153846153846156,9,android-gpuimage-plus-MDEwOlJlcG9zaXRvcnk0NjU0NzQxNw==-flat-cgeVideoUtils.h,fftw3-MDEwOlJlcG9zaXRvcnk4ODQzMzg4-flat-conf_3.c,8,8,0,6,15,9
246739,https://htmlpreview.github.io/?https://github.com/Christina96/boilerplate-sample-matches/blob/main/C-beta/xmrig-MDEwOlJlcG9zaXRvcnk4ODMyNzQwNg==-flat-bitmap.c-libpcap-MDEwOlJlcG9zaXRvcnk5NDM1ODg3-flat-sf-pcap.c.html,0.11624834874504623,8,xmrig-MDEwOlJlcG9zaXRvcnk4ODMyNzQwNg==-flat-bitmap.c,libpcap-MDEwOlJlcG9zaXRvcnk5NDM1ODg3-flat-sf-pcap.c,123,128,5,194,200,6
246756,https://htmlpreview.github.io/?https://github.com/Christina96/boilerplate-sample-matches/blob/main/C-beta/fftw3-MDEwOlJlcG9zaXRvcnk4ODQzMzg4-flat-n.c-redis-MDEwOlJlcG9zaXRvcnkxMDgxMTA3MDY=-flat-stats.c.html,0.05860805860805861,8,fftw3-MDEwOlJlcG9zaXRvcnk4ODQzMzg4-flat-n.c,redis-MDEwOlJlcG9zaXRvcnkxMDgxMTA3MDY=-flat-stats.c,3,6,3,23,30,7
261106,https://htmlpreview.github.io/?https://github.com/Christina96/boilerplate-sample-matches/blob/main/C-beta/Adafruit_nRF52_Arduino-MDEwOlJlcG9zaXRvcnk3NDM1NDcyOQ==-flat-flash_cache.c-PINRemoteImage-MDEwOlJlcG9zaXRvcnkzOTUzNzEwMw==-flat-quant_enc.c.html,0.036709721278042146,10,Adafruit_nRF52_Arduino-MDEwOlJlcG9zaXRvcnk3NDM1NDcyOQ==-flat-flash_cache.c,PINRemoteImage-MDEwOlJlcG9zaXRvcnkzOTUzNzEwMw==-flat-quant_enc.c,12,16,4,540,549,9
262779,https://htmlpreview.github.io/?https://github.com/Christina96/boilerplate-sample-matches/blob/main/C-beta/redis-MDEwOlJlcG9zaXRvcnkxMDgxMTA3MDY=-flat-tsd.h-Adafruit_nRF52_Arduino-MDEwOlJlcG9zaXRvcnk3NDM1NDcyOQ==-flat-WString.h.html,0.15241057542768274,8,redis-MDEwOlJlcG9zaXRvcnkxMDgxMTA3MDY=-flat-tsd.h,Adafruit_nRF52_Arduino-MDEwOlJlcG9zaXRvcnk3NDM1NDcyOQ==-flat-WString.h,79,86,7,25,26,1
268117,https://htmlpreview.github.io/?https://github.com/Christina96/boilerplate-sample-matches/blob/main/C-beta/redis-MDEwOlJlcG9zaXRvcnkxMDgxMTA3MDY=-flat-ldump.c-libpcap-MDEwOlJlcG9zaXRvcnk5NDM1ODg3-flat-pcap-sita.c.html,0.04758999389871873,8,redis-MDEwOlJlcG9zaXRvcnkxMDgxMTA3MDY=-flat-ldump.c,libpcap-MDEwOlJlcG9zaXRvcnk5NDM1ODg3-flat-pcap-sita.c,37,39,2,276,279,3
273169,https://htmlpreview.github.io/?https://github.com/Christina96/boilerplate-sample-matches/blob/main/C-beta/Adafruit_nRF52_Arduino-MDEwOlJlcG9zaXRvcnk3NDM1NDcyOQ==-flat-ble_gatt_19.h-xmrig-MDEwOlJlcG9zaXRvcnk4ODMyNzQwNg==-flat-topology-synthetic.c.html,0.050816696914700546,8,Adafruit_nRF52_Arduino-MDEwOlJlcG9zaXRvcnk3NDM1NDcyOQ==-flat-ble_gatt_19.h,xmrig-MDEwOlJlcG9zaXRvcnk4ODMyNzQwNg==-flat-topology-synthetic.c,109,110,1,12,16,4
290936,https://htmlpreview.github.io/?https://github.com/Christina96/boilerplate-sample-matches/blob/main/C-beta/PINRemoteImage-MDEwOlJlcG9zaXRvcnkzOTUzNzEwMw==-flat-rescaler_utils.c-PINRemoteImage-MDEwOlJlcG9zaXRvcnkzOTUzNzEwMw==-flat-yuv.h.html,0.16338028169014085,10,PINRemoteImage-MDEwOlJlcG9zaXRvcnkzOTUzNzEwMw==-flat-rescaler_utils.c,PINRemoteImage-MDEwOlJlcG9zaXRvcnkzOTUzNzEwMw==-flat-yuv.h,44,54,10,39,43,4
291166,https://htmlpreview.github.io/?https://github.com/Christina96/boilerplate-sample-matches/blob/main/C-beta/libtomcrypt-MDEwOlJlcG9zaXRvcnk3NzcwMTE=-flat-xcbc_done.c-libtomcrypt-MDEwOlJlcG9zaXRvcnk3NzcwMTE=-flat-der_encode_ia5_string.c.html,0.2702702702702703,10,libtomcrypt-MDEwOlJlcG9zaXRvcnk3NzcwMTE=-flat-xcbc_done.c,libtomcrypt-MDEwOlJlcG9zaXRvcnk3NzcwMTE=-flat-der_encode_ia5_string.c,3,11,8,4,14,10
304046,https://htmlpreview.github.io/?https://github.com/Christina96/boilerplate-sample-matches/blob/main/C-beta/libtomcrypt-MDEwOlJlcG9zaXRvcnk3NzcwMTE=-flat-pkcs_1_oaep_encode.c-PINRemoteImage-MDEwOlJlcG9zaXRvcnkzOTUzNzEwMw==-flat-enc_mips32.c.html,0.03836930455635491,8,libtomcrypt-MDEwOlJlcG9zaXRvcnk3NzcwMTE=-flat-pkcs_1_oaep_encode.c,PINRemoteImage-MDEwOlJlcG9zaXRvcnkzOTUzNzEwMw==-flat-enc_mips32.c,3,6,3,82,88,6
316561,https://htmlpreview.github.io/?https://github.com/Christina96/boilerplate-sample-matches/blob/main/C-beta/xmrig-MDEwOlJlcG9zaXRvcnk4ODMyNzQwNg==-flat-Config.h-redis-MDEwOlJlcG9zaXRvcnkxMDgxMTA3MDY=-flat-geohash_helper_33.h.html,0.2564102564102564,10,xmrig-MDEwOlJlcG9zaXRvcnk4ODMyNzQwNg==-flat-Config.h,redis-MDEwOlJlcG9zaXRvcnkxMDgxMTA3MDY=-flat-geohash_helper_33.h,57,61,4,14,19,5
322579,https://htmlpreview.github.io/?https://github.com/Christina96/boilerplate-sample-matches/blob/main/C-beta/fftw3-MDEwOlJlcG9zaXRvcnk4ODQzMzg4-flat-export-wisdom.c-Adafruit_nRF52_Arduino-MDEwOlJlcG9zaXRvcnk3NDM1NDcyOQ==-flat-queue.c.html,0.03397027600849257,8,fftw3-MDEwOlJlcG9zaXRvcnk4ODQzMzg4-flat-export-wisdom.c,Adafruit_nRF52_Arduino-MDEwOlJlcG9zaXRvcnk3NDM1NDcyOQ==-flat-queue.c,11,14,3,127,131,4
332429,https://htmlpreview.github.io/?https://github.com/Christina96/boilerplate-sample-matches/blob/main/C-beta/Adafruit_nRF52_Arduino-MDEwOlJlcG9zaXRvcnk3NDM1NDcyOQ==-flat-debug.h-Adafruit_nRF52_Arduino-MDEwOlJlcG9zaXRvcnk3NDM1NDcyOQ==-flat-nrf_rng.h.html,0.28346456692913385,9,Adafruit_nRF52_Arduino-MDEwOlJlcG9zaXRvcnk3NDM1NDcyOQ==-flat-debug.h,Adafruit_nRF52_Arduino-MDEwOlJlcG9zaXRvcnk3NDM1NDcyOQ==-flat-nrf_rng.h,8,16,8,34,40,6
332590,https://htmlpreview.github.io/?https://github.com/Christina96/boilerplate-sample-matches/blob/main/C-beta/fftw3-MDEwOlJlcG9zaXRvcnk4ODQzMzg4-flat-print.c-PINRemoteImage-MDEwOlJlcG9zaXRvcnkzOTUzNzEwMw==-flat-histogram_enc.c.html,0.05670103092783505,9,fftw3-MDEwOlJlcG9zaXRvcnk4ODQzMzg4-flat-print.c,PINRemoteImage-MDEwOlJlcG9zaXRvcnkzOTUzNzEwMw==-flat-histogram_enc.c,184,190,6,215,221,6
334730,https://htmlpreview.github.io/?https://github.com/Christina96/boilerplate-sample-matches/blob/main/C-beta/xmrig-MDEwOlJlcG9zaXRvcnk4ODMyNzQwNg==-flat-sph_skein.c-redis-MDEwOlJlcG9zaXRvcnkxMDgxMTA3MDY=-flat-replication.c.html,0.06951484431571325,12,xmrig-MDEwOlJlcG9zaXRvcnk4ODMyNzQwNg==-flat-sph_skein.c,redis-MDEwOlJlcG9zaXRvcnkxMDgxMTA3MDY=-flat-replication.c,773,781,8,96,102,6
340566,https://htmlpreview.github.io/?https://github.com/Christina96/boilerplate-sample-matches/blob/main/C-beta/Adafruit_nRF52_Arduino-MDEwOlJlcG9zaXRvcnk3NDM1NDcyOQ==-flat-SEGGER_SYSVIEW.h-xmrig-MDEwOlJlcG9zaXRvcnk4ODMyNzQwNg==-flat-sph_fugue.c.html,0.12261217236783652,9,Adafruit_nRF52_Arduino-MDEwOlJlcG9zaXRvcnk3NDM1NDcyOQ==-flat-SEGGER_SYSVIEW.h,xmrig-MDEwOlJlcG9zaXRvcnk4ODMyNzQwNg==-flat-sph_fugue.c,131,135,4,732,732,0
341485,https://htmlpreview.github.io/?https://github.com/Christina96/boilerplate-sample-matches/blob/main/C-beta/android-gpuimage-plus-MDEwOlJlcG9zaXRvcnk0NjU0NzQxNw==-flat-cgePolarPixellateFilter.h-fftw3-MDEwOlJlcG9zaXRvcnk4ODQzMzg4-flat-dftw-direct.c.html,0.06753246753246753,13,android-gpuimage-plus-MDEwOlJlcG9zaXRvcnk0NjU0NzQxNw==-flat-cgePolarPixellateFilter.h,fftw3-MDEwOlJlcG9zaXRvcnk4ODQzMzg4-flat-dftw-direct.c,15,20,5,102,107,5
352783,https://htmlpreview.github.io/?https://github.com/Christina96/boilerplate-sample-matches/blob/main/C-beta/Adafruit_nRF52_Arduino-MDEwOlJlcG9zaXRvcnk3NDM1NDcyOQ==-flat-BLEService.h-Adafruit_nRF52_Arduino-MDEwOlJlcG9zaXRvcnk3NDM1NDcyOQ==-flat-BLEDiscovery.h.html,0.36548223350253806,28,Adafruit_nRF52_Arduino-MDEwOlJlcG9zaXRvcnk3NDM1NDcyOQ==-flat-BLEService.h,Adafruit_nRF52_Arduino-MDEwOlJlcG9zaXRvcnk3NDM1NDcyOQ==-flat-BLEDiscovery.h,5,21,16,9,22,13
355942,https://htmlpreview.github.io/?https://github.com/Christina96/boilerplate-sample-matches/blob/main/C-beta/PINRemoteImage-MDEwOlJlcG9zaXRvcnkzOTUzNzEwMw==-flat-filters_mips_dsp_r2.c-redis-MDEwOlJlcG9zaXRvcnkxMDgxMTA3MDY=-flat-large.c.html,0.16420361247947454,8,PINRemoteImage-MDEwOlJlcG9zaXRvcnkzOTUzNzEwMw==-flat-filters_mips_dsp_r2.c,redis-MDEwOlJlcG9zaXRvcnkxMDgxMTA3MDY=-flat-large.c,228,233,5,262,266,4
360974,https://htmlpreview.github.io/?https://github.com/Christina96/boilerplate-sample-matches/blob/main/C-beta/xmrig-MDEwOlJlcG9zaXRvcnk4ODMyNzQwNg==-flat-Network.h-libpcap-MDEwOlJlcG9zaXRvcnk5NDM1ODg3-flat-pcap-snit.c.html,0.04819277108433735,8,xmrig-MDEwOlJlcG9zaXRvcnk4ODMyNzQwNg==-flat-Network.h,libpcap-MDEwOlJlcG9zaXRvcnk5NDM1ODg3-flat-pcap-snit.c,43,48,5,272,275,3
361777,https://htmlpreview.github.io/?https://github.com/Christina96/boilerplate-sample-matches/blob/main/C-beta/libfuse-MDEwOlJlcG9zaXRvcnk0ODI5NjE3Nw==-flat-fuse_i.h-PINRemoteImage-MDEwOlJlcG9zaXRvcnkzOTUzNzEwMw==-flat-mux_22.h.html,0.5357142857142857,9,libfuse-MDEwOlJlcG9zaXRvcnk0ODI5NjE3Nw==-flat-fuse_i.h,PINRemoteImage-MDEwOlJlcG9zaXRvcnkzOTUzNzEwMw==-flat-mux_22.h,95,99,4,45,50,5
368703,https://htmlpreview.github.io/?https://github.com/Christina96/boilerplate-sample-matches/blob/main/C-beta/redis-MDEwOlJlcG9zaXRvcnkxMDgxMTA3MDY=-flat-binshard.c-redis-MDEwOlJlcG9zaXRvcnkxMDgxMTA3MDY=-flat-t_stream.c.html,0.02339595887982985,11,redis-MDEwOlJlcG9zaXRvcnkxMDgxMTA3MDY=-flat-binshard.c,redis-MDEwOlJlcG9zaXRvcnkxMDgxMTA3MDY=-flat-t_stream.c,79,89,10,663,666,3
376137,https://htmlpreview.github.io/?https://github.com/Christina96/boilerplate-sample-matches/blob/main/C-beta/android-gpuimage-plus-MDEwOlJlcG9zaXRvcnk0NjU0NzQxNw==-flat-cgeMat.h-PINRemoteImage-MDEwOlJlcG9zaXRvcnkzOTUzNzEwMw==-flat-picture_csp_enc.c.html,0.2645273200346921,8,android-gpuimage-plus-MDEwOlJlcG9zaXRvcnk0NjU0NzQxNw==-flat-cgeMat.h,PINRemoteImage-MDEwOlJlcG9zaXRvcnkzOTUzNzEwMw==-flat-picture_csp_enc.c,307,312,5,287,290,3
384811,https://htmlpreview.github.io/?https://github.com/Christina96/boilerplate-sample-matches/blob/main/C-beta/PINRemoteImage-MDEwOlJlcG9zaXRvcnkzOTUzNzEwMw==-flat-quant_levels_dec_utils.c-Adafruit_nRF52_Arduino-MDEwOlJlcG9zaXRvcnk3NDM1NDcyOQ==-flat-nrf_i2s.h.html,0.14576271186440679,9,PINRemoteImage-MDEwOlJlcG9zaXRvcnkzOTUzNzEwMw==-flat-quant_levels_dec_utils.c,Adafruit_nRF52_Arduino-MDEwOlJlcG9zaXRvcnk3NDM1NDcyOQ==-flat-nrf_i2s.h,153,156,3,273,280,7
390612,https://htmlpreview.github.io/?https://github.com/Christina96/boilerplate-sample-matches/blob/main/C-beta/PINRemoteImage-MDEwOlJlcG9zaXRvcnkzOTUzNzEwMw==-flat-decode_39.h-fftw3-MDEwOlJlcG9zaXRvcnk4ODQzMzg4-flat-genus.c.html,0.4863123993558776,8,PINRemoteImage-MDEwOlJlcG9zaXRvcnkzOTUzNzEwMw==-flat-decode_39.h,fftw3-MDEwOlJlcG9zaXRvcnk4ODQzMzg4-flat-genus.c,139,140,1,249,251,2
391813,https://htmlpreview.github.io/?https://github.com/Christina96/boilerplate-sample-matches/blob/main/C-beta/libtomcrypt-MDEwOlJlcG9zaXRvcnk3NzcwMTE=-flat-ltc_ecc_points.c-xmrig-MDEwOlJlcG9zaXRvcnk4ODMyNzQwNg==-flat-sph_luffa.c.html,0.026490066225165563,8,libtomcrypt-MDEwOlJlcG9zaXRvcnk3NzcwMTE=-flat-ltc_ecc_points.c,xmrig-MDEwOlJlcG9zaXRvcnk4ODMyNzQwNg==-flat-sph_luffa.c,21,25,4,1017,1022,5
400589,https://htmlpreview.github.io/?https://github.com/Christina96/boilerplate-sample-matches/blob/main/C-beta/android-gpuimage-plus-MDEwOlJlcG9zaXRvcnk0NjU0NzQxNw==-flat-cgeGLFunctions.h-PINRemoteImage-MDEwOlJlcG9zaXRvcnkzOTUzNzEwMw==-flat-enc_mips32.c.html,0.17993079584775087,8,android-gpuimage-plus-MDEwOlJlcG9zaXRvcnk0NjU0NzQxNw==-flat-cgeGLFunctions.h,PINRemoteImage-MDEwOlJlcG9zaXRvcnkzOTUzNzEwMw==-flat-enc_mips32.c,153,160,7,82,88,6
405328,https://htmlpreview.github.io/?https://github.com/Christina96/boilerplate-sample-matches/blob/main/C-beta/xmrig-MDEwOlJlcG9zaXRvcnk4ODMyNzQwNg==-flat-encodings.h-PINRemoteImage-MDEwOlJlcG9zaXRvcnkzOTUzNzEwMw==-flat-picture_csp_enc.c.html,0.019382192610539067,8,xmrig-MDEwOlJlcG9zaXRvcnk4ODMyNzQwNg==-flat-encodings.h,PINRemoteImage-MDEwOlJlcG9zaXRvcnkzOTUzNzEwMw==-flat-picture_csp_enc.c,202,205,3,213,217,4
408902,https://htmlpreview.github.io/?https://github.com/Christina96/boilerplate-sample-matches/blob/main/C-beta/android-gpuimage-plus-MDEwOlJlcG9zaXRvcnk0NjU0NzQxNw==-flat-vaapi.h-small-MDEwOlJlcG9zaXRvcnkyNTY3NjMxNjk=-flat-json.h.html,0.3711340206185567,8,android-gpuimage-plus-MDEwOlJlcG9zaXRvcnk0NjU0NzQxNw==-flat-vaapi.h,small-MDEwOlJlcG9zaXRvcnkyNTY3NjMxNjk=-flat-json.h,19,24,5,29,36,7
410581,https://htmlpreview.github.io/?https://github.com/Christina96/boilerplate-sample-matches/blob/main/C-beta/fftw3-MDEwOlJlcG9zaXRvcnk4ODQzMzg4-flat-scan.c-redis-MDEwOlJlcG9zaXRvcnkxMDgxMTA3MDY=-flat-zone.c.html,0.05,8,fftw3-MDEwOlJlcG9zaXRvcnk4ODQzMzg4-flat-scan.c,redis-MDEwOlJlcG9zaXRvcnkxMDgxMTA3MDY=-flat-zone.c,23,28,5,278,284,6
420093,https://htmlpreview.github.io/?https://github.com/Christina96/boilerplate-sample-matches/blob/main/C-beta/fftw3-MDEwOlJlcG9zaXRvcnk4ODQzMzg4-flat-plan-guru-dft-r2c.h-fftw3-MDEwOlJlcG9zaXRvcnk4ODQzMzg4-flat-mpi-bench.c.html,0.04699738903394256,9,fftw3-MDEwOlJlcG9zaXRvcnk4ODQzMzg4-flat-plan-guru-dft-r2c.h,fftw3-MDEwOlJlcG9zaXRvcnk4ODQzMzg4-flat-mpi-bench.c,3,8,5,130,133,3
420666,https://htmlpreview.github.io/?https://github.com/Christina96/boilerplate-sample-matches/blob/main/C-beta/libtomcrypt-MDEwOlJlcG9zaXRvcnk3NzcwMTE=-flat-dsa_sign_hash.c-Adafruit_nRF52_Arduino-MDEwOlJlcG9zaXRvcnk3NDM1NDcyOQ==-flat-nrf_spim.h.html,0.08492569002123142,9,libtomcrypt-MDEwOlJlcG9zaXRvcnk3NzcwMTE=-flat-dsa_sign_hash.c,Adafruit_nRF52_Arduino-MDEwOlJlcG9zaXRvcnk3NDM1NDcyOQ==-flat-nrf_spim.h,55,60,5,64,72,8
425199,https://htmlpreview.github.io/?https://github.com/Christina96/boilerplate-sample-matches/blob/main/C-beta/redis-MDEwOlJlcG9zaXRvcnkxMDgxMTA3MDY=-flat-hiredis.c-PINRemoteImage-MDEwOlJlcG9zaXRvcnkzOTUzNzEwMw==-flat-enc_msa.c.html,0.10083532219570406,8,redis-MDEwOlJlcG9zaXRvcnkxMDgxMTA3MDY=-flat-hiredis.c,PINRemoteImage-MDEwOlJlcG9zaXRvcnkzOTUzNzEwMw==-flat-enc_msa.c,766,769,3,265,267,2
440493,https://htmlpreview.github.io/?https://github.com/Christina96/boilerplate-sample-matches/blob/main/C-beta/redis-MDEwOlJlcG9zaXRvcnkxMDgxMTA3MDY=-flat-ctl.h-libtomcrypt-MDEwOlJlcG9zaXRvcnk3NzcwMTE=-flat-tomcrypt_cipher.h.html,0.136986301369863,10,redis-MDEwOlJlcG9zaXRvcnkxMDgxMTA3MDY=-flat-ctl.h,libtomcrypt-MDEwOlJlcG9zaXRvcnk3NzcwMTE=-flat-tomcrypt_cipher.h,33,42,9,220,234,14
441089,https://htmlpreview.github.io/?https://github.com/Christina96/boilerplate-sample-matches/blob/main/C-beta/xmrig-MDEwOlJlcG9zaXRvcnk4ODMyNzQwNg==-flat-bitmap.c-xmrig-MDEwOlJlcG9zaXRvcnk4ODMyNzQwNg==-flat-biginteger.h.html,0.09981515711645102,9,xmrig-MDEwOlJlcG9zaXRvcnk4ODMyNzQwNg==-flat-bitmap.c,xmrig-MDEwOlJlcG9zaXRvcnk4ODMyNzQwNg==-flat-biginteger.h,149,155,6,111,116,5
445824,https://htmlpreview.github.io/?https://github.com/Christina96/boilerplate-sample-matches/blob/main/C-beta/libtomcrypt-MDEwOlJlcG9zaXRvcnk3NzcwMTE=-flat-ocb_init.c-libtomcrypt-MDEwOlJlcG9zaXRvcnk3NzcwMTE=-flat-ltc_ecc_projective_add_point.c.html,0.07782101167315175,11,libtomcrypt-MDEwOlJlcG9zaXRvcnk3NzcwMTE=-flat-ocb_init.c,libtomcrypt-MDEwOlJlcG9zaXRvcnk3NzcwMTE=-flat-ltc_ecc_projective_add_point.c,20,29,9,3,14,11
445886,https://htmlpreview.github.io/?https://github.com/Christina96/boilerplate-sample-matches/blob/main/C-beta/redis-MDEwOlJlcG9zaXRvcnkxMDgxMTA3MDY=-flat-Win32_FDAPI.h-Adafruit_nRF52_Arduino-MDEwOlJlcG9zaXRvcnk3NDM1NDcyOQ==-flat-bignum.c.html,0.06029684601113173,12,redis-MDEwOlJlcG9zaXRvcnkxMDgxMTA3MDY=-flat-Win32_FDAPI.h,Adafruit_nRF52_Arduino-MDEwOlJlcG9zaXRvcnk3NDM1NDcyOQ==-flat-bignum.c,70,73,3,1363,1370,7
447149,https://htmlpreview.github.io/?https://github.com/Christina96/boilerplate-sample-matches/blob/main/C-beta/redis-MDEwOlJlcG9zaXRvcnkxMDgxMTA3MDY=-flat-win32_hiredis.h-libfuse-MDEwOlJlcG9zaXRvcnk0ODI5NjE3Nw==-flat-release_unlink_race.c.html,0.11764705882352941,8,redis-MDEwOlJlcG9zaXRvcnkxMDgxMTA3MDY=-flat-win32_hiredis.h,libfuse-MDEwOlJlcG9zaXRvcnk0ODI5NjE3Nw==-flat-release_unlink_race.c,18,23,5,37,42,5
451818,https://htmlpreview.github.io/?https://github.com/Christina96/boilerplate-sample-matches/blob/main/C-beta/redis-MDEwOlJlcG9zaXRvcnkxMDgxMTA3MDY=-flat-testrdb.c-PINRemoteImage-MDEwOlJlcG9zaXRvcnkzOTUzNzEwMw==-flat-libwebp_python_wrap.c.html,0.050677666470241606,9,redis-MDEwOlJlcG9zaXRvcnkxMDgxMTA3MDY=-flat-testrdb.c,PINRemoteImage-MDEwOlJlcG9zaXRvcnkzOTUzNzEwMw==-flat-libwebp_python_wrap.c,8,12,4,1137,1141,4
460980,https://htmlpreview.github.io/?https://github.com/Christina96/boilerplate-sample-matches/blob/main/C-beta/redis-MDEwOlJlcG9zaXRvcnkxMDgxMTA3MDY=-flat-sha1.c-redis-MDEwOlJlcG9zaXRvcnkxMDgxMTA3MDY=-flat-linenoise.c.html,0.061686086360520906,11,redis-MDEwOlJlcG9zaXRvcnkxMDgxMTA3MDY=-flat-sha1.c,redis-MDEwOlJlcG9zaXRvcnkxMDgxMTA3MDY=-flat-linenoise.c,39,42,3,456,459,3
475237,https://htmlpreview.github.io/?https://github.com/Christina96/boilerplate-sample-matches/blob/main/C-beta/redis-MDEwOlJlcG9zaXRvcnkxMDgxMTA3MDY=-flat-smallocx.c-redis-MDEwOlJlcG9zaXRvcnkxMDgxMTA3MDY=-flat-bitops.c.html,0.024759284731774415,9,redis-MDEwOlJlcG9zaXRvcnkxMDgxMTA3MDY=-flat-smallocx.c,redis-MDEwOlJlcG9zaXRvcnkxMDgxMTA3MDY=-flat-bitops.c,29,35,6,135,140,5
480569,https://htmlpreview.github.io/?https://github.com/Christina96/boilerplate-sample-matches/blob/main/C-beta/xmrig-MDEwOlJlcG9zaXRvcnk4ODMyNzQwNg==-flat-CudaDevice.h-PINRemoteImage-MDEwOlJlcG9zaXRvcnkzOTUzNzEwMw==-flat-vp8i_enc.h.html,0.12173913043478261,21,xmrig-MDEwOlJlcG9zaXRvcnk4ODMyNzQwNg==-flat-CudaDevice.h,PINRemoteImage-MDEwOlJlcG9zaXRvcnkzOTUzNzEwMw==-flat-vp8i_enc.h,15,24,9,133,153,20
482403,https://htmlpreview.github.io/?https://github.com/Christina96/boilerplate-sample-matches/blob/main/C-beta/Adafruit_nRF52_Arduino-MDEwOlJlcG9zaXRvcnk3NDM1NDcyOQ==-flat-HAPProcedure.h-PINRemoteImage-MDEwOlJlcG9zaXRvcnkzOTUzNzEwMw==-flat-wicdec.c.html,0.03680981595092025,9,Adafruit_nRF52_Arduino-MDEwOlJlcG9zaXRvcnk3NDM1NDcyOQ==-flat-HAPProcedure.h,PINRemoteImage-MDEwOlJlcG9zaXRvcnkzOTUzNzEwMw==-flat-wicdec.c,14,22,8,40,42,2
500573,https://htmlpreview.github.io/?https://github.com/Christina96/boilerplate-sample-matches/blob/main/C-beta/android-gpuimage-plus-MDEwOlJlcG9zaXRvcnk0NjU0NzQxNw==-flat-cgeEmbossFilter.h-libfuse-MDEwOlJlcG9zaXRvcnk0ODI5NjE3Nw==-flat-cuse_lowlevel.c.html,0.06295399515738499,13,android-gpuimage-plus-MDEwOlJlcG9zaXRvcnk0NjU0NzQxNw==-flat-cgeEmbossFilter.h,libfuse-MDEwOlJlcG9zaXRvcnk0ODI5NjE3Nw==-flat-cuse_lowlevel.c,17,24,7,31,35,4
507980,https://htmlpreview.github.io/?https://github.com/Christina96/boilerplate-sample-matches/blob/main/C-beta/redis-MDEwOlJlcG9zaXRvcnkxMDgxMTA3MDY=-flat-bio.h-redis-MDEwOlJlcG9zaXRvcnkxMDgxMTA3MDY=-flat-rax.h.html,0.12,9,redis-MDEwOlJlcG9zaXRvcnkxMDgxMTA3MDY=-flat-bio.h,redis-MDEwOlJlcG9zaXRvcnkxMDgxMTA3MDY=-flat-rax.h,1,6,5,10,12,2
510044,https://htmlpreview.github.io/?https://github.com/Christina96/boilerplate-sample-matches/blob/main/C-beta/android-gpuimage-plus-MDEwOlJlcG9zaXRvcnk0NjU0NzQxNw==-flat-cgeCommonDefine.h-libtomcrypt-MDEwOlJlcG9zaXRvcnk3NzcwMTE=-flat-der_decode_sequence_flexi.c.html,0.08682170542635659,8,android-gpuimage-plus-MDEwOlJlcG9zaXRvcnk0NjU0NzQxNw==-flat-cgeCommonDefine.h,libtomcrypt-MDEwOlJlcG9zaXRvcnk3NzcwMTE=-flat-der_decode_sequence_flexi.c,217,224,7,20,24,4
511499,https://htmlpreview.github.io/?https://github.com/Christina96/boilerplate-sample-matches/blob/main/C-beta/libtomcrypt-MDEwOlJlcG9zaXRvcnk3NzcwMTE=-flat-tomcrypt_misc.h-android-gpuimage-plus-MDEwOlJlcG9zaXRvcnk0NjU0NzQxNw==-flat-avformat.h.html,0.343649946638207,73,libtomcrypt-MDEwOlJlcG9zaXRvcnk3NzcwMTE=-flat-tomcrypt_misc.h,android-gpuimage-plus-MDEwOlJlcG9zaXRvcnk0NjU0NzQxNw==-flat-avformat.h,30,85,55,294,387,93
512252,https://htmlpreview.github.io/?https://github.com/Christina96/boilerplate-sample-matches/blob/main/C-beta/PINRemoteImage-MDEwOlJlcG9zaXRvcnkzOTUzNzEwMw==-flat-demux.h-PINRemoteImage-MDEwOlJlcG9zaXRvcnkzOTUzNzEwMw==-flat-enc_msa.c.html,0.01810344827586207,12,PINRemoteImage-MDEwOlJlcG9zaXRvcnkzOTUzNzEwMw==-flat-demux.h,PINRemoteImage-MDEwOlJlcG9zaXRvcnkzOTUzNzEwMw==-flat-enc_msa.c,42,53,11,40,41,1
513315,https://htmlpreview.github.io/?https://github.com/Christina96/boilerplate-sample-matches/blob/main/C-beta/redis-MDEwOlJlcG9zaXRvcnkxMDgxMTA3MDY=-flat-lua_cjson.c-redis-MDEwOlJlcG9zaXRvcnkxMDgxMTA3MDY=-flat-server.c.html,0.054924242424242424,13,redis-MDEwOlJlcG9zaXRvcnkxMDgxMTA3MDY=-flat-lua_cjson.c,redis-MDEwOlJlcG9zaXRvcnkxMDgxMTA3MDY=-flat-server.c,33,45,12,456,463,7
517376,https://htmlpreview.github.io/?https://github.com/Christina96/boilerplate-sample-matches/blob/main/C-beta/fftw3-MDEwOlJlcG9zaXRvcnk4ODQzMzg4-flat-hc2hc.c-PINRemoteImage-MDEwOlJlcG9zaXRvcnkzOTUzNzEwMw==-flat-tiffdec.c.html,0.09716599190283401,8,fftw3-MDEwOlJlcG9zaXRvcnk4ODQzMzg4-flat-hc2hc.c,PINRemoteImage-MDEwOlJlcG9zaXRvcnkzOTUzNzEwMw==-flat-tiffdec.c,136,140,4,208,213,5
517392,https://htmlpreview.github.io/?https://github.com/Christina96/boilerplate-sample-matches/blob/main/C-beta/Adafruit_nRF52_Arduino-MDEwOlJlcG9zaXRvcnk3NDM1NDcyOQ==-flat-BLEClientBas.h-android-gpuimage-plus-MDEwOlJlcG9zaXRvcnk0NjU0NzQxNw==-flat-cgeGL3Stub.h.html,0.3865546218487395,23,Adafruit_nRF52_Arduino-MDEwOlJlcG9zaXRvcnk3NDM1NDcyOQ==-flat-BLEClientBas.h,android-gpuimage-plus-MDEwOlJlcG9zaXRvcnk0NjU0NzQxNw==-flat-cgeGL3Stub.h,9,17,8,10,354,344
519942,https://htmlpreview.github.io/?https://github.com/Christina96/boilerplate-sample-matches/blob/main/C-beta/xmrig-MDEwOlJlcG9zaXRvcnk4ODMyNzQwNg==-flat-Httpd.h-Adafruit_nRF52_Arduino-MDEwOlJlcG9zaXRvcnk3NDM1NDcyOQ==-flat-wiring_analog_nRF52.c.html,0.064,8,xmrig-MDEwOlJlcG9zaXRvcnk4ODMyNzQwNg==-flat-Httpd.h,Adafruit_nRF52_Arduino-MDEwOlJlcG9zaXRvcnk3NDM1NDcyOQ==-flat-wiring_analog_nRF52.c,28,33,5,8,11,3
521110,https://htmlpreview.github.io/?https://github.com/Christina96/boilerplate-sample-matches/blob/main/C-beta/redis-MDEwOlJlcG9zaXRvcnkxMDgxMTA3MDY=-flat-adlist.c-PINRemoteImage-MDEwOlJlcG9zaXRvcnkzOTUzNzEwMw==-flat-lossless_sse2.c.html,0.036613272311212815,8,redis-MDEwOlJlcG9zaXRvcnkxMDgxMTA3MDY=-flat-adlist.c,PINRemoteImage-MDEwOlJlcG9zaXRvcnkzOTUzNzEwMw==-flat-lossless_sse2.c,74,77,3,37,41,4
533375,https://htmlpreview.github.io/?https://github.com/Christina96/boilerplate-sample-matches/blob/main/C-beta/Adafruit_nRF52_Arduino-MDEwOlJlcG9zaXRvcnk3NDM1NDcyOQ==-flat-nrf_gpiote.h-PINRemoteImage-MDEwOlJlcG9zaXRvcnkzOTUzNzEwMw==-flat-dec_sse2.c.html,0.13808463251670378,11,Adafruit_nRF52_Arduino-MDEwOlJlcG9zaXRvcnk3NDM1NDcyOQ==-flat-nrf_gpiote.h,PINRemoteImage-MDEwOlJlcG9zaXRvcnkzOTUzNzEwMw==-flat-dec_sse2.c,82,99,17,472,480,8
533934,https://htmlpreview.github.io/?https://github.com/Christina96/boilerplate-sample-matches/blob/main/C-beta/PINRemoteImage-MDEwOlJlcG9zaXRvcnkzOTUzNzEwMw==-flat-encode.h-libpcap-MDEwOlJlcG9zaXRvcnk5NDM1ODg3-flat-gencode.c.html,0.15419501133786848,8,PINRemoteImage-MDEwOlJlcG9zaXRvcnkzOTUzNzEwMw==-flat-encode.h,libpcap-MDEwOlJlcG9zaXRvcnk5NDM1ODg3-flat-gencode.c,83,88,5,1206,1214,8
538563,https://htmlpreview.github.io/?https://github.com/Christina96/boilerplate-sample-matches/blob/main/C-beta/Adafruit_nRF52_Arduino-MDEwOlJlcG9zaXRvcnk3NDM1NDcyOQ==-flat-nrf_qspi.h-redis-MDEwOlJlcG9zaXRvcnkxMDgxMTA3MDY=-flat-dict.c.html,0.04460966542750929,12,Adafruit_nRF52_Arduino-MDEwOlJlcG9zaXRvcnk3NDM1NDcyOQ==-flat-nrf_qspi.h,redis-MDEwOlJlcG9zaXRvcnkxMDgxMTA3MDY=-flat-dict.c,176,181,5,9,14,5
555174,https://htmlpreview.github.io/?https://github.com/Christina96/boilerplate-sample-matches/blob/main/C-beta/xmrig-MDEwOlJlcG9zaXRvcnk4ODMyNzQwNg==-flat-xml.h-xmrig-MDEwOlJlcG9zaXRvcnk4ODMyNzQwNg==-flat-sph_echo.c.html,0.0621301775147929,21,xmrig-MDEwOlJlcG9zaXRvcnk4ODMyNzQwNg==-flat-xml.h,xmrig-MDEwOlJlcG9zaXRvcnk4ODMyNzQwNg==-flat-sph_echo.c,26,32,6,70,71,1
556228,https://htmlpreview.github.io/?https://github.com/Christina96/boilerplate-sample-matches/blob/main/C-beta/Adafruit_nRF52_Arduino-MDEwOlJlcG9zaXRvcnk3NDM1NDcyOQ==-flat-nrfbintool.c-libtomcrypt-MDEwOlJlcG9zaXRvcnk3NzcwMTE=-flat-aes.c.html,0.064343163538874,8,Adafruit_nRF52_Arduino-MDEwOlJlcG9zaXRvcnk3NDM1NDcyOQ==-flat-nrfbintool.c,libtomcrypt-MDEwOlJlcG9zaXRvcnk3NzcwMTE=-flat-aes.c,61,68,7,339,347,8
563402,https://htmlpreview.github.io/?https://github.com/Christina96/boilerplate-sample-matches/blob/main/C-beta/xmrig-MDEwOlJlcG9zaXRvcnk4ODMyNzQwNg==-flat-internal-components.h-libpcap-MDEwOlJlcG9zaXRvcnk5NDM1ODg3-flat-pcap-dpdk.c.html,0.14869888475836432,8,xmrig-MDEwOlJlcG9zaXRvcnk4ODMyNzQwNg==-flat-internal-components.h,libpcap-MDEwOlJlcG9zaXRvcnk5NDM1ODg3-flat-pcap-dpdk.c,15,22,7,109,115,6
563893,https://htmlpreview.github.io/?https://github.com/Christina96/boilerplate-sample-matches/blob/main/C-beta/PINRemoteImage-MDEwOlJlcG9zaXRvcnkzOTUzNzEwMw==-flat-yuv_sse41.c-PINRemoteImage-MDEwOlJlcG9zaXRvcnkzOTUzNzEwMw==-flat-lossless_sse2.c.html,0.23754789272030652,49,PINRemoteImage-MDEwOlJlcG9zaXRvcnkzOTUzNzEwMw==-flat-yuv_sse41.c,PINRemoteImage-MDEwOlJlcG9zaXRvcnkzOTUzNzEwMw==-flat-lossless_sse2.c,16,32,16,503,522,19
572977,https://htmlpreview.github.io/?https://github.com/Christina96/boilerplate-sample-matches/blob/main/C-beta/libtomcrypt-MDEwOlJlcG9zaXRvcnk3NzcwMTE=-flat-tiger.c-Adafruit_nRF52_Arduino-MDEwOlJlcG9zaXRvcnk3NDM1NDcyOQ==-flat-nrf_soc_21.h.html,0.015888778550148957,8,libtomcrypt-MDEwOlJlcG9zaXRvcnk3NzcwMTE=-flat-tiger.c,Adafruit_nRF52_Arduino-MDEwOlJlcG9zaXRvcnk3NDM1NDcyOQ==-flat-nrf_soc_21.h,555,557,2,127,132,5
580453,https://htmlpreview.github.io/?https://github.com/Christina96/boilerplate-sample-matches/blob/main/C-beta/redis-MDEwOlJlcG9zaXRvcnkxMDgxMTA3MDY=-flat-mutex.c-xmrig-MDEwOlJlcG9zaXRvcnk4ODMyNzQwNg==-flat-KPHash.h.html,0.6829268292682927,14,redis-MDEwOlJlcG9zaXRvcnkxMDgxMTA3MDY=-flat-mutex.c,xmrig-MDEwOlJlcG9zaXRvcnk4ODMyNzQwNg==-flat-KPHash.h,11,22,11,13,16,3
588051,https://htmlpreview.github.io/?https://github.com/Christina96/boilerplate-sample-matches/blob/main/C-beta/libpcap-MDEwOlJlcG9zaXRvcnk5NDM1ODg3-flat-pktdrvr.c-libtomcrypt-MDEwOlJlcG9zaXRvcnk3NzcwMTE=-flat-cast5.c.html,0.04747774480712166,8,libpcap-MDEwOlJlcG9zaXRvcnk5NDM1ODg3-flat-pktdrvr.c,libtomcrypt-MDEwOlJlcG9zaXRvcnk3NzcwMTE=-flat-cast5.c,51,58,7,375,380,5
592726,https://htmlpreview.github.io/?https://github.com/Christina96/boilerplate-sample-matches/blob/main/C-beta/libtomcrypt-MDEwOlJlcG9zaXRvcnk3NzcwMTE=-flat-hmac_process.c-libtomcrypt-MDEwOlJlcG9zaXRvcnk3NzcwMTE=-flat-ecc_set_curve.c.html,0.13114754098360656,8,libtomcrypt-MDEwOlJlcG9zaXRvcnk3NzcwMTE=-flat-hmac_process.c,libtomcrypt-MDEwOlJlcG9zaXRvcnk3NzcwMTE=-flat-ecc_set_curve.c,3,10,7,3,13,10
603451,https://htmlpreview.github.io/?https://github.com/Christina96/boilerplate-sample-matches/blob/main/C-beta/xmrig-MDEwOlJlcG9zaXRvcnk4ODMyNzQwNg==-flat-sph_skein.c-android-gpuimage-plus-MDEwOlJlcG9zaXRvcnk0NjU0NzQxNw==-flat-avcodec.h.html,0.060991105463786534,8,xmrig-MDEwOlJlcG9zaXRvcnk4ODMyNzQwNg==-flat-sph_skein.c,android-gpuimage-plus-MDEwOlJlcG9zaXRvcnk0NjU0NzQxNw==-flat-avcodec.h,639,644,5,1589,1592,3
603998,https://htmlpreview.github.io/?https://github.com/Christina96/boilerplate-sample-matches/blob/main/C-beta/redis-MDEwOlJlcG9zaXRvcnkxMDgxMTA3MDY=-flat-prof_externs.h-PINRemoteImage-MDEwOlJlcG9zaXRvcnkzOTUzNzEwMw==-flat-demux.h.html,0.21649484536082475,12,redis-MDEwOlJlcG9zaXRvcnkxMDgxMTA3MDY=-flat-prof_externs.h,PINRemoteImage-MDEwOlJlcG9zaXRvcnkzOTUzNzEwMw==-flat-demux.h,4,15,11,42,53,11
620857,https://htmlpreview.github.io/?https://github.com/Christina96/boilerplate-sample-matches/blob/main/C-beta/redis-MDEwOlJlcG9zaXRvcnkxMDgxMTA3MDY=-flat-testmodule.c-fftw3-MDEwOlJlcG9zaXRvcnk4ODQzMzg4-flat-rdft2-rdft.c.html,0.07710843373493977,8,redis-MDEwOlJlcG9zaXRvcnkxMDgxMTA3MDY=-flat-testmodule.c,fftw3-MDEwOlJlcG9zaXRvcnk4ODQzMzg4-flat-rdft2-rdft.c,207,210,3,53,55,2
628609,https://htmlpreview.github.io/?https://github.com/Christina96/boilerplate-sample-matches/blob/main/C-beta/Adafruit_nRF52_Arduino-MDEwOlJlcG9zaXRvcnk3NDM1NDcyOQ==-flat-nrf_rtc.h-Adafruit_nRF52_Arduino-MDEwOlJlcG9zaXRvcnk3NDM1NDcyOQ==-flat-nrf_nvic_17.h.html,0.14035087719298245,24,Adafruit_nRF52_Arduino-MDEwOlJlcG9zaXRvcnk3NDM1NDcyOQ==-flat-nrf_rtc.h,Adafruit_nRF52_Arduino-MDEwOlJlcG9zaXRvcnk3NDM1NDcyOQ==-flat-nrf_nvic_17.h,52,69,17,36,57,21
628869,https://htmlpreview.github.io/?https://github.com/Christina96/boilerplate-sample-matches/blob/main/C-beta/libfuse-MDEwOlJlcG9zaXRvcnk0ODI5NjE3Nw==-flat-hello.c-xmrig-MDEwOlJlcG9zaXRvcnk4ODMyNzQwNg==-flat-topology-windows.c.html,0.05977382875605816,11,libfuse-MDEwOlJlcG9zaXRvcnk0ODI5NjE3Nw==-flat-hello.c,xmrig-MDEwOlJlcG9zaXRvcnk4ODMyNzQwNg==-flat-topology-windows.c,66,72,6,613,619,6
632032,https://htmlpreview.github.io/?https://github.com/Christina96/boilerplate-sample-matches/blob/main/C-beta/xmrig-MDEwOlJlcG9zaXRvcnk4ODMyNzQwNg==-flat-adl_defines.h-PINRemoteImage-MDEwOlJlcG9zaXRvcnkzOTUzNzEwMw==-flat-enc.c.html,0.03291139240506329,26,xmrig-MDEwOlJlcG9zaXRvcnk4ODMyNzQwNg==-flat-adl_defines.h,PINRemoteImage-MDEwOlJlcG9zaXRvcnkzOTUzNzEwMw==-flat-enc.c,397,397,0,577,602,25
636926,https://htmlpreview.github.io/?https://github.com/Christina96/boilerplate-sample-matches/blob/main/C-beta/xmrig-MDEwOlJlcG9zaXRvcnk4ODMyNzQwNg==-flat-cl_13.h-xmrig-MDEwOlJlcG9zaXRvcnk4ODMyNzQwNg==-flat-sph_simd.c.html,0.3745928338762215,12,xmrig-MDEwOlJlcG9zaXRvcnk4ODMyNzQwNg==-flat-cl_13.h,xmrig-MDEwOlJlcG9zaXRvcnk4ODMyNzQwNg==-flat-sph_simd.c,682,713,31,977,978,1
653121,https://htmlpreview.github.io/?https://github.com/Christina96/boilerplate-sample-matches/blob/main/C-beta/libtomcrypt-MDEwOlJlcG9zaXRvcnk3NzcwMTE=-flat-dh_generate_key.c-libtomcrypt-MDEwOlJlcG9zaXRvcnk3NzcwMTE=-flat-ltc_ecc_import_point.c.html,0.23076923076923078,12,libtomcrypt-MDEwOlJlcG9zaXRvcnk3NzcwMTE=-flat-dh_generate_key.c,libtomcrypt-MDEwOlJlcG9zaXRvcnk3NzcwMTE=-flat-ltc_ecc_import_point.c,52,59,7,17,19,2
664591,https://htmlpreview.github.io/?https://github.com/Christina96/boilerplate-sample-matches/blob/main/C-beta/Adafruit_nRF52_Arduino-MDEwOlJlcG9zaXRvcnk3NDM1NDcyOQ==-flat-nrfx_pwm.c-redis-MDEwOlJlcG9zaXRvcnkxMDgxMTA3MDY=-flat-ctl.c.html,0.028409090909090908,10,Adafruit_nRF52_Arduino-MDEwOlJlcG9zaXRvcnk3NDM1NDcyOQ==-flat-nrfx_pwm.c,redis-MDEwOlJlcG9zaXRvcnkxMDgxMTA3MDY=-flat-ctl.c,172,183,11,2159,2165,6
669863,https://htmlpreview.github.io/?https://github.com/Christina96/boilerplate-sample-matches/blob/main/C-beta/PINRemoteImage-MDEwOlJlcG9zaXRvcnkzOTUzNzEwMw==-flat-tiffdec.c-redis-MDEwOlJlcG9zaXRvcnkxMDgxMTA3MDY=-flat-bitops.c.html,0.09746328437917223,9,PINRemoteImage-MDEwOlJlcG9zaXRvcnkzOTUzNzEwMw==-flat-tiffdec.c,redis-MDEwOlJlcG9zaXRvcnkxMDgxMTA3MDY=-flat-bitops.c,50,54,4,247,250,3
673925,https://htmlpreview.github.io/?https://github.com/Christina96/boilerplate-sample-matches/blob/main/C-beta/fftw3-MDEwOlJlcG9zaXRvcnk4ODQzMzg4-flat-bench-user.h-xmrig-MDEwOlJlcG9zaXRvcnk4ODMyNzQwNg==-flat-CudaConfig.h.html,0.21428571428571427,15,fftw3-MDEwOlJlcG9zaXRvcnk4ODQzMzg4-flat-bench-user.h,xmrig-MDEwOlJlcG9zaXRvcnk4ODMyNzQwNg==-flat-CudaConfig.h,53,62,9,11,13,2
674038,https://htmlpreview.github.io/?https://github.com/Christina96/boilerplate-sample-matches/blob/main/C-beta/PINRemoteImage-MDEwOlJlcG9zaXRvcnkzOTUzNzEwMw==-flat-picture_psnr_enc.c-libtomcrypt-MDEwOlJlcG9zaXRvcnk3NzcwMTE=-flat-tfm_desc.c.html,0.07252747252747253,9,PINRemoteImage-MDEwOlJlcG9zaXRvcnkzOTUzNzEwMw==-flat-picture_psnr_enc.c,libtomcrypt-MDEwOlJlcG9zaXRvcnk3NzcwMTE=-flat-tfm_desc.c,130,140,10,219,225,6
686381,https://htmlpreview.github.io/?https://github.com/Christina96/boilerplate-sample-matches/blob/main/C-beta/redis-MDEwOlJlcG9zaXRvcnkxMDgxMTA3MDY=-flat-dict_34.h-libfuse-MDEwOlJlcG9zaXRvcnk0ODI5NjE3Nw==-flat-cuse.c.html,0.045454545454545456,9,redis-MDEwOlJlcG9zaXRvcnkxMDgxMTA3MDY=-flat-dict_34.h,libfuse-MDEwOlJlcG9zaXRvcnk0ODI5NjE3Nw==-flat-cuse.c,21,23,2,130,134,4
686943,https://htmlpreview.github.io/?https://github.com/Christina96/boilerplate-sample-matches/blob/main/C-beta/libtomcrypt-MDEwOlJlcG9zaXRvcnk3NzcwMTE=-flat-ocb_encrypt.c-libfuse-MDEwOlJlcG9zaXRvcnk0ODI5NjE3Nw==-flat-passthrough_fh.c.html,0.025806451612903226,8,libtomcrypt-MDEwOlJlcG9zaXRvcnk3NzcwMTE=-flat-ocb_encrypt.c,libfuse-MDEwOlJlcG9zaXRvcnk0ODI5NjE3Nw==-flat-passthrough_fh.c,3,10,7,217,222,5
687662,https://htmlpreview.github.io/?https://github.com/Christina96/boilerplate-sample-matches/blob/main/C-beta/redis-MDEwOlJlcG9zaXRvcnkxMDgxMTA3MDY=-flat-lua_struct.c-redis-MDEwOlJlcG9zaXRvcnkxMDgxMTA3MDY=-flat-server.c.html,0.038692461641094064,9,redis-MDEwOlJlcG9zaXRvcnkxMDgxMTA3MDY=-flat-lua_struct.c,redis-MDEwOlJlcG9zaXRvcnkxMDgxMTA3MDY=-flat-server.c,67,69,2,279,283,4
706451,https://htmlpreview.github.io/?https://github.com/Christina96/boilerplate-sample-matches/blob/main/C-beta/redis-MDEwOlJlcG9zaXRvcnkxMDgxMTA3MDY=-flat-geohash.c-libfuse-MDEwOlJlcG9zaXRvcnk0ODI5NjE3Nw==-flat-test_syscalls.c.html,0.11942554799697656,9,redis-MDEwOlJlcG9zaXRvcnkxMDgxMTA3MDY=-flat-geohash.c,libfuse-MDEwOlJlcG9zaXRvcnk0ODI5NjE3Nw==-flat-test_syscalls.c,71,74,3,347,353,6
710740,https://htmlpreview.github.io/?https://github.com/Christina96/boilerplate-sample-matches/blob/main/C-beta/Adafruit_nRF52_Arduino-MDEwOlJlcG9zaXRvcnk3NDM1NDcyOQ==-flat-nrfx_power.h-xmrig-MDEwOlJlcG9zaXRvcnk4ODMyNzQwNg==-flat-cl_platform.h.html,0.30962343096234307,17,Adafruit_nRF52_Arduino-MDEwOlJlcG9zaXRvcnk3NDM1NDcyOQ==-flat-nrfx_power.h,xmrig-MDEwOlJlcG9zaXRvcnk4ODMyNzQwNg==-flat-cl_platform.h,95,118,23,164,262,98
714341,https://htmlpreview.github.io/?https://github.com/Christina96/boilerplate-sample-matches/blob/main/C-beta/PINRemoteImage-MDEwOlJlcG9zaXRvcnkzOTUzNzEwMw==-flat-enc_sse41.c-redis-MDEwOlJlcG9zaXRvcnkxMDgxMTA3MDY=-flat-extent_24.c.html,0.09033543673198273,10,PINRemoteImage-MDEwOlJlcG9zaXRvcnkzOTUzNzEwMw==-flat-enc_sse41.c,redis-MDEwOlJlcG9zaXRvcnkxMDgxMTA3MDY=-flat-extent_24.c,185,191,6,915,922,7
716415,https://htmlpreview.github.io/?https://github.com/Christina96/boilerplate-sample-matches/blob/main/C-beta/redis-MDEwOlJlcG9zaXRvcnkxMDgxMTA3MDY=-flat-WS2tcpip.h-Adafruit_nRF52_Arduino-MDEwOlJlcG9zaXRvcnk3NDM1NDcyOQ==-flat-nrfx_spim.c.html,0.03902439024390244,12,redis-MDEwOlJlcG9zaXRvcnkxMDgxMTA3MDY=-flat-WS2tcpip.h,Adafruit_nRF52_Arduino-MDEwOlJlcG9zaXRvcnk3NDM1NDcyOQ==-flat-nrfx_spim.c,35,67,32,119,133,14
723774,https://htmlpreview.github.io/?https://github.com/Christina96/boilerplate-sample-matches/blob/main/C-beta/xmrig-MDEwOlJlcG9zaXRvcnk4ODMyNzQwNg==-flat-topology-x86.c-Adafruit_nRF52_Arduino-MDEwOlJlcG9zaXRvcnk3NDM1NDcyOQ==-flat-nrf52833.h.html,0.0672637543410711,9,xmrig-MDEwOlJlcG9zaXRvcnk4ODMyNzQwNg==-flat-topology-x86.c,Adafruit_nRF52_Arduino-MDEwOlJlcG9zaXRvcnk3NDM1NDcyOQ==-flat-nrf52833.h,607,608,1,153,158,5
729380,https://htmlpreview.github.io/?https://github.com/Christina96/boilerplate-sample-matches/blob/main/C-beta/xmrig-MDEwOlJlcG9zaXRvcnk4ODMyNzQwNg==-flat-CryptoNight_x86.h-redis-MDEwOlJlcG9zaXRvcnkxMDgxMTA3MDY=-flat-arena_inlines_b.h.html,0.10725552050473186,8,xmrig-MDEwOlJlcG9zaXRvcnk4ODMyNzQwNg==-flat-CryptoNight_x86.h,redis-MDEwOlJlcG9zaXRvcnkxMDgxMTA3MDY=-flat-arena_inlines_b.h,43,49,6,9,14,5
735565,https://htmlpreview.github.io/?https://github.com/Christina96/boilerplate-sample-matches/blob/main/C-beta/redis-MDEwOlJlcG9zaXRvcnkxMDgxMTA3MDY=-flat-ldump.c-libpcap-MDEwOlJlcG9zaXRvcnk5NDM1ODg3-flat-sf-pcap.c.html,0.041504539559014265,8,redis-MDEwOlJlcG9zaXRvcnkxMDgxMTA3MDY=-flat-ldump.c,libpcap-MDEwOlJlcG9zaXRvcnk5NDM1ODg3-flat-sf-pcap.c,11,17,6,52,57,5
736248,https://htmlpreview.github.io/?https://github.com/Christina96/boilerplate-sample-matches/blob/main/C-beta/Adafruit_nRF52_Arduino-MDEwOlJlcG9zaXRvcnk3NDM1NDcyOQ==-flat-nrf_sdm.h-android-gpuimage-plus-MDEwOlJlcG9zaXRvcnk0NjU0NzQxNw==-flat-pixfmt.h.html,0.38620689655172413,13,Adafruit_nRF52_Arduino-MDEwOlJlcG9zaXRvcnk3NDM1NDcyOQ==-flat-nrf_sdm.h,android-gpuimage-plus-MDEwOlJlcG9zaXRvcnk0NjU0NzQxNw==-flat-pixfmt.h,97,99,2,77,91,14
742958,https://htmlpreview.github.io/?https://github.com/Christina96/boilerplate-sample-matches/blob/main/C-beta/Adafruit_nRF52_Arduino-MDEwOlJlcG9zaXRvcnk3NDM1NDcyOQ==-flat-nrfx_egu.h-libtomcrypt-MDEwOlJlcG9zaXRvcnk3NzcwMTE=-flat-pss-vect.c.html,0.04871794871794872,19,Adafruit_nRF52_Arduino-MDEwOlJlcG9zaXRvcnk3NDM1NDcyOQ==-flat-nrfx_egu.h,libtomcrypt-MDEwOlJlcG9zaXRvcnk3NzcwMTE=-flat-pss-vect.c,41,55,14,2,14,12
746653,https://htmlpreview.github.io/?https://github.com/Christina96/boilerplate-sample-matches/blob/main/C-beta/xmrig-MDEwOlJlcG9zaXRvcnk4ODMyNzQwNg==-flat-cl_dx9_media_sharing.h-xmrig-MDEwOlJlcG9zaXRvcnk4ODMyNzQwNg==-flat-sph_fugue.h.html,0.3333333333333333,11,xmrig-MDEwOlJlcG9zaXRvcnk4ODMyNzQwNg==-flat-cl_dx9_media_sharing.h,xmrig-MDEwOlJlcG9zaXRvcnk4ODMyNzQwNg==-flat-sph_fugue.h,15,65,50,19,30,11
751700,https://htmlpreview.github.io/?https://github.com/Christina96/boilerplate-sample-matches/blob/main/C-beta/fftw3-MDEwOlJlcG9zaXRvcnk4ODQzMzg4-flat-block.c-PINRemoteImage-MDEwOlJlcG9zaXRvcnkzOTUzNzEwMw==-flat-pngdec.c.html,0.06390977443609022,9,fftw3-MDEwOlJlcG9zaXRvcnk4ODQzMzg4-flat-block.c,PINRemoteImage-MDEwOlJlcG9zaXRvcnkzOTUzNzEwMw==-flat-pngdec.c,4,10,6,273,286,13
758838,https://htmlpreview.github.io/?https://github.com/Christina96/boilerplate-sample-matches/blob/main/C-beta/fftw3-MDEwOlJlcG9zaXRvcnk4ODQzMzg4-flat-khc2hc.c-xmrig-MDEwOlJlcG9zaXRvcnk4ODMyNzQwNg==-flat-api.c.html,0.05172413793103448,9,fftw3-MDEwOlJlcG9zaXRvcnk4ODQzMzg4-flat-khc2hc.c,xmrig-MDEwOlJlcG9zaXRvcnk4ODMyNzQwNg==-flat-api.c,2,4,2,172,174,2
761280,https://htmlpreview.github.io/?https://github.com/Christina96/boilerplate-sample-matches/blob/main/C-beta/Adafruit_nRF52_Arduino-MDEwOlJlcG9zaXRvcnk3NDM1NDcyOQ==-flat-nrf_nfct.h-small-MDEwOlJlcG9zaXRvcnkyNTY3NjMxNjk=-flat-encrypt.c.html,0.09258285113098369,9,Adafruit_nRF52_Arduino-MDEwOlJlcG9zaXRvcnk3NDM1NDcyOQ==-flat-nrf_nfct.h,small-MDEwOlJlcG9zaXRvcnkyNTY3NjMxNjk=-flat-encrypt.c,258,266,8,48,57,9
780067,https://htmlpreview.github.io/?https://github.com/Christina96/boilerplate-sample-matches/blob/main/C-beta/Adafruit_nRF52_Arduino-MDEwOlJlcG9zaXRvcnk3NDM1NDcyOQ==-flat-nrf_aar.h-Adafruit_nRF52_Arduino-MDEwOlJlcG9zaXRvcnk3NDM1NDcyOQ==-flat-SEGGER_SYSVIEW.c.html,0.08431163287086446,8,Adafruit_nRF52_Arduino-MDEwOlJlcG9zaXRvcnk3NDM1NDcyOQ==-flat-nrf_aar.h,Adafruit_nRF52_Arduino-MDEwOlJlcG9zaXRvcnk3NDM1NDcyOQ==-flat-SEGGER_SYSVIEW.c,115,120,5,875,880,5
781498,https://htmlpreview.github.io/?https://github.com/Christina96/boilerplate-sample-matches/blob/main/C-beta/android-gpuimage-plus-MDEwOlJlcG9zaXRvcnk0NjU0NzQxNw==-flat-aes_ctr.h-xmrig-MDEwOlJlcG9zaXRvcnk4ODMyNzQwNg==-flat-argon2.c.html,0.04744525547445255,13,android-gpuimage-plus-MDEwOlJlcG9zaXRvcnk0NjU0NzQxNw==-flat-aes_ctr.h,xmrig-MDEwOlJlcG9zaXRvcnk4ODMyNzQwNg==-flat-argon2.c,9,16,7,80,85,5
784567,https://htmlpreview.github.io/?https://github.com/Christina96/boilerplate-sample-matches/blob/main/C-beta/redis-MDEwOlJlcG9zaXRvcnkxMDgxMTA3MDY=-flat-strings.h-libtomcrypt-MDEwOlJlcG9zaXRvcnk3NzcwMTE=-flat-pkcs_5_1.c.html,0.09523809523809523,8,redis-MDEwOlJlcG9zaXRvcnkxMDgxMTA3MDY=-flat-strings.h,libtomcrypt-MDEwOlJlcG9zaXRvcnk3NzcwMTE=-flat-pkcs_5_1.c,13,20,7,91,98,7
789674,https://htmlpreview.github.io/?https://github.com/Christina96/boilerplate-sample-matches/blob/main/C-beta/PINRemoteImage-MDEwOlJlcG9zaXRvcnkzOTUzNzEwMw==-flat-ssim_sse2.c-PINRemoteImage-MDEwOlJlcG9zaXRvcnkzOTUzNzEwMw==-flat-vp8l_enc.c.html,0.061224489795918366,8,PINRemoteImage-MDEwOlJlcG9zaXRvcnkzOTUzNzEwMw==-flat-ssim_sse2.c,PINRemoteImage-MDEwOlJlcG9zaXRvcnkzOTUzNzEwMw==-flat-vp8l_enc.c,92,95,3,531,536,5
807270,https://htmlpreview.github.io/?https://github.com/Christina96/boilerplate-sample-matches/blob/main/C-beta/redis-MDEwOlJlcG9zaXRvcnkxMDgxMTA3MDY=-flat-rehashing.c-redis-MDEwOlJlcG9zaXRvcnkxMDgxMTA3MDY=-flat-pqsort.c.html,0.0943952802359882,8,redis-MDEwOlJlcG9zaXRvcnkxMDgxMTA3MDY=-flat-rehashing.c,redis-MDEwOlJlcG9zaXRvcnkxMDgxMTA3MDY=-flat-pqsort.c,61,64,3,49,52,3
819524,https://htmlpreview.github.io/?https://github.com/Christina96/boilerplate-sample-matches/blob/main/C-beta/android-gpuimage-plus-MDEwOlJlcG9zaXRvcnk0NjU0NzQxNw==-flat-cgeBeautifyFilter.h-fftw3-MDEwOlJlcG9zaXRvcnk4ODQzMzg4-flat-generic.c.html,0.16143497757847533,9,android-gpuimage-plus-MDEwOlJlcG9zaXRvcnk0NjU0NzQxNw==-flat-cgeBeautifyFilter.h,fftw3-MDEwOlJlcG9zaXRvcnk4ODQzMzg4-flat-generic.c,17,18,1,28,32,4
832271,https://htmlpreview.github.io/?https://github.com/Christina96/boilerplate-sample-matches/blob/main/C-beta/Adafruit_nRF52_Arduino-MDEwOlJlcG9zaXRvcnk3NDM1NDcyOQ==-flat-queue.c-fftw3-MDEwOlJlcG9zaXRvcnk4ODQzMzg4-flat-vrank3-transpose.c.html,0.18699186991869918,21,Adafruit_nRF52_Arduino-MDEwOlJlcG9zaXRvcnk3NDM1NDcyOQ==-flat-queue.c,fftw3-MDEwOlJlcG9zaXRvcnk4ODQzMzg4-flat-vrank3-transpose.c,25,26,1,7,11,4
844941,https://htmlpreview.github.io/?https://github.com/Christina96/boilerplate-sample-matches/blob/main/C-beta/libtomcrypt-MDEwOlJlcG9zaXRvcnk3NzcwMTE=-flat-blake2smac_memory_multi.c-redis-MDEwOlJlcG9zaXRvcnkxMDgxMTA3MDY=-flat-SFMT_1.c.html,0.04693140794223827,13,libtomcrypt-MDEwOlJlcG9zaXRvcnk3NzcwMTE=-flat-blake2smac_memory_multi.c,redis-MDEwOlJlcG9zaXRvcnkxMDgxMTA3MDY=-flat-SFMT_1.c,4,10,6,43,51,8
851248,https://htmlpreview.github.io/?https://github.com/Christina96/boilerplate-sample-matches/blob/main/C-beta/libtomcrypt-MDEwOlJlcG9zaXRvcnk3NzcwMTE=-flat-dsa_decrypt_key.c-redis-MDEwOlJlcG9zaXRvcnkxMDgxMTA3MDY=-flat-ckh.c.html,0.06037735849056604,8,libtomcrypt-MDEwOlJlcG9zaXRvcnk3NzcwMTE=-flat-dsa_decrypt_key.c,redis-MDEwOlJlcG9zaXRvcnkxMDgxMTA3MDY=-flat-ckh.c,9,11,2,14,23,9
853322,https://htmlpreview.github.io/?https://github.com/Christina96/boilerplate-sample-matches/blob/main/C-beta/android-gpuimage-plus-MDEwOlJlcG9zaXRvcnk0NjU0NzQxNw==-flat-avformat.h-PINRemoteImage-MDEwOlJlcG9zaXRvcnkzOTUzNzEwMw==-flat-picture_csp_enc.c.html,0.09340394800192585,8,android-gpuimage-plus-MDEwOlJlcG9zaXRvcnk0NjU0NzQxNw==-flat-avformat.h,PINRemoteImage-MDEwOlJlcG9zaXRvcnkzOTUzNzEwMw==-flat-picture_csp_enc.c,82,85,3,384,386,2
853703,https://htmlpreview.github.io/?https://github.com/Christina96/boilerplate-sample-matches/blob/main/C-beta/xmrig-MDEwOlJlcG9zaXRvcnk4ODMyNzQwNg==-flat-sph_shabal.h-redis-MDEwOlJlcG9zaXRvcnkxMDgxMTA3MDY=-flat-Win32_FDAPI.h.html,0.43205574912891986,62,xmrig-MDEwOlJlcG9zaXRvcnk4ODMyNzQwNg==-flat-sph_shabal.h,redis-MDEwOlJlcG9zaXRvcnkxMDgxMTA3MDY=-flat-Win32_FDAPI.h,15,50,35,65,88,23
853992,https://htmlpreview.github.io/?https://github.com/Christina96/boilerplate-sample-matches/blob/main/C-beta/libpcap-MDEwOlJlcG9zaXRvcnk5NDM1ODg3-flat-pcap-int.h-libtomcrypt-MDEwOlJlcG9zaXRvcnk3NzcwMTE=-flat-saferp.c.html,0.1414141414141414,16,libpcap-MDEwOlJlcG9zaXRvcnk5NDM1ODg3-flat-pcap-int.h,libtomcrypt-MDEwOlJlcG9zaXRvcnk3NzcwMTE=-flat-saferp.c,62,67,5,249,254,5
856774,https://htmlpreview.github.io/?https://github.com/Christina96/boilerplate-sample-matches/blob/main/C-beta/xmrig-MDEwOlJlcG9zaXRvcnk4ODMyNzQwNg==-flat-Cn1Kernel.h-PINRemoteImage-MDEwOlJlcG9zaXRvcnkzOTUzNzEwMw==-flat-vp8li_enc.h.html,0.6153846153846154,24,xmrig-MDEwOlJlcG9zaXRvcnk4ODMyNzQwNg==-flat-Cn1Kernel.h,PINRemoteImage-MDEwOlJlcG9zaXRvcnkzOTUzNzEwMw==-flat-vp8li_enc.h,8,11,3,46,60,14
863270,https://htmlpreview.github.io/?https://github.com/Christina96/boilerplate-sample-matches/blob/main/C-beta/xmrig-MDEwOlJlcG9zaXRvcnk4ODMyNzQwNg==-flat-OclDevice.h-libpcap-MDEwOlJlcG9zaXRvcnk5NDM1ODg3-flat-opentest.c.html,0.06,9,xmrig-MDEwOlJlcG9zaXRvcnk4ODMyNzQwNg==-flat-OclDevice.h,libpcap-MDEwOlJlcG9zaXRvcnk5NDM1ODg3-flat-opentest.c,17,25,8,28,36,8
866114,https://htmlpreview.github.io/?https://github.com/Christina96/boilerplate-sample-matches/blob/main/C-beta/fftw3-MDEwOlJlcG9zaXRvcnk4ODQzMzg4-flat-rdft.h-xmrig-MDEwOlJlcG9zaXRvcnk4ODMyNzQwNg==-flat-crypto-ops.c.html,0.0526592943654555,39,fftw3-MDEwOlJlcG9zaXRvcnk4ODQzMzg4-flat-rdft.h,xmrig-MDEwOlJlcG9zaXRvcnk4ODMyNzQwNg==-flat-crypto-ops.c,21,33,12,2853,2891,38
873302,https://htmlpreview.github.io/?https://github.com/Christina96/boilerplate-sample-matches/blob/main/C-beta/Adafruit_nRF52_Arduino-MDEwOlJlcG9zaXRvcnk3NDM1NDcyOQ==-flat-BLEClientIas.h-redis-MDEwOlJlcG9zaXRvcnkxMDgxMTA3MDY=-flat-liolib.c.html,0.04477611940298507,12,Adafruit_nRF52_Arduino-MDEwOlJlcG9zaXRvcnk3NDM1NDcyOQ==-flat-BLEClientIas.h,redis-MDEwOlJlcG9zaXRvcnkxMDgxMTA3MDY=-flat-liolib.c,8,13,5,216,218,2
881548,https://htmlpreview.github.io/?https://github.com/Christina96/boilerplate-sample-matches/blob/main/C-beta/Adafruit_nRF52_Arduino-MDEwOlJlcG9zaXRvcnk3NDM1NDcyOQ==-flat-crypto.h-PINRemoteImage-MDEwOlJlcG9zaXRvcnkzOTUzNzEwMw==-flat-vp8_dec.h.html,0.717948717948718,22,Adafruit_nRF52_Arduino-MDEwOlJlcG9zaXRvcnk3NDM1NDcyOQ==-flat-crypto.h,PINRemoteImage-MDEwOlJlcG9zaXRvcnkzOTUzNzEwMw==-flat-vp8_dec.h,34,41,7,44,59,15
883403,https://htmlpreview.github.io/?https://github.com/Christina96/boilerplate-sample-matches/blob/main/C-beta/Adafruit_nRF52_Arduino-MDEwOlJlcG9zaXRvcnk3NDM1NDcyOQ==-flat-flash_nrf5x.h-Adafruit_nRF52_Arduino-MDEwOlJlcG9zaXRvcnk3NDM1NDcyOQ==-flat-nrf_spim.h.html,0.16621983914209115,10,Adafruit_nRF52_Arduino-MDEwOlJlcG9zaXRvcnk3NDM1NDcyOQ==-flat-flash_nrf5x.h,Adafruit_nRF52_Arduino-MDEwOlJlcG9zaXRvcnk3NDM1NDcyOQ==-flat-nrf_spim.h,15,20,5,181,188,7
883645,https://htmlpreview.github.io/?https://github.com/Christina96/boilerplate-sample-matches/blob/main/C-beta/xmrig-MDEwOlJlcG9zaXRvcnk4ODMyNzQwNg==-flat-RxConfig.h-fftw3-MDEwOlJlcG9zaXRvcnk4ODQzMzg4-flat-redft00e-r2hc.c.html,0.12244897959183673,8,xmrig-MDEwOlJlcG9zaXRvcnk4ODMyNzQwNg==-flat-RxConfig.h,fftw3-MDEwOlJlcG9zaXRvcnk4ODQzMzg4-flat-redft00e-r2hc.c,60,64,4,14,17,3
887694,https://htmlpreview.github.io/?https://github.com/Christina96/boilerplate-sample-matches/blob/main/C-beta/PINRemoteImage-MDEwOlJlcG9zaXRvcnkzOTUzNzEwMw==-flat-lossless.c-redis-MDEwOlJlcG9zaXRvcnkxMDgxMTA3MDY=-flat-t_stream.c.html,0.1224246043595103,10,PINRemoteImage-MDEwOlJlcG9zaXRvcnkzOTUzNzEwMw==-flat-lossless.c,redis-MDEwOlJlcG9zaXRvcnkxMDgxMTA3MDY=-flat-t_stream.c,337,341,4,152,154,2
890609,https://htmlpreview.github.io/?https://github.com/Christina96/boilerplate-sample-matches/blob/main/C-beta/Adafruit_nRF52_Arduino-MDEwOlJlcG9zaXRvcnk3NDM1NDcyOQ==-flat-event_groups.h-Adafruit_nRF52_Arduino-MDEwOlJlcG9zaXRvcnk3NDM1NDcyOQ==-flat-nrf_pdm.h.html,0.17857142857142858,25,Adafruit_nRF52_Arduino-MDEwOlJlcG9zaXRvcnk3NDM1NDcyOQ==-flat-event_groups.h,Adafruit_nRF52_Arduino-MDEwOlJlcG9zaXRvcnk3NDM1NDcyOQ==-flat-nrf_pdm.h,10,39,29,80,98,18
898491,https://htmlpreview.github.io/?https://github.com/Christina96/boilerplate-sample-matches/blob/main/C-beta/PINRemoteImage-MDEwOlJlcG9zaXRvcnkzOTUzNzEwMw==-flat-encode_32.h-PINRemoteImage-MDEwOlJlcG9zaXRvcnkzOTUzNzEwMw==-flat-libwebp_python_wrap.c.html,0.16065192083818394,26,PINRemoteImage-MDEwOlJlcG9zaXRvcnkzOTUzNzEwMw==-flat-encode_32.h,PINRemoteImage-MDEwOlJlcG9zaXRvcnkzOTUzNzEwMw==-flat-libwebp_python_wrap.c,180,196,16,172,175,3
908067,https://htmlpreview.github.io/?https://github.com/Christina96/boilerplate-sample-matches/blob/main/C-beta/redis-MDEwOlJlcG9zaXRvcnkxMDgxMTA3MDY=-flat-anet.h-PINRemoteImage-MDEwOlJlcG9zaXRvcnkzOTUzNzEwMw==-flat-dec_sse2.c.html,0.08996539792387544,8,redis-MDEwOlJlcG9zaXRvcnkxMDgxMTA3MDY=-flat-anet.h,PINRemoteImage-MDEwOlJlcG9zaXRvcnkzOTUzNzEwMw==-flat-dec_sse2.c,37,39,2,537,540,3
928550,https://htmlpreview.github.io/?https://github.com/Christina96/boilerplate-sample-matches/blob/main/C-beta/libfuse-MDEwOlJlcG9zaXRvcnk0ODI5NjE3Nw==-flat-fuse_opt.h-Adafruit_nRF52_Arduino-MDEwOlJlcG9zaXRvcnk3NDM1NDcyOQ==-flat-nrf_lpcomp.h.html,0.17543859649122806,20,libfuse-MDEwOlJlcG9zaXRvcnk0ODI5NjE3Nw==-flat-fuse_opt.h,Adafruit_nRF52_Arduino-MDEwOlJlcG9zaXRvcnk3NDM1NDcyOQ==-flat-nrf_lpcomp.h,23,32,9,90,111,21
932548,https://htmlpreview.github.io/?https://github.com/Christina96/boilerplate-sample-matches/blob/main/C-beta/Adafruit_nRF52_Arduino-MDEwOlJlcG9zaXRvcnk3NDM1NDcyOQ==-flat-BLEHidGamepad.h-xmrig-MDEwOlJlcG9zaXRvcnk4ODMyNzQwNg==-flat-OclConfig.h.html,0.48333333333333334,19,Adafruit_nRF52_Arduino-MDEwOlJlcG9zaXRvcnk3NDM1NDcyOQ==-flat-BLEHidGamepad.h,xmrig-MDEwOlJlcG9zaXRvcnk4ODMyNzQwNg==-flat-OclConfig.h,7,15,8,8,15,7
934593,https://htmlpreview.github.io/?https://github.com/Christina96/boilerplate-sample-matches/blob/main/C-beta/fftw3-MDEwOlJlcG9zaXRvcnk4ODQzMzg4-flat-reodft010e-r2hc.c-redis-MDEwOlJlcG9zaXRvcnkxMDgxMTA3MDY=-flat-object.c.html,0.046224961479198766,10,fftw3-MDEwOlJlcG9zaXRvcnk4ODQzMzg4-flat-reodft010e-r2hc.c,redis-MDEwOlJlcG9zaXRvcnkxMDgxMTA3MDY=-flat-object.c,135,142,7,687,693,6
935537,https://htmlpreview.github.io/?https://github.com/Christina96/boilerplate-sample-matches/blob/main/C-beta/libfuse-MDEwOlJlcG9zaXRvcnk0ODI5NjE3Nw==-flat-notify_inval_inode.c-redis-MDEwOlJlcG9zaXRvcnkxMDgxMTA3MDY=-flat-t_set.c.html,0.13425468904244817,9,libfuse-MDEwOlJlcG9zaXRvcnk0ODI5NjE3Nw==-flat-notify_inval_inode.c,redis-MDEwOlJlcG9zaXRvcnkxMDgxMTA3MDY=-flat-t_set.c,111,116,5,479,486,7
946284,https://htmlpreview.github.io/?https://github.com/Christina96/boilerplate-sample-matches/blob/main/C-beta/xmrig-MDEwOlJlcG9zaXRvcnk4ODMyNzQwNg==-flat-KPHash.h-xmrig-MDEwOlJlcG9zaXRvcnk4ODMyNzQwNg==-flat-topology-synthetic.c.html,0.03958529688972667,9,xmrig-MDEwOlJlcG9zaXRvcnk4ODMyNzQwNg==-flat-KPHash.h,xmrig-MDEwOlJlcG9zaXRvcnk4ODMyNzQwNg==-flat-topology-synthetic.c,16,16,0,18,21,3
956911,https://htmlpreview.github.io/?https://github.com/Christina96/boilerplate-sample-matches/blob/main/C-beta/libtomcrypt-MDEwOlJlcG9zaXRvcnk3NzcwMTE=-flat-sober128_stream_memory.c-android-gpuimage-plus-MDEwOlJlcG9zaXRvcnk0NjU0NzQxNw==-flat-cgeBeautifyFilter.h.html,0.35294117647058826,9,libtomcrypt-MDEwOlJlcG9zaXRvcnk3NzcwMTE=-flat-sober128_stream_memory.c,android-gpuimage-plus-MDEwOlJlcG9zaXRvcnk0NjU0NzQxNw==-flat-cgeBeautifyFilter.h,3,9,6,15,17,2
964875,https://htmlpreview.github.io/?https://github.com/Christina96/boilerplate-sample-matches/blob/main/C-beta/PINRemoteImage-MDEwOlJlcG9zaXRvcnkzOTUzNzEwMw==-flat-decode_39.h-Adafruit_nRF52_Arduino-MDEwOlJlcG9zaXRvcnk3NDM1NDcyOQ==-flat-SEGGER_SYSVIEW.c.html,0.15191146881287726,10,PINRemoteImage-MDEwOlJlcG9zaXRvcnkzOTUzNzEwMw==-flat-decode_39.h,Adafruit_nRF52_Arduino-MDEwOlJlcG9zaXRvcnk3NDM1NDcyOQ==-flat-SEGGER_SYSVIEW.c,116,122,6,757,759,2
967682,https://htmlpreview.github.io/?https://github.com/Christina96/boilerplate-sample-matches/blob/main/C-beta/redis-MDEwOlJlcG9zaXRvcnkxMDgxMTA3MDY=-flat-dlfcn.c-PINRemoteImage-MDEwOlJlcG9zaXRvcnkzOTUzNzEwMw==-flat-libwebp_java_wrap.c.html,0.03875379939209726,8,redis-MDEwOlJlcG9zaXRvcnkxMDgxMTA3MDY=-flat-dlfcn.c,PINRemoteImage-MDEwOlJlcG9zaXRvcnkzOTUzNzEwMw==-flat-libwebp_java_wrap.c,67,72,5,252,259,7
968565,https://htmlpreview.github.io/?https://github.com/Christina96/boilerplate-sample-matches/blob/main/C-beta/libpcap-MDEwOlJlcG9zaXRvcnk5NDM1ODg3-flat-writecaptest.c-redis-MDEwOlJlcG9zaXRvcnkxMDgxMTA3MDY=-flat-ctl.c.html,0.023388632036986674,11,libpcap-MDEwOlJlcG9zaXRvcnk5NDM1ODg3-flat-writecaptest.c,redis-MDEwOlJlcG9zaXRvcnkxMDgxMTA3MDY=-flat-ctl.c,72,82,10,857,862,5
987296,https://htmlpreview.github.io/?https://github.com/Christina96/boilerplate-sample-matches/blob/main/C-beta/libtomcrypt-MDEwOlJlcG9zaXRvcnk3NzcwMTE=-flat-der_length_printable_string.c-libfuse-MDEwOlJlcG9zaXRvcnk0ODI5NjE3Nw==-flat-iconv.c.html,0.01717557251908397,9,libtomcrypt-MDEwOlJlcG9zaXRvcnk3NzcwMTE=-flat-der_length_printable_string.c,libfuse-MDEwOlJlcG9zaXRvcnk0ODI5NjE3Nw==-flat-iconv.c,99,104,5,147,151,4
1003754,https://htmlpreview.github.io/?https://github.com/Christina96/boilerplate-sample-matches/blob/main/C-beta/redis-MDEwOlJlcG9zaXRvcnkxMDgxMTA3MDY=-flat-replication.c-redis-MDEwOlJlcG9zaXRvcnkxMDgxMTA3MDY=-flat-config.c.html,0.0695906432748538,8,redis-MDEwOlJlcG9zaXRvcnkxMDgxMTA3MDY=-flat-replication.c,redis-MDEwOlJlcG9zaXRvcnkxMDgxMTA3MDY=-flat-config.c,571,574,3,1612,1614,2
1020903,https://htmlpreview.github.io/?https://github.com/Christina96/boilerplate-sample-matches/blob/main/C-beta/xmrig-MDEwOlJlcG9zaXRvcnk4ODMyNzQwNg==-flat-sph_sha2.c-xmrig-MDEwOlJlcG9zaXRvcnk4ODMyNzQwNg==-flat-sph_skein.c.html,0.31758034026465026,26,xmrig-MDEwOlJlcG9zaXRvcnk4ODMyNzQwNg==-flat-sph_sha2.c,xmrig-MDEwOlJlcG9zaXRvcnk4ODMyNzQwNg==-flat-sph_skein.c,14,579,565,847,861,14
1021167,https://htmlpreview.github.io/?https://github.com/Christina96/boilerplate-sample-matches/blob/main/C-beta/xmrig-MDEwOlJlcG9zaXRvcnk4ODMyNzQwNg==-flat-OclDevice.h-Adafruit_nRF52_Arduino-MDEwOlJlcG9zaXRvcnk3NDM1NDcyOQ==-flat-timers.c.html,0.19540229885057472,14,xmrig-MDEwOlJlcG9zaXRvcnk4ODMyNzQwNg==-flat-OclDevice.h,Adafruit_nRF52_Arduino-MDEwOlJlcG9zaXRvcnk3NDM1NDcyOQ==-flat-timers.c,31,35,4,65,78,13
1022379,https://htmlpreview.github.io/?https://github.com/Christina96/boilerplate-sample-matches/blob/main/C-beta/PINRemoteImage-MDEwOlJlcG9zaXRvcnkzOTUzNzEwMw==-flat-extras.h-libpcap-MDEwOlJlcG9zaXRvcnk5NDM1ODg3-flat-rpcap-protocol.h.html,0.09740259740259741,15,PINRemoteImage-MDEwOlJlcG9zaXRvcnkzOTUzNzEwMw==-flat-extras.h,libpcap-MDEwOlJlcG9zaXRvcnk5NDM1ODg3-flat-rpcap-protocol.h,9,18,9,19,26,7
1029108,https://htmlpreview.github.io/?https://github.com/Christina96/boilerplate-sample-matches/blob/main/C-beta/fftw3-MDEwOlJlcG9zaXRvcnk4ODQzMzg4-flat-problem_5.c-libpcap-MDEwOlJlcG9zaXRvcnk5NDM1ODg3-flat-pcap-sita.c.html,0.054272517321016164,9,fftw3-MDEwOlJlcG9zaXRvcnk4ODQzMzg4-flat-problem_5.c,libpcap-MDEwOlJlcG9zaXRvcnk5NDM1ODg3-flat-pcap-sita.c,162,165,3,133,138,5
1032966,https://htmlpreview.github.io/?https://github.com/Christina96/boilerplate-sample-matches/blob/main/C-beta/Adafruit_nRF52_Arduino-MDEwOlJlcG9zaXRvcnk3NDM1NDcyOQ==-flat-nrf_temp.h-xmrig-MDEwOlJlcG9zaXRvcnk4ODMyNzQwNg==-flat-bitmap.c.html,0.13852813852813853,16,Adafruit_nRF52_Arduino-MDEwOlJlcG9zaXRvcnk3NDM1NDcyOQ==-flat-nrf_temp.h,xmrig-MDEwOlJlcG9zaXRvcnk4ODMyNzQwNg==-flat-bitmap.c,19,29,10,17,20,3
1036040,https://htmlpreview.github.io/?https://github.com/Christina96/boilerplate-sample-matches/blob/main/C-beta/libtomcrypt-MDEwOlJlcG9zaXRvcnk3NzcwMTE=-flat-tomcrypt_misc.h-libtomcrypt-MDEwOlJlcG9zaXRvcnk3NzcwMTE=-flat-tomcrypt_private.h.html,0.5962264150943396,36,libtomcrypt-MDEwOlJlcG9zaXRvcnk3NzcwMTE=-flat-tomcrypt_misc.h,libtomcrypt-MDEwOlJlcG9zaXRvcnk3NzcwMTE=-flat-tomcrypt_private.h,2,21,19,183,194,11
1044113,https://htmlpreview.github.io/?https://github.com/Christina96/boilerplate-sample-matches/blob/main/C-beta/libtomcrypt-MDEwOlJlcG9zaXRvcnk3NzcwMTE=-flat-saferp.c-libtomcrypt-MDEwOlJlcG9zaXRvcnk3NzcwMTE=-flat-twofish.c.html,0.3294701986754967,12,libtomcrypt-MDEwOlJlcG9zaXRvcnk3NzcwMTE=-flat-saferp.c,libtomcrypt-MDEwOlJlcG9zaXRvcnk3NzcwMTE=-flat-twofish.c,124,128,4,27,31,4
1048129,https://htmlpreview.github.io/?https://github.com/Christina96/boilerplate-sample-matches/blob/main/C-beta/libtomcrypt-MDEwOlJlcG9zaXRvcnk3NzcwMTE=-flat-whirlgen.c-libtomcrypt-MDEwOlJlcG9zaXRvcnk3NzcwMTE=-flat-blowfish.c.html,0.12322274881516587,8,libtomcrypt-MDEwOlJlcG9zaXRvcnk3NzcwMTE=-flat-whirlgen.c,libtomcrypt-MDEwOlJlcG9zaXRvcnk3NzcwMTE=-flat-blowfish.c,19,25,6,289,298,9
1048173,https://htmlpreview.github.io/?https://github.com/Christina96/boilerplate-sample-matches/blob/main/C-beta/xmrig-MDEwOlJlcG9zaXRvcnk4ODMyNzQwNg==-flat-IClientListener.h-fftw3-MDEwOlJlcG9zaXRvcnk4ODQzMzg4-flat-transpose-pairwise.c.html,0.09807355516637478,8,xmrig-MDEwOlJlcG9zaXRvcnk4ODMyNzQwNg==-flat-IClientListener.h,fftw3-MDEwOlJlcG9zaXRvcnk4ODQzMzg4-flat-transpose-pairwise.c,19,19,0,178,182,4
1052017,https://htmlpreview.github.io/?https://github.com/Christina96/boilerplate-sample-matches/blob/main/C-beta/Adafruit_nRF52_Arduino-MDEwOlJlcG9zaXRvcnk3NDM1NDcyOQ==-flat-ble_11.h-fftw3-MDEwOlJlcG9zaXRvcnk4ODQzMzg4-flat-verify-rdft2.c.html,0.07482014388489208,8,Adafruit_nRF52_Arduino-MDEwOlJlcG9zaXRvcnk3NDM1NDcyOQ==-flat-ble_11.h,fftw3-MDEwOlJlcG9zaXRvcnk4ODQzMzg4-flat-verify-rdft2.c,50,51,1,101,107,6
1056868,https://htmlpreview.github.io/?https://github.com/Christina96/boilerplate-sample-matches/blob/main/C-beta/redis-MDEwOlJlcG9zaXRvcnkxMDgxMTA3MDY=-flat-extent_hooks.h-libtomcrypt-MDEwOlJlcG9zaXRvcnk3NzcwMTE=-flat-xts_test.c.html,0.12547528517110265,14,redis-MDEwOlJlcG9zaXRvcnkxMDgxMTA3MDY=-flat-extent_hooks.h,libtomcrypt-MDEwOlJlcG9zaXRvcnk3NzcwMTE=-flat-xts_test.c,199,208,9,21,29,8
1057778,https://htmlpreview.github.io/?https://github.com/Christina96/boilerplate-sample-matches/blob/main/C-beta/xmrig-MDEwOlJlcG9zaXRvcnk4ODMyNzQwNg==-flat-diff.c-libtomcrypt-MDEwOlJlcG9zaXRvcnk3NzcwMTE=-flat-twofish.c.html,0.1178318931657502,8,xmrig-MDEwOlJlcG9zaXRvcnk4ODMyNzQwNg==-flat-diff.c,libtomcrypt-MDEwOlJlcG9zaXRvcnk3NzcwMTE=-flat-twofish.c,248,255,7,321,326,5
1062966,https://htmlpreview.github.io/?https://github.com/Christina96/boilerplate-sample-matches/blob/main/C-beta/Adafruit_nRF52_Arduino-MDEwOlJlcG9zaXRvcnk3NDM1NDcyOQ==-flat-nrf_nvmc.h-PINRemoteImage-MDEwOlJlcG9zaXRvcnkzOTUzNzEwMw==-flat-yuv_sse41.c.html,0.055299539170506916,12,Adafruit_nRF52_Arduino-MDEwOlJlcG9zaXRvcnk3NDM1NDcyOQ==-flat-nrf_nvmc.h,PINRemoteImage-MDEwOlJlcG9zaXRvcnkzOTUzNzEwMw==-flat-yuv_sse41.c,36,54,18,68,74,6
1066362,https://htmlpreview.github.io/?https://github.com/Christina96/boilerplate-sample-matches/blob/main/C-beta/android-gpuimage-plus-MDEwOlJlcG9zaXRvcnk0NjU0NzQxNw==-flat-opt.h-PINRemoteImage-MDEwOlJlcG9zaXRvcnkzOTUzNzEwMw==-flat-rescaler_msa.c.html,0.11383928571428571,9,android-gpuimage-plus-MDEwOlJlcG9zaXRvcnk0NjU0NzQxNw==-flat-opt.h,PINRemoteImage-MDEwOlJlcG9zaXRvcnkzOTUzNzEwMw==-flat-rescaler_msa.c,78,82,4,164,164,0
1076209,https://htmlpreview.github.io/?https://github.com/Christina96/boilerplate-sample-matches/blob/main/C-beta/redis-MDEwOlJlcG9zaXRvcnkxMDgxMTA3MDY=-flat-ltable.h-libtomcrypt-MDEwOlJlcG9zaXRvcnk3NzcwMTE=-flat-x509_decode_public_key_from_certificate.c.html,0.30434782608695654,14,redis-MDEwOlJlcG9zaXRvcnkxMDgxMTA3MDY=-flat-ltable.h,libtomcrypt-MDEwOlJlcG9zaXRvcnk3NzcwMTE=-flat-x509_decode_public_key_from_certificate.c,9,14,5,9,17,8
1077908,https://htmlpreview.github.io/?https://github.com/Christina96/boilerplate-sample-matches/blob/main/C-beta/libtomcrypt-MDEwOlJlcG9zaXRvcnk3NzcwMTE=-flat-der_encode_octet_string.c-fftw3-MDEwOlJlcG9zaXRvcnk4ODQzMzg4-flat-dft-r2hc.c.html,0.06611570247933884,8,libtomcrypt-MDEwOlJlcG9zaXRvcnk3NzcwMTE=-flat-der_encode_octet_string.c,fftw3-MDEwOlJlcG9zaXRvcnk4ODQzMzg4-flat-dft-r2hc.c,3,7,4,77,82,5
1081875,https://htmlpreview.github.io/?https://github.com/Christina96/boilerplate-sample-matches/blob/main/C-beta/xmrig-MDEwOlJlcG9zaXRvcnk4ODMyNzQwNg==-flat-sph_hamsi.c-PINRemoteImage-MDEwOlJlcG9zaXRvcnkzOTUzNzEwMw==-flat-analysis_enc.c.html,0.0668693009118541,8,xmrig-MDEwOlJlcG9zaXRvcnk4ODMyNzQwNg==-flat-sph_hamsi.c,PINRemoteImage-MDEwOlJlcG9zaXRvcnkzOTUzNzEwMw==-flat-analysis_enc.c,295,483,188,270,274,4
1086341,https://htmlpreview.github.io/?https://github.com/Christina96/boilerplate-sample-matches/blob/main/C-beta/libtomcrypt-MDEwOlJlcG9zaXRvcnk3NzcwMTE=-flat-hash_memory_multi.c-libtomcrypt-MDEwOlJlcG9zaXRvcnk3NzcwMTE=-flat-store_test.c.html,0.1652892561983471,10,libtomcrypt-MDEwOlJlcG9zaXRvcnk3NzcwMTE=-flat-hash_memory_multi.c,libtomcrypt-MDEwOlJlcG9zaXRvcnk3NzcwMTE=-flat-store_test.c,4,10,6,2,9,7
1089047,https://htmlpreview.github.io/?https://github.com/Christina96/boilerplate-sample-matches/blob/main/C-beta/xmrig-MDEwOlJlcG9zaXRvcnk4ODMyNzQwNg==-flat-DonateStrategy.h-xmrig-MDEwOlJlcG9zaXRvcnk4ODMyNzQwNg==-flat-c_blake256.c.html,0.2236024844720497,8,xmrig-MDEwOlJlcG9zaXRvcnk4ODMyNzQwNg==-flat-DonateStrategy.h,xmrig-MDEwOlJlcG9zaXRvcnk4ODMyNzQwNg==-flat-c_blake256.c,32,34,2,166,172,6
1097049,https://htmlpreview.github.io/?https://github.com/Christina96/boilerplate-sample-matches/blob/main/C-beta/libpcap-MDEwOlJlcG9zaXRvcnk5NDM1ODg3-flat-pcap-dos.c-Adafruit_nRF52_Arduino-MDEwOlJlcG9zaXRvcnk3NDM1NDcyOQ==-flat-nrf_gpiote.h.html,0.41409691629955947,21,libpcap-MDEwOlJlcG9zaXRvcnk5NDM1ODg3-flat-pcap-dos.c,Adafruit_nRF52_Arduino-MDEwOlJlcG9zaXRvcnk3NDM1NDcyOQ==-flat-nrf_gpiote.h,45,67,22,112,127,15
1097872,https://htmlpreview.github.io/?https://github.com/Christina96/boilerplate-sample-matches/blob/main/C-beta/fftw3-MDEwOlJlcG9zaXRvcnk4ODQzMzg4-flat-rdft2-rdft.c-xmrig-MDEwOlJlcG9zaXRvcnk4ODMyNzQwNg==-flat-helper.h.html,0.07892376681614349,9,fftw3-MDEwOlJlcG9zaXRvcnk4ODQzMzg4-flat-rdft2-rdft.c,xmrig-MDEwOlJlcG9zaXRvcnk4ODMyNzQwNg==-flat-helper.h,25,29,4,274,279,5
1097953,https://htmlpreview.github.io/?https://github.com/Christina96/boilerplate-sample-matches/blob/main/C-beta/android-gpuimage-plus-MDEwOlJlcG9zaXRvcnk0NjU0NzQxNw==-flat-cgeBilateralBlurFilter.h-xmrig-MDEwOlJlcG9zaXRvcnk4ODMyNzQwNg==-flat-helper.h.html,0.04736842105263158,10,android-gpuimage-plus-MDEwOlJlcG9zaXRvcnk0NjU0NzQxNw==-flat-cgeBilateralBlurFilter.h,xmrig-MDEwOlJlcG9zaXRvcnk4ODMyNzQwNg==-flat-helper.h,17,23,6,387,395,8
1099656,https://htmlpreview.github.io/?https://github.com/Christina96/boilerplate-sample-matches/blob/main/C-beta/Adafruit_nRF52_Arduino-MDEwOlJlcG9zaXRvcnk3NDM1NDcyOQ==-flat-ble_gattc_26.h-xmrig-MDEwOlJlcG9zaXRvcnk4ODMyNzQwNg==-flat-adl_structures.h.html,0.3412140575079872,8,Adafruit_nRF52_Arduino-MDEwOlJlcG9zaXRvcnk3NDM1NDcyOQ==-flat-ble_gattc_26.h,xmrig-MDEwOlJlcG9zaXRvcnk4ODMyNzQwNg==-flat-adl_structures.h,197,197,0,227,234,7
1106963,https://htmlpreview.github.io/?https://github.com/Christina96/boilerplate-sample-matches/blob/main/C-beta/libtomcrypt-MDEwOlJlcG9zaXRvcnk3NzcwMTE=-flat-ocb3_encrypt.c-libtomcrypt-MDEwOlJlcG9zaXRvcnk3NzcwMTE=-flat-pkcs_1_pss_encode.c.html,0.10695187165775401,10,libtomcrypt-MDEwOlJlcG9zaXRvcnk3NzcwMTE=-flat-ocb3_encrypt.c,libtomcrypt-MDEwOlJlcG9zaXRvcnk3NzcwMTE=-flat-pkcs_1_pss_encode.c,3,7,4,3,7,4
1109092,https://htmlpreview.github.io/?https://github.com/Christina96/boilerplate-sample-matches/blob/main/C-beta/redis-MDEwOlJlcG9zaXRvcnkxMDgxMTA3MDY=-flat-llex.h-xmrig-MDEwOlJlcG9zaXRvcnk4ODMyNzQwNg==-flat-reader.h.html,0.11504424778761062,13,redis-MDEwOlJlcG9zaXRvcnkxMDgxMTA3MDY=-flat-llex.h,xmrig-MDEwOlJlcG9zaXRvcnk4ODMyNzQwNg==-flat-reader.h,7,10,3,64,76,12
1117309,https://htmlpreview.github.io/?https://github.com/Christina96/boilerplate-sample-matches/blob/main/C-beta/android-gpuimage-plus-MDEwOlJlcG9zaXRvcnk0NjU0NzQxNw==-flat-cgeGLFunctions.h-redis-MDEwOlJlcG9zaXRvcnkxMDgxMTA3MDY=-flat-t_stream.c.html,0.04588394062078273,9,android-gpuimage-plus-MDEwOlJlcG9zaXRvcnk0NjU0NzQxNw==-flat-cgeGLFunctions.h,redis-MDEwOlJlcG9zaXRvcnkxMDgxMTA3MDY=-flat-t_stream.c,141,145,4,111,112,1
1118033,https://htmlpreview.github.io/?https://github.com/Christina96/boilerplate-sample-matches/blob/main/C-beta/PINRemoteImage-MDEwOlJlcG9zaXRvcnkzOTUzNzEwMw==-flat-lossless_neon.c-redis-MDEwOlJlcG9zaXRvcnkxMDgxMTA3MDY=-flat-db.c.html,0.09095661265028751,8,PINRemoteImage-MDEwOlJlcG9zaXRvcnkzOTUzNzEwMw==-flat-lossless_neon.c,redis-MDEwOlJlcG9zaXRvcnkxMDgxMTA3MDY=-flat-db.c,104,116,12,693,696,3
1121076,https://htmlpreview.github.io/?https://github.com/Christina96/boilerplate-sample-matches/blob/main/C-beta/xmrig-MDEwOlJlcG9zaXRvcnk4ODMyNzQwNg==-flat-compile.h-redis-MDEwOlJlcG9zaXRvcnkxMDgxMTA3MDY=-flat-extent_24.c.html,0.05887496356747304,8,xmrig-MDEwOlJlcG9zaXRvcnk4ODMyNzQwNg==-flat-compile.h,redis-MDEwOlJlcG9zaXRvcnkxMDgxMTA3MDY=-flat-extent_24.c,130,135,5,505,510,5
1127747,https://htmlpreview.github.io/?https://github.com/Christina96/boilerplate-sample-matches/blob/main/C-beta/PINRemoteImage-MDEwOlJlcG9zaXRvcnkzOTUzNzEwMw==-flat-picture_rescale_enc.c-redis-MDEwOlJlcG9zaXRvcnkxMDgxMTA3MDY=-flat-rio.c.html,0.14991482112436116,10,PINRemoteImage-MDEwOlJlcG9zaXRvcnkzOTUzNzEwMw==-flat-picture_rescale_enc.c,redis-MDEwOlJlcG9zaXRvcnkxMDgxMTA3MDY=-flat-rio.c,58,63,5,193,198,5
1147013,https://htmlpreview.github.io/?https://github.com/Christina96/boilerplate-sample-matches/blob/main/C-beta/PINRemoteImage-MDEwOlJlcG9zaXRvcnkzOTUzNzEwMw==-flat-lossless_enc_sse2.c-redis-MDEwOlJlcG9zaXRvcnkxMDgxMTA3MDY=-flat-config.c.html,0.06462781304096941,11,PINRemoteImage-MDEwOlJlcG9zaXRvcnkzOTUzNzEwMw==-flat-lossless_enc_sse2.c,redis-MDEwOlJlcG9zaXRvcnkxMDgxMTA3MDY=-flat-config.c,98,102,4,1635,1638,3
1161345,https://htmlpreview.github.io/?https://github.com/Christina96/boilerplate-sample-matches/blob/main/C-beta/libpcap-MDEwOlJlcG9zaXRvcnk5NDM1ODg3-flat-opentest.c-libtomcrypt-MDEwOlJlcG9zaXRvcnk3NzcwMTE=-flat-ecc_verify_hash.c.html,0.042735042735042736,10,libpcap-MDEwOlJlcG9zaXRvcnk5NDM1ODg3-flat-opentest.c,libtomcrypt-MDEwOlJlcG9zaXRvcnk3NzcwMTE=-flat-ecc_verify_hash.c,28,37,9,3,7,4
1169741,https://htmlpreview.github.io/?https://github.com/Christina96/boilerplate-sample-matches/blob/main/C-beta/xmrig-MDEwOlJlcG9zaXRvcnk4ODMyNzQwNg==-flat-HttpClient.h-libtomcrypt-MDEwOlJlcG9zaXRvcnk3NzcwMTE=-flat-rsa_verify_hash.c.html,0.15730337078651685,14,xmrig-MDEwOlJlcG9zaXRvcnk4ODMyNzQwNg==-flat-HttpClient.h,libtomcrypt-MDEwOlJlcG9zaXRvcnk3NzcwMTE=-flat-rsa_verify_hash.c,20,25,5,3,11,8
1170138,https://htmlpreview.github.io/?https://github.com/Christina96/boilerplate-sample-matches/blob/main/C-beta/PINRemoteImage-MDEwOlJlcG9zaXRvcnkzOTUzNzEwMw==-flat-backward_references_cost_enc.c-redis-MDEwOlJlcG9zaXRvcnkxMDgxMTA3MDY=-flat-t_zset.c.html,0.13220088626292467,10,PINRemoteImage-MDEwOlJlcG9zaXRvcnkzOTUzNzEwMw==-flat-backward_references_cost_enc.c,redis-MDEwOlJlcG9zaXRvcnkxMDgxMTA3MDY=-flat-t_zset.c,295,299,4,941,945,4
1170372,https://htmlpreview.github.io/?https://github.com/Christina96/boilerplate-sample-matches/blob/main/C-beta/xmrig-MDEwOlJlcG9zaXRvcnk4ODMyNzQwNg==-flat-CpuWorker.h-xmrig-MDEwOlJlcG9zaXRvcnk4ODMyNzQwNg==-flat-JobResult.h.html,0.24113475177304963,9,xmrig-MDEwOlJlcG9zaXRvcnk4ODMyNzQwNg==-flat-CpuWorker.h,xmrig-MDEwOlJlcG9zaXRvcnk4ODMyNzQwNg==-flat-JobResult.h,50,57,7,49,57,8
1172455,https://htmlpreview.github.io/?https://github.com/Christina96/boilerplate-sample-matches/blob/main/C-beta/PINRemoteImage-MDEwOlJlcG9zaXRvcnkzOTUzNzEwMw==-flat-muxinternal.c-redis-MDEwOlJlcG9zaXRvcnkxMDgxMTA3MDY=-flat-lbaselib.c.html,0.11681914144968332,9,PINRemoteImage-MDEwOlJlcG9zaXRvcnkzOTUzNzEwMw==-flat-muxinternal.c,redis-MDEwOlJlcG9zaXRvcnkxMDgxMTA3MDY=-flat-lbaselib.c,128,135,7,243,248,5
1192571,https://htmlpreview.github.io/?https://github.com/Christina96/boilerplate-sample-matches/blob/main/C-beta/Adafruit_nRF52_Arduino-MDEwOlJlcG9zaXRvcnk3NDM1NDcyOQ==-flat-BLEUuid.h-libfuse-MDEwOlJlcG9zaXRvcnk0ODI5NjE3Nw==-flat-fuse_lowlevel.c.html,0.022788203753351208,9,Adafruit_nRF52_Arduino-MDEwOlJlcG9zaXRvcnk3NDM1NDcyOQ==-flat-BLEUuid.h,libfuse-MDEwOlJlcG9zaXRvcnk0ODI5NjE3Nw==-flat-fuse_lowlevel.c,13,17,4,289,296,7
1200891,https://htmlpreview.github.io/?https://github.com/Christina96/boilerplate-sample-matches/blob/main/C-beta/Adafruit_nRF52_Arduino-MDEwOlJlcG9zaXRvcnk3NDM1NDcyOQ==-flat-BLEHidGeneric.h-PINRemoteImage-MDEwOlJlcG9zaXRvcnkzOTUzNzEwMw==-flat-alpha_enc.c.html,0.1425891181988743,12,Adafruit_nRF52_Arduino-MDEwOlJlcG9zaXRvcnk3NDM1NDcyOQ==-flat-BLEHidGeneric.h,PINRemoteImage-MDEwOlJlcG9zaXRvcnkzOTUzNzEwMw==-flat-alpha_enc.c,13,15,2,149,155,6
1201138,https://htmlpreview.github.io/?https://github.com/Christina96/boilerplate-sample-matches/blob/main/C-beta/xmrig-MDEwOlJlcG9zaXRvcnk4ODMyNzQwNg==-flat-opencl.h-fftw3-MDEwOlJlcG9zaXRvcnk4ODQzMzg4-flat-vrank-geq1-rdft2.c.html,0.1935483870967742,9,xmrig-MDEwOlJlcG9zaXRvcnk4ODMyNzQwNg==-flat-opencl.h,fftw3-MDEwOlJlcG9zaXRvcnk4ODQzMzg4-flat-vrank-geq1-rdft2.c,28,34,6,84,91,7
1209197,https://htmlpreview.github.io/?https://github.com/Christina96/boilerplate-sample-matches/blob/main/C-beta/redis-MDEwOlJlcG9zaXRvcnkxMDgxMTA3MDY=-flat-slowlog.h-Adafruit_nRF52_Arduino-MDEwOlJlcG9zaXRvcnk3NDM1NDcyOQ==-flat-nrf52_erratas.h.html,0.115,23,redis-MDEwOlJlcG9zaXRvcnkxMDgxMTA3MDY=-flat-slowlog.h,Adafruit_nRF52_Arduino-MDEwOlJlcG9zaXRvcnk3NDM1NDcyOQ==-flat-nrf52_erratas.h,4,10,6,6,28,22
1213061,https://htmlpreview.github.io/?https://github.com/Christina96/boilerplate-sample-matches/blob/main/C-beta/libtomcrypt-MDEwOlJlcG9zaXRvcnk3NzcwMTE=-flat-pkcs_1_pss_encode.c-redis-MDEwOlJlcG9zaXRvcnkxMDgxMTA3MDY=-flat-mallocx.c.html,0.047337278106508875,8,libtomcrypt-MDEwOlJlcG9zaXRvcnk3NzcwMTE=-flat-pkcs_1_pss_encode.c,redis-MDEwOlJlcG9zaXRvcnkxMDgxMTA3MDY=-flat-mallocx.c,28,31,3,123,132,9
1217066,https://htmlpreview.github.io/?https://github.com/Christina96/boilerplate-sample-matches/blob/main/C-beta/xmrig-MDEwOlJlcG9zaXRvcnk4ODMyNzQwNg==-flat-Arguments.h-libtomcrypt-MDEwOlJlcG9zaXRvcnk3NzcwMTE=-flat-hash_filehandle.c.html,0.225,9,xmrig-MDEwOlJlcG9zaXRvcnk4ODMyNzQwNg==-flat-Arguments.h,libtomcrypt-MDEwOlJlcG9zaXRvcnk3NzcwMTE=-flat-hash_filehandle.c,9,11,2,3,8,5
1230089,https://htmlpreview.github.io/?https://github.com/Christina96/boilerplate-sample-matches/blob/main/C-beta/PINRemoteImage-MDEwOlJlcG9zaXRvcnkzOTUzNzEwMw==-flat-libwebp_go_wrap.c-redis-MDEwOlJlcG9zaXRvcnkxMDgxMTA3MDY=-flat-test_25.c.html,0.02359882005899705,8,PINRemoteImage-MDEwOlJlcG9zaXRvcnkzOTUzNzEwMw==-flat-libwebp_go_wrap.c,redis-MDEwOlJlcG9zaXRvcnkxMDgxMTA3MDY=-flat-test_25.c,123,127,4,321,326,5
1230548,https://htmlpreview.github.io/?https://github.com/Christina96/boilerplate-sample-matches/blob/main/C-beta/xmrig-MDEwOlJlcG9zaXRvcnk4ODMyNzQwNg==-flat-DnsRecords.h-android-gpuimage-plus-MDEwOlJlcG9zaXRvcnk0NjU0NzQxNw==-flat-avio.h.html,0.08376963350785341,16,xmrig-MDEwOlJlcG9zaXRvcnk4ODMyNzQwNg==-flat-DnsRecords.h,android-gpuimage-plus-MDEwOlJlcG9zaXRvcnk0NjU0NzQxNw==-flat-avio.h,8,15,7,137,150,13
1234475,https://htmlpreview.github.io/?https://github.com/Christina96/boilerplate-sample-matches/blob/main/C-beta/xmrig-MDEwOlJlcG9zaXRvcnk4ODMyNzQwNg==-flat-blake2.h-Adafruit_nRF52_Arduino-MDEwOlJlcG9zaXRvcnk3NDM1NDcyOQ==-flat-SEGGER_RTT.h.html,0.49710982658959535,11,xmrig-MDEwOlJlcG9zaXRvcnk4ODMyNzQwNg==-flat-blake2.h,Adafruit_nRF52_Arduino-MDEwOlJlcG9zaXRvcnk3NDM1NDcyOQ==-flat-SEGGER_RTT.h,17,27,10,89,94,5
1253025,https://htmlpreview.github.io/?https://github.com/Christina96/boilerplate-sample-matches/blob/main/C-beta/libtomcrypt-MDEwOlJlcG9zaXRvcnk3NzcwMTE=-flat-ec25519_crypto_ctx.c-libpcap-MDEwOlJlcG9zaXRvcnk5NDM1ODg3-flat-pcap-rpcap.c.html,0.01497566454511419,10,libtomcrypt-MDEwOlJlcG9zaXRvcnk3NzcwMTE=-flat-ec25519_crypto_ctx.c,libpcap-MDEwOlJlcG9zaXRvcnk5NDM1ODg3-flat-pcap-rpcap.c,10,16,6,1905,1914,9
1257080,https://htmlpreview.github.io/?https://github.com/Christina96/boilerplate-sample-matches/blob/main/C-beta/xmrig-MDEwOlJlcG9zaXRvcnk4ODMyNzQwNg==-flat-c_blake256.h-libtomcrypt-MDEwOlJlcG9zaXRvcnk3NzcwMTE=-flat-tomcrypt_pk.h.html,0.11913814955640051,47,xmrig-MDEwOlJlcG9zaXRvcnk4ODMyNzQwNg==-flat-c_blake256.h,libtomcrypt-MDEwOlJlcG9zaXRvcnk3NzcwMTE=-flat-tomcrypt_pk.h,10,28,18,18,51,33
1258761,https://htmlpreview.github.io/?https://github.com/Christina96/boilerplate-sample-matches/blob/main/C-beta/PINRemoteImage-MDEwOlJlcG9zaXRvcnkzOTUzNzEwMw==-flat-rescaler_mips32.c-fftw3-MDEwOlJlcG9zaXRvcnk4ODQzMzg4-flat-verify-rdft2.c.html,0.0979020979020979,9,PINRemoteImage-MDEwOlJlcG9zaXRvcnkzOTUzNzEwMw==-flat-rescaler_mips32.c,fftw3-MDEwOlJlcG9zaXRvcnk4ODQzMzg4-flat-verify-rdft2.c,63,67,4,65,69,4
1259657,https://htmlpreview.github.io/?https://github.com/Christina96/boilerplate-sample-matches/blob/main/C-beta/xmrig-MDEwOlJlcG9zaXRvcnk4ODMyNzQwNg==-flat-IClientListener.h-small-MDEwOlJlcG9zaXRvcnkyNTY3NjMxNjk=-flat-http.c.html,0.11678832116788321,8,xmrig-MDEwOlJlcG9zaXRvcnk4ODMyNzQwNg==-flat-IClientListener.h,small-MDEwOlJlcG9zaXRvcnkyNTY3NjMxNjk=-flat-http.c,15,15,0,13,15,2
1266615,https://htmlpreview.github.io/?https://github.com/Christina96/boilerplate-sample-matches/blob/main/C-beta/fftw3-MDEwOlJlcG9zaXRvcnk4ODQzMzg4-flat-plan-many-dft-c2r.c-xmrig-MDEwOlJlcG9zaXRvcnk4ODMyNzQwNg==-flat-BenchConfig.h.html,0.22900763358778625,15,fftw3-MDEwOlJlcG9zaXRvcnk4ODQzMzg4-flat-plan-many-dft-c2r.c,xmrig-MDEwOlJlcG9zaXRvcnk4ODMyNzQwNg==-flat-BenchConfig.h,3,12,9,28,29,1
1267909,https://htmlpreview.github.io/?https://github.com/Christina96/boilerplate-sample-matches/blob/main/C-beta/libtomcrypt-MDEwOlJlcG9zaXRvcnk3NzcwMTE=-flat-ltc_ecc_import_point.c-android-gpuimage-plus-MDEwOlJlcG9zaXRvcnk0NjU0NzQxNw==-flat-cgeMat.h.html,0.022242817423540315,12,libtomcrypt-MDEwOlJlcG9zaXRvcnk3NzcwMTE=-flat-ltc_ecc_import_point.c,android-gpuimage-plus-MDEwOlJlcG9zaXRvcnk0NjU0NzQxNw==-flat-cgeMat.h,3,7,4,1,6,5
1284680,https://htmlpreview.github.io/?https://github.com/Christina96/boilerplate-sample-matches/blob/main/C-beta/fftw3-MDEwOlJlcG9zaXRvcnk4ODQzMzg4-flat-mktensor-rowmajor.c-libtomcrypt-MDEwOlJlcG9zaXRvcnk3NzcwMTE=-flat-tv_gen.c.html,0.024746906636670417,11,fftw3-MDEwOlJlcG9zaXRvcnk4ODQzMzg4-flat-mktensor-rowmajor.c,libtomcrypt-MDEwOlJlcG9zaXRvcnk3NzcwMTE=-flat-tv_gen.c,2,6,4,40,47,7
1291129,https://htmlpreview.github.io/?https://github.com/Christina96/boilerplate-sample-matches/blob/main/C-beta/libtomcrypt-MDEwOlJlcG9zaXRvcnk3NzcwMTE=-flat-rabbit.c-PINRemoteImage-MDEwOlJlcG9zaXRvcnkzOTUzNzEwMw==-flat-anim_util.c.html,0.06393442622950819,11,libtomcrypt-MDEwOlJlcG9zaXRvcnk3NzcwMTE=-flat-rabbit.c,PINRemoteImage-MDEwOlJlcG9zaXRvcnkzOTUzNzEwMw==-flat-anim_util.c,129,134,5,400,407,7
1295985,https://htmlpreview.github.io/?https://github.com/Christina96/boilerplate-sample-matches/blob/main/C-beta/Adafruit_nRF52_Arduino-MDEwOlJlcG9zaXRvcnk3NDM1NDcyOQ==-flat-nrfx_wdt.h-libtomcrypt-MDEwOlJlcG9zaXRvcnk3NzcwMTE=-flat-khazad.c.html,0.013611229264142918,8,Adafruit_nRF52_Arduino-MDEwOlJlcG9zaXRvcnk3NDM1NDcyOQ==-flat-nrfx_wdt.h,libtomcrypt-MDEwOlJlcG9zaXRvcnk3NzcwMTE=-flat-khazad.c,38,53,15,570,577,7
1296619,https://htmlpreview.github.io/?https://github.com/Christina96/boilerplate-sample-matches/blob/main/C-beta/libtomcrypt-MDEwOlJlcG9zaXRvcnk3NzcwMTE=-flat-test.c-fftw3-MDEwOlJlcG9zaXRvcnk4ODQzMzg4-flat-buffered2.c.html,0.17655172413793102,8,libtomcrypt-MDEwOlJlcG9zaXRvcnk3NzcwMTE=-flat-test.c,fftw3-MDEwOlJlcG9zaXRvcnk4ODQzMzg4-flat-buffered2.c,139,160,21,182,185,3
1299621,https://htmlpreview.github.io/?https://github.com/Christina96/boilerplate-sample-matches/blob/main/C-beta/PINRemoteImage-MDEwOlJlcG9zaXRvcnkzOTUzNzEwMw==-flat-backward_references_cost_enc.c-PINRemoteImage-MDEwOlJlcG9zaXRvcnkzOTUzNzEwMw==-flat-enc_sse2.c.html,0.09318028359216746,9,PINRemoteImage-MDEwOlJlcG9zaXRvcnkzOTUzNzEwMw==-flat-backward_references_cost_enc.c,PINRemoteImage-MDEwOlJlcG9zaXRvcnkzOTUzNzEwMw==-flat-enc_sse2.c,37,41,4,112,119,7
1310524,https://htmlpreview.github.io/?https://github.com/Christina96/boilerplate-sample-matches/blob/main/C-beta/libtomcrypt-MDEwOlJlcG9zaXRvcnk3NzcwMTE=-flat-tomcrypt_misc.h-android-gpuimage-plus-MDEwOlJlcG9zaXRvcnk0NjU0NzQxNw==-flat-cgeThread.h.html,0.24,15,libtomcrypt-MDEwOlJlcG9zaXRvcnk3NzcwMTE=-flat-tomcrypt_misc.h,android-gpuimage-plus-MDEwOlJlcG9zaXRvcnk0NjU0NzQxNw==-flat-cgeThread.h,30,40,10,109,117,8
1311089,https://htmlpreview.github.io/?https://github.com/Christina96/boilerplate-sample-matches/blob/main/C-beta/PINRemoteImage-MDEwOlJlcG9zaXRvcnkzOTUzNzEwMw==-flat-alpha_processing_mips_dsp_r2.c-xmrig-MDEwOlJlcG9zaXRvcnk4ODMyNzQwNg==-flat-topology-x86.c.html,0.0555858310626703,10,PINRemoteImage-MDEwOlJlcG9zaXRvcnkzOTUzNzEwMw==-flat-alpha_processing_mips_dsp_r2.c,xmrig-MDEwOlJlcG9zaXRvcnk4ODMyNzQwNg==-flat-topology-x86.c,55,63,8,96,103,7
1322896,https://htmlpreview.github.io/?https://github.com/Christina96/boilerplate-sample-matches/blob/main/C-beta/redis-MDEwOlJlcG9zaXRvcnkxMDgxMTA3MDY=-flat-extent_mmap.c-libtomcrypt-MDEwOlJlcG9zaXRvcnk3NzcwMTE=-flat-salsa20_setup.c.html,0.23529411764705882,8,redis-MDEwOlJlcG9zaXRvcnkxMDgxMTA3MDY=-flat-extent_mmap.c,libtomcrypt-MDEwOlJlcG9zaXRvcnk3NzcwMTE=-flat-salsa20_setup.c,6,15,9,4,7,3
1324952,https://htmlpreview.github.io/?https://github.com/Christina96/boilerplate-sample-matches/blob/main/C-beta/redis-MDEwOlJlcG9zaXRvcnkxMDgxMTA3MDY=-flat-adlist.h-Adafruit_nRF52_Arduino-MDEwOlJlcG9zaXRvcnk3NDM1NDcyOQ==-flat-nrfx_twis.h.html,0.40298507462686567,27,redis-MDEwOlJlcG9zaXRvcnkxMDgxMTA3MDY=-flat-adlist.h,Adafruit_nRF52_Arduino-MDEwOlJlcG9zaXRvcnk3NDM1NDcyOQ==-flat-nrfx_twis.h,20,46,26,67,102,35
1325401,https://htmlpreview.github.io/?https://github.com/Christina96/boilerplate-sample-matches/blob/main/C-beta/xmrig-MDEwOlJlcG9zaXRvcnk4ODMyNzQwNg==-flat-CudaConfig_gen.h-Adafruit_nRF52_Arduino-MDEwOlJlcG9zaXRvcnk3NDM1NDcyOQ==-flat-nrf_saadc.h.html,0.10756302521008404,11,xmrig-MDEwOlJlcG9zaXRvcnk4ODMyNzQwNg==-flat-CudaConfig_gen.h,Adafruit_nRF52_Arduino-MDEwOlJlcG9zaXRvcnk3NDM1NDcyOQ==-flat-nrf_saadc.h,39,52,13,240,248,8
1331339,https://htmlpreview.github.io/?https://github.com/Christina96/boilerplate-sample-matches/blob/main/C-beta/Adafruit_nRF52_Arduino-MDEwOlJlcG9zaXRvcnk3NDM1NDcyOQ==-flat-flash_nrf5x.c-fftw3-MDEwOlJlcG9zaXRvcnk4ODQzMzg4-flat-timer_23.c.html,0.18867924528301888,8,Adafruit_nRF52_Arduino-MDEwOlJlcG9zaXRvcnk3NDM1NDcyOQ==-flat-flash_nrf5x.c,fftw3-MDEwOlJlcG9zaXRvcnk4ODQzMzg4-flat-timer_23.c,96,101,5,28,38,10
1332764,https://htmlpreview.github.io/?https://github.com/Christina96/boilerplate-sample-matches/blob/main/C-beta/libpcap-MDEwOlJlcG9zaXRvcnk5NDM1ODg3-flat-fuzz_rserver.c-xmrig-MDEwOlJlcG9zaXRvcnk4ODMyNzQwNg==-flat-compile.h.html,0.021834061135371178,10,libpcap-MDEwOlJlcG9zaXRvcnk5NDM1ODg3-flat-fuzz_rserver.c,xmrig-MDEwOlJlcG9zaXRvcnk4ODMyNzQwNg==-flat-compile.h,29,31,2,81,88,7
1335980,https://htmlpreview.github.io/?https://github.com/Christina96/boilerplate-sample-matches/blob/main/C-beta/Adafruit_nRF52_Arduino-MDEwOlJlcG9zaXRvcnk3NDM1NDcyOQ==-flat-ble_types.h-libtomcrypt-MDEwOlJlcG9zaXRvcnk3NzcwMTE=-flat-sober128.c.html,0.06201550387596899,8,Adafruit_nRF52_Arduino-MDEwOlJlcG9zaXRvcnk3NDM1NDcyOQ==-flat-ble_types.h,libtomcrypt-MDEwOlJlcG9zaXRvcnk3NzcwMTE=-flat-sober128.c,96,101,5,25,29,4
1336771,https://htmlpreview.github.io/?https://github.com/Christina96/boilerplate-sample-matches/blob/main/C-beta/PINRemoteImage-MDEwOlJlcG9zaXRvcnkzOTUzNzEwMw==-flat-delta_palettization_enc.c-PINRemoteImage-MDEwOlJlcG9zaXRvcnkzOTUzNzEwMw==-flat-webpinfo.c.html,0.10430247718383312,8,PINRemoteImage-MDEwOlJlcG9zaXRvcnkzOTUzNzEwMw==-flat-delta_palettization_enc.c,PINRemoteImage-MDEwOlJlcG9zaXRvcnkzOTUzNzEwMw==-flat-webpinfo.c,313,317,4,180,200,20
1340023,https://htmlpreview.github.io/?https://github.com/Christina96/boilerplate-sample-matches/blob/main/C-beta/libfuse-MDEwOlJlcG9zaXRvcnk0ODI5NjE3Nw==-flat-hello_ll_uds.c-libtomcrypt-MDEwOlJlcG9zaXRvcnk3NzcwMTE=-flat-tweetnacl.c.html,0.12395929694727105,9,libfuse-MDEwOlJlcG9zaXRvcnk0ODI5NjE3Nw==-flat-hello_ll_uds.c,libtomcrypt-MDEwOlJlcG9zaXRvcnk3NzcwMTE=-flat-tweetnacl.c,113,118,5,396,399,3
1345932,https://htmlpreview.github.io/?https://github.com/Christina96/boilerplate-sample-matches/blob/main/C-beta/libfuse-MDEwOlJlcG9zaXRvcnk0ODI5NjE3Nw==-flat-fuse.c-libtomcrypt-MDEwOlJlcG9zaXRvcnk3NzcwMTE=-flat-safer.c.html,0.0853932584269663,9,libfuse-MDEwOlJlcG9zaXRvcnk0ODI5NjE3Nw==-flat-fuse.c,libtomcrypt-MDEwOlJlcG9zaXRvcnk3NzcwMTE=-flat-safer.c,85,96,11,189,195,6
1356347,https://htmlpreview.github.io/?https://github.com/Christina96/boilerplate-sample-matches/blob/main/C-beta/libtomcrypt-MDEwOlJlcG9zaXRvcnk3NzcwMTE=-flat-rmd320.c-libpcap-MDEwOlJlcG9zaXRvcnk5NDM1ODg3-flat-pcap-rpcap.c.html,0.01867145421903052,15,libtomcrypt-MDEwOlJlcG9zaXRvcnk3NzcwMTE=-flat-rmd320.c,libpcap-MDEwOlJlcG9zaXRvcnk5NDM1ODg3-flat-pcap-rpcap.c,214,258,44,1405,1421,16
1359395,https://htmlpreview.github.io/?https://github.com/Christina96/boilerplate-sample-matches/blob/main/C-beta/Adafruit_nRF52_Arduino-MDEwOlJlcG9zaXRvcnk3NDM1NDcyOQ==-flat-nrfx_ppi.h-Adafruit_nRF52_Arduino-MDEwOlJlcG9zaXRvcnk3NDM1NDcyOQ==-flat-nrf_rng.h.html,0.4,26,Adafruit_nRF52_Arduino-MDEwOlJlcG9zaXRvcnk3NDM1NDcyOQ==-flat-nrfx_ppi.h,Adafruit_nRF52_Arduino-MDEwOlJlcG9zaXRvcnk3NDM1NDcyOQ==-flat-nrf_rng.h,25,47,22,23,40,17
1362035,https://htmlpreview.github.io/?https://github.com/Christina96/boilerplate-sample-matches/blob/main/C-beta/PINRemoteImage-MDEwOlJlcG9zaXRvcnkzOTUzNzEwMw==-flat-libwebp_go_wrap.c-redis-MDEwOlJlcG9zaXRvcnkxMDgxMTA3MDY=-flat-large.c.html,0.06716417910447761,8,PINRemoteImage-MDEwOlJlcG9zaXRvcnkzOTUzNzEwMw==-flat-libwebp_go_wrap.c,redis-MDEwOlJlcG9zaXRvcnkxMDgxMTA3MDY=-flat-large.c,123,127,4,262,266,4
1386976,https://htmlpreview.github.io/?https://github.com/Christina96/boilerplate-sample-matches/blob/main/C-beta/libtomcrypt-MDEwOlJlcG9zaXRvcnk3NzcwMTE=-flat-der_encode_setof.c-redis-MDEwOlJlcG9zaXRvcnkxMDgxMTA3MDY=-flat-lstate.h.html,0.05962059620596206,11,libtomcrypt-MDEwOlJlcG9zaXRvcnk3NzcwMTE=-flat-der_encode_setof.c,redis-MDEwOlJlcG9zaXRvcnkxMDgxMTA3MDY=-flat-lstate.h,30,37,7,57,61,4
1388099,https://htmlpreview.github.io/?https://github.com/Christina96/boilerplate-sample-matches/blob/main/C-beta/xmrig-MDEwOlJlcG9zaXRvcnk4ODMyNzQwNg==-flat-sph_skein.c-Adafruit_nRF52_Arduino-MDEwOlJlcG9zaXRvcnk3NDM1NDcyOQ==-flat-nrf_soc_21.h.html,0.10640066500415628,10,xmrig-MDEwOlJlcG9zaXRvcnk4ODMyNzQwNg==-flat-sph_skein.c,Adafruit_nRF52_Arduino-MDEwOlJlcG9zaXRvcnk3NDM1NDcyOQ==-flat-nrf_soc_21.h,700,708,8,191,194,3
1397352,https://htmlpreview.github.io/?https://github.com/Christina96/boilerplate-sample-matches/blob/main/C-beta/PINRemoteImage-MDEwOlJlcG9zaXRvcnkzOTUzNzEwMw==-flat-image_enc.h-small-MDEwOlJlcG9zaXRvcnkyNTY3NjMxNjk=-flat-resolv.c.html,0.18313253012048192,10,PINRemoteImage-MDEwOlJlcG9zaXRvcnkzOTUzNzEwMw==-flat-image_enc.h,small-MDEwOlJlcG9zaXRvcnkyNTY3NjMxNjk=-flat-resolv.c,26,34,8,22,28,6
1400951,https://htmlpreview.github.io/?https://github.com/Christina96/boilerplate-sample-matches/blob/main/C-beta/fftw3-MDEwOlJlcG9zaXRvcnk4ODQzMzg4-flat-map-r2r-kind.c-xmrig-MDEwOlJlcG9zaXRvcnk4ODMyNzQwNg==-flat-Hashrate.h.html,0.23880597014925373,8,fftw3-MDEwOlJlcG9zaXRvcnk4ODQzMzg4-flat-map-r2r-kind.c,xmrig-MDEwOlJlcG9zaXRvcnk4ODMyNzQwNg==-flat-Hashrate.h,3,8,5,33,36,3
1401468,https://htmlpreview.github.io/?https://github.com/Christina96/boilerplate-sample-matches/blob/main/C-beta/redis-MDEwOlJlcG9zaXRvcnkxMDgxMTA3MDY=-flat-stdint.h-redis-MDEwOlJlcG9zaXRvcnkxMDgxMTA3MDY=-flat-rax.c.html,0.059085841694537344,8,redis-MDEwOlJlcG9zaXRvcnkxMDgxMTA3MDY=-flat-stdint.h,redis-MDEwOlJlcG9zaXRvcnkxMDgxMTA3MDY=-flat-rax.c,58,62,4,246,248,2
1407553,https://htmlpreview.github.io/?https://github.com/Christina96/boilerplate-sample-matches/blob/main/C-beta/libtomcrypt-MDEwOlJlcG9zaXRvcnk3NzcwMTE=-flat-rng_make_prng.c-android-gpuimage-plus-MDEwOlJlcG9zaXRvcnk0NjU0NzQxNw==-flat-cgeGL3Stub.h.html,0.125,10,libtomcrypt-MDEwOlJlcG9zaXRvcnk3NzcwMTE=-flat-rng_make_prng.c,android-gpuimage-plus-MDEwOlJlcG9zaXRvcnk0NjU0NzQxNw==-flat-cgeGL3Stub.h,3,8,5,10,336,326
1408580,https://htmlpreview.github.io/?https://github.com/Christina96/boilerplate-sample-matches/blob/main/C-beta/Adafruit_nRF52_Arduino-MDEwOlJlcG9zaXRvcnk3NDM1NDcyOQ==-flat-SEGGER_SYSVIEW_Int.h-xmrig-MDEwOlJlcG9zaXRvcnk4ODMyNzQwNg==-flat-HashrateInterpolator.h.html,0.5714285714285714,8,Adafruit_nRF52_Arduino-MDEwOlJlcG9zaXRvcnk3NDM1NDcyOQ==-flat-SEGGER_SYSVIEW_Int.h,xmrig-MDEwOlJlcG9zaXRvcnk4ODMyNzQwNg==-flat-HashrateInterpolator.h,10,17,7,13,14,1
1429214,https://htmlpreview.github.io/?https://github.com/Christina96/boilerplate-sample-matches/blob/main/C-beta/Adafruit_nRF52_Arduino-MDEwOlJlcG9zaXRvcnk3NDM1NDcyOQ==-flat-BLEClientDis.h-fftw3-MDEwOlJlcG9zaXRvcnk4ODQzMzg4-flat-api_16.c.html,0.1267605633802817,9,Adafruit_nRF52_Arduino-MDEwOlJlcG9zaXRvcnk3NDM1NDcyOQ==-flat-BLEClientDis.h,fftw3-MDEwOlJlcG9zaXRvcnk4ODQzMzg4-flat-api_16.c,9,12,3,57,57,0
1429978,https://htmlpreview.github.io/?https://github.com/Christina96/boilerplate-sample-matches/blob/main/C-beta/libpcap-MDEwOlJlcG9zaXRvcnk5NDM1ODg3-flat-pcap-rpcap-int.h-xmrig-MDEwOlJlcG9zaXRvcnk4ODMyNzQwNg==-flat-ICpuInfo.h.html,0.17204301075268819,8,libpcap-MDEwOlJlcG9zaXRvcnk5NDM1ODg3-flat-pcap-rpcap-int.h,xmrig-MDEwOlJlcG9zaXRvcnk4ODMyNzQwNg==-flat-ICpuInfo.h,6,7,1,25,32,7
1436136,https://htmlpreview.github.io/?https://github.com/Christina96/boilerplate-sample-matches/blob/main/C-beta/libtomcrypt-MDEwOlJlcG9zaXRvcnk3NzcwMTE=-flat-ltm_desc.c-redis-MDEwOlJlcG9zaXRvcnkxMDgxMTA3MDY=-flat-extent_inlines.h.html,0.10134436401240951,10,libtomcrypt-MDEwOlJlcG9zaXRvcnk3NzcwMTE=-flat-ltm_desc.c,redis-MDEwOlJlcG9zaXRvcnkxMDgxMTA3MDY=-flat-extent_inlines.h,319,328,9,395,402,7
1442076,https://htmlpreview.github.io/?https://github.com/Christina96/boilerplate-sample-matches/blob/main/C-beta/libtomcrypt-MDEwOlJlcG9zaXRvcnk3NzcwMTE=-flat-eax_decrypt_verify_memory.c-xmrig-MDEwOlJlcG9zaXRvcnk4ODMyNzQwNg==-flat-md_helper.c.html,0.1285140562248996,8,libtomcrypt-MDEwOlJlcG9zaXRvcnk3NzcwMTE=-flat-eax_decrypt_verify_memory.c,xmrig-MDEwOlJlcG9zaXRvcnk4ODMyNzQwNg==-flat-md_helper.c,7,13,6,228,234,6
1444596,https://htmlpreview.github.io/?https://github.com/Christina96/boilerplate-sample-matches/blob/main/C-beta/xmrig-MDEwOlJlcG9zaXRvcnk4ODMyNzQwNg==-flat-Dns.h-PINRemoteImage-MDEwOlJlcG9zaXRvcnkzOTUzNzEwMw==-flat-lossless.h.html,0.12440191387559808,13,xmrig-MDEwOlJlcG9zaXRvcnk4ODMyNzQwNg==-flat-Dns.h,PINRemoteImage-MDEwOlJlcG9zaXRvcnkzOTUzNzEwMw==-flat-lossless.h,17,20,3,10,19,9
1449088,https://htmlpreview.github.io/?https://github.com/Christina96/boilerplate-sample-matches/blob/main/C-beta/fftw3-MDEwOlJlcG9zaXRvcnk4ODQzMzg4-flat-threads.h-libpcap-MDEwOlJlcG9zaXRvcnk5NDM1ODg3-flat-pcap-airpcap.c.html,0.25386996904024767,41,fftw3-MDEwOlJlcG9zaXRvcnk4ODQzMzg4-flat-threads.h,libpcap-MDEwOlJlcG9zaXRvcnk5NDM1ODg3-flat-pcap-airpcap.c,10,28,18,9,33,24
1465474,https://htmlpreview.github.io/?https://github.com/Christina96/boilerplate-sample-matches/blob/main/C-beta/redis-MDEwOlJlcG9zaXRvcnkxMDgxMTA3MDY=-flat-memtest.c-fftw3-MDEwOlJlcG9zaXRvcnk4ODQzMzg4-flat-mpi-bench.c.html,0.05299860529986053,9,redis-MDEwOlJlcG9zaXRvcnkxMDgxMTA3MDY=-flat-memtest.c,fftw3-MDEwOlJlcG9zaXRvcnk4ODQzMzg4-flat-mpi-bench.c,172,177,5,156,159,3
1467763,https://htmlpreview.github.io/?https://github.com/Christina96/boilerplate-sample-matches/blob/main/C-beta/fftw3-MDEwOlJlcG9zaXRvcnk4ODQzMzg4-flat-amd64-cpuid.h-PINRemoteImage-MDEwOlJlcG9zaXRvcnkzOTUzNzEwMw==-flat-decode_45.h.html,0.10285714285714286,10,fftw3-MDEwOlJlcG9zaXRvcnk4ODQzMzg4-flat-amd64-cpuid.h,PINRemoteImage-MDEwOlJlcG9zaXRvcnkzOTUzNzEwMw==-flat-decode_45.h,35,47,12,141,144,3
1490788,https://htmlpreview.github.io/?https://github.com/Christina96/boilerplate-sample-matches/blob/main/C-beta/PINRemoteImage-MDEwOlJlcG9zaXRvcnkzOTUzNzEwMw==-flat-utils.h-fftw3-MDEwOlJlcG9zaXRvcnk4ODQzMzg4-flat-vrank-geq1-rdft2.c.html,0.10062893081761007,8,PINRemoteImage-MDEwOlJlcG9zaXRvcnkzOTUzNzEwMw==-flat-utils.h,fftw3-MDEwOlJlcG9zaXRvcnk4ODQzMzg4-flat-vrank-geq1-rdft2.c,40,43,3,43,48,5
1495405,https://htmlpreview.github.io/?https://github.com/Christina96/boilerplate-sample-matches/blob/main/C-beta/Adafruit_nRF52_Arduino-MDEwOlJlcG9zaXRvcnk3NDM1NDcyOQ==-flat-bignum.h-redis-MDEwOlJlcG9zaXRvcnkxMDgxMTA3MDY=-flat-jemalloc_internal_inlines_c.h.html,0.20535714285714285,12,Adafruit_nRF52_Arduino-MDEwOlJlcG9zaXRvcnk3NDM1NDcyOQ==-flat-bignum.h,redis-MDEwOlJlcG9zaXRvcnkxMDgxMTA3MDY=-flat-jemalloc_internal_inlines_c.h,56,81,25,98,104,6
1495661,https://htmlpreview.github.io/?https://github.com/Christina96/boilerplate-sample-matches/blob/main/C-beta/libfuse-MDEwOlJlcG9zaXRvcnk0ODI5NjE3Nw==-flat-null.c-small-MDEwOlJlcG9zaXRvcnkyNTY3NjMxNjk=-flat-encrypt.c.html,0.04030576789437109,9,libfuse-MDEwOlJlcG9zaXRvcnk0ODI5NjE3Nw==-flat-null.c,small-MDEwOlJlcG9zaXRvcnkyNTY3NjMxNjk=-flat-encrypt.c,10,18,8,1337,1349,12
1498589,https://htmlpreview.github.io/?https://github.com/Christina96/boilerplate-sample-matches/blob/main/C-beta/android-gpuimage-plus-MDEwOlJlcG9zaXRvcnk0NjU0NzQxNw==-flat-cgeNativeLibrary.h-redis-MDEwOlJlcG9zaXRvcnkxMDgxMTA3MDY=-flat-pubsub.c.html,0.10933940774487472,8,android-gpuimage-plus-MDEwOlJlcG9zaXRvcnk0NjU0NzQxNw==-flat-cgeNativeLibrary.h,redis-MDEwOlJlcG9zaXRvcnkxMDgxMTA3MDY=-flat-pubsub.c,12,12,0,90,90,0
1503726,https://htmlpreview.github.io/?https://github.com/Christina96/boilerplate-sample-matches/blob/main/C-beta/libtomcrypt-MDEwOlJlcG9zaXRvcnk3NzcwMTE=-flat-hash_memory_multi.c-libtomcrypt-MDEwOlJlcG9zaXRvcnk3NzcwMTE=-flat-ecc_recover_key.c.html,0.05274725274725275,12,libtomcrypt-MDEwOlJlcG9zaXRvcnk3NzcwMTE=-flat-hash_memory_multi.c,libtomcrypt-MDEwOlJlcG9zaXRvcnk3NzcwMTE=-flat-ecc_recover_key.c,4,11,7,169,169,0
1527329,https://htmlpreview.github.io/?https://github.com/Christina96/boilerplate-sample-matches/blob/main/C-beta/fftw3-MDEwOlJlcG9zaXRvcnk4ODQzMzg4-flat-import-wisdom-from-file.c-redis-MDEwOlJlcG9zaXRvcnkxMDgxMTA3MDY=-flat-pack.c.html,0.17592592592592593,11,fftw3-MDEwOlJlcG9zaXRvcnk4ODQzMzg4-flat-import-wisdom-from-file.c,redis-MDEwOlJlcG9zaXRvcnkxMDgxMTA3MDY=-flat-pack.c,33,39,6,43,52,9
1533309,https://htmlpreview.github.io/?https://github.com/Christina96/boilerplate-sample-matches/blob/main/C-beta/Adafruit_nRF52_Arduino-MDEwOlJlcG9zaXRvcnk3NDM1NDcyOQ==-flat-SwRotaryEncoder.h-redis-MDEwOlJlcG9zaXRvcnkxMDgxMTA3MDY=-flat-net.c.html,0.027874564459930314,8,Adafruit_nRF52_Arduino-MDEwOlJlcG9zaXRvcnk3NDM1NDcyOQ==-flat-SwRotaryEncoder.h,redis-MDEwOlJlcG9zaXRvcnkxMDgxMTA3MDY=-flat-net.c,16,17,1,244,250,6
1548176,https://htmlpreview.github.io/?https://github.com/Christina96/boilerplate-sample-matches/blob/main/C-beta/Adafruit_nRF52_Arduino-MDEwOlJlcG9zaXRvcnk3NDM1NDcyOQ==-flat-nrfx_egu.h-xmrig-MDEwOlJlcG9zaXRvcnk4ODMyNzQwNg==-flat-sph_bmw.c.html,0.06946983546617916,9,Adafruit_nRF52_Arduino-MDEwOlJlcG9zaXRvcnk3NDM1NDcyOQ==-flat-nrfx_egu.h,xmrig-MDEwOlJlcG9zaXRvcnk4ODMyNzQwNg==-flat-sph_bmw.c,48,55,7,529,536,7
1552933,https://htmlpreview.github.io/?https://github.com/Christina96/boilerplate-sample-matches/blob/main/C-beta/redis-MDEwOlJlcG9zaXRvcnkxMDgxMTA3MDY=-flat-malloc_io_7.c-xmrig-MDEwOlJlcG9zaXRvcnk4ODMyNzQwNg==-flat-DaemonClient.h.html,0.22085889570552147,9,redis-MDEwOlJlcG9zaXRvcnkxMDgxMTA3MDY=-flat-malloc_io_7.c,xmrig-MDEwOlJlcG9zaXRvcnk4ODMyNzQwNg==-flat-DaemonClient.h,47,51,4,60,68,8
1554676,https://htmlpreview.github.io/?https://github.com/Christina96/boilerplate-sample-matches/blob/main/C-beta/libtomcrypt-MDEwOlJlcG9zaXRvcnk3NzcwMTE=-flat-poly1305_memory.c-libpcap-MDEwOlJlcG9zaXRvcnk5NDM1ODg3-flat-rpcap-protocol.h.html,0.056962025316455694,9,libtomcrypt-MDEwOlJlcG9zaXRvcnk3NzcwMTE=-flat-poly1305_memory.c,libpcap-MDEwOlJlcG9zaXRvcnk5NDM1ODg3-flat-rpcap-protocol.h,3,6,3,59,63,4
1556012,https://htmlpreview.github.io/?https://github.com/Christina96/boilerplate-sample-matches/blob/main/C-beta/PINRemoteImage-MDEwOlJlcG9zaXRvcnkzOTUzNzEwMw==-flat-example_util.h-Adafruit_nRF52_Arduino-MDEwOlJlcG9zaXRvcnk3NDM1NDcyOQ==-flat-nrf_uarte.h.html,0.13675213675213677,10,PINRemoteImage-MDEwOlJlcG9zaXRvcnkzOTUzNzEwMw==-flat-example_util.h,Adafruit_nRF52_Arduino-MDEwOlJlcG9zaXRvcnk3NDM1NDcyOQ==-flat-nrf_uarte.h,14,22,8,101,114,13
1557872,https://htmlpreview.github.io/?https://github.com/Christina96/boilerplate-sample-matches/blob/main/C-beta/android-gpuimage-plus-MDEwOlJlcG9zaXRvcnk0NjU0NzQxNw==-flat-cgeFrameRendererWrapper.h-fftw3-MDEwOlJlcG9zaXRvcnk4ODQzMzg4-flat-reodft11e-radix2.c.html,0.058919803600654665,8,android-gpuimage-plus-MDEwOlJlcG9zaXRvcnk0NjU0NzQxNw==-flat-cgeFrameRendererWrapper.h,fftw3-MDEwOlJlcG9zaXRvcnk4ODQzMzg4-flat-reodft11e-radix2.c,10,11,1,6,13,7
1559182,https://htmlpreview.github.io/?https://github.com/Christina96/boilerplate-sample-matches/blob/main/C-beta/fftw3-MDEwOlJlcG9zaXRvcnk4ODQzMzg4-flat-ifftw-mpi.h-xmrig-MDEwOlJlcG9zaXRvcnk4ODMyNzQwNg==-flat-WalletAddress.h.html,0.14414414414414414,16,fftw3-MDEwOlJlcG9zaXRvcnk4ODQzMzg4-flat-ifftw-mpi.h,xmrig-MDEwOlJlcG9zaXRvcnk4ODMyNzQwNg==-flat-WalletAddress.h,39,45,6,40,46,6
1562002,https://htmlpreview.github.io/?https://github.com/Christina96/boilerplate-sample-matches/blob/main/C-beta/PINRemoteImage-MDEwOlJlcG9zaXRvcnkzOTUzNzEwMw==-flat-image_dec.c-libtomcrypt-MDEwOlJlcG9zaXRvcnk3NzcwMTE=-flat-base64_encode.c.html,0.08530805687203792,9,PINRemoteImage-MDEwOlJlcG9zaXRvcnkzOTUzNzEwMw==-flat-image_dec.c,libtomcrypt-MDEwOlJlcG9zaXRvcnk3NzcwMTE=-flat-base64_encode.c,26,36,10,69,73,4
1583090,https://htmlpreview.github.io/?https://github.com/Christina96/boilerplate-sample-matches/blob/main/C-beta/redis-MDEwOlJlcG9zaXRvcnkxMDgxMTA3MDY=-flat-ae_epoll.c-libtomcrypt-MDEwOlJlcG9zaXRvcnk3NzcwMTE=-flat-saferp.c.html,0.025,8,redis-MDEwOlJlcG9zaXRvcnkxMDgxMTA3MDY=-flat-ae_epoll.c,libtomcrypt-MDEwOlJlcG9zaXRvcnk3NzcwMTE=-flat-saferp.c,44,48,4,230,238,8
1583428,https://htmlpreview.github.io/?https://github.com/Christina96/boilerplate-sample-matches/blob/main/C-beta/xmrig-MDEwOlJlcG9zaXRvcnk4ODMyNzQwNg==-flat-blake2.c-fftw3-MDEwOlJlcG9zaXRvcnk4ODQzMzg4-flat-vrank-geq1-rdft2.c.html,0.1608695652173913,8,xmrig-MDEwOlJlcG9zaXRvcnk4ODMyNzQwNg==-flat-blake2.c,fftw3-MDEwOlJlcG9zaXRvcnk4ODQzMzg4-flat-vrank-geq1-rdft2.c,6,9,3,72,73,1
1585696,https://htmlpreview.github.io/?https://github.com/Christina96/boilerplate-sample-matches/blob/main/C-beta/Adafruit_nRF52_Arduino-MDEwOlJlcG9zaXRvcnk3NDM1NDcyOQ==-flat-model_tester.h-xmrig-MDEwOlJlcG9zaXRvcnk4ODMyNzQwNg==-flat-plugins.h.html,0.23423423423423423,13,Adafruit_nRF52_Arduino-MDEwOlJlcG9zaXRvcnk3NDM1NDcyOQ==-flat-model_tester.h,xmrig-MDEwOlJlcG9zaXRvcnk4ODMyNzQwNg==-flat-plugins.h,9,19,10,13,16,3
1593436,https://htmlpreview.github.io/?https://github.com/Christina96/boilerplate-sample-matches/blob/main/C-beta/redis-MDEwOlJlcG9zaXRvcnkxMDgxMTA3MDY=-flat-read.h-Adafruit_nRF52_Arduino-MDEwOlJlcG9zaXRvcnk3NDM1NDcyOQ==-flat-nrf_spu.h.html,0.40390879478827363,36,redis-MDEwOlJlcG9zaXRvcnkxMDgxMTA3MDY=-flat-read.h,Adafruit_nRF52_Arduino-MDEwOlJlcG9zaXRvcnk3NDM1NDcyOQ==-flat-nrf_spu.h,40,50,10,37,71,34
1596130,https://htmlpreview.github.io/?https://github.com/Christina96/boilerplate-sample-matches/blob/main/C-beta/fftw3-MDEwOlJlcG9zaXRvcnk4ODQzMzg4-flat-tensor2.c-Adafruit_nRF52_Arduino-MDEwOlJlcG9zaXRvcnk3NDM1NDcyOQ==-flat-nrf_twim.h.html,0.12063492063492064,11,fftw3-MDEwOlJlcG9zaXRvcnk4ODQzMzg4-flat-tensor2.c,Adafruit_nRF52_Arduino-MDEwOlJlcG9zaXRvcnk3NDM1NDcyOQ==-flat-nrf_twim.h,14,18,4,70,80,10
1597192,https://htmlpreview.github.io/?https://github.com/Christina96/boilerplate-sample-matches/blob/main/C-beta/redis-MDEwOlJlcG9zaXRvcnkxMDgxMTA3MDY=-flat-Win32_PThread.h-libtomcrypt-MDEwOlJlcG9zaXRvcnk3NzcwMTE=-flat-ed25519_sign.c.html,0.17886178861788618,11,redis-MDEwOlJlcG9zaXRvcnkxMDgxMTA3MDY=-flat-Win32_PThread.h,libtomcrypt-MDEwOlJlcG9zaXRvcnk3NzcwMTE=-flat-ed25519_sign.c,35,41,6,3,9,6
1605894,https://htmlpreview.github.io/?https://github.com/Christina96/boilerplate-sample-matches/blob/main/C-beta/xmrig-MDEwOlJlcG9zaXRvcnk4ODMyNzQwNg==-flat-argon2-avx512f.c-libfuse-MDEwOlJlcG9zaXRvcnk0ODI5NjE3Nw==-flat-test_syscalls.c.html,0.03896103896103896,8,xmrig-MDEwOlJlcG9zaXRvcnk4ODMyNzQwNg==-flat-argon2-avx512f.c,libfuse-MDEwOlJlcG9zaXRvcnk0ODI5NjE3Nw==-flat-test_syscalls.c,157,158,1,20,27,7
1606863,https://htmlpreview.github.io/?https://github.com/Christina96/boilerplate-sample-matches/blob/main/C-beta/libtomcrypt-MDEwOlJlcG9zaXRvcnk3NzcwMTE=-flat-rabbit_memory.c-PINRemoteImage-MDEwOlJlcG9zaXRvcnkzOTUzNzEwMw==-flat-yuv_sse41.c.html,0.05454545454545454,9,libtomcrypt-MDEwOlJlcG9zaXRvcnk3NzcwMTE=-flat-rabbit_memory.c,PINRemoteImage-MDEwOlJlcG9zaXRvcnkzOTUzNzEwMw==-flat-yuv_sse41.c,3,9,6,68,71,3
1609737,https://htmlpreview.github.io/?https://github.com/Christina96/boilerplate-sample-matches/blob/main/C-beta/xmrig-MDEwOlJlcG9zaXRvcnk4ODMyNzQwNg==-flat-sph_types.h-Adafruit_nRF52_Arduino-MDEwOlJlcG9zaXRvcnk3NDM1NDcyOQ==-flat-stream_buffer.c.html,0.14330874604847207,9,xmrig-MDEwOlJlcG9zaXRvcnk4ODMyNzQwNg==-flat-sph_types.h,Adafruit_nRF52_Arduino-MDEwOlJlcG9zaXRvcnk3NDM1NDcyOQ==-flat-stream_buffer.c,320,330,10,770,780,10
1611138,https://htmlpreview.github.io/?https://github.com/Christina96/boilerplate-sample-matches/blob/main/C-beta/libtomcrypt-MDEwOlJlcG9zaXRvcnk3NzcwMTE=-flat-gcm_memory.c-libtomcrypt-MDEwOlJlcG9zaXRvcnk3NzcwMTE=-flat-eax_init.c.html,0.4975124378109453,11,libtomcrypt-MDEwOlJlcG9zaXRvcnk3NzcwMTE=-flat-gcm_memory.c,libtomcrypt-MDEwOlJlcG9zaXRvcnk3NzcwMTE=-flat-eax_init.c,39,46,7,36,42,6
1616596,https://htmlpreview.github.io/?https://github.com/Christina96/boilerplate-sample-matches/blob/main/C-beta/fftw3-MDEwOlJlcG9zaXRvcnk4ODQzMzg4-flat-ct.h-fftw3-MDEwOlJlcG9zaXRvcnk4ODQzMzg4-flat-transpose.c.html,0.11805555555555555,9,fftw3-MDEwOlJlcG9zaXRvcnk4ODQzMzg4-flat-ct.h,fftw3-MDEwOlJlcG9zaXRvcnk4ODQzMzg4-flat-transpose.c,2,6,4,117,120,3
1617398,https://htmlpreview.github.io/?https://github.com/Christina96/boilerplate-sample-matches/blob/main/C-beta/fftw3-MDEwOlJlcG9zaXRvcnk4ODQzMzg4-flat-rdft-rank-geq2.c-fftw3-MDEwOlJlcG9zaXRvcnk4ODQzMzg4-flat-simd-kcvi.h.html,0.0967741935483871,8,fftw3-MDEwOlJlcG9zaXRvcnk4ODQzMzg4-flat-rdft-rank-geq2.c,fftw3-MDEwOlJlcG9zaXRvcnk4ODQzMzg4-flat-simd-kcvi.h,23,28,5,70,81,11
1623813,https://htmlpreview.github.io/?https://github.com/Christina96/boilerplate-sample-matches/blob/main/C-beta/libtomcrypt-MDEwOlJlcG9zaXRvcnk3NzcwMTE=-flat-pk_oid_cmp.c-PINRemoteImage-MDEwOlJlcG9zaXRvcnkzOTUzNzEwMw==-flat-vp8l_enc.c.html,0.017716535433070866,9,libtomcrypt-MDEwOlJlcG9zaXRvcnk3NzcwMTE=-flat-pk_oid_cmp.c,PINRemoteImage-MDEwOlJlcG9zaXRvcnkzOTUzNzEwMw==-flat-vp8l_enc.c,13,18,5,938,944,6
1631727,https://htmlpreview.github.io/?https://github.com/Christina96/boilerplate-sample-matches/blob/main/C-beta/libfuse-MDEwOlJlcG9zaXRvcnk0ODI5NjE3Nw==-flat-cuse_lowlevel.c-Adafruit_nRF52_Arduino-MDEwOlJlcG9zaXRvcnk3NDM1NDcyOQ==-flat-nrf_gpio.h.html,0.3078817733990148,19,libfuse-MDEwOlJlcG9zaXRvcnk0ODI5NjE3Nw==-flat-cuse_lowlevel.c,Adafruit_nRF52_Arduino-MDEwOlJlcG9zaXRvcnk3NDM1NDcyOQ==-flat-nrf_gpio.h,37,41,4,110,124,14
1634490,https://htmlpreview.github.io/?https://github.com/Christina96/boilerplate-sample-matches/blob/main/C-beta/PINRemoteImage-MDEwOlJlcG9zaXRvcnkzOTUzNzEwMw==-flat-argb_mips_dsp_r2.c-small-MDEwOlJlcG9zaXRvcnkyNTY3NjMxNjk=-flat-tls1.2_ticket.c.html,0.05221932114882506,10,PINRemoteImage-MDEwOlJlcG9zaXRvcnkzOTUzNzEwMw==-flat-argb_mips_dsp_r2.c,small-MDEwOlJlcG9zaXRvcnkyNTY3NjMxNjk=-flat-tls1.2_ticket.c,42,47,5,373,375,2
1640264,https://htmlpreview.github.io/?https://github.com/Christina96/boilerplate-sample-matches/blob/main/C-beta/xmrig-MDEwOlJlcG9zaXRvcnk4ODMyNzQwNg==-flat-umul128.h-Adafruit_nRF52_Arduino-MDEwOlJlcG9zaXRvcnk3NDM1NDcyOQ==-flat-croutine.c.html,0.1708542713567839,9,xmrig-MDEwOlJlcG9zaXRvcnk4ODMyNzQwNg==-flat-umul128.h,Adafruit_nRF52_Arduino-MDEwOlJlcG9zaXRvcnk3NDM1NDcyOQ==-flat-croutine.c,18,21,3,11,16,5
1644327,https://htmlpreview.github.io/?https://github.com/Christina96/boilerplate-sample-matches/blob/main/C-beta/PINRemoteImage-MDEwOlJlcG9zaXRvcnkzOTUzNzEwMw==-flat-PINRemoteImageManager.h-redis-MDEwOlJlcG9zaXRvcnkxMDgxMTA3MDY=-flat-linenoise.c.html,0.024709302325581394,8,PINRemoteImage-MDEwOlJlcG9zaXRvcnkzOTUzNzEwMw==-flat-PINRemoteImageManager.h,redis-MDEwOlJlcG9zaXRvcnkxMDgxMTA3MDY=-flat-linenoise.c,24,31,7,50,57,7
1649660,https://htmlpreview.github.io/?https://github.com/Christina96/boilerplate-sample-matches/blob/main/C-beta/xmrig-MDEwOlJlcG9zaXRvcnk4ODMyNzQwNg==-flat-encoding.h-xmrig-MDEwOlJlcG9zaXRvcnk4ODMyNzQwNg==-flat-ExecuteVmKernel.h.html,0.43902439024390244,9,xmrig-MDEwOlJlcG9zaXRvcnk4ODMyNzQwNg==-flat-encoding.h,xmrig-MDEwOlJlcG9zaXRvcnk4ODMyNzQwNg==-flat-ExecuteVmKernel.h,7,11,4,9,10,1
1667047,https://htmlpreview.github.io/?https://github.com/Christina96/boilerplate-sample-matches/blob/main/C-beta/libtomcrypt-MDEwOlJlcG9zaXRvcnk3NzcwMTE=-flat-tomcrypt_hash.h-xmrig-MDEwOlJlcG9zaXRvcnk4ODMyNzQwNg==-flat-adl_structures.h.html,0.45885885885885885,9,libtomcrypt-MDEwOlJlcG9zaXRvcnk3NzcwMTE=-flat-tomcrypt_hash.h,xmrig-MDEwOlJlcG9zaXRvcnk4ODMyNzQwNg==-flat-adl_structures.h,337,343,6,687,695,8
1674437,https://htmlpreview.github.io/?https://github.com/Christina96/boilerplate-sample-matches/blob/main/C-beta/redis-MDEwOlJlcG9zaXRvcnkxMDgxMTA3MDY=-flat-redis-cli.c-libtomcrypt-MDEwOlJlcG9zaXRvcnk3NzcwMTE=-flat-ecc_test.c.html,0.09046692607003891,11,redis-MDEwOlJlcG9zaXRvcnkxMDgxMTA3MDY=-flat-redis-cli.c,libtomcrypt-MDEwOlJlcG9zaXRvcnk3NzcwMTE=-flat-ecc_test.c,147,157,10,413,420,7
1688247,https://htmlpreview.github.io/?https://github.com/Christina96/boilerplate-sample-matches/blob/main/C-beta/libtomcrypt-MDEwOlJlcG9zaXRvcnk3NzcwMTE=-flat-tomcrypt_math.h-PINRemoteImage-MDEwOlJlcG9zaXRvcnkzOTUzNzEwMw==-flat-lossless_enc.c.html,0.021256931608133085,23,libtomcrypt-MDEwOlJlcG9zaXRvcnk3NzcwMTE=-flat-tomcrypt_math.h,PINRemoteImage-MDEwOlJlcG9zaXRvcnkzOTUzNzEwMw==-flat-lossless_enc.c,17,23,6,756,778,22
1703328,https://htmlpreview.github.io/?https://github.com/Christina96/boilerplate-sample-matches/blob/main/C-beta/libtomcrypt-MDEwOlJlcG9zaXRvcnk3NzcwMTE=-flat-sosemanuk_memory.c-android-gpuimage-plus-MDEwOlJlcG9zaXRvcnk0NjU0NzQxNw==-flat-cgeGLFunctions.h.html,0.05825242718446602,9,libtomcrypt-MDEwOlJlcG9zaXRvcnk3NzcwMTE=-flat-sosemanuk_memory.c,android-gpuimage-plus-MDEwOlJlcG9zaXRvcnk0NjU0NzQxNw==-flat-cgeGLFunctions.h,3,9,6,135,136,1
1715338,https://htmlpreview.github.io/?https://github.com/Christina96/boilerplate-sample-matches/blob/main/C-beta/fftw3-MDEwOlJlcG9zaXRvcnk4ODQzMzg4-flat-rdft2-rank-geq2.c-redis-MDEwOlJlcG9zaXRvcnkxMDgxMTA3MDY=-flat-xallocx.c.html,0.16417910447761194,8,fftw3-MDEwOlJlcG9zaXRvcnk4ODQzMzg4-flat-rdft2-rank-geq2.c,redis-MDEwOlJlcG9zaXRvcnkxMDgxMTA3MDY=-flat-xallocx.c,121,126,5,177,189,12
1716514,https://htmlpreview.github.io/?https://github.com/Christina96/boilerplate-sample-matches/blob/main/C-beta/fftw3-MDEwOlJlcG9zaXRvcnk4ODQzMzg4-flat-block.c-fftw3-MDEwOlJlcG9zaXRvcnk4ODQzMzg4-flat-verify-dft.c.html,0.10198300283286119,8,fftw3-MDEwOlJlcG9zaXRvcnk4ODQzMzg4-flat-block.c,fftw3-MDEwOlJlcG9zaXRvcnk4ODQzMzg4-flat-verify-dft.c,77,81,4,64,67,3
1723328,https://htmlpreview.github.io/?https://github.com/Christina96/boilerplate-sample-matches/blob/main/C-beta/android-gpuimage-plus-MDEwOlJlcG9zaXRvcnk0NjU0NzQxNw==-flat-rc4.h-small-MDEwOlJlcG9zaXRvcnkyNTY3NjMxNjk=-flat-cache.h.html,0.2077922077922078,8,android-gpuimage-plus-MDEwOlJlcG9zaXRvcnk0NjU0NzQxNw==-flat-rc4.h,small-MDEwOlJlcG9zaXRvcnkyNTY3NjMxNjk=-flat-cache.h,8,10,2,12,13,1
1730544,https://htmlpreview.github.io/?https://github.com/Christina96/boilerplate-sample-matches/blob/main/C-beta/Adafruit_nRF52_Arduino-MDEwOlJlcG9zaXRvcnk3NDM1NDcyOQ==-flat-nrfx_usbd.h-fftw3-MDEwOlJlcG9zaXRvcnk4ODQzMzg4-flat-trigtest.c.html,0.1561712846347607,11,Adafruit_nRF52_Arduino-MDEwOlJlcG9zaXRvcnk3NDM1NDcyOQ==-flat-nrfx_usbd.h,fftw3-MDEwOlJlcG9zaXRvcnk4ODQzMzg4-flat-trigtest.c,43,44,1,87,90,3
1730870,https://htmlpreview.github.io/?https://github.com/Christina96/boilerplate-sample-matches/blob/main/C-beta/xmrig-MDEwOlJlcG9zaXRvcnk4ODMyNzQwNg==-flat-FailoverStrategy.h-libpcap-MDEwOlJlcG9zaXRvcnk5NDM1ODg3-flat-sf-pcapng.c.html,0.03955500618046971,8,xmrig-MDEwOlJlcG9zaXRvcnk4ODMyNzQwNg==-flat-FailoverStrategy.h,libpcap-MDEwOlJlcG9zaXRvcnk5NDM1ODg3-flat-sf-pcapng.c,38,43,5,577,588,11
1747639,https://htmlpreview.github.io/?https://github.com/Christina96/boilerplate-sample-matches/blob/main/C-beta/xmrig-MDEwOlJlcG9zaXRvcnk4ODMyNzQwNg==-flat-Signatures.h-redis-MDEwOlJlcG9zaXRvcnkxMDgxMTA3MDY=-flat-tcache_externs.h.html,0.6666666666666666,25,xmrig-MDEwOlJlcG9zaXRvcnk4ODMyNzQwNg==-flat-Signatures.h,redis-MDEwOlJlcG9zaXRvcnkxMDgxMTA3MDY=-flat-tcache_externs.h,5,12,7,3,16,13
1751875,https://htmlpreview.github.io/?https://github.com/Christina96/boilerplate-sample-matches/blob/main/C-beta/libtomcrypt-MDEwOlJlcG9zaXRvcnk3NzcwMTE=-flat-sha256.c-libfuse-MDEwOlJlcG9zaXRvcnk0ODI5NjE3Nw==-flat-iconv.c.html,0.07221664994984955,10,libtomcrypt-MDEwOlJlcG9zaXRvcnk3NzcwMTE=-flat-sha256.c,libfuse-MDEwOlJlcG9zaXRvcnk0ODI5NjE3Nw==-flat-iconv.c,162,171,9,535,544,9
1755199,https://htmlpreview.github.io/?https://github.com/Christina96/boilerplate-sample-matches/blob/main/C-beta/xmrig-MDEwOlJlcG9zaXRvcnk4ODMyNzQwNg==-flat-OclSharedData.h-PINRemoteImage-MDEwOlJlcG9zaXRvcnkzOTUzNzEwMw==-flat-gif2webp.c.html,0.03908794788273615,12,xmrig-MDEwOlJlcG9zaXRvcnk4ODMyNzQwNg==-flat-OclSharedData.h,PINRemoteImage-MDEwOlJlcG9zaXRvcnkzOTUzNzEwMw==-flat-gif2webp.c,23,30,7,68,73,5
1764315,https://htmlpreview.github.io/?https://github.com/Christina96/boilerplate-sample-matches/blob/main/C-beta/fftw3-MDEwOlJlcG9zaXRvcnk4ODQzMzg4-flat-buffered_8.c-PINRemoteImage-MDEwOlJlcG9zaXRvcnkzOTUzNzEwMw==-flat-anim_encode.c.html,0.06759656652360516,8,fftw3-MDEwOlJlcG9zaXRvcnk4ODQzMzg4-flat-buffered_8.c,PINRemoteImage-MDEwOlJlcG9zaXRvcnkzOTUzNzEwMw==-flat-anim_encode.c,103,110,7,392,398,6
1772932,https://htmlpreview.github.io/?https://github.com/Christina96/boilerplate-sample-matches/blob/main/C-beta/xmrig-MDEwOlJlcG9zaXRvcnk4ODMyNzQwNg==-flat-cl_dx9_media_sharing.h-libpcap-MDEwOlJlcG9zaXRvcnk5NDM1ODg3-flat-pcap-dlpi.c.html,0.029304029304029304,8,xmrig-MDEwOlJlcG9zaXRvcnk4ODMyNzQwNg==-flat-cl_dx9_media_sharing.h,libpcap-MDEwOlJlcG9zaXRvcnk5NDM1ODg3-flat-pcap-dlpi.c,37,65,28,51,54,3
1778308,https://htmlpreview.github.io/?https://github.com/Christina96/boilerplate-sample-matches/blob/main/C-beta/libtomcrypt-MDEwOlJlcG9zaXRvcnk3NzcwMTE=-flat-sosemanuk_memory.c-libtomcrypt-MDEwOlJlcG9zaXRvcnk3NzcwMTE=-flat-sosemanuk.c.html,0.08333333333333333,9,libtomcrypt-MDEwOlJlcG9zaXRvcnk3NzcwMTE=-flat-sosemanuk_memory.c,libtomcrypt-MDEwOlJlcG9zaXRvcnk3NzcwMTE=-flat-sosemanuk.c,3,9,6,162,176,14
1804542,https://htmlpreview.github.io/?https://github.com/Christina96/boilerplate-sample-matches/blob/main/C-beta/fftw3-MDEwOlJlcG9zaXRvcnk4ODQzMzg4-flat-rdft2-rdft.c-xmrig-MDEwOlJlcG9zaXRvcnk4ODMyNzQwNg==-flat-pointer.h.html,0.11619718309859155,9,fftw3-MDEwOlJlcG9zaXRvcnk4ODQzMzg4-flat-rdft2-rdft.c,xmrig-MDEwOlJlcG9zaXRvcnk4ODMyNzQwNg==-flat-pointer.h,126,131,5,105,110,5
1835279,https://htmlpreview.github.io/?https://github.com/Christina96/boilerplate-sample-matches/blob/main/C-beta/fftw3-MDEwOlJlcG9zaXRvcnk4ODQzMzg4-flat-dftw-directsq.c-fftw3-MDEwOlJlcG9zaXRvcnk4ODQzMzg4-flat-dft-r2hc.c.html,0.292817679558011,11,fftw3-MDEwOlJlcG9zaXRvcnk4ODQzMzg4-flat-dftw-directsq.c,fftw3-MDEwOlJlcG9zaXRvcnk4ODQzMzg4-flat-dft-r2hc.c,53,65,12,74,82,8
1851983,https://htmlpreview.github.io/?https://github.com/Christina96/boilerplate-sample-matches/blob/main/C-beta/PINRemoteImage-MDEwOlJlcG9zaXRvcnkzOTUzNzEwMw==-flat-lossless.h-redis-MDEwOlJlcG9zaXRvcnkxMDgxMTA3MDY=-flat-arena.c.html,0.08994484514212983,21,PINRemoteImage-MDEwOlJlcG9zaXRvcnkzOTUzNzEwMw==-flat-lossless.h,redis-MDEwOlJlcG9zaXRvcnkxMDgxMTA3MDY=-flat-arena.c,26,42,16,34,43,9
1865165,https://htmlpreview.github.io/?https://github.com/Christina96/boilerplate-sample-matches/blob/main/C-beta/redis-MDEwOlJlcG9zaXRvcnkxMDgxMTA3MDY=-flat-slowlog.c-redis-MDEwOlJlcG9zaXRvcnkxMDgxMTA3MDY=-flat-smallocx.c.html,0.041884816753926704,8,redis-MDEwOlJlcG9zaXRvcnkxMDgxMTA3MDY=-flat-slowlog.c,redis-MDEwOlJlcG9zaXRvcnkxMDgxMTA3MDY=-flat-smallocx.c,3,4,1,99,105,6
1865823,https://htmlpreview.github.io/?https://github.com/Christina96/boilerplate-sample-matches/blob/main/C-beta/Adafruit_nRF52_Arduino-MDEwOlJlcG9zaXRvcnk3NDM1NDcyOQ==-flat-mpu_prototypes.h-redis-MDEwOlJlcG9zaXRvcnkxMDgxMTA3MDY=-flat-defrag.c.html,0.0423728813559322,10,Adafruit_nRF52_Arduino-MDEwOlJlcG9zaXRvcnk3NDM1NDcyOQ==-flat-mpu_prototypes.h,redis-MDEwOlJlcG9zaXRvcnkxMDgxMTA3MDY=-flat-defrag.c,3,4,1,6,8,2
1882100,https://htmlpreview.github.io/?https://github.com/Christina96/boilerplate-sample-matches/blob/main/C-beta/xmrig-MDEwOlJlcG9zaXRvcnk4ODMyNzQwNg==-flat-cl_d3d10.h-libtomcrypt-MDEwOlJlcG9zaXRvcnk3NzcwMTE=-flat-der_encode_custom_type.c.html,0.08035714285714286,9,xmrig-MDEwOlJlcG9zaXRvcnk4ODMyNzQwNg==-flat-cl_d3d10.h,libtomcrypt-MDEwOlJlcG9zaXRvcnk3NzcwMTE=-flat-der_encode_custom_type.c,10,46,36,3,10,7
1886051,https://htmlpreview.github.io/?https://github.com/Christina96/boilerplate-sample-matches/blob/main/C-beta/fftw3-MDEwOlJlcG9zaXRvcnk4ODQzMzg4-flat-tensor2.c-Adafruit_nRF52_Arduino-MDEwOlJlcG9zaXRvcnk3NDM1NDcyOQ==-flat-lfs.c.html,0.08995502248875563,12,fftw3-MDEwOlJlcG9zaXRvcnk4ODQzMzg4-flat-tensor2.c,Adafruit_nRF52_Arduino-MDEwOlJlcG9zaXRvcnk3NDM1NDcyOQ==-flat-lfs.c,7,14,7,315,324,9
1910706,https://htmlpreview.github.io/?https://github.com/Christina96/boilerplate-sample-matches/blob/main/C-beta/xmrig-MDEwOlJlcG9zaXRvcnk4ODMyNzQwNg==-flat-misc.c-libtomcrypt-MDEwOlJlcG9zaXRvcnk3NzcwMTE=-flat-timing.c.html,0.01164294954721863,9,xmrig-MDEwOlJlcG9zaXRvcnk4ODMyNzQwNg==-flat-misc.c,libtomcrypt-MDEwOlJlcG9zaXRvcnk3NzcwMTE=-flat-timing.c,21,27,6,484,490,6
1911167,https://htmlpreview.github.io/?https://github.com/Christina96/boilerplate-sample-matches/blob/main/C-beta/redis-MDEwOlJlcG9zaXRvcnkxMDgxMTA3MDY=-flat-Win32_FDAPI.h-libtomcrypt-MDEwOlJlcG9zaXRvcnk3NzcwMTE=-flat-khazad.c.html,0.025256511444356748,8,redis-MDEwOlJlcG9zaXRvcnkxMDgxMTA3MDY=-flat-Win32_FDAPI.h,libtomcrypt-MDEwOlJlcG9zaXRvcnk3NzcwMTE=-flat-khazad.c,68,70,2,579,586,7
1912488,https://htmlpreview.github.io/?https://github.com/Christina96/boilerplate-sample-matches/blob/main/C-beta/PINRemoteImage-MDEwOlJlcG9zaXRvcnkzOTUzNzEwMw==-flat-ssim.c-redis-MDEwOlJlcG9zaXRvcnkxMDgxMTA3MDY=-flat-testrdb.c.html,0.06015037593984962,8,PINRemoteImage-MDEwOlJlcG9zaXRvcnkzOTUzNzEwMw==-flat-ssim.c,redis-MDEwOlJlcG9zaXRvcnkxMDgxMTA3MDY=-flat-testrdb.c,11,14,3,4,7,3
1927724,https://htmlpreview.github.io/?https://github.com/Christina96/boilerplate-sample-matches/blob/main/C-beta/Adafruit_nRF52_Arduino-MDEwOlJlcG9zaXRvcnk3NDM1NDcyOQ==-flat-BLEAncs.h-Adafruit_nRF52_Arduino-MDEwOlJlcG9zaXRvcnk3NDM1NDcyOQ==-flat-tweetnacl.c.html,0.054775280898876406,8,Adafruit_nRF52_Arduino-MDEwOlJlcG9zaXRvcnk3NDM1NDcyOQ==-flat-BLEAncs.h,Adafruit_nRF52_Arduino-MDEwOlJlcG9zaXRvcnk3NDM1NDcyOQ==-flat-tweetnacl.c,83,85,2,692,696,4
1951071,https://htmlpreview.github.io/?https://github.com/Christina96/boilerplate-sample-matches/blob/main/C-beta/libpcap-MDEwOlJlcG9zaXRvcnk5NDM1ODg3-flat-bpf.h-fftw3-MDEwOlJlcG9zaXRvcnk4ODQzMzg4-flat-rank-geq2-rdft2.c.html,0.05128205128205128,8,libpcap-MDEwOlJlcG9zaXRvcnk5NDM1ODg3-flat-bpf.h,fftw3-MDEwOlJlcG9zaXRvcnk4ODQzMzg4-flat-rank-geq2-rdft2.c,86,90,4,130,130,0
1956937,https://htmlpreview.github.io/?https://github.com/Christina96/boilerplate-sample-matches/blob/main/C-beta/PINRemoteImage-MDEwOlJlcG9zaXRvcnkzOTUzNzEwMw==-flat-msa_macro.h-xmrig-MDEwOlJlcG9zaXRvcnk4ODMyNzQwNg==-flat-sse2neon.h.html,0.035489410417859184,38,PINRemoteImage-MDEwOlJlcG9zaXRvcnkzOTUzNzEwMw==-flat-msa_macro.h,xmrig-MDEwOlJlcG9zaXRvcnk4ODMyNzQwNg==-flat-sse2neon.h,71,354,283,289,317,28
1962442,https://htmlpreview.github.io/?https://github.com/Christina96/boilerplate-sample-matches/blob/main/C-beta/Adafruit_nRF52_Arduino-MDEwOlJlcG9zaXRvcnk3NDM1NDcyOQ==-flat-nrfx_errors.h-Adafruit_nRF52_Arduino-MDEwOlJlcG9zaXRvcnk3NDM1NDcyOQ==-flat-nrfx_timer.h.html,0.24427480916030533,16,Adafruit_nRF52_Arduino-MDEwOlJlcG9zaXRvcnk3NDM1NDcyOQ==-flat-nrfx_errors.h,Adafruit_nRF52_Arduino-MDEwOlJlcG9zaXRvcnk3NDM1NDcyOQ==-flat-nrfx_timer.h,7,22,15,56,71,15
1964381,https://htmlpreview.github.io/?https://github.com/Christina96/boilerplate-sample-matches/blob/main/C-beta/android-gpuimage-plus-MDEwOlJlcG9zaXRvcnk0NjU0NzQxNw==-flat-cgeMultipleEffects.h-redis-MDEwOlJlcG9zaXRvcnkxMDgxMTA3MDY=-flat-stream.h.html,0.2532299741602067,16,android-gpuimage-plus-MDEwOlJlcG9zaXRvcnk0NjU0NzQxNw==-flat-cgeMultipleEffects.h,redis-MDEwOlJlcG9zaXRvcnkxMDgxMTA3MDY=-flat-stream.h,17,26,9,23,27,4
1970677,https://htmlpreview.github.io/?https://github.com/Christina96/boilerplate-sample-matches/blob/main/C-beta/redis-MDEwOlJlcG9zaXRvcnkxMDgxMTA3MDY=-flat-latency.c-Adafruit_nRF52_Arduino-MDEwOlJlcG9zaXRvcnk3NDM1NDcyOQ==-flat-ble_gap.h.html,0.04261682242990654,15,redis-MDEwOlJlcG9zaXRvcnkxMDgxMTA3MDY=-flat-latency.c,Adafruit_nRF52_Arduino-MDEwOlJlcG9zaXRvcnk3NDM1NDcyOQ==-flat-ble_gap.h,122,126,4,41,44,3
1971559,https://htmlpreview.github.io/?https://github.com/Christina96/boilerplate-sample-matches/blob/main/C-beta/android-gpuimage-plus-MDEwOlJlcG9zaXRvcnk0NjU0NzQxNw==-flat-cgeBeautifyFilter.h-PINRemoteImage-MDEwOlJlcG9zaXRvcnkzOTUzNzEwMw==-flat-utils.h.html,0.1834862385321101,10,android-gpuimage-plus-MDEwOlJlcG9zaXRvcnk0NjU0NzQxNw==-flat-cgeBeautifyFilter.h,PINRemoteImage-MDEwOlJlcG9zaXRvcnkzOTUzNzEwMw==-flat-utils.h,15,17,2,85,91,6
1972229,https://htmlpreview.github.io/?https://github.com/Christina96/boilerplate-sample-matches/blob/main/C-beta/Adafruit_nRF52_Arduino-MDEwOlJlcG9zaXRvcnk3NDM1NDcyOQ==-flat-ble_gatt.h-redis-MDEwOlJlcG9zaXRvcnkxMDgxMTA3MDY=-flat-hyperloglog.c.html,0.04505813953488372,10,Adafruit_nRF52_Arduino-MDEwOlJlcG9zaXRvcnk3NDM1NDcyOQ==-flat-ble_gatt.h,redis-MDEwOlJlcG9zaXRvcnkxMDgxMTA3MDY=-flat-hyperloglog.c,105,106,1,250,250,0
1985728,https://htmlpreview.github.io/?https://github.com/Christina96/boilerplate-sample-matches/blob/main/C-beta/redis-MDEwOlJlcG9zaXRvcnkxMDgxMTA3MDY=-flat-extent_dss.h-Adafruit_nRF52_Arduino-MDEwOlJlcG9zaXRvcnk3NDM1NDcyOQ==-flat-nrf_temp.h.html,0.4166666666666667,15,redis-MDEwOlJlcG9zaXRvcnkxMDgxMTA3MDY=-flat-extent_dss.h,Adafruit_nRF52_Arduino-MDEwOlJlcG9zaXRvcnk3NDM1NDcyOQ==-flat-nrf_temp.h,11,19,8,19,28,9
1991557,https://htmlpreview.github.io/?https://github.com/Christina96/boilerplate-sample-matches/blob/main/C-beta/xmrig-MDEwOlJlcG9zaXRvcnk4ODMyNzQwNg==-flat-GpuWorker.h-xmrig-MDEwOlJlcG9zaXRvcnk4ODMyNzQwNg==-flat-cl_platform.h.html,0.19047619047619047,8,xmrig-MDEwOlJlcG9zaXRvcnk4ODMyNzQwNg==-flat-GpuWorker.h,xmrig-MDEwOlJlcG9zaXRvcnk4ODMyNzQwNg==-flat-cl_platform.h,10,10,0,81,85,4
1992470,https://htmlpreview.github.io/?https://github.com/Christina96/boilerplate-sample-matches/blob/main/C-beta/fftw3-MDEwOlJlcG9zaXRvcnk4ODQzMzg4-flat-simd-generic256.h-redis-MDEwOlJlcG9zaXRvcnkxMDgxMTA3MDY=-flat-ldblib.c.html,0.13166144200626959,10,fftw3-MDEwOlJlcG9zaXRvcnk4ODQzMzg4-flat-simd-generic256.h,redis-MDEwOlJlcG9zaXRvcnkxMDgxMTA3MDY=-flat-ldblib.c,24,30,6,223,228,5
1995391,https://htmlpreview.github.io/?https://github.com/Christina96/boilerplate-sample-matches/blob/main/C-beta/fftw3-MDEwOlJlcG9zaXRvcnk4ODQzMzg4-flat-vrank-geq1-rdft2_18.c-PINRemoteImage-MDEwOlJlcG9zaXRvcnkzOTUzNzEwMw==-flat-enc_msa.c.html,0.072,8,fftw3-MDEwOlJlcG9zaXRvcnk4ODQzMzg4-flat-vrank-geq1-rdft2_18.c,PINRemoteImage-MDEwOlJlcG9zaXRvcnkzOTUzNzEwMw==-flat-enc_msa.c,73,77,4,143,147,4
2008704,https://htmlpreview.github.io/?https://github.com/Christina96/boilerplate-sample-matches/blob/main/C-beta/redis-MDEwOlJlcG9zaXRvcnkxMDgxMTA3MDY=-flat-lzf_c.c-redis-MDEwOlJlcG9zaXRvcnkxMDgxMTA3MDY=-flat-lvm.c.html,0.029556650246305417,9,redis-MDEwOlJlcG9zaXRvcnkxMDgxMTA3MDY=-flat-lzf_c.c,redis-MDEwOlJlcG9zaXRvcnkxMDgxMTA3MDY=-flat-lvm.c,35,46,11,69,76,7
2011546,https://htmlpreview.github.io/?https://github.com/Christina96/boilerplate-sample-matches/blob/main/C-beta/xmrig-MDEwOlJlcG9zaXRvcnk4ODMyNzQwNg==-flat-argon2-template-128.h-libtomcrypt-MDEwOlJlcG9zaXRvcnk3NzcwMTE=-flat-timing.c.html,0.04878048780487805,8,xmrig-MDEwOlJlcG9zaXRvcnk4ODMyNzQwNg==-flat-argon2-template-128.h,libtomcrypt-MDEwOlJlcG9zaXRvcnk3NzcwMTE=-flat-timing.c,8,12,4,147,152,5
2013857,https://htmlpreview.github.io/?https://github.com/Christina96/boilerplate-sample-matches/blob/main/C-beta/redis-MDEwOlJlcG9zaXRvcnkxMDgxMTA3MDY=-flat-mutex_prof.h-xmrig-MDEwOlJlcG9zaXRvcnk4ODMyNzQwNg==-flat-distances.c.html,0.13432835820895522,9,redis-MDEwOlJlcG9zaXRvcnkxMDgxMTA3MDY=-flat-mutex_prof.h,xmrig-MDEwOlJlcG9zaXRvcnk4ODMyNzQwNg==-flat-distances.c,60,68,8,9,11,2
2018348,https://htmlpreview.github.io/?https://github.com/Christina96/boilerplate-sample-matches/blob/main/C-beta/libtomcrypt-MDEwOlJlcG9zaXRvcnk3NzcwMTE=-flat-der_encode_raw_bit_string.c-libtomcrypt-MDEwOlJlcG9zaXRvcnk3NzcwMTE=-flat-rabbit.c.html,0.0345489443378119,9,libtomcrypt-MDEwOlJlcG9zaXRvcnk3NzcwMTE=-flat-der_encode_raw_bit_string.c,libtomcrypt-MDEwOlJlcG9zaXRvcnk3NzcwMTE=-flat-rabbit.c,4,8,4,131,134,3
2019695,https://htmlpreview.github.io/?https://github.com/Christina96/boilerplate-sample-matches/blob/main/C-beta/android-gpuimage-plus-MDEwOlJlcG9zaXRvcnk0NjU0NzQxNw==-flat-vda.h-fftw3-MDEwOlJlcG9zaXRvcnk4ODQzMzg4-flat-reodft11e-r2hc-odd.c.html,0.053763440860215055,10,android-gpuimage-plus-MDEwOlJlcG9zaXRvcnk0NjU0NzQxNw==-flat-vda.h,fftw3-MDEwOlJlcG9zaXRvcnk4ODQzMzg4-flat-reodft11e-r2hc-odd.c,15,24,9,165,173,8
2026316,https://htmlpreview.github.io/?https://github.com/Christina96/boilerplate-sample-matches/blob/main/C-beta/libtomcrypt-MDEwOlJlcG9zaXRvcnk3NzcwMTE=-flat-ed25519_sign.c-redis-MDEwOlJlcG9zaXRvcnkxMDgxMTA3MDY=-flat-dict.c.html,0.1596009975062344,8,libtomcrypt-MDEwOlJlcG9zaXRvcnk3NzcwMTE=-flat-ed25519_sign.c,redis-MDEwOlJlcG9zaXRvcnkxMDgxMTA3MDY=-flat-dict.c,23,31,8,81,84,3
2028061,https://htmlpreview.github.io/?https://github.com/Christina96/boilerplate-sample-matches/blob/main/C-beta/Adafruit_nRF52_Arduino-MDEwOlJlcG9zaXRvcnk3NDM1NDcyOQ==-flat-BLEBas.h-xmrig-MDEwOlJlcG9zaXRvcnk4ODMyNzQwNg==-flat-cl_ext.h.html,0.23776223776223776,17,Adafruit_nRF52_Arduino-MDEwOlJlcG9zaXRvcnk3NDM1NDcyOQ==-flat-BLEBas.h,xmrig-MDEwOlJlcG9zaXRvcnk4ODMyNzQwNg==-flat-cl_ext.h,9,15,6,12,33,21
2038204,https://htmlpreview.github.io/?https://github.com/Christina96/boilerplate-sample-matches/blob/main/C-beta/xmrig-MDEwOlJlcG9zaXRvcnk4ODMyNzQwNg==-flat-api.h-fftw3-MDEwOlJlcG9zaXRvcnk4ODQzMzg4-flat-verify.h.html,0.5572139303482587,13,xmrig-MDEwOlJlcG9zaXRvcnk4ODMyNzQwNg==-flat-api.h,fftw3-MDEwOlJlcG9zaXRvcnk4ODQzMzg4-flat-verify.h,12,23,11,35,39,4
2039666,https://htmlpreview.github.io/?https://github.com/Christina96/boilerplate-sample-matches/blob/main/C-beta/redis-MDEwOlJlcG9zaXRvcnkxMDgxMTA3MDY=-flat-async.c-PINRemoteImage-MDEwOlJlcG9zaXRvcnkzOTUzNzEwMw==-flat-dec.c.html,0.11842105263157894,19,redis-MDEwOlJlcG9zaXRvcnkxMDgxMTA3MDY=-flat-async.c,PINRemoteImage-MDEwOlJlcG9zaXRvcnkzOTUzNzEwMw==-flat-dec.c,80,100,20,611,635,24
2041817,https://htmlpreview.github.io/?https://github.com/Christina96/boilerplate-sample-matches/blob/main/C-beta/xmrig-MDEwOlJlcG9zaXRvcnk4ODMyNzQwNg==-flat-HttpResponse.h-libtomcrypt-MDEwOlJlcG9zaXRvcnk3NzcwMTE=-flat-hmac_done.c.html,0.14953271028037382,8,xmrig-MDEwOlJlcG9zaXRvcnk4ODMyNzQwNg==-flat-HttpResponse.h,libtomcrypt-MDEwOlJlcG9zaXRvcnk3NzcwMTE=-flat-hmac_done.c,14,18,4,4,8,4
2051871,https://htmlpreview.github.io/?https://github.com/Christina96/boilerplate-sample-matches/blob/main/C-beta/redis-MDEwOlJlcG9zaXRvcnkxMDgxMTA3MDY=-flat-bio.h-PINRemoteImage-MDEwOlJlcG9zaXRvcnkzOTUzNzEwMw==-flat-PINURLSessionManager.h.html,0.5142857142857142,9,redis-MDEwOlJlcG9zaXRvcnkxMDgxMTA3MDY=-flat-bio.h,PINRemoteImage-MDEwOlJlcG9zaXRvcnkzOTUzNzEwMw==-flat-PINURLSessionManager.h,1,6,5,10,13,3
2054062,https://htmlpreview.github.io/?https://github.com/Christina96/boilerplate-sample-matches/blob/main/C-beta/android-gpuimage-plus-MDEwOlJlcG9zaXRvcnk0NjU0NzQxNw==-flat-tree.h-libpcap-MDEwOlJlcG9zaXRvcnk5NDM1ODg3-flat-filtertest.c.html,0.08633093525179857,12,android-gpuimage-plus-MDEwOlJlcG9zaXRvcnk0NjU0NzQxNw==-flat-tree.h,libpcap-MDEwOlJlcG9zaXRvcnk5NDM1ODg3-flat-filtertest.c,6,11,5,133,146,13
2061590,https://htmlpreview.github.io/?https://github.com/Christina96/boilerplate-sample-matches/blob/main/C-beta/xmrig-MDEwOlJlcG9zaXRvcnk4ODMyNzQwNg==-flat-HashrateInterpolator.h-libtomcrypt-MDEwOlJlcG9zaXRvcnk3NzcwMTE=-flat-hmac_memory.c.html,0.29508196721311475,9,xmrig-MDEwOlJlcG9zaXRvcnk4ODMyNzQwNg==-flat-HashrateInterpolator.h,libtomcrypt-MDEwOlJlcG9zaXRvcnk3NzcwMTE=-flat-hmac_memory.c,13,16,3,3,9,6
2064453,https://htmlpreview.github.io/?https://github.com/Christina96/boilerplate-sample-matches/blob/main/C-beta/PINRemoteImage-MDEwOlJlcG9zaXRvcnkzOTUzNzEwMw==-flat-demux_24.h-libtomcrypt-MDEwOlJlcG9zaXRvcnk3NzcwMTE=-flat-blake2b.c.html,0.06896551724137931,12,PINRemoteImage-MDEwOlJlcG9zaXRvcnkzOTUzNzEwMw==-flat-demux_24.h,libtomcrypt-MDEwOlJlcG9zaXRvcnk3NzcwMTE=-flat-blake2b.c,42,53,11,12,23,11
2072177,https://htmlpreview.github.io/?https://github.com/Christina96/boilerplate-sample-matches/blob/main/C-beta/redis-MDEwOlJlcG9zaXRvcnkxMDgxMTA3MDY=-flat-background_thread_inlines.h-fftw3-MDEwOlJlcG9zaXRvcnk4ODQzMzg4-flat-amd64-cpuid.h.html,0.1095890410958904,8,redis-MDEwOlJlcG9zaXRvcnkxMDgxMTA3MDY=-flat-background_thread_inlines.h,fftw3-MDEwOlJlcG9zaXRvcnk4ODQzMzg4-flat-amd64-cpuid.h,23,30,7,56,67,11
2082645,https://htmlpreview.github.io/?https://github.com/Christina96/boilerplate-sample-matches/blob/main/C-beta/android-gpuimage-plus-MDEwOlJlcG9zaXRvcnk0NjU0NzQxNw==-flat-avio.h-PINRemoteImage-MDEwOlJlcG9zaXRvcnkzOTUzNzEwMw==-flat-libwebp_java_wrap.c.html,0.181271154569387,55,android-gpuimage-plus-MDEwOlJlcG9zaXRvcnk0NjU0NzQxNw==-flat-avio.h,PINRemoteImage-MDEwOlJlcG9zaXRvcnkzOTUzNzEwMw==-flat-libwebp_java_wrap.c,139,177,38,195,209,14
2087530,https://htmlpreview.github.io/?https://github.com/Christina96/boilerplate-sample-matches/blob/main/C-beta/fftw3-MDEwOlJlcG9zaXRvcnk4ODQzMzg4-flat-plan-dft-r2c-3d.c-PINRemoteImage-MDEwOlJlcG9zaXRvcnkzOTUzNzEwMw==-flat-decode_39.h.html,0.058823529411764705,8,fftw3-MDEwOlJlcG9zaXRvcnk4ODQzMzg4-flat-plan-dft-r2c-3d.c,PINRemoteImage-MDEwOlJlcG9zaXRvcnkzOTUzNzEwMw==-flat-decode_39.h,2,5,3,141,143,2
2088823,https://htmlpreview.github.io/?https://github.com/Christina96/boilerplate-sample-matches/blob/main/C-beta/Adafruit_nRF52_Arduino-MDEwOlJlcG9zaXRvcnk3NDM1NDcyOQ==-flat-Udp.h-xmrig-MDEwOlJlcG9zaXRvcnk4ODMyNzQwNg==-flat-BenchClient.h.html,0.233502538071066,9,Adafruit_nRF52_Arduino-MDEwOlJlcG9zaXRvcnk3NDM1NDcyOQ==-flat-Udp.h,xmrig-MDEwOlJlcG9zaXRvcnk4ODMyNzQwNg==-flat-BenchClient.h,9,10,1,69,76,7
2099108,https://htmlpreview.github.io/?https://github.com/Christina96/boilerplate-sample-matches/blob/main/C-beta/xmrig-MDEwOlJlcG9zaXRvcnk4ODMyNzQwNg==-flat-sph_cubehash.c-fftw3-MDEwOlJlcG9zaXRvcnk4ODQzMzg4-flat-rdft2-rdft.c.html,0.1967654986522911,12,xmrig-MDEwOlJlcG9zaXRvcnk4ODMyNzQwNg==-flat-sph_cubehash.c,fftw3-MDEwOlJlcG9zaXRvcnk4ODQzMzg4-flat-rdft2-rdft.c,30,33,3,105,108,3
2099666,https://htmlpreview.github.io/?https://github.com/Christina96/boilerplate-sample-matches/blob/main/C-beta/libtomcrypt-MDEwOlJlcG9zaXRvcnk3NzcwMTE=-flat-xtea.c-libtomcrypt-MDEwOlJlcG9zaXRvcnk3NzcwMTE=-flat-rsa_make_key.c.html,0.1187648456057007,8,libtomcrypt-MDEwOlJlcG9zaXRvcnk3NzcwMTE=-flat-xtea.c,libtomcrypt-MDEwOlJlcG9zaXRvcnk3NzcwMTE=-flat-rsa_make_key.c,62,67,5,76,78,2
2111558,https://htmlpreview.github.io/?https://github.com/Christina96/boilerplate-sample-matches/blob/main/C-beta/redis-MDEwOlJlcG9zaXRvcnkxMDgxMTA3MDY=-flat-tcache_inlines.h-redis-MDEwOlJlcG9zaXRvcnkxMDgxMTA3MDY=-flat-geohash_38.c.html,0.16015625,8,redis-MDEwOlJlcG9zaXRvcnkxMDgxMTA3MDY=-flat-tcache_inlines.h,redis-MDEwOlJlcG9zaXRvcnkxMDgxMTA3MDY=-flat-geohash_38.c,10,15,5,76,80,4
2116902,https://htmlpreview.github.io/?https://github.com/Christina96/boilerplate-sample-matches/blob/main/C-beta/fftw3-MDEwOlJlcG9zaXRvcnk4ODQzMzg4-flat-dft-vrank-geq1.c-redis-MDEwOlJlcG9zaXRvcnkxMDgxMTA3MDY=-flat-hyperloglog.c.html,0.1264222503160556,10,fftw3-MDEwOlJlcG9zaXRvcnk4ODQzMzg4-flat-dft-vrank-geq1.c,redis-MDEwOlJlcG9zaXRvcnkxMDgxMTA3MDY=-flat-hyperloglog.c,30,34,4,237,243,6
2117162,https://htmlpreview.github.io/?https://github.com/Christina96/boilerplate-sample-matches/blob/main/C-beta/PINRemoteImage-MDEwOlJlcG9zaXRvcnkzOTUzNzEwMw==-flat-pngdec.c-PINRemoteImage-MDEwOlJlcG9zaXRvcnkzOTUzNzEwMw==-flat-webpmux.c.html,0.11702127659574468,8,PINRemoteImage-MDEwOlJlcG9zaXRvcnkzOTUzNzEwMw==-flat-pngdec.c,PINRemoteImage-MDEwOlJlcG9zaXRvcnkzOTUzNzEwMw==-flat-webpmux.c,60,65,5,311,316,5
2128655,https://htmlpreview.github.io/?https://github.com/Christina96/boilerplate-sample-matches/blob/main/C-beta/libpcap-MDEwOlJlcG9zaXRvcnk5NDM1ODg3-flat-threadsignaltest.c-libfuse-MDEwOlJlcG9zaXRvcnk0ODI5NjE3Nw==-flat-iconv.c.html,0.04186489058039962,14,libpcap-MDEwOlJlcG9zaXRvcnk5NDM1ODg3-flat-threadsignaltest.c,libfuse-MDEwOlJlcG9zaXRvcnk0ODI5NjE3Nw==-flat-iconv.c,116,128,12,131,142,11
2136658,https://htmlpreview.github.io/?https://github.com/Christina96/boilerplate-sample-matches/blob/main/C-beta/redis-MDEwOlJlcG9zaXRvcnkxMDgxMTA3MDY=-flat-commandfilter.c-PINRemoteImage-MDEwOlJlcG9zaXRvcnkzOTUzNzEwMw==-flat-io_dec.c.html,0.08450704225352113,8,redis-MDEwOlJlcG9zaXRvcnkxMDgxMTA3MDY=-flat-commandfilter.c,PINRemoteImage-MDEwOlJlcG9zaXRvcnkzOTUzNzEwMw==-flat-io_dec.c,16,22,6,129,133,4
2140529,https://htmlpreview.github.io/?https://github.com/Christina96/boilerplate-sample-matches/blob/main/C-beta/android-gpuimage-plus-MDEwOlJlcG9zaXRvcnk0NjU0NzQxNw==-flat-cgeMultiInputFilter.h-PINRemoteImage-MDEwOlJlcG9zaXRvcnkzOTUzNzEwMw==-flat-common_dec.h.html,0.35294117647058826,12,android-gpuimage-plus-MDEwOlJlcG9zaXRvcnk0NjU0NzQxNw==-flat-cgeMultiInputFilter.h,PINRemoteImage-MDEwOlJlcG9zaXRvcnkzOTUzNzEwMw==-flat-common_dec.h,18,19,1,3,14,11
2143254,https://htmlpreview.github.io/?https://github.com/Christina96/boilerplate-sample-matches/blob/main/C-beta/redis-MDEwOlJlcG9zaXRvcnkxMDgxMTA3MDY=-flat-pack.c-PINRemoteImage-MDEwOlJlcG9zaXRvcnkzOTUzNzEwMw==-flat-quant_enc.c.html,0.03534031413612566,8,redis-MDEwOlJlcG9zaXRvcnkxMDgxMTA3MDY=-flat-pack.c,PINRemoteImage-MDEwOlJlcG9zaXRvcnkzOTUzNzEwMw==-flat-quant_enc.c,28,36,8,539,547,8
2153385,https://htmlpreview.github.io/?https://github.com/Christina96/boilerplate-sample-matches/blob/main/C-beta/PINRemoteImage-MDEwOlJlcG9zaXRvcnkzOTUzNzEwMw==-flat-cost_mips_dsp_r2.c-xmrig-MDEwOlJlcG9zaXRvcnk4ODMyNzQwNg==-flat-OclDevice.h.html,0.15217391304347827,14,PINRemoteImage-MDEwOlJlcG9zaXRvcnkzOTUzNzEwMw==-flat-cost_mips_dsp_r2.c,xmrig-MDEwOlJlcG9zaXRvcnk4ODMyNzQwNg==-flat-OclDevice.h,4,11,7,58,66,8
2170214,https://htmlpreview.github.io/?https://github.com/Christina96/boilerplate-sample-matches/blob/main/C-beta/PINRemoteImage-MDEwOlJlcG9zaXRvcnkzOTUzNzEwMw==-flat-color_cache_utils.h-libfuse-MDEwOlJlcG9zaXRvcnk0ODI5NjE3Nw==-flat-iconv.c.html,0.017817371937639197,8,PINRemoteImage-MDEwOlJlcG9zaXRvcnkzOTUzNzEwMw==-flat-color_cache_utils.h,libfuse-MDEwOlJlcG9zaXRvcnk0ODI5NjE3Nw==-flat-iconv.c,35,40,5,25,29,4
2182918,https://htmlpreview.github.io/?https://github.com/Christina96/boilerplate-sample-matches/blob/main/C-beta/xmrig-MDEwOlJlcG9zaXRvcnk4ODMyNzQwNg==-flat-itoa.h-redis-MDEwOlJlcG9zaXRvcnkxMDgxMTA3MDY=-flat-redis-benchmark.c.html,0.028308563340410473,8,xmrig-MDEwOlJlcG9zaXRvcnk4ODMyNzQwNg==-flat-itoa.h,redis-MDEwOlJlcG9zaXRvcnkxMDgxMTA3MDY=-flat-redis-benchmark.c,21,25,4,294,300,6
2183396,https://htmlpreview.github.io/?https://github.com/Christina96/boilerplate-sample-matches/blob/main/C-beta/redis-MDEwOlJlcG9zaXRvcnkxMDgxMTA3MDY=-flat-lua.h-PINRemoteImage-MDEwOlJlcG9zaXRvcnkzOTUzNzEwMw==-flat-webpinfo.c.html,0.03861003861003861,14,redis-MDEwOlJlcG9zaXRvcnkxMDgxMTA3MDY=-flat-lua.h,PINRemoteImage-MDEwOlJlcG9zaXRvcnkzOTUzNzEwMw==-flat-webpinfo.c,23,42,19,77,90,13
2187414,https://htmlpreview.github.io/?https://github.com/Christina96/boilerplate-sample-matches/blob/main/C-beta/Adafruit_nRF52_Arduino-MDEwOlJlcG9zaXRvcnk3NDM1NDcyOQ==-flat-nrf_rtc.h-redis-MDEwOlJlcG9zaXRvcnkxMDgxMTA3MDY=-flat-defrag.c.html,0.062421972534332085,10,Adafruit_nRF52_Arduino-MDEwOlJlcG9zaXRvcnk3NDM1NDcyOQ==-flat-nrf_rtc.h,redis-MDEwOlJlcG9zaXRvcnkxMDgxMTA3MDY=-flat-defrag.c,36,41,5,683,683,0
2199071,https://htmlpreview.github.io/?https://github.com/Christina96/boilerplate-sample-matches/blob/main/C-beta/android-gpuimage-plus-MDEwOlJlcG9zaXRvcnk0NjU0NzQxNw==-flat-frame.h-PINRemoteImage-MDEwOlJlcG9zaXRvcnkzOTUzNzEwMw==-flat-decode_13.h.html,0.6682692307692307,8,android-gpuimage-plus-MDEwOlJlcG9zaXRvcnk0NjU0NzQxNw==-flat-frame.h,PINRemoteImage-MDEwOlJlcG9zaXRvcnkzOTUzNzEwMw==-flat-decode_13.h,30,37,7,106,113,7
2200788,https://htmlpreview.github.io/?https://github.com/Christina96/boilerplate-sample-matches/blob/main/C-beta/redis-MDEwOlJlcG9zaXRvcnkxMDgxMTA3MDY=-flat-Win32_fdapi_crt.h-redis-MDEwOlJlcG9zaXRvcnkxMDgxMTA3MDY=-flat-sc_14.c.html,0.13953488372093023,8,redis-MDEwOlJlcG9zaXRvcnkxMDgxMTA3MDY=-flat-Win32_fdapi_crt.h,redis-MDEwOlJlcG9zaXRvcnkxMDgxMTA3MDY=-flat-sc_14.c,11,14,3,81,82,1
2226402,https://htmlpreview.github.io/?https://github.com/Christina96/boilerplate-sample-matches/blob/main/C-beta/xmrig-MDEwOlJlcG9zaXRvcnk4ODMyNzQwNg==-flat-CpuConfig.h-PINRemoteImage-MDEwOlJlcG9zaXRvcnkzOTUzNzEwMw==-flat-libwebp_java_wrap.c.html,0.040731504571903575,15,xmrig-MDEwOlJlcG9zaXRvcnk4ODMyNzQwNg==-flat-CpuConfig.h,PINRemoteImage-MDEwOlJlcG9zaXRvcnkzOTUzNzEwMw==-flat-libwebp_java_wrap.c,31,36,5,175,180,5
2246948,https://htmlpreview.github.io/?https://github.com/Christina96/boilerplate-sample-matches/blob/main/C-beta/xmrig-MDEwOlJlcG9zaXRvcnk4ODMyNzQwNg==-flat-plugins.h-libtomcrypt-MDEwOlJlcG9zaXRvcnk3NzcwMTE=-flat-ecc_recover_key.c.html,0.0973630831643002,9,xmrig-MDEwOlJlcG9zaXRvcnk4ODMyNzQwNg==-flat-plugins.h,libtomcrypt-MDEwOlJlcG9zaXRvcnk3NzcwMTE=-flat-ecc_recover_key.c,73,82,9,4,8,4
2255518,https://htmlpreview.github.io/?https://github.com/Christina96/boilerplate-sample-matches/blob/main/C-beta/PINRemoteImage-MDEwOlJlcG9zaXRvcnkzOTUzNzEwMw==-flat-vp8_dec.h-xmrig-MDEwOlJlcG9zaXRvcnk4ODMyNzQwNg==-flat-sph_shabal.h.html,0.819672131147541,8,PINRemoteImage-MDEwOlJlcG9zaXRvcnkzOTUzNzEwMw==-flat-vp8_dec.h,xmrig-MDEwOlJlcG9zaXRvcnk4ODMyNzQwNg==-flat-sph_shabal.h,33,40,7,41,44,3
2264301,https://htmlpreview.github.io/?https://github.com/Christina96/boilerplate-sample-matches/blob/main/C-beta/fftw3-MDEwOlJlcG9zaXRvcnk4ODQzMzg4-flat-rodft00e-r2hc-pad.c-xmrig-MDEwOlJlcG9zaXRvcnk4ODMyNzQwNg==-flat-variant4_random_math.h.html,0.0365296803652968,8,fftw3-MDEwOlJlcG9zaXRvcnk4ODQzMzg4-flat-rodft00e-r2hc-pad.c,xmrig-MDEwOlJlcG9zaXRvcnk4ODMyNzQwNg==-flat-variant4_random_math.h,16,19,3,189,192,3
2284708,https://htmlpreview.github.io/?https://github.com/Christina96/boilerplate-sample-matches/blob/main/C-beta/fftw3-MDEwOlJlcG9zaXRvcnk4ODQzMzg4-flat-verify-dft.c-PINRemoteImage-MDEwOlJlcG9zaXRvcnkzOTUzNzEwMw==-flat-webpinfo.c.html,0.05367008681925809,8,fftw3-MDEwOlJlcG9zaXRvcnk4ODQzMzg4-flat-verify-dft.c,PINRemoteImage-MDEwOlJlcG9zaXRvcnkzOTUzNzEwMw==-flat-webpinfo.c,108,113,5,383,386,3
2286583,https://htmlpreview.github.io/?https://github.com/Christina96/boilerplate-sample-matches/blob/main/C-beta/redis-MDEwOlJlcG9zaXRvcnkxMDgxMTA3MDY=-flat-arena_structs_b.h-fftw3-MDEwOlJlcG9zaXRvcnk4ODQzMzg4-flat-transpose-pairwise.c.html,0.13217391304347825,8,redis-MDEwOlJlcG9zaXRvcnkxMDgxMTA3MDY=-flat-arena_structs_b.h,fftw3-MDEwOlJlcG9zaXRvcnk4ODQzMzg4-flat-transpose-pairwise.c,49,56,7,277,277,0
2293410,https://htmlpreview.github.io/?https://github.com/Christina96/boilerplate-sample-matches/blob/main/C-beta/PINRemoteImage-MDEwOlJlcG9zaXRvcnkzOTUzNzEwMw==-flat-metadata.h-libfuse-MDEwOlJlcG9zaXRvcnk0ODI5NjE3Nw==-flat-fuse.h.html,0.03395585738539898,10,PINRemoteImage-MDEwOlJlcG9zaXRvcnkzOTUzNzEwMw==-flat-metadata.h,libfuse-MDEwOlJlcG9zaXRvcnk0ODI5NjE3Nw==-flat-fuse.h,12,21,9,119,132,13
2325727,https://htmlpreview.github.io/?https://github.com/Christina96/boilerplate-sample-matches/blob/main/C-beta/fftw3-MDEwOlJlcG9zaXRvcnk4ODQzMzg4-flat-tensor.c-libtomcrypt-MDEwOlJlcG9zaXRvcnk3NzcwMTE=-flat-twofish.c.html,0.03375527426160337,8,fftw3-MDEwOlJlcG9zaXRvcnk4ODQzMzg4-flat-tensor.c,libtomcrypt-MDEwOlJlcG9zaXRvcnk3NzcwMTE=-flat-twofish.c,24,27,3,489,492,3
2330187,https://htmlpreview.github.io/?https://github.com/Christina96/boilerplate-sample-matches/blob/main/C-beta/redis-MDEwOlJlcG9zaXRvcnkxMDgxMTA3MDY=-flat-ldo.h-Adafruit_nRF52_Arduino-MDEwOlJlcG9zaXRvcnk3NDM1NDcyOQ==-flat-nrf_qdec.h.html,0.23890784982935154,35,redis-MDEwOlJlcG9zaXRvcnkxMDgxMTA3MDY=-flat-ldo.h,Adafruit_nRF52_Arduino-MDEwOlJlcG9zaXRvcnk3NDM1NDcyOQ==-flat-nrf_qdec.h,18,31,13,67,93,26
2370989,https://htmlpreview.github.io/?https://github.com/Christina96/boilerplate-sample-matches/blob/main/C-beta/android-gpuimage-plus-MDEwOlJlcG9zaXRvcnk0NjU0NzQxNw==-flat-pixfmt.h-libtomcrypt-MDEwOlJlcG9zaXRvcnk3NzcwMTE=-flat-tomcrypt_private.h.html,0.8362480127186009,16,android-gpuimage-plus-MDEwOlJlcG9zaXRvcnk0NjU0NzQxNw==-flat-pixfmt.h,libtomcrypt-MDEwOlJlcG9zaXRvcnk3NzcwMTE=-flat-tomcrypt_private.h,292,307,15,265,273,8
2374050,https://htmlpreview.github.io/?https://github.com/Christina96/boilerplate-sample-matches/blob/main/C-beta/xmrig-MDEwOlJlcG9zaXRvcnk4ODMyNzQwNg==-flat-FileLog.h-xmrig-MDEwOlJlcG9zaXRvcnk4ODMyNzQwNg==-flat-netloc.h.html,0.09937888198757763,16,xmrig-MDEwOlJlcG9zaXRvcnk4ODMyNzQwNg==-flat-FileLog.h,xmrig-MDEwOlJlcG9zaXRvcnk4ODMyNzQwNg==-flat-netloc.h,9,13,4,64,68,4
2388152,https://htmlpreview.github.io/?https://github.com/Christina96/boilerplate-sample-matches/blob/main/C-beta/xmrig-MDEwOlJlcG9zaXRvcnk4ODMyNzQwNg==-flat-Console.h-xmrig-MDEwOlJlcG9zaXRvcnk4ODMyNzQwNg==-flat-Workers.h.html,0.5517241379310345,8,xmrig-MDEwOlJlcG9zaXRvcnk4ODMyNzQwNg==-flat-Console.h,xmrig-MDEwOlJlcG9zaXRvcnk4ODMyNzQwNg==-flat-Workers.h,19,25,6,24,35,11
2389627,https://htmlpreview.github.io/?https://github.com/Christina96/boilerplate-sample-matches/blob/main/C-beta/libtomcrypt-MDEwOlJlcG9zaXRvcnk3NzcwMTE=-flat-ocb3_decrypt.c-Adafruit_nRF52_Arduino-MDEwOlJlcG9zaXRvcnk3NDM1NDcyOQ==-flat-Print.h.html,0.07407407407407407,9,libtomcrypt-MDEwOlJlcG9zaXRvcnk3NzcwMTE=-flat-ocb3_decrypt.c,Adafruit_nRF52_Arduino-MDEwOlJlcG9zaXRvcnk3NDM1NDcyOQ==-flat-Print.h,3,7,4,15,17,2
2397926,https://htmlpreview.github.io/?https://github.com/Christina96/boilerplate-sample-matches/blob/main/C-beta/redis-MDEwOlJlcG9zaXRvcnkxMDgxMTA3MDY=-flat-rtree_16.c-fftw3-MDEwOlJlcG9zaXRvcnk4ODQzMzg4-flat-vrank-geq1-rdft2_18.c.html,0.19389587073608616,10,redis-MDEwOlJlcG9zaXRvcnkxMDgxMTA3MDY=-flat-rtree_16.c,fftw3-MDEwOlJlcG9zaXRvcnk4ODQzMzg4-flat-vrank-geq1-rdft2_18.c,159,165,6,30,34,4
2399190,https://htmlpreview.github.io/?https://github.com/Christina96/boilerplate-sample-matches/blob/main/C-beta/libtomcrypt-MDEwOlJlcG9zaXRvcnk3NzcwMTE=-flat-hkdf.c-libtomcrypt-MDEwOlJlcG9zaXRvcnk3NzcwMTE=-flat-xts_test.c.html,0.23414634146341465,10,libtomcrypt-MDEwOlJlcG9zaXRvcnk3NzcwMTE=-flat-hkdf.c,libtomcrypt-MDEwOlJlcG9zaXRvcnk3NzcwMTE=-flat-xts_test.c,15,20,5,54,59,5
2414512,https://htmlpreview.github.io/?https://github.com/Christina96/boilerplate-sample-matches/blob/main/C-beta/PINRemoteImage-MDEwOlJlcG9zaXRvcnkzOTUzNzEwMw==-flat-predictor_enc.c-PINRemoteImage-MDEwOlJlcG9zaXRvcnkzOTUzNzEwMw==-flat-lossless_enc.c.html,0.23407407407407407,9,PINRemoteImage-MDEwOlJlcG9zaXRvcnkzOTUzNzEwMw==-flat-predictor_enc.c,PINRemoteImage-MDEwOlJlcG9zaXRvcnkzOTUzNzEwMw==-flat-lossless_enc.c,81,85,4,391,395,4
2415014,https://htmlpreview.github.io/?https://github.com/Christina96/boilerplate-sample-matches/blob/main/C-beta/redis-MDEwOlJlcG9zaXRvcnkxMDgxMTA3MDY=-flat-geohash_helper.h-libtomcrypt-MDEwOlJlcG9zaXRvcnk3NzcwMTE=-flat-rsa_encrypt_key.c.html,0.28865979381443296,14,redis-MDEwOlJlcG9zaXRvcnkxMDgxMTA3MDY=-flat-geohash_helper.h,libtomcrypt-MDEwOlJlcG9zaXRvcnk3NzcwMTE=-flat-rsa_encrypt_key.c,15,22,7,3,11,8
2419020,https://htmlpreview.github.io/?https://github.com/Christina96/boilerplate-sample-matches/blob/main/C-beta/Adafruit_nRF52_Arduino-MDEwOlJlcG9zaXRvcnk3NDM1NDcyOQ==-flat-nrf_dppi.h-PINRemoteImage-MDEwOlJlcG9zaXRvcnkzOTUzNzEwMw==-flat-libwebp_python_wrap.c.html,0.07407407407407407,11,Adafruit_nRF52_Arduino-MDEwOlJlcG9zaXRvcnk3NDM1NDcyOQ==-flat-nrf_dppi.h,PINRemoteImage-MDEwOlJlcG9zaXRvcnkzOTUzNzEwMw==-flat-libwebp_python_wrap.c,122,132,10,1122,1132,10
2419346,https://htmlpreview.github.io/?https://github.com/Christina96/boilerplate-sample-matches/blob/main/C-beta/libtomcrypt-MDEwOlJlcG9zaXRvcnk3NzcwMTE=-flat-salsa20_test.c-PINRemoteImage-MDEwOlJlcG9zaXRvcnkzOTUzNzEwMw==-flat-cwebp.c.html,0.02343211578221916,9,libtomcrypt-MDEwOlJlcG9zaXRvcnk3NzcwMTE=-flat-salsa20_test.c,PINRemoteImage-MDEwOlJlcG9zaXRvcnkzOTUzNzEwMw==-flat-cwebp.c,32,35,3,278,281,3
2440812,https://htmlpreview.github.io/?https://github.com/Christina96/boilerplate-sample-matches/blob/main/C-beta/xmrig-MDEwOlJlcG9zaXRvcnk4ODMyNzQwNg==-flat-Job.h-PINRemoteImage-MDEwOlJlcG9zaXRvcnkzOTUzNzEwMw==-flat-cwebp.c.html,0.030358227079538554,13,xmrig-MDEwOlJlcG9zaXRvcnk4ODMyNzQwNg==-flat-Job.h,PINRemoteImage-MDEwOlJlcG9zaXRvcnkzOTUzNzEwMw==-flat-cwebp.c,101,109,8,349,357,8
2444812,https://htmlpreview.github.io/?https://github.com/Christina96/boilerplate-sample-matches/blob/main/C-beta/fftw3-MDEwOlJlcG9zaXRvcnk4ODQzMzg4-flat-nop_13.c-redis-MDEwOlJlcG9zaXRvcnkxMDgxMTA3MDY=-flat-t_stream.c.html,0.025510204081632654,9,fftw3-MDEwOlJlcG9zaXRvcnk4ODQzMzg4-flat-nop_13.c,redis-MDEwOlJlcG9zaXRvcnkxMDgxMTA3MDY=-flat-t_stream.c,5,10,5,669,674,5
2451130,https://htmlpreview.github.io/?https://github.com/Christina96/boilerplate-sample-matches/blob/main/C-beta/redis-MDEwOlJlcG9zaXRvcnkxMDgxMTA3MDY=-flat-sparkline.h-Adafruit_nRF52_Arduino-MDEwOlJlcG9zaXRvcnk3NDM1NDcyOQ==-flat-SoftwareSerial.h.html,0.4155844155844156,16,redis-MDEwOlJlcG9zaXRvcnkxMDgxMTA3MDY=-flat-sparkline.h,Adafruit_nRF52_Arduino-MDEwOlJlcG9zaXRvcnk3NDM1NDcyOQ==-flat-SoftwareSerial.h,16,20,4,10,25,15
2457428,https://htmlpreview.github.io/?https://github.com/Christina96/boilerplate-sample-matches/blob/main/C-beta/libtomcrypt-MDEwOlJlcG9zaXRvcnk3NzcwMTE=-flat-ecc_shared_secret.c-libtomcrypt-MDEwOlJlcG9zaXRvcnk3NzcwMTE=-flat-noekeon.c.html,0.06349206349206349,8,libtomcrypt-MDEwOlJlcG9zaXRvcnk3NzcwMTE=-flat-ecc_shared_secret.c,libtomcrypt-MDEwOlJlcG9zaXRvcnk3NzcwMTE=-flat-noekeon.c,6,16,10,44,51,7
2457652,https://htmlpreview.github.io/?https://github.com/Christina96/boilerplate-sample-matches/blob/main/C-beta/Adafruit_nRF52_Arduino-MDEwOlJlcG9zaXRvcnk3NDM1NDcyOQ==-flat-crypto.c-redis-MDEwOlJlcG9zaXRvcnkxMDgxMTA3MDY=-flat-arena_inlines_b.h.html,0.11127819548872181,10,Adafruit_nRF52_Arduino-MDEwOlJlcG9zaXRvcnk3NDM1NDcyOQ==-flat-crypto.c,redis-MDEwOlJlcG9zaXRvcnkxMDgxMTA3MDY=-flat-arena_inlines_b.h,107,111,4,121,125,4
2458881,https://htmlpreview.github.io/?https://github.com/Christina96/boilerplate-sample-matches/blob/main/C-beta/Adafruit_nRF52_Arduino-MDEwOlJlcG9zaXRvcnk3NDM1NDcyOQ==-flat-nrf_saadc.h-libfuse-MDEwOlJlcG9zaXRvcnk0ODI5NjE3Nw==-flat-fuse_lowlevel.c.html,0.07705882352941176,8,Adafruit_nRF52_Arduino-MDEwOlJlcG9zaXRvcnk3NDM1NDcyOQ==-flat-nrf_saadc.h,libfuse-MDEwOlJlcG9zaXRvcnk0ODI5NjE3Nw==-flat-fuse_lowlevel.c,360,367,7,1409,1414,5
2465783,https://htmlpreview.github.io/?https://github.com/Christina96/boilerplate-sample-matches/blob/main/C-beta/libpcap-MDEwOlJlcG9zaXRvcnk5NDM1ODg3-flat-writecaptest.c-xmrig-MDEwOlJlcG9zaXRvcnk4ODMyNzQwNg==-flat-crypto-ops.c.html,0.016150740242261104,10,libpcap-MDEwOlJlcG9zaXRvcnk5NDM1ODg3-flat-writecaptest.c,xmrig-MDEwOlJlcG9zaXRvcnk4ODMyNzQwNg==-flat-crypto-ops.c,73,82,9,1173,1176,3
2473834,https://htmlpreview.github.io/?https://github.com/Christina96/boilerplate-sample-matches/blob/main/C-beta/libtomcrypt-MDEwOlJlcG9zaXRvcnk3NzcwMTE=-flat-eax_encrypt_authenticate_memory.c-android-gpuimage-plus-MDEwOlJlcG9zaXRvcnk0NjU0NzQxNw==-flat-samplefmt.h.html,0.2828282828282828,14,libtomcrypt-MDEwOlJlcG9zaXRvcnk3NzcwMTE=-flat-eax_encrypt_authenticate_memory.c,android-gpuimage-plus-MDEwOlJlcG9zaXRvcnk0NjU0NzQxNw==-flat-samplefmt.h,3,12,9,7,20,13
2476952,https://htmlpreview.github.io/?https://github.com/Christina96/boilerplate-sample-matches/blob/main/C-beta/Adafruit_nRF52_Arduino-MDEwOlJlcG9zaXRvcnk3NDM1NDcyOQ==-flat-BLEHidGeneric.h-redis-MDEwOlJlcG9zaXRvcnkxMDgxMTA3MDY=-flat-lstate.h.html,0.5837837837837838,39,Adafruit_nRF52_Arduino-MDEwOlJlcG9zaXRvcnk3NDM1NDcyOQ==-flat-BLEHidGeneric.h,redis-MDEwOlJlcG9zaXRvcnkxMDgxMTA3MDY=-flat-lstate.h,13,20,7,32,40,8
2483630,https://htmlpreview.github.io/?https://github.com/Christina96/boilerplate-sample-matches/blob/main/C-beta/xmrig-MDEwOlJlcG9zaXRvcnk4ODMyNzQwNg==-flat-NetworkState.h-PINRemoteImage-MDEwOlJlcG9zaXRvcnkzOTUzNzEwMw==-flat-muxread.c.html,0.05013927576601671,10,xmrig-MDEwOlJlcG9zaXRvcnk4ODMyNzQwNg==-flat-NetworkState.h,PINRemoteImage-MDEwOlJlcG9zaXRvcnkzOTUzNzEwMw==-flat-muxread.c,40,46,6,129,136,7
2492159,https://htmlpreview.github.io/?https://github.com/Christina96/boilerplate-sample-matches/blob/main/C-beta/xmrig-MDEwOlJlcG9zaXRvcnk4ODMyNzQwNg==-flat-BenchConfig.h-Adafruit_nRF52_Arduino-MDEwOlJlcG9zaXRvcnk3NDM1NDcyOQ==-flat-WString.h.html,0.17035775127768313,13,xmrig-MDEwOlJlcG9zaXRvcnk4ODMyNzQwNg==-flat-BenchConfig.h,Adafruit_nRF52_Arduino-MDEwOlJlcG9zaXRvcnk3NDM1NDcyOQ==-flat-WString.h,9,22,13,16,24,8
2509147,https://htmlpreview.github.io/?https://github.com/Christina96/boilerplate-sample-matches/blob/main/C-beta/fftw3-MDEwOlJlcG9zaXRvcnk4ODQzMzg4-flat-ifftw-mpi.h-libpcap-MDEwOlJlcG9zaXRvcnk5NDM1ODg3-flat-writecaptest.c.html,0.03468208092485549,9,fftw3-MDEwOlJlcG9zaXRvcnk4ODQzMzg4-flat-ifftw-mpi.h,libpcap-MDEwOlJlcG9zaXRvcnk5NDM1ODg3-flat-writecaptest.c,60,68,8,158,169,11
2511440,https://htmlpreview.github.io/?https://github.com/Christina96/boilerplate-sample-matches/blob/main/C-beta/PINRemoteImage-MDEwOlJlcG9zaXRvcnkzOTUzNzEwMw==-flat-lossless_enc_mips32.c-PINRemoteImage-MDEwOlJlcG9zaXRvcnkzOTUzNzEwMw==-flat-dec_mips_dsp_r2.c.html,0.3333333333333333,9,PINRemoteImage-MDEwOlJlcG9zaXRvcnkzOTUzNzEwMw==-flat-lossless_enc_mips32.c,PINRemoteImage-MDEwOlJlcG9zaXRvcnkzOTUzNzEwMw==-flat-dec_mips_dsp_r2.c,118,148,30,264,267,3
