ID,Link,Similarity,Tokens,File 1,File 2,Start 1,End 1,Detected Lines 1,Start 2,End 2,Detected Lines 2
314,https://htmlpreview.github.io/?https://github.com/Christina96/boilerplate-sample-matches/blob/main/C/PINRemoteImage-MDEwOlJlcG9zaXRvcnkzOTUzNzEwMw==-flat-upsampling_mips_dsp_r2.c-libfuse-MDEwOlJlcG9zaXRvcnk0ODI5NjE3Nw==-flat-notify_store_retrieve.c.html,0.08629441624365482,9,PINRemoteImage-MDEwOlJlcG9zaXRvcnkzOTUzNzEwMw==-flat-upsampling_mips_dsp_r2.c,libfuse-MDEwOlJlcG9zaXRvcnk0ODI5NjE3Nw==-flat-notify_store_retrieve.c,182,192,10,155,167,12
652,https://htmlpreview.github.io/?https://github.com/Christina96/boilerplate-sample-matches/blob/main/C/android-gpuimage-plus-MDEwOlJlcG9zaXRvcnk0NjU0NzQxNw==-flat-avcodec.h-PINRemoteImage-MDEwOlJlcG9zaXRvcnkzOTUzNzEwMw==-flat-quant_enc.c.html,0.025930572982015895,10,android-gpuimage-plus-MDEwOlJlcG9zaXRvcnk0NjU0NzQxNw==-flat-avcodec.h,PINRemoteImage-MDEwOlJlcG9zaXRvcnkzOTUzNzEwMw==-flat-quant_enc.c,516,526,10,638,648,10
668,https://htmlpreview.github.io/?https://github.com/Christina96/boilerplate-sample-matches/blob/main/C/PINRemoteImage-MDEwOlJlcG9zaXRvcnkzOTUzNzEwMw==-flat-lossless_neon.c-PINRemoteImage-MDEwOlJlcG9zaXRvcnkzOTUzNzEwMw==-flat-vp8l_enc.c.html,0.07418738049713193,10,PINRemoteImage-MDEwOlJlcG9zaXRvcnkzOTUzNzEwMw==-flat-lossless_neon.c,PINRemoteImage-MDEwOlJlcG9zaXRvcnkzOTUzNzEwMw==-flat-vp8l_enc.c,55,58,3,232,235,3
1493,https://htmlpreview.github.io/?https://github.com/Christina96/boilerplate-sample-matches/blob/main/C/redis-MDEwOlJlcG9zaXRvcnkxMDgxMTA3MDY=-flat-witness.h-redis-MDEwOlJlcG9zaXRvcnkxMDgxMTA3MDY=-flat-pages_20.c.html,0.05732484076433121,9,redis-MDEwOlJlcG9zaXRvcnkxMDgxMTA3MDY=-flat-witness.h,redis-MDEwOlJlcG9zaXRvcnkxMDgxMTA3MDY=-flat-pages_20.c,117,123,6,202,210,8
2007,https://htmlpreview.github.io/?https://github.com/Christina96/boilerplate-sample-matches/blob/main/C/Adafruit_nRF52_Arduino-MDEwOlJlcG9zaXRvcnk3NDM1NDcyOQ==-flat-nrf_nvic_17.h-redis-MDEwOlJlcG9zaXRvcnkxMDgxMTA3MDY=-flat-t_string.c.html,0.037243947858473,10,Adafruit_nRF52_Arduino-MDEwOlJlcG9zaXRvcnk3NDM1NDcyOQ==-flat-nrf_nvic_17.h,redis-MDEwOlJlcG9zaXRvcnkxMDgxMTA3MDY=-flat-t_string.c,71,81,10,98,106,8
3231,https://htmlpreview.github.io/?https://github.com/Christina96/boilerplate-sample-matches/blob/main/C/PINRemoteImage-MDEwOlJlcG9zaXRvcnkzOTUzNzEwMw==-flat-extras.c-small-MDEwOlJlcG9zaXRvcnkyNTY3NjMxNjk=-flat-server.c.html,0.02451202905129369,10,PINRemoteImage-MDEwOlJlcG9zaXRvcnkzOTUzNzEwMw==-flat-extras.c,small-MDEwOlJlcG9zaXRvcnkyNTY3NjMxNjk=-flat-server.c,76,86,10,1729,1738,9
3813,https://htmlpreview.github.io/?https://github.com/Christina96/boilerplate-sample-matches/blob/main/C/PINRemoteImage-MDEwOlJlcG9zaXRvcnkzOTUzNzEwMw==-flat-ssim_sse2.c-xmrig-MDEwOlJlcG9zaXRvcnk4ODMyNzQwNg==-flat-CryptoNight_x86.h.html,0.030112923462986198,15,PINRemoteImage-MDEwOlJlcG9zaXRvcnkzOTUzNzEwMw==-flat-ssim_sse2.c,xmrig-MDEwOlJlcG9zaXRvcnk4ODMyNzQwNg==-flat-CryptoNight_x86.h,9,16,7,163,170,7
4875,https://htmlpreview.github.io/?https://github.com/Christina96/boilerplate-sample-matches/blob/main/C/xmrig-MDEwOlJlcG9zaXRvcnk4ODMyNzQwNg==-flat-MemoryPool.h-PINRemoteImage-MDEwOlJlcG9zaXRvcnkzOTUzNzEwMw==-flat-lossless_enc_msa.c.html,0.14414414414414414,8,xmrig-MDEwOlJlcG9zaXRvcnk4ODMyNzQwNg==-flat-MemoryPool.h,PINRemoteImage-MDEwOlJlcG9zaXRvcnkzOTUzNzEwMw==-flat-lossless_enc_msa.c,11,23,12,104,110,6
8272,https://htmlpreview.github.io/?https://github.com/Christina96/boilerplate-sample-matches/blob/main/C/libtomcrypt-MDEwOlJlcG9zaXRvcnk3NzcwMTE=-flat-whirlgen.c-redis-MDEwOlJlcG9zaXRvcnkxMDgxMTA3MDY=-flat-arena.c.html,0.012911555842479019,10,libtomcrypt-MDEwOlJlcG9zaXRvcnk3NzcwMTE=-flat-whirlgen.c,redis-MDEwOlJlcG9zaXRvcnkxMDgxMTA3MDY=-flat-arena.c,34,40,6,162,197,35
10301,https://htmlpreview.github.io/?https://github.com/Christina96/boilerplate-sample-matches/blob/main/C/Adafruit_nRF52_Arduino-MDEwOlJlcG9zaXRvcnk3NDM1NDcyOQ==-flat-nrf_nvic_17.h-PINRemoteImage-MDEwOlJlcG9zaXRvcnkzOTUzNzEwMw==-flat-webp_enc.c.html,0.037037037037037035,10,Adafruit_nRF52_Arduino-MDEwOlJlcG9zaXRvcnk3NDM1NDcyOQ==-flat-nrf_nvic_17.h,PINRemoteImage-MDEwOlJlcG9zaXRvcnkzOTUzNzEwMw==-flat-webp_enc.c,92,101,9,237,243,6
10795,https://htmlpreview.github.io/?https://github.com/Christina96/boilerplate-sample-matches/blob/main/C/PINRemoteImage-MDEwOlJlcG9zaXRvcnkzOTUzNzEwMw==-flat-encode_32.h-libtomcrypt-MDEwOlJlcG9zaXRvcnk3NzcwMTE=-flat-tv_gen.c.html,0.015151515151515152,8,PINRemoteImage-MDEwOlJlcG9zaXRvcnkzOTUzNzEwMw==-flat-encode_32.h,libtomcrypt-MDEwOlJlcG9zaXRvcnk3NzcwMTE=-flat-tv_gen.c,149,175,26,569,575,6
12752,https://htmlpreview.github.io/?https://github.com/Christina96/boilerplate-sample-matches/blob/main/C/PINRemoteImage-MDEwOlJlcG9zaXRvcnkzOTUzNzEwMw==-flat-anim_encode.c-xmrig-MDEwOlJlcG9zaXRvcnk4ODMyNzQwNg==-flat-format-inl.h.html,0.032671245591238164,11,PINRemoteImage-MDEwOlJlcG9zaXRvcnkzOTUzNzEwMw==-flat-anim_encode.c,xmrig-MDEwOlJlcG9zaXRvcnk4ODMyNzQwNg==-flat-format-inl.h,856,866,10,2179,2186,7
13351,https://htmlpreview.github.io/?https://github.com/Christina96/boilerplate-sample-matches/blob/main/C/libtomcrypt-MDEwOlJlcG9zaXRvcnk3NzcwMTE=-flat-x509_decode_subject_public_key_info.c-PINRemoteImage-MDEwOlJlcG9zaXRvcnkzOTUzNzEwMw==-flat-backward_references_cost_enc.c.html,0.0176017601760176,8,libtomcrypt-MDEwOlJlcG9zaXRvcnk3NzcwMTE=-flat-x509_decode_subject_public_key_info.c,PINRemoteImage-MDEwOlJlcG9zaXRvcnkzOTUzNzEwMw==-flat-backward_references_cost_enc.c,19,23,4,310,314,4
13382,https://htmlpreview.github.io/?https://github.com/Christina96/boilerplate-sample-matches/blob/main/C/xmrig-MDEwOlJlcG9zaXRvcnk4ODMyNzQwNg==-flat-argon2-template-64.h-PINRemoteImage-MDEwOlJlcG9zaXRvcnkzOTUzNzEwMw==-flat-enc.c.html,0.03140495867768595,11,xmrig-MDEwOlJlcG9zaXRvcnk4ODMyNzQwNg==-flat-argon2-template-64.h,PINRemoteImage-MDEwOlJlcG9zaXRvcnkzOTUzNzEwMw==-flat-enc.c,40,70,30,102,109,7
13460,https://htmlpreview.github.io/?https://github.com/Christina96/boilerplate-sample-matches/blob/main/C/xmrig-MDEwOlJlcG9zaXRvcnk4ODMyNzQwNg==-flat-itoa.h-PINRemoteImage-MDEwOlJlcG9zaXRvcnkzOTUzNzEwMw==-flat-frame_enc.c.html,0.024691358024691357,9,xmrig-MDEwOlJlcG9zaXRvcnk4ODMyNzQwNg==-flat-itoa.h,PINRemoteImage-MDEwOlJlcG9zaXRvcnkzOTUzNzEwMw==-flat-frame_enc.c,92,95,3,625,629,4
13751,https://htmlpreview.github.io/?https://github.com/Christina96/boilerplate-sample-matches/blob/main/C/fftw3-MDEwOlJlcG9zaXRvcnk4ODQzMzg4-flat-simd-generic128.h-PINRemoteImage-MDEwOlJlcG9zaXRvcnkzOTUzNzEwMw==-flat-analysis_enc.c.html,0.047244094488188976,9,fftw3-MDEwOlJlcG9zaXRvcnk4ODQzMzg4-flat-simd-generic128.h,PINRemoteImage-MDEwOlJlcG9zaXRvcnkzOTUzNzEwMw==-flat-analysis_enc.c,75,87,12,287,295,8
15994,https://htmlpreview.github.io/?https://github.com/Christina96/boilerplate-sample-matches/blob/main/C/libtomcrypt-MDEwOlJlcG9zaXRvcnk3NzcwMTE=-flat-ecc_import_pkcs8.c-libfuse-MDEwOlJlcG9zaXRvcnk0ODI5NjE3Nw==-flat-mount.fuse.c.html,0.029574861367837338,8,libtomcrypt-MDEwOlJlcG9zaXRvcnk3NzcwMTE=-flat-ecc_import_pkcs8.c,libfuse-MDEwOlJlcG9zaXRvcnk0ODI5NjE3Nw==-flat-mount.fuse.c,57,65,8,70,74,4
18125,https://htmlpreview.github.io/?https://github.com/Christina96/boilerplate-sample-matches/blob/main/C/xmrig-MDEwOlJlcG9zaXRvcnk4ODMyNzQwNg==-flat-c_blake256.c-PINRemoteImage-MDEwOlJlcG9zaXRvcnkzOTUzNzEwMw==-flat-lossless.c.html,0.06805708013172337,11,xmrig-MDEwOlJlcG9zaXRvcnk4ODMyNzQwNg==-flat-c_blake256.c,PINRemoteImage-MDEwOlJlcG9zaXRvcnkzOTUzNzEwMw==-flat-lossless.c,85,89,4,369,374,5
18502,https://htmlpreview.github.io/?https://github.com/Christina96/boilerplate-sample-matches/blob/main/C/fftw3-MDEwOlJlcG9zaXRvcnk4ODQzMzg4-flat-verify-dft.c-libtomcrypt-MDEwOlJlcG9zaXRvcnk3NzcwMTE=-flat-der_test.c.html,0.026830631637786474,8,fftw3-MDEwOlJlcG9zaXRvcnk4ODQzMzg4-flat-verify-dft.c,libtomcrypt-MDEwOlJlcG9zaXRvcnk3NzcwMTE=-flat-der_test.c,119,127,8,445,452,7
19393,https://htmlpreview.github.io/?https://github.com/Christina96/boilerplate-sample-matches/blob/main/C/redis-MDEwOlJlcG9zaXRvcnkxMDgxMTA3MDY=-flat-hiredis.h-PINRemoteImage-MDEwOlJlcG9zaXRvcnkzOTUzNzEwMw==-flat-alpha_processing.c.html,0.03793103448275862,11,redis-MDEwOlJlcG9zaXRvcnkxMDgxMTA3MDY=-flat-hiredis.h,PINRemoteImage-MDEwOlJlcG9zaXRvcnkzOTUzNzEwMw==-flat-alpha_processing.c,97,105,8,317,319,2
20623,https://htmlpreview.github.io/?https://github.com/Christina96/boilerplate-sample-matches/blob/main/C/libtomcrypt-MDEwOlJlcG9zaXRvcnk3NzcwMTE=-flat-tiger.c-Adafruit_nRF52_Arduino-MDEwOlJlcG9zaXRvcnk3NDM1NDcyOQ==-flat-nrf_i2s.h.html,0.0787037037037037,17,libtomcrypt-MDEwOlJlcG9zaXRvcnk3NzcwMTE=-flat-tiger.c,Adafruit_nRF52_Arduino-MDEwOlJlcG9zaXRvcnk3NDM1NDcyOQ==-flat-nrf_i2s.h,559,575,16,51,72,21
21526,https://htmlpreview.github.io/?https://github.com/Christina96/boilerplate-sample-matches/blob/main/C/fftw3-MDEwOlJlcG9zaXRvcnk4ODQzMzg4-flat-reodft11e-r2hc-odd.c-small-MDEwOlJlcG9zaXRvcnkyNTY3NjMxNjk=-flat-auth.c.html,0.04415954415954416,9,fftw3-MDEwOlJlcG9zaXRvcnk4ODQzMzg4-flat-reodft11e-r2hc-odd.c,small-MDEwOlJlcG9zaXRvcnkyNTY3NjMxNjk=-flat-auth.c,52,64,12,139,146,7
22106,https://htmlpreview.github.io/?https://github.com/Christina96/boilerplate-sample-matches/blob/main/C/fftw3-MDEwOlJlcG9zaXRvcnk4ODQzMzg4-flat-dftw-generic.c-fftw3-MDEwOlJlcG9zaXRvcnk4ODQzMzg4-flat-buffered2.c.html,0.20689655172413793,12,fftw3-MDEwOlJlcG9zaXRvcnk4ODQzMzg4-flat-dftw-generic.c,fftw3-MDEwOlJlcG9zaXRvcnk4ODQzMzg4-flat-buffered2.c,114,125,11,221,232,11
24260,https://htmlpreview.github.io/?https://github.com/Christina96/boilerplate-sample-matches/blob/main/C/small-MDEwOlJlcG9zaXRvcnkyNTY3NjMxNjk=-flat-jconf.c-small-MDEwOlJlcG9zaXRvcnkyNTY3NjMxNjk=-flat-server.c.html,0.05753542292829541,22,small-MDEwOlJlcG9zaXRvcnkyNTY3NjMxNjk=-flat-jconf.c,small-MDEwOlJlcG9zaXRvcnkyNTY3NjMxNjk=-flat-server.c,146,154,8,1420,1430,10
24416,https://htmlpreview.github.io/?https://github.com/Christina96/boilerplate-sample-matches/blob/main/C/xmrig-MDEwOlJlcG9zaXRvcnk4ODMyNzQwNg==-flat-CryptoNight_arm.h-PINRemoteImage-MDEwOlJlcG9zaXRvcnkzOTUzNzEwMw==-flat-demux.c.html,0.10137741046831956,10,xmrig-MDEwOlJlcG9zaXRvcnk4ODMyNzQwNg==-flat-CryptoNight_arm.h,PINRemoteImage-MDEwOlJlcG9zaXRvcnkzOTUzNzEwMw==-flat-demux.c,41,50,9,496,505,9
25714,https://htmlpreview.github.io/?https://github.com/Christina96/boilerplate-sample-matches/blob/main/C/libtomcrypt-MDEwOlJlcG9zaXRvcnk3NzcwMTE=-flat-pkcs_5_test.c-PINRemoteImage-MDEwOlJlcG9zaXRvcnkzOTUzNzEwMw==-flat-get_disto.c.html,0.07643312101910828,8,libtomcrypt-MDEwOlJlcG9zaXRvcnk3NzcwMTE=-flat-pkcs_5_test.c,PINRemoteImage-MDEwOlJlcG9zaXRvcnkzOTUzNzEwMw==-flat-get_disto.c,140,148,8,135,139,4
27037,https://htmlpreview.github.io/?https://github.com/Christina96/boilerplate-sample-matches/blob/main/C/PINRemoteImage-MDEwOlJlcG9zaXRvcnkzOTUzNzEwMw==-flat-cost_neon.c-xmrig-MDEwOlJlcG9zaXRvcnk4ODMyNzQwNg==-flat-reader.h.html,0.05074198180947822,8,PINRemoteImage-MDEwOlJlcG9zaXRvcnkzOTUzNzEwMw==-flat-cost_neon.c,xmrig-MDEwOlJlcG9zaXRvcnk4ODMyNzQwNg==-flat-reader.h,44,47,3,249,252,3
27935,https://htmlpreview.github.io/?https://github.com/Christina96/boilerplate-sample-matches/blob/main/C/fftw3-MDEwOlJlcG9zaXRvcnk4ODQzMzg4-flat-rank-geq2.c-fftw3-MDEwOlJlcG9zaXRvcnk4ODQzMzg4-flat-bluestein.c.html,0.19726027397260273,11,fftw3-MDEwOlJlcG9zaXRvcnk4ODQzMzg4-flat-rank-geq2.c,fftw3-MDEwOlJlcG9zaXRvcnk4ODQzMzg4-flat-bluestein.c,27,36,9,109,117,8
28398,https://htmlpreview.github.io/?https://github.com/Christina96/boilerplate-sample-matches/blob/main/C/xmrig-MDEwOlJlcG9zaXRvcnk4ODMyNzQwNg==-flat-CudaConfig.h-Adafruit_nRF52_Arduino-MDEwOlJlcG9zaXRvcnk3NDM1NDcyOQ==-flat-system_nrf52.c.html,0.0784313725490196,8,xmrig-MDEwOlJlcG9zaXRvcnk4ODMyNzQwNg==-flat-CudaConfig.h,Adafruit_nRF52_Arduino-MDEwOlJlcG9zaXRvcnk3NDM1NDcyOQ==-flat-system_nrf52.c,28,44,16,72,79,7
31069,https://htmlpreview.github.io/?https://github.com/Christina96/boilerplate-sample-matches/blob/main/C/fftw3-MDEwOlJlcG9zaXRvcnk4ODQzMzg4-flat-problem_0.c-fftw3-MDEwOlJlcG9zaXRvcnk4ODQzMzg4-flat-rdft2-problem.c.html,0.5384615384615384,17,fftw3-MDEwOlJlcG9zaXRvcnk4ODQzMzg4-flat-problem_0.c,fftw3-MDEwOlJlcG9zaXRvcnk4ODQzMzg4-flat-rdft2-problem.c,22,38,16,21,37,16
31131,https://htmlpreview.github.io/?https://github.com/Christina96/boilerplate-sample-matches/blob/main/C/xmrig-MDEwOlJlcG9zaXRvcnk4ODMyNzQwNg==-flat-IConfig.h-libtomcrypt-MDEwOlJlcG9zaXRvcnk3NzcwMTE=-flat-rabbit.c.html,0.15734265734265734,17,xmrig-MDEwOlJlcG9zaXRvcnk4ODMyNzQwNg==-flat-IConfig.h,libtomcrypt-MDEwOlJlcG9zaXRvcnk3NzcwMTE=-flat-rabbit.c,11,27,16,68,84,16
31815,https://htmlpreview.github.io/?https://github.com/Christina96/boilerplate-sample-matches/blob/main/C/small-MDEwOlJlcG9zaXRvcnkyNTY3NjMxNjk=-flat-acl.h-libpcap-MDEwOlJlcG9zaXRvcnk5NDM1ODg3-flat-pcap-tc.c.html,0.026442307692307692,11,small-MDEwOlJlcG9zaXRvcnkyNTY3NjMxNjk=-flat-acl.h,libpcap-MDEwOlJlcG9zaXRvcnk5NDM1ODg3-flat-pcap-tc.c,15,22,7,98,108,10
32186,https://htmlpreview.github.io/?https://github.com/Christina96/boilerplate-sample-matches/blob/main/C/xmrig-MDEwOlJlcG9zaXRvcnk4ODMyNzQwNg==-flat-OclContext.h-xmrig-MDEwOlJlcG9zaXRvcnk4ODMyNzQwNg==-flat-Assembly.h.html,0.16981132075471697,9,xmrig-MDEwOlJlcG9zaXRvcnk4ODMyNzQwNg==-flat-OclContext.h,xmrig-MDEwOlJlcG9zaXRvcnk4ODMyNzQwNg==-flat-Assembly.h,17,18,1,24,25,1
33442,https://htmlpreview.github.io/?https://github.com/Christina96/boilerplate-sample-matches/blob/main/C/libtomcrypt-MDEwOlJlcG9zaXRvcnk3NzcwMTE=-flat-ocb3_decrypt.c-libtomcrypt-MDEwOlJlcG9zaXRvcnk3NzcwMTE=-flat-der_encode_asn1_identifier.c.html,0.2620689655172414,8,libtomcrypt-MDEwOlJlcG9zaXRvcnk3NzcwMTE=-flat-ocb3_decrypt.c,libtomcrypt-MDEwOlJlcG9zaXRvcnk3NzcwMTE=-flat-der_encode_asn1_identifier.c,3,6,3,3,7,4
34829,https://htmlpreview.github.io/?https://github.com/Christina96/boilerplate-sample-matches/blob/main/C/xmrig-MDEwOlJlcG9zaXRvcnk4ODMyNzQwNg==-flat-Algorithm.h-fftw3-MDEwOlJlcG9zaXRvcnk4ODQzMzg4-flat-mp.c.html,0.0163265306122449,8,xmrig-MDEwOlJlcG9zaXRvcnk4ODMyNzQwNg==-flat-Algorithm.h,fftw3-MDEwOlJlcG9zaXRvcnk4ODQzMzg4-flat-mp.c,10,17,7,178,182,4
36901,https://htmlpreview.github.io/?https://github.com/Christina96/boilerplate-sample-matches/blob/main/C/libfuse-MDEwOlJlcG9zaXRvcnk0ODI5NjE3Nw==-flat-subdir.c-redis-MDEwOlJlcG9zaXRvcnkxMDgxMTA3MDY=-flat-jemalloc.c.html,0.03726346433770015,8,libfuse-MDEwOlJlcG9zaXRvcnk0ODI5NjE3Nw==-flat-subdir.c,redis-MDEwOlJlcG9zaXRvcnkxMDgxMTA3MDY=-flat-jemalloc.c,561,569,8,160,166,6
37100,https://htmlpreview.github.io/?https://github.com/Christina96/boilerplate-sample-matches/blob/main/C/libtomcrypt-MDEwOlJlcG9zaXRvcnk3NzcwMTE=-flat-bcrypt.c-redis-MDEwOlJlcG9zaXRvcnkxMDgxMTA3MDY=-flat-object.c.html,0.012836970474967908,10,libtomcrypt-MDEwOlJlcG9zaXRvcnk3NzcwMTE=-flat-bcrypt.c,redis-MDEwOlJlcG9zaXRvcnkxMDgxMTA3MDY=-flat-object.c,67,73,6,38,44,6
37530,https://htmlpreview.github.io/?https://github.com/Christina96/boilerplate-sample-matches/blob/main/C/redis-MDEwOlJlcG9zaXRvcnkxMDgxMTA3MDY=-flat-ae_wsiocp.c-PINRemoteImage-MDEwOlJlcG9zaXRvcnkzOTUzNzEwMw==-flat-cwebp.c.html,0.029137529137529136,8,redis-MDEwOlJlcG9zaXRvcnkxMDgxMTA3MDY=-flat-ae_wsiocp.c,PINRemoteImage-MDEwOlJlcG9zaXRvcnkzOTUzNzEwMw==-flat-cwebp.c,180,184,4,56,60,4
37706,https://htmlpreview.github.io/?https://github.com/Christina96/boilerplate-sample-matches/blob/main/C/PINRemoteImage-MDEwOlJlcG9zaXRvcnkzOTUzNzEwMw==-flat-mux_types.h-small-MDEwOlJlcG9zaXRvcnkyNTY3NjMxNjk=-flat-udprelay.c.html,0.012432012432012432,8,PINRemoteImage-MDEwOlJlcG9zaXRvcnkzOTUzNzEwMw==-flat-mux_types.h,small-MDEwOlJlcG9zaXRvcnkyNTY3NjMxNjk=-flat-udprelay.c,34,40,6,429,438,9
38342,https://htmlpreview.github.io/?https://github.com/Christina96/boilerplate-sample-matches/blob/main/C/Adafruit_nRF52_Arduino-MDEwOlJlcG9zaXRvcnk3NDM1NDcyOQ==-flat-lfs.h-redis-MDEwOlJlcG9zaXRvcnkxMDgxMTA3MDY=-flat-listpack.c.html,0.04929577464788732,13,Adafruit_nRF52_Arduino-MDEwOlJlcG9zaXRvcnk3NDM1NDcyOQ==-flat-lfs.h,redis-MDEwOlJlcG9zaXRvcnkxMDgxMTA3MDY=-flat-listpack.c,42,54,12,157,169,12
38375,https://htmlpreview.github.io/?https://github.com/Christina96/boilerplate-sample-matches/blob/main/C/xmrig-MDEwOlJlcG9zaXRvcnk4ODMyNzQwNg==-flat-strtod.h-redis-MDEwOlJlcG9zaXRvcnkxMDgxMTA3MDY=-flat-jemalloc_internal.h.html,0.03007518796992481,10,xmrig-MDEwOlJlcG9zaXRvcnk4ODMyNzQwNg==-flat-strtod.h,redis-MDEwOlJlcG9zaXRvcnkxMDgxMTA3MDY=-flat-jemalloc_internal.h,19,27,8,734,742,8
39595,https://htmlpreview.github.io/?https://github.com/Christina96/boilerplate-sample-matches/blob/main/C/libtomcrypt-MDEwOlJlcG9zaXRvcnk3NzcwMTE=-flat-base64_test.c-redis-MDEwOlJlcG9zaXRvcnkxMDgxMTA3MDY=-flat-siphash.c.html,0.1996370235934664,15,libtomcrypt-MDEwOlJlcG9zaXRvcnk3NzcwMTE=-flat-base64_test.c,redis-MDEwOlJlcG9zaXRvcnkxMDgxMTA3MDY=-flat-siphash.c,22,29,7,180,187,7
40663,https://htmlpreview.github.io/?https://github.com/Christina96/boilerplate-sample-matches/blob/main/C/xmrig-MDEwOlJlcG9zaXRvcnk4ODMyNzQwNg==-flat-core.h-Adafruit_nRF52_Arduino-MDEwOlJlcG9zaXRvcnk3NDM1NDcyOQ==-flat-nrfx_nfct.h.html,0.2698412698412698,9,xmrig-MDEwOlJlcG9zaXRvcnk4ODMyNzQwNg==-flat-core.h,Adafruit_nRF52_Arduino-MDEwOlJlcG9zaXRvcnk3NDM1NDcyOQ==-flat-nrfx_nfct.h,37,47,10,65,74,9
41817,https://htmlpreview.github.io/?https://github.com/Christina96/boilerplate-sample-matches/blob/main/C/libtomcrypt-MDEwOlJlcG9zaXRvcnk3NzcwMTE=-flat-base16_test.c-PINRemoteImage-MDEwOlJlcG9zaXRvcnkzOTUzNzEwMw==-flat-analysis_enc.c.html,0.02511773940345369,8,libtomcrypt-MDEwOlJlcG9zaXRvcnk3NzcwMTE=-flat-base16_test.c,PINRemoteImage-MDEwOlJlcG9zaXRvcnkzOTUzNzEwMw==-flat-analysis_enc.c,15,16,1,16,17,1
42629,https://htmlpreview.github.io/?https://github.com/Christina96/boilerplate-sample-matches/blob/main/C/redis-MDEwOlJlcG9zaXRvcnkxMDgxMTA3MDY=-flat-ae_wsiocp.c-libfuse-MDEwOlJlcG9zaXRvcnk0ODI5NjE3Nw==-flat-fusermount.c.html,0.054871220604703244,8,redis-MDEwOlJlcG9zaXRvcnkxMDgxMTA3MDY=-flat-ae_wsiocp.c,libfuse-MDEwOlJlcG9zaXRvcnk0ODI5NjE3Nw==-flat-fusermount.c,181,186,5,529,534,5
44453,https://htmlpreview.github.io/?https://github.com/Christina96/boilerplate-sample-matches/blob/main/C/fftw3-MDEwOlJlcG9zaXRvcnk4ODQzMzg4-flat-md5.c-xmrig-MDEwOlJlcG9zaXRvcnk4ODMyNzQwNg==-flat-format.h.html,0.027385351010649858,17,fftw3-MDEwOlJlcG9zaXRvcnk4ODQzMzg4-flat-md5.c,xmrig-MDEwOlJlcG9zaXRvcnk4ODMyNzQwNg==-flat-format.h,23,25,2,1098,1109,11
45670,https://htmlpreview.github.io/?https://github.com/Christina96/boilerplate-sample-matches/blob/main/C/libtomcrypt-MDEwOlJlcG9zaXRvcnk3NzcwMTE=-flat-idea.c-PINRemoteImage-MDEwOlJlcG9zaXRvcnkzOTUzNzEwMw==-flat-enc.c.html,0.03770848440899202,15,libtomcrypt-MDEwOlJlcG9zaXRvcnk3NzcwMTE=-flat-idea.c,PINRemoteImage-MDEwOlJlcG9zaXRvcnkzOTUzNzEwMw==-flat-enc.c,13,14,1,669,683,14
45808,https://htmlpreview.github.io/?https://github.com/Christina96/boilerplate-sample-matches/blob/main/C/small-MDEwOlJlcG9zaXRvcnkyNTY3NjMxNjk=-flat-obfs.c-libfuse-MDEwOlJlcG9zaXRvcnk0ODI5NjE3Nw==-flat-subdir.c.html,0.06741573033707865,9,small-MDEwOlJlcG9zaXRvcnkyNTY3NjMxNjk=-flat-obfs.c,libfuse-MDEwOlJlcG9zaXRvcnk0ODI5NjE3Nw==-flat-subdir.c,143,151,8,535,543,8
46338,https://htmlpreview.github.io/?https://github.com/Christina96/boilerplate-sample-matches/blob/main/C/redis-MDEwOlJlcG9zaXRvcnkxMDgxMTA3MDY=-flat-extent_24.c-PINRemoteImage-MDEwOlJlcG9zaXRvcnkzOTUzNzEwMw==-flat-vp8l_enc.c.html,0.040249433106575964,8,redis-MDEwOlJlcG9zaXRvcnkxMDgxMTA3MDY=-flat-extent_24.c,PINRemoteImage-MDEwOlJlcG9zaXRvcnkzOTUzNzEwMw==-flat-vp8l_enc.c,117,123,6,252,257,5
46781,https://htmlpreview.github.io/?https://github.com/Christina96/boilerplate-sample-matches/blob/main/C/Adafruit_nRF52_Arduino-MDEwOlJlcG9zaXRvcnk3NDM1NDcyOQ==-flat-nrf_ppi.h-libtomcrypt-MDEwOlJlcG9zaXRvcnk3NzcwMTE=-flat-rabbit.c.html,0.09,17,Adafruit_nRF52_Arduino-MDEwOlJlcG9zaXRvcnk3NDM1NDcyOQ==-flat-nrf_ppi.h,libtomcrypt-MDEwOlJlcG9zaXRvcnk3NzcwMTE=-flat-rabbit.c,9,26,17,68,84,16
49948,https://htmlpreview.github.io/?https://github.com/Christina96/boilerplate-sample-matches/blob/main/C/redis-MDEwOlJlcG9zaXRvcnkxMDgxMTA3MDY=-flat-helloworld.c-redis-MDEwOlJlcG9zaXRvcnkxMDgxMTA3MDY=-flat-net.c.html,0.02097902097902098,9,redis-MDEwOlJlcG9zaXRvcnkxMDgxMTA3MDY=-flat-helloworld.c,redis-MDEwOlJlcG9zaXRvcnkxMDgxMTA3MDY=-flat-net.c,65,82,17,228,234,6
50331,https://htmlpreview.github.io/?https://github.com/Christina96/boilerplate-sample-matches/blob/main/C/android-gpuimage-plus-MDEwOlJlcG9zaXRvcnk0NjU0NzQxNw==-flat-imgutils.h-android-gpuimage-plus-MDEwOlJlcG9zaXRvcnk0NjU0NzQxNw==-flat-avcodec.h.html,0.049029622063329927,8,android-gpuimage-plus-MDEwOlJlcG9zaXRvcnk0NjU0NzQxNw==-flat-imgutils.h,android-gpuimage-plus-MDEwOlJlcG9zaXRvcnk0NjU0NzQxNw==-flat-avcodec.h,11,14,3,1434,1446,12
53732,https://htmlpreview.github.io/?https://github.com/Christina96/boilerplate-sample-matches/blob/main/C/libtomcrypt-MDEwOlJlcG9zaXRvcnk3NzcwMTE=-flat-twofish_tab.c-PINRemoteImage-MDEwOlJlcG9zaXRvcnkzOTUzNzEwMw==-flat-vp8l_dec.c.html,0.03490566037735849,27,libtomcrypt-MDEwOlJlcG9zaXRvcnk3NzcwMTE=-flat-twofish_tab.c,PINRemoteImage-MDEwOlJlcG9zaXRvcnkzOTUzNzEwMw==-flat-vp8l_dec.c,195,362,167,22,65,43
53987,https://htmlpreview.github.io/?https://github.com/Christina96/boilerplate-sample-matches/blob/main/C/android-gpuimage-plus-MDEwOlJlcG9zaXRvcnk0NjU0NzQxNw==-flat-pixdesc.h-libtomcrypt-MDEwOlJlcG9zaXRvcnk3NzcwMTE=-flat-cast5.c.html,0.03643724696356275,9,android-gpuimage-plus-MDEwOlJlcG9zaXRvcnk0NjU0NzQxNw==-flat-pixdesc.h,libtomcrypt-MDEwOlJlcG9zaXRvcnk3NzcwMTE=-flat-cast5.c,7,16,9,3,13,10
54039,https://htmlpreview.github.io/?https://github.com/Christina96/boilerplate-sample-matches/blob/main/C/libpcap-MDEwOlJlcG9zaXRvcnk5NDM1ODg3-flat-pcap-airpcap.c-redis-MDEwOlJlcG9zaXRvcnkxMDgxMTA3MDY=-flat-ziplist.c.html,0.03287427809862283,8,libpcap-MDEwOlJlcG9zaXRvcnk5NDM1ODg3-flat-pcap-airpcap.c,redis-MDEwOlJlcG9zaXRvcnkxMDgxMTA3MDY=-flat-ziplist.c,65,72,7,1095,1096,1
57454,https://htmlpreview.github.io/?https://github.com/Christina96/boilerplate-sample-matches/blob/main/C/xmrig-MDEwOlJlcG9zaXRvcnk4ODMyNzQwNg==-flat-SubmitResult.h-xmrig-MDEwOlJlcG9zaXRvcnk4ODMyNzQwNg==-flat-distances.c.html,0.012491325468424705,9,xmrig-MDEwOlJlcG9zaXRvcnk4ODMyNzQwNg==-flat-SubmitResult.h,xmrig-MDEwOlJlcG9zaXRvcnk4ODMyNzQwNg==-flat-distances.c,17,25,8,311,319,8
58505,https://htmlpreview.github.io/?https://github.com/Christina96/boilerplate-sample-matches/blob/main/C/fftw3-MDEwOlJlcG9zaXRvcnk4ODQzMzg4-flat-t.c-fftw3-MDEwOlJlcG9zaXRvcnk4ODQzMzg4-flat-verify.h.html,0.14285714285714285,8,fftw3-MDEwOlJlcG9zaXRvcnk4ODQzMzg4-flat-t.c,fftw3-MDEwOlJlcG9zaXRvcnk4ODQzMzg4-flat-verify.h,4,5,1,41,46,5
61377,https://htmlpreview.github.io/?https://github.com/Christina96/boilerplate-sample-matches/blob/main/C/PINRemoteImage-MDEwOlJlcG9zaXRvcnkzOTUzNzEwMw==-flat-yuv_neon.c-PINRemoteImage-MDEwOlJlcG9zaXRvcnkzOTUzNzEwMw==-flat-dec.c.html,0.08827586206896551,8,PINRemoteImage-MDEwOlJlcG9zaXRvcnkzOTUzNzEwMw==-flat-yuv_neon.c,PINRemoteImage-MDEwOlJlcG9zaXRvcnkzOTUzNzEwMw==-flat-dec.c,36,40,4,149,154,5
62313,https://htmlpreview.github.io/?https://github.com/Christina96/boilerplate-sample-matches/blob/main/C/libpcap-MDEwOlJlcG9zaXRvcnk5NDM1ODg3-flat-pcap-airpcap.c-fftw3-MDEwOlJlcG9zaXRvcnk4ODQzMzg4-flat-mpi-bench.c.html,0.09642074506939372,8,libpcap-MDEwOlJlcG9zaXRvcnk5NDM1ODg3-flat-pcap-airpcap.c,fftw3-MDEwOlJlcG9zaXRvcnk4ODQzMzg4-flat-mpi-bench.c,513,520,7,517,527,10
63921,https://htmlpreview.github.io/?https://github.com/Christina96/boilerplate-sample-matches/blob/main/C/PINRemoteImage-MDEwOlJlcG9zaXRvcnkzOTUzNzEwMw==-flat-vp8i_enc.h-libtomcrypt-MDEwOlJlcG9zaXRvcnk3NzcwMTE=-flat-ccm_test.c.html,0.02707275803722504,8,PINRemoteImage-MDEwOlJlcG9zaXRvcnkzOTUzNzEwMw==-flat-vp8i_enc.h,libtomcrypt-MDEwOlJlcG9zaXRvcnk3NzcwMTE=-flat-ccm_test.c,93,98,5,15,19,4
64527,https://htmlpreview.github.io/?https://github.com/Christina96/boilerplate-sample-matches/blob/main/C/PINRemoteImage-MDEwOlJlcG9zaXRvcnkzOTUzNzEwMw==-flat-dec_mips_dsp_r2.c-libtomcrypt-MDEwOlJlcG9zaXRvcnk3NzcwMTE=-flat-blake2b.c.html,0.0759493670886076,9,PINRemoteImage-MDEwOlJlcG9zaXRvcnkzOTUzNzEwMw==-flat-dec_mips_dsp_r2.c,libtomcrypt-MDEwOlJlcG9zaXRvcnk3NzcwMTE=-flat-blake2b.c,413,418,5,121,125,4
65271,https://htmlpreview.github.io/?https://github.com/Christina96/boilerplate-sample-matches/blob/main/C/xmrig-MDEwOlJlcG9zaXRvcnk4ODMyNzQwNg==-flat-argon2.c-libfuse-MDEwOlJlcG9zaXRvcnk0ODI5NjE3Nw==-flat-fuse.c.html,0.024139794631597912,8,xmrig-MDEwOlJlcG9zaXRvcnk4ODMyNzQwNg==-flat-argon2.c,libfuse-MDEwOlJlcG9zaXRvcnk0ODI5NjE3Nw==-flat-fuse.c,196,204,8,1084,1091,7
65611,https://htmlpreview.github.io/?https://github.com/Christina96/boilerplate-sample-matches/blob/main/C/libtomcrypt-MDEwOlJlcG9zaXRvcnk3NzcwMTE=-flat-rmd256.c-Adafruit_nRF52_Arduino-MDEwOlJlcG9zaXRvcnk3NDM1NDcyOQ==-flat-bignum.c.html,0.05714285714285714,8,libtomcrypt-MDEwOlJlcG9zaXRvcnk3NzcwMTE=-flat-rmd256.c,Adafruit_nRF52_Arduino-MDEwOlJlcG9zaXRvcnk3NDM1NDcyOQ==-flat-bignum.c,96,195,99,941,948,7
69226,https://htmlpreview.github.io/?https://github.com/Christina96/boilerplate-sample-matches/blob/main/C/redis-MDEwOlJlcG9zaXRvcnkxMDgxMTA3MDY=-flat-rb.c-libtomcrypt-MDEwOlJlcG9zaXRvcnk3NzcwMTE=-flat-tv_gen.c.html,0.04801477377654663,8,redis-MDEwOlJlcG9zaXRvcnkxMDgxMTA3MDY=-flat-rb.c,libtomcrypt-MDEwOlJlcG9zaXRvcnk3NzcwMTE=-flat-tv_gen.c,172,175,3,53,56,3
73679,https://htmlpreview.github.io/?https://github.com/Christina96/boilerplate-sample-matches/blob/main/C/redis-MDEwOlJlcG9zaXRvcnkxMDgxMTA3MDY=-flat-arena_inlines_b.h-libpcap-MDEwOlJlcG9zaXRvcnk5NDM1ODg3-flat-nametoaddr.c.html,0.01927710843373494,8,redis-MDEwOlJlcG9zaXRvcnkxMDgxMTA3MDY=-flat-arena_inlines_b.h,libpcap-MDEwOlJlcG9zaXRvcnk5NDM1ODg3-flat-nametoaddr.c,18,22,4,488,493,5
74114,https://htmlpreview.github.io/?https://github.com/Christina96/boilerplate-sample-matches/blob/main/C/libtomcrypt-MDEwOlJlcG9zaXRvcnk3NzcwMTE=-flat-dh_shared_secret.c-libtomcrypt-MDEwOlJlcG9zaXRvcnk3NzcwMTE=-flat-ltc_ecc_projective_add_point.c.html,0.05309734513274336,12,libtomcrypt-MDEwOlJlcG9zaXRvcnk3NzcwMTE=-flat-dh_shared_secret.c,libtomcrypt-MDEwOlJlcG9zaXRvcnk3NzcwMTE=-flat-ltc_ecc_projective_add_point.c,20,27,7,119,122,3
74833,https://htmlpreview.github.io/?https://github.com/Christina96/boilerplate-sample-matches/blob/main/C/libtomcrypt-MDEwOlJlcG9zaXRvcnk3NzcwMTE=-flat-sha512_256.c-libtomcrypt-MDEwOlJlcG9zaXRvcnk3NzcwMTE=-flat-xts_test.c.html,0.09523809523809523,9,libtomcrypt-MDEwOlJlcG9zaXRvcnk3NzcwMTE=-flat-sha512_256.c,libtomcrypt-MDEwOlJlcG9zaXRvcnk3NzcwMTE=-flat-xts_test.c,45,52,7,44,53,9
74968,https://htmlpreview.github.io/?https://github.com/Christina96/boilerplate-sample-matches/blob/main/C/redis-MDEwOlJlcG9zaXRvcnkxMDgxMTA3MDY=-flat-Win32_QFork_impl.c-redis-MDEwOlJlcG9zaXRvcnkxMDgxMTA3MDY=-flat-redis-check-aof.c.html,0.2054794520547945,8,redis-MDEwOlJlcG9zaXRvcnkxMDgxMTA3MDY=-flat-Win32_QFork_impl.c,redis-MDEwOlJlcG9zaXRvcnkxMDgxMTA3MDY=-flat-redis-check-aof.c,24,29,5,108,112,4
75859,https://htmlpreview.github.io/?https://github.com/Christina96/boilerplate-sample-matches/blob/main/C/fftw3-MDEwOlJlcG9zaXRvcnk4ODQzMzg4-flat-redft00e-r2hc.c-android-gpuimage-plus-MDEwOlJlcG9zaXRvcnk0NjU0NzQxNw==-flat-opt.h.html,0.04157043879907621,9,fftw3-MDEwOlJlcG9zaXRvcnk4ODQzMzg4-flat-redft00e-r2hc.c,android-gpuimage-plus-MDEwOlJlcG9zaXRvcnk0NjU0NzQxNw==-flat-opt.h,28,36,8,10,28,18
76367,https://htmlpreview.github.io/?https://github.com/Christina96/boilerplate-sample-matches/blob/main/C/xmrig-MDEwOlJlcG9zaXRvcnk4ODMyNzQwNg==-flat-netloc.h-PINRemoteImage-MDEwOlJlcG9zaXRvcnkzOTUzNzEwMw==-flat-encode_32.h.html,0.18807339449541285,8,xmrig-MDEwOlJlcG9zaXRvcnk4ODMyNzQwNg==-flat-netloc.h,PINRemoteImage-MDEwOlJlcG9zaXRvcnkzOTUzNzEwMw==-flat-encode_32.h,24,29,5,130,135,5
76980,https://htmlpreview.github.io/?https://github.com/Christina96/boilerplate-sample-matches/blob/main/C/libtomcrypt-MDEwOlJlcG9zaXRvcnk3NzcwMTE=-flat-der_decode_generalizedtime.c-redis-MDEwOlJlcG9zaXRvcnkxMDgxMTA3MDY=-flat-redis-check-aof.c.html,0.05750798722044728,9,libtomcrypt-MDEwOlJlcG9zaXRvcnk3NzcwMTE=-flat-der_decode_generalizedtime.c,redis-MDEwOlJlcG9zaXRvcnkxMDgxMTA3MDY=-flat-redis-check-aof.c,43,51,8,58,64,6
77559,https://htmlpreview.github.io/?https://github.com/Christina96/boilerplate-sample-matches/blob/main/C/PINRemoteImage-MDEwOlJlcG9zaXRvcnkzOTUzNzEwMw==-flat-picture_tools_enc.c-libtomcrypt-MDEwOlJlcG9zaXRvcnk3NzcwMTE=-flat-blowfish.c.html,0.06493506493506493,8,PINRemoteImage-MDEwOlJlcG9zaXRvcnkzOTUzNzEwMw==-flat-picture_tools_enc.c,libtomcrypt-MDEwOlJlcG9zaXRvcnk3NzcwMTE=-flat-blowfish.c,202,210,8,360,368,8
78242,https://htmlpreview.github.io/?https://github.com/Christina96/boilerplate-sample-matches/blob/main/C/PINRemoteImage-MDEwOlJlcG9zaXRvcnkzOTUzNzEwMw==-flat-dec_mips_dsp_r2.c-libfuse-MDEwOlJlcG9zaXRvcnk0ODI5NjE3Nw==-flat-subdir.c.html,0.06060606060606061,26,PINRemoteImage-MDEwOlJlcG9zaXRvcnkzOTUzNzEwMw==-flat-dec_mips_dsp_r2.c,libfuse-MDEwOlJlcG9zaXRvcnk0ODI5NjE3Nw==-flat-subdir.c,872,897,25,507,532,25
79777,https://htmlpreview.github.io/?https://github.com/Christina96/boilerplate-sample-matches/blob/main/C/Adafruit_nRF52_Arduino-MDEwOlJlcG9zaXRvcnk3NDM1NDcyOQ==-flat-WInterrupts.c-libpcap-MDEwOlJlcG9zaXRvcnk5NDM1ODg3-flat-pcap-dpdk.c.html,0.042986425339366516,8,Adafruit_nRF52_Arduino-MDEwOlJlcG9zaXRvcnk3NDM1NDcyOQ==-flat-WInterrupts.c,libpcap-MDEwOlJlcG9zaXRvcnk5NDM1ODg3-flat-pcap-dpdk.c,99,103,4,392,395,3
80524,https://htmlpreview.github.io/?https://github.com/Christina96/boilerplate-sample-matches/blob/main/C/PINRemoteImage-MDEwOlJlcG9zaXRvcnkzOTUzNzEwMw==-flat-tiffdec.c-libfuse-MDEwOlJlcG9zaXRvcnk0ODI5NjE3Nw==-flat-test_syscalls.c.html,0.01392515230635335,8,PINRemoteImage-MDEwOlJlcG9zaXRvcnkzOTUzNzEwMw==-flat-tiffdec.c,libfuse-MDEwOlJlcG9zaXRvcnk0ODI5NjE3Nw==-flat-test_syscalls.c,60,68,8,808,816,8
81661,https://htmlpreview.github.io/?https://github.com/Christina96/boilerplate-sample-matches/blob/main/C/libtomcrypt-MDEwOlJlcG9zaXRvcnk3NzcwMTE=-flat-xts_test.c-xmrig-MDEwOlJlcG9zaXRvcnk4ODMyNzQwNg==-flat-pci-common.c.html,0.024390243902439025,8,libtomcrypt-MDEwOlJlcG9zaXRvcnk3NzcwMTE=-flat-xts_test.c,xmrig-MDEwOlJlcG9zaXRvcnk4ODMyNzQwNg==-flat-pci-common.c,185,191,6,733,744,11
81878,https://htmlpreview.github.io/?https://github.com/Christina96/boilerplate-sample-matches/blob/main/C/redis-MDEwOlJlcG9zaXRvcnkxMDgxMTA3MDY=-flat-t_list.c-redis-MDEwOlJlcG9zaXRvcnkxMDgxMTA3MDY=-flat-tcache.c.html,0.05901639344262295,11,redis-MDEwOlJlcG9zaXRvcnkxMDgxMTA3MDY=-flat-t_list.c,redis-MDEwOlJlcG9zaXRvcnkxMDgxMTA3MDY=-flat-tcache.c,187,191,4,578,585,7
82198,https://htmlpreview.github.io/?https://github.com/Christina96/boilerplate-sample-matches/blob/main/C/libtomcrypt-MDEwOlJlcG9zaXRvcnk3NzcwMTE=-flat-omac_memory_multi.c-libtomcrypt-MDEwOlJlcG9zaXRvcnk3NzcwMTE=-flat-der_length_printable_string.c.html,0.05442176870748299,8,libtomcrypt-MDEwOlJlcG9zaXRvcnk3NzcwMTE=-flat-omac_memory_multi.c,libtomcrypt-MDEwOlJlcG9zaXRvcnk3NzcwMTE=-flat-der_length_printable_string.c,4,6,2,101,101,0
83268,https://htmlpreview.github.io/?https://github.com/Christina96/boilerplate-sample-matches/blob/main/C/redis-MDEwOlJlcG9zaXRvcnkxMDgxMTA3MDY=-flat-math.h-xmrig-MDEwOlJlcG9zaXRvcnk4ODMyNzQwNg==-flat-document.h.html,0.029135642602784072,11,redis-MDEwOlJlcG9zaXRvcnkxMDgxMTA3MDY=-flat-math.h,xmrig-MDEwOlJlcG9zaXRvcnk4ODMyNzQwNg==-flat-document.h,200,213,13,937,947,10
83747,https://htmlpreview.github.io/?https://github.com/Christina96/boilerplate-sample-matches/blob/main/C/libtomcrypt-MDEwOlJlcG9zaXRvcnk3NzcwMTE=-flat-safer.c-PINRemoteImage-MDEwOlJlcG9zaXRvcnkzOTUzNzEwMw==-flat-dec_neon.c.html,0.06711409395973154,36,libtomcrypt-MDEwOlJlcG9zaXRvcnk3NzcwMTE=-flat-safer.c,PINRemoteImage-MDEwOlJlcG9zaXRvcnkzOTUzNzEwMw==-flat-dec_neon.c,204,214,10,1269,1308,39
85681,https://htmlpreview.github.io/?https://github.com/Christina96/boilerplate-sample-matches/blob/main/C/libtomcrypt-MDEwOlJlcG9zaXRvcnk3NzcwMTE=-flat-pkcs1v15sign-vectors.c-xmrig-MDEwOlJlcG9zaXRvcnk4ODMyNzQwNg==-flat-crypto-ops-data.c.html,0.6656115758534931,10,libtomcrypt-MDEwOlJlcG9zaXRvcnk3NzcwMTE=-flat-pkcs1v15sign-vectors.c,xmrig-MDEwOlJlcG9zaXRvcnk4ODMyNzQwNg==-flat-crypto-ops-data.c,565,577,12,212,215,3
87074,https://htmlpreview.github.io/?https://github.com/Christina96/boilerplate-sample-matches/blob/main/C/PINRemoteImage-MDEwOlJlcG9zaXRvcnkzOTUzNzEwMw==-flat-yuv_sse41.c-PINRemoteImage-MDEwOlJlcG9zaXRvcnkzOTUzNzEwMw==-flat-dec_msa.c.html,0.25208681135225375,10,PINRemoteImage-MDEwOlJlcG9zaXRvcnkzOTUzNzEwMw==-flat-yuv_sse41.c,PINRemoteImage-MDEwOlJlcG9zaXRvcnkzOTUzNzEwMw==-flat-dec_msa.c,149,159,10,83,92,9
87762,https://htmlpreview.github.io/?https://github.com/Christina96/boilerplate-sample-matches/blob/main/C/libtomcrypt-MDEwOlJlcG9zaXRvcnk3NzcwMTE=-flat-camellia.c-redis-MDEwOlJlcG9zaXRvcnkxMDgxMTA3MDY=-flat-arena.c.html,0.0519893899204244,8,libtomcrypt-MDEwOlJlcG9zaXRvcnk3NzcwMTE=-flat-camellia.c,redis-MDEwOlJlcG9zaXRvcnkxMDgxMTA3MDY=-flat-arena.c,218,222,4,440,444,4
87808,https://htmlpreview.github.io/?https://github.com/Christina96/boilerplate-sample-matches/blob/main/C/fftw3-MDEwOlJlcG9zaXRvcnk4ODQzMzg4-flat-trigtest.c-PINRemoteImage-MDEwOlJlcG9zaXRvcnkzOTUzNzEwMw==-flat-dec_sse2.c.html,0.05186880244088482,8,fftw3-MDEwOlJlcG9zaXRvcnk4ODQzMzg4-flat-trigtest.c,PINRemoteImage-MDEwOlJlcG9zaXRvcnkzOTUzNzEwMw==-flat-dec_sse2.c,91,99,8,90,97,7
93609,https://htmlpreview.github.io/?https://github.com/Christina96/boilerplate-sample-matches/blob/main/C/libtomcrypt-MDEwOlJlcG9zaXRvcnk3NzcwMTE=-flat-sober128_stream_memory.c-libtomcrypt-MDEwOlJlcG9zaXRvcnk3NzcwMTE=-flat-ocb_decrypt_verify_memory.c.html,0.20224719101123595,9,libtomcrypt-MDEwOlJlcG9zaXRvcnk3NzcwMTE=-flat-sober128_stream_memory.c,libtomcrypt-MDEwOlJlcG9zaXRvcnk3NzcwMTE=-flat-ocb_decrypt_verify_memory.c,3,4,1,3,5,2
94501,https://htmlpreview.github.io/?https://github.com/Christina96/boilerplate-sample-matches/blob/main/C/Adafruit_nRF52_Arduino-MDEwOlJlcG9zaXRvcnk3NDM1NDcyOQ==-flat-nrf_gpiote.h-PINRemoteImage-MDEwOlJlcG9zaXRvcnkzOTUzNzEwMw==-flat-dec_neon.c.html,0.06099706744868035,9,Adafruit_nRF52_Arduino-MDEwOlJlcG9zaXRvcnk3NDM1NDcyOQ==-flat-nrf_gpiote.h,PINRemoteImage-MDEwOlJlcG9zaXRvcnkzOTUzNzEwMw==-flat-dec_neon.c,71,80,9,110,118,8
94519,https://htmlpreview.github.io/?https://github.com/Christina96/boilerplate-sample-matches/blob/main/C/libtomcrypt-MDEwOlJlcG9zaXRvcnk3NzcwMTE=-flat-base16_test.c-libtomcrypt-MDEwOlJlcG9zaXRvcnk3NzcwMTE=-flat-omac_process.c.html,0.11428571428571428,8,libtomcrypt-MDEwOlJlcG9zaXRvcnk3NzcwMTE=-flat-base16_test.c,libtomcrypt-MDEwOlJlcG9zaXRvcnk3NzcwMTE=-flat-omac_process.c,14,16,2,20,22,2
95516,https://htmlpreview.github.io/?https://github.com/Christina96/boilerplate-sample-matches/blob/main/C/libtomcrypt-MDEwOlJlcG9zaXRvcnk3NzcwMTE=-flat-aes.c-xmrig-MDEwOlJlcG9zaXRvcnk4ODMyNzQwNg==-flat-color.h.html,0.09397163120567376,19,libtomcrypt-MDEwOlJlcG9zaXRvcnk3NzcwMTE=-flat-aes.c,xmrig-MDEwOlJlcG9zaXRvcnk4ODMyNzQwNg==-flat-color.h,158,190,32,5,23,18
97306,https://htmlpreview.github.io/?https://github.com/Christina96/boilerplate-sample-matches/blob/main/C/PINRemoteImage-MDEwOlJlcG9zaXRvcnkzOTUzNzEwMw==-flat-ssim.c-PINRemoteImage-MDEwOlJlcG9zaXRvcnkzOTUzNzEwMw==-flat-yuv_sse41.c.html,0.12517385257301808,10,PINRemoteImage-MDEwOlJlcG9zaXRvcnkzOTUzNzEwMw==-flat-ssim.c,PINRemoteImage-MDEwOlJlcG9zaXRvcnkzOTUzNzEwMw==-flat-yuv_sse41.c,56,64,8,298,310,12
98998,https://htmlpreview.github.io/?https://github.com/Christina96/boilerplate-sample-matches/blob/main/C/Adafruit_nRF52_Arduino-MDEwOlJlcG9zaXRvcnk3NDM1NDcyOQ==-flat-nrf_usbd.h-small-MDEwOlJlcG9zaXRvcnkyNTY3NjMxNjk=-flat-auth.c.html,0.06984866123399301,8,Adafruit_nRF52_Arduino-MDEwOlJlcG9zaXRvcnk3NDM1NDcyOQ==-flat-nrf_usbd.h,small-MDEwOlJlcG9zaXRvcnkyNTY3NjMxNjk=-flat-auth.c,608,615,7,340,347,7
99447,https://htmlpreview.github.io/?https://github.com/Christina96/boilerplate-sample-matches/blob/main/C/libtomcrypt-MDEwOlJlcG9zaXRvcnk3NzcwMTE=-flat-bcrypt.c-libtomcrypt-MDEwOlJlcG9zaXRvcnk3NzcwMTE=-flat-xts_test.c.html,0.2047244094488189,8,libtomcrypt-MDEwOlJlcG9zaXRvcnk3NzcwMTE=-flat-bcrypt.c,libtomcrypt-MDEwOlJlcG9zaXRvcnk3NzcwMTE=-flat-xts_test.c,47,49,2,30,31,1
100383,https://htmlpreview.github.io/?https://github.com/Christina96/boilerplate-sample-matches/blob/main/C/Adafruit_nRF52_Arduino-MDEwOlJlcG9zaXRvcnk3NDM1NDcyOQ==-flat-nrf_aar.h-Adafruit_nRF52_Arduino-MDEwOlJlcG9zaXRvcnk3NDM1NDcyOQ==-flat-nrf_egu.h.html,0.3776223776223776,9,Adafruit_nRF52_Arduino-MDEwOlJlcG9zaXRvcnk3NDM1NDcyOQ==-flat-nrf_aar.h,Adafruit_nRF52_Arduino-MDEwOlJlcG9zaXRvcnk3NDM1NDcyOQ==-flat-nrf_egu.h,21,39,18,62,92,30
100879,https://htmlpreview.github.io/?https://github.com/Christina96/boilerplate-sample-matches/blob/main/C/PINRemoteImage-MDEwOlJlcG9zaXRvcnkzOTUzNzEwMw==-flat-cpu.c-android-gpuimage-plus-MDEwOlJlcG9zaXRvcnk0NjU0NzQxNw==-flat-cgeShaderFunctions.h.html,0.04050632911392405,8,PINRemoteImage-MDEwOlJlcG9zaXRvcnkzOTUzNzEwMw==-flat-cpu.c,android-gpuimage-plus-MDEwOlJlcG9zaXRvcnk0NjU0NzQxNw==-flat-cgeShaderFunctions.h,96,98,2,95,99,4
102553,https://htmlpreview.github.io/?https://github.com/Christina96/boilerplate-sample-matches/blob/main/C/libfuse-MDEwOlJlcG9zaXRvcnk0ODI5NjE3Nw==-flat-null.c-libtomcrypt-MDEwOlJlcG9zaXRvcnk3NzcwMTE=-flat-serpent.c.html,0.03827751196172249,8,libfuse-MDEwOlJlcG9zaXRvcnk0ODI5NjE3Nw==-flat-null.c,libtomcrypt-MDEwOlJlcG9zaXRvcnk3NzcwMTE=-flat-serpent.c,79,90,11,623,629,6
104100,https://htmlpreview.github.io/?https://github.com/Christina96/boilerplate-sample-matches/blob/main/C/libtomcrypt-MDEwOlJlcG9zaXRvcnk3NzcwMTE=-flat-noekeon.c-libtomcrypt-MDEwOlJlcG9zaXRvcnk3NzcwMTE=-flat-der_length_teletex_string.c.html,0.08421052631578947,8,libtomcrypt-MDEwOlJlcG9zaXRvcnk3NzcwMTE=-flat-noekeon.c,libtomcrypt-MDEwOlJlcG9zaXRvcnk3NzcwMTE=-flat-der_length_teletex_string.c,200,201,1,127,128,1
104600,https://htmlpreview.github.io/?https://github.com/Christina96/boilerplate-sample-matches/blob/main/C/PINRemoteImage-MDEwOlJlcG9zaXRvcnkzOTUzNzEwMw==-flat-lossless_enc.c-PINRemoteImage-MDEwOlJlcG9zaXRvcnkzOTUzNzEwMw==-flat-vp8l_dec.c.html,0.06362237044638276,10,PINRemoteImage-MDEwOlJlcG9zaXRvcnkzOTUzNzEwMw==-flat-lossless_enc.c,PINRemoteImage-MDEwOlJlcG9zaXRvcnkzOTUzNzEwMw==-flat-vp8l_dec.c,823,830,7,1299,1307,8
107974,https://htmlpreview.github.io/?https://github.com/Christina96/boilerplate-sample-matches/blob/main/C/libtomcrypt-MDEwOlJlcG9zaXRvcnk3NzcwMTE=-flat-cast5.c-libtomcrypt-MDEwOlJlcG9zaXRvcnk3NzcwMTE=-flat-des.c.html,0.32663316582914576,12,libtomcrypt-MDEwOlJlcG9zaXRvcnk3NzcwMTE=-flat-cast5.c,libtomcrypt-MDEwOlJlcG9zaXRvcnk3NzcwMTE=-flat-des.c,481,492,11,1390,1406,16
109784,https://htmlpreview.github.io/?https://github.com/Christina96/boilerplate-sample-matches/blob/main/C/xmrig-MDEwOlJlcG9zaXRvcnk4ODMyNzQwNg==-flat-stack.h-fftw3-MDEwOlJlcG9zaXRvcnk4ODQzMzg4-flat-rdft-dht.c.html,0.05187319884726225,9,xmrig-MDEwOlJlcG9zaXRvcnk4ODMyNzQwNg==-flat-stack.h,fftw3-MDEwOlJlcG9zaXRvcnk4ODQzMzg4-flat-rdft-dht.c,25,34,9,39,51,12
111068,https://htmlpreview.github.io/?https://github.com/Christina96/boilerplate-sample-matches/blob/main/C/PINRemoteImage-MDEwOlJlcG9zaXRvcnkzOTUzNzEwMw==-flat-webpmux.c-redis-MDEwOlJlcG9zaXRvcnkxMDgxMTA3MDY=-flat-ctl.c.html,0.0810657596371882,8,PINRemoteImage-MDEwOlJlcG9zaXRvcnkzOTUzNzEwMw==-flat-webpmux.c,redis-MDEwOlJlcG9zaXRvcnkxMDgxMTA3MDY=-flat-ctl.c,580,583,3,1105,1108,3
111151,https://htmlpreview.github.io/?https://github.com/Christina96/boilerplate-sample-matches/blob/main/C/libtomcrypt-MDEwOlJlcG9zaXRvcnk3NzcwMTE=-flat-blake2s.c-xmrig-MDEwOlJlcG9zaXRvcnk4ODMyNzQwNg==-flat-color.h.html,0.06491228070175438,8,libtomcrypt-MDEwOlJlcG9zaXRvcnk3NzcwMTE=-flat-blake2s.c,xmrig-MDEwOlJlcG9zaXRvcnk4ODMyNzQwNg==-flat-color.h,201,208,7,17,24,7
112799,https://htmlpreview.github.io/?https://github.com/Christina96/boilerplate-sample-matches/blob/main/C/fftw3-MDEwOlJlcG9zaXRvcnk4ODQzMzg4-flat-tensor3.c-redis-MDEwOlJlcG9zaXRvcnkxMDgxMTA3MDY=-flat-mallocx.c.html,0.07048458149779736,8,fftw3-MDEwOlJlcG9zaXRvcnk4ODQzMzg4-flat-tensor3.c,redis-MDEwOlJlcG9zaXRvcnkxMDgxMTA3MDY=-flat-mallocx.c,6,13,7,120,142,22
113341,https://htmlpreview.github.io/?https://github.com/Christina96/boilerplate-sample-matches/blob/main/C/PINRemoteImage-MDEwOlJlcG9zaXRvcnkzOTUzNzEwMw==-flat-decode_45.h-PINRemoteImage-MDEwOlJlcG9zaXRvcnkzOTUzNzEwMw==-flat-encode_44.h.html,0.372960372960373,20,PINRemoteImage-MDEwOlJlcG9zaXRvcnkzOTUzNzEwMw==-flat-decode_45.h,PINRemoteImage-MDEwOlJlcG9zaXRvcnkzOTUzNzEwMw==-flat-encode_44.h,15,27,12,199,212,13
114712,https://htmlpreview.github.io/?https://github.com/Christina96/boilerplate-sample-matches/blob/main/C/PINRemoteImage-MDEwOlJlcG9zaXRvcnkzOTUzNzEwMw==-flat-mux_40.h-PINRemoteImage-MDEwOlJlcG9zaXRvcnkzOTUzNzEwMw==-flat-decode.h.html,0.17307692307692307,11,PINRemoteImage-MDEwOlJlcG9zaXRvcnkzOTUzNzEwMw==-flat-mux_40.h,PINRemoteImage-MDEwOlJlcG9zaXRvcnkzOTUzNzEwMw==-flat-decode.h,5,12,7,5,12,7
115092,https://htmlpreview.github.io/?https://github.com/Christina96/boilerplate-sample-matches/blob/main/C/libtomcrypt-MDEwOlJlcG9zaXRvcnk3NzcwMTE=-flat-ecc_verify_hash.c-libtomcrypt-MDEwOlJlcG9zaXRvcnk3NzcwMTE=-flat-ltc_ecc_projective_add_point.c.html,0.3112391930835735,10,libtomcrypt-MDEwOlJlcG9zaXRvcnk3NzcwMTE=-flat-ecc_verify_hash.c,libtomcrypt-MDEwOlJlcG9zaXRvcnk3NzcwMTE=-flat-ltc_ecc_projective_add_point.c,32,39,7,69,72,3
115141,https://htmlpreview.github.io/?https://github.com/Christina96/boilerplate-sample-matches/blob/main/C/libtomcrypt-MDEwOlJlcG9zaXRvcnk3NzcwMTE=-flat-pkcs12_kdf.c-libtomcrypt-MDEwOlJlcG9zaXRvcnk3NzcwMTE=-flat-timing.c.html,0.039764359351988215,8,libtomcrypt-MDEwOlJlcG9zaXRvcnk3NzcwMTE=-flat-pkcs12_kdf.c,libtomcrypt-MDEwOlJlcG9zaXRvcnk3NzcwMTE=-flat-timing.c,4,6,2,396,397,1
115641,https://htmlpreview.github.io/?https://github.com/Christina96/boilerplate-sample-matches/blob/main/C/PINRemoteImage-MDEwOlJlcG9zaXRvcnkzOTUzNzEwMw==-flat-syntax_enc.c-PINRemoteImage-MDEwOlJlcG9zaXRvcnkzOTUzNzEwMw==-flat-histogram_enc.c.html,0.04400694846554719,9,PINRemoteImage-MDEwOlJlcG9zaXRvcnkzOTUzNzEwMw==-flat-syntax_enc.c,PINRemoteImage-MDEwOlJlcG9zaXRvcnkzOTUzNzEwMw==-flat-histogram_enc.c,152,158,6,404,407,3
116765,https://htmlpreview.github.io/?https://github.com/Christina96/boilerplate-sample-matches/blob/main/C/Adafruit_nRF52_Arduino-MDEwOlJlcG9zaXRvcnk3NDM1NDcyOQ==-flat-nrf_comp.h-xmrig-MDEwOlJlcG9zaXRvcnk4ODMyNzQwNg==-flat-format-inl.h.html,0.013684744044602128,8,Adafruit_nRF52_Arduino-MDEwOlJlcG9zaXRvcnk3NDM1NDcyOQ==-flat-nrf_comp.h,xmrig-MDEwOlJlcG9zaXRvcnk4ODMyNzQwNg==-flat-format-inl.h,33,40,7,2180,2187,7
117845,https://htmlpreview.github.io/?https://github.com/Christina96/boilerplate-sample-matches/blob/main/C/Adafruit_nRF52_Arduino-MDEwOlJlcG9zaXRvcnk3NDM1NDcyOQ==-flat-nrfx_gppi.h-Adafruit_nRF52_Arduino-MDEwOlJlcG9zaXRvcnk3NDM1NDcyOQ==-flat-nrf_uart.h.html,0.24731182795698925,32,Adafruit_nRF52_Arduino-MDEwOlJlcG9zaXRvcnk3NDM1NDcyOQ==-flat-nrfx_gppi.h,Adafruit_nRF52_Arduino-MDEwOlJlcG9zaXRvcnk3NDM1NDcyOQ==-flat-nrf_uart.h,28,61,33,18,47,29
118155,https://htmlpreview.github.io/?https://github.com/Christina96/boilerplate-sample-matches/blob/main/C/redis-MDEwOlJlcG9zaXRvcnkxMDgxMTA3MDY=-flat-Win32_Signal_Process.c-libpcap-MDEwOlJlcG9zaXRvcnk5NDM1ODg3-flat-pcap-snf.c.html,0.03550295857988166,9,redis-MDEwOlJlcG9zaXRvcnkxMDgxMTA3MDY=-flat-Win32_Signal_Process.c,libpcap-MDEwOlJlcG9zaXRvcnk5NDM1ODg3-flat-pcap-snf.c,13,17,4,127,132,5
119104,https://htmlpreview.github.io/?https://github.com/Christina96/boilerplate-sample-matches/blob/main/C/libtomcrypt-MDEwOlJlcG9zaXRvcnk3NzcwMTE=-flat-xtea.c-PINRemoteImage-MDEwOlJlcG9zaXRvcnkzOTUzNzEwMw==-flat-cwebp.c.html,0.01079136690647482,9,libtomcrypt-MDEwOlJlcG9zaXRvcnk3NzcwMTE=-flat-xtea.c,PINRemoteImage-MDEwOlJlcG9zaXRvcnkzOTUzNzEwMw==-flat-cwebp.c,50,58,8,708,713,5
120438,https://htmlpreview.github.io/?https://github.com/Christina96/boilerplate-sample-matches/blob/main/C/PINRemoteImage-MDEwOlJlcG9zaXRvcnkzOTUzNzEwMw==-flat-syntax_enc.c-libtomcrypt-MDEwOlJlcG9zaXRvcnk3NzcwMTE=-flat-tv_gen.c.html,0.015100671140939598,9,PINRemoteImage-MDEwOlJlcG9zaXRvcnkzOTUzNzEwMw==-flat-syntax_enc.c,libtomcrypt-MDEwOlJlcG9zaXRvcnk3NzcwMTE=-flat-tv_gen.c,135,141,6,25,34,9
122287,https://htmlpreview.github.io/?https://github.com/Christina96/boilerplate-sample-matches/blob/main/C/libtomcrypt-MDEwOlJlcG9zaXRvcnk3NzcwMTE=-flat-chacha_ivctr32.c-libtomcrypt-MDEwOlJlcG9zaXRvcnk3NzcwMTE=-flat-crc32.c.html,0.20930232558139536,9,libtomcrypt-MDEwOlJlcG9zaXRvcnk3NzcwMTE=-flat-chacha_ivctr32.c,libtomcrypt-MDEwOlJlcG9zaXRvcnk3NzcwMTE=-flat-crc32.c,3,8,5,128,133,5
123086,https://htmlpreview.github.io/?https://github.com/Christina96/boilerplate-sample-matches/blob/main/C/libpcap-MDEwOlJlcG9zaXRvcnk5NDM1ODg3-flat-sf-pcap.c-PINRemoteImage-MDEwOlJlcG9zaXRvcnkzOTUzNzEwMw==-flat-dec.c.html,0.04964539007092199,8,libpcap-MDEwOlJlcG9zaXRvcnk5NDM1ODg3-flat-sf-pcap.c,PINRemoteImage-MDEwOlJlcG9zaXRvcnkzOTUzNzEwMw==-flat-dec.c,366,372,6,656,663,7
123412,https://htmlpreview.github.io/?https://github.com/Christina96/boilerplate-sample-matches/blob/main/C/PINRemoteImage-MDEwOlJlcG9zaXRvcnkzOTUzNzEwMw==-flat-webp_to_sdl.c-PINRemoteImage-MDEwOlJlcG9zaXRvcnkzOTUzNzEwMw==-flat-alpha_enc.c.html,0.07302231237322515,10,PINRemoteImage-MDEwOlJlcG9zaXRvcnkzOTUzNzEwMw==-flat-webp_to_sdl.c,PINRemoteImage-MDEwOlJlcG9zaXRvcnkzOTUzNzEwMw==-flat-alpha_enc.c,22,31,9,225,232,7
123699,https://htmlpreview.github.io/?https://github.com/Christina96/boilerplate-sample-matches/blob/main/C/fftw3-MDEwOlJlcG9zaXRvcnk4ODQzMzg4-flat-buffered_8.c-PINRemoteImage-MDEwOlJlcG9zaXRvcnkzOTUzNzEwMw==-flat-yuv_sse2.c.html,0.04208754208754209,8,fftw3-MDEwOlJlcG9zaXRvcnk4ODQzMzg4-flat-buffered_8.c,PINRemoteImage-MDEwOlJlcG9zaXRvcnkzOTUzNzEwMw==-flat-yuv_sse2.c,75,78,3,9,13,4
124684,https://htmlpreview.github.io/?https://github.com/Christina96/boilerplate-sample-matches/blob/main/C/Adafruit_nRF52_Arduino-MDEwOlJlcG9zaXRvcnk3NDM1NDcyOQ==-flat-nrf_gpiote.h-Adafruit_nRF52_Arduino-MDEwOlJlcG9zaXRvcnk3NDM1NDcyOQ==-flat-nrf_pwm.h.html,0.578005115089514,34,Adafruit_nRF52_Arduino-MDEwOlJlcG9zaXRvcnk3NDM1NDcyOQ==-flat-nrf_gpiote.h,Adafruit_nRF52_Arduino-MDEwOlJlcG9zaXRvcnk3NDM1NDcyOQ==-flat-nrf_pwm.h,171,220,49,212,261,49
124799,https://htmlpreview.github.io/?https://github.com/Christina96/boilerplate-sample-matches/blob/main/C/redis-MDEwOlJlcG9zaXRvcnkxMDgxMTA3MDY=-flat-slowlog.c-redis-MDEwOlJlcG9zaXRvcnkxMDgxMTA3MDY=-flat-t_list.c.html,0.04755244755244755,8,redis-MDEwOlJlcG9zaXRvcnkxMDgxMTA3MDY=-flat-slowlog.c,redis-MDEwOlJlcG9zaXRvcnkxMDgxMTA3MDY=-flat-t_list.c,9,14,5,134,140,6
124879,https://htmlpreview.github.io/?https://github.com/Christina96/boilerplate-sample-matches/blob/main/C/fftw3-MDEwOlJlcG9zaXRvcnk4ODQzMzg4-flat-rodft00e-r2hc.c-fftw3-MDEwOlJlcG9zaXRvcnk4ODQzMzg4-flat-generic_9.c.html,0.49076517150395776,9,fftw3-MDEwOlJlcG9zaXRvcnk4ODQzMzg4-flat-rodft00e-r2hc.c,fftw3-MDEwOlJlcG9zaXRvcnk4ODQzMzg4-flat-generic_9.c,75,85,10,123,137,14
125137,https://htmlpreview.github.io/?https://github.com/Christina96/boilerplate-sample-matches/blob/main/C/libtomcrypt-MDEwOlJlcG9zaXRvcnk3NzcwMTE=-flat-gcm_gf_mult.c-redis-MDEwOlJlcG9zaXRvcnkxMDgxMTA3MDY=-flat-ph.c.html,0.036036036036036036,8,libtomcrypt-MDEwOlJlcG9zaXRvcnk3NzcwMTE=-flat-gcm_gf_mult.c,redis-MDEwOlJlcG9zaXRvcnkxMDgxMTA3MDY=-flat-ph.c,113,116,3,78,85,7
126703,https://htmlpreview.github.io/?https://github.com/Christina96/boilerplate-sample-matches/blob/main/C/Adafruit_nRF52_Arduino-MDEwOlJlcG9zaXRvcnk3NDM1NDcyOQ==-flat-nrf_saadc.h-xmrig-MDEwOlJlcG9zaXRvcnk4ODMyNzQwNg==-flat-sph_echo.c.html,0.2,10,Adafruit_nRF52_Arduino-MDEwOlJlcG9zaXRvcnk3NDM1NDcyOQ==-flat-nrf_saadc.h,xmrig-MDEwOlJlcG9zaXRvcnk4ODMyNzQwNg==-flat-sph_echo.c,31,40,9,420,430,10
126891,https://htmlpreview.github.io/?https://github.com/Christina96/boilerplate-sample-matches/blob/main/C/libtomcrypt-MDEwOlJlcG9zaXRvcnk3NzcwMTE=-flat-der_encode_raw_bit_string.c-libtomcrypt-MDEwOlJlcG9zaXRvcnk3NzcwMTE=-flat-pkcs_1_oaep_decode.c.html,0.3431372549019608,8,libtomcrypt-MDEwOlJlcG9zaXRvcnk3NzcwMTE=-flat-der_encode_raw_bit_string.c,libtomcrypt-MDEwOlJlcG9zaXRvcnk3NzcwMTE=-flat-pkcs_1_oaep_decode.c,23,28,5,16,21,5
128821,https://htmlpreview.github.io/?https://github.com/Christina96/boilerplate-sample-matches/blob/main/C/fftw3-MDEwOlJlcG9zaXRvcnk4ODQzMzg4-flat-redft00e-r2hc.c-PINRemoteImage-MDEwOlJlcG9zaXRvcnkzOTUzNzEwMw==-flat-lossless_mips_dsp_r2.c.html,0.14713896457765668,9,fftw3-MDEwOlJlcG9zaXRvcnk4ODQzMzg4-flat-redft00e-r2hc.c,PINRemoteImage-MDEwOlJlcG9zaXRvcnkzOTUzNzEwMw==-flat-lossless_mips_dsp_r2.c,91,96,5,165,168,3
129682,https://htmlpreview.github.io/?https://github.com/Christina96/boilerplate-sample-matches/blob/main/C/fftw3-MDEwOlJlcG9zaXRvcnk4ODQzMzg4-flat-testsched.c-redis-MDEwOlJlcG9zaXRvcnkxMDgxMTA3MDY=-flat-t_set.c.html,0.012057272042200452,8,fftw3-MDEwOlJlcG9zaXRvcnk4ODQzMzg4-flat-testsched.c,redis-MDEwOlJlcG9zaXRvcnkxMDgxMTA3MDY=-flat-t_set.c,185,191,6,170,175,5
130164,https://htmlpreview.github.io/?https://github.com/Christina96/boilerplate-sample-matches/blob/main/C/PINRemoteImage-MDEwOlJlcG9zaXRvcnkzOTUzNzEwMw==-flat-extras.c-libtomcrypt-MDEwOlJlcG9zaXRvcnk3NzcwMTE=-flat-aes.c.html,0.06140350877192982,13,PINRemoteImage-MDEwOlJlcG9zaXRvcnkzOTUzNzEwMw==-flat-extras.c,libtomcrypt-MDEwOlJlcG9zaXRvcnk3NzcwMTE=-flat-aes.c,76,89,13,168,198,30
132150,https://htmlpreview.github.io/?https://github.com/Christina96/boilerplate-sample-matches/blob/main/C/xmrig-MDEwOlJlcG9zaXRvcnk4ODMyNzQwNg==-flat-llhttp.h-small-MDEwOlJlcG9zaXRvcnkyNTY3NjMxNjk=-flat-obfs.c.html,0.350253807106599,8,xmrig-MDEwOlJlcG9zaXRvcnk4ODMyNzQwNg==-flat-llhttp.h,small-MDEwOlJlcG9zaXRvcnkyNTY3NjMxNjk=-flat-obfs.c,134,141,7,95,102,7
132979,https://htmlpreview.github.io/?https://github.com/Christina96/boilerplate-sample-matches/blob/main/C/PINRemoteImage-MDEwOlJlcG9zaXRvcnkzOTUzNzEwMw==-flat-yuv.h-PINRemoteImage-MDEwOlJlcG9zaXRvcnkzOTUzNzEwMw==-flat-anim_diff.c.html,0.17845117845117844,16,PINRemoteImage-MDEwOlJlcG9zaXRvcnkzOTUzNzEwMw==-flat-yuv.h,PINRemoteImage-MDEwOlJlcG9zaXRvcnkzOTUzNzEwMw==-flat-anim_diff.c,42,47,5,21,26,5
133008,https://htmlpreview.github.io/?https://github.com/Christina96/boilerplate-sample-matches/blob/main/C/redis-MDEwOlJlcG9zaXRvcnkxMDgxMTA3MDY=-flat-t_stream.c-PINRemoteImage-MDEwOlJlcG9zaXRvcnkzOTUzNzEwMw==-flat-vp8l_dec.c.html,0.05390702274975272,9,redis-MDEwOlJlcG9zaXRvcnkxMDgxMTA3MDY=-flat-t_stream.c,PINRemoteImage-MDEwOlJlcG9zaXRvcnkzOTUzNzEwMw==-flat-vp8l_dec.c,31,37,6,326,332,6
133427,https://htmlpreview.github.io/?https://github.com/Christina96/boilerplate-sample-matches/blob/main/C/libtomcrypt-MDEwOlJlcG9zaXRvcnk3NzcwMTE=-flat-pmac_process.c-libtomcrypt-MDEwOlJlcG9zaXRvcnk3NzcwMTE=-flat-bcrypt.c.html,0.11612903225806452,8,libtomcrypt-MDEwOlJlcG9zaXRvcnk3NzcwMTE=-flat-pmac_process.c,libtomcrypt-MDEwOlJlcG9zaXRvcnk3NzcwMTE=-flat-bcrypt.c,25,28,3,13,16,3
135096,https://htmlpreview.github.io/?https://github.com/Christina96/boilerplate-sample-matches/blob/main/C/PINRemoteImage-MDEwOlJlcG9zaXRvcnkzOTUzNzEwMw==-flat-filters_msa.c-fftw3-MDEwOlJlcG9zaXRvcnk4ODQzMzg4-flat-reodft11e-r2hc.c.html,0.07710843373493977,8,PINRemoteImage-MDEwOlJlcG9zaXRvcnkzOTUzNzEwMw==-flat-filters_msa.c,fftw3-MDEwOlJlcG9zaXRvcnk4ODQzMzg4-flat-reodft11e-r2hc.c,23,31,8,34,42,8
137112,https://htmlpreview.github.io/?https://github.com/Christina96/boilerplate-sample-matches/blob/main/C/redis-MDEwOlJlcG9zaXRvcnkxMDgxMTA3MDY=-flat-prng.c-libtomcrypt-MDEwOlJlcG9zaXRvcnk3NzcwMTE=-flat-lrw_test.c.html,0.1746031746031746,11,redis-MDEwOlJlcG9zaXRvcnkxMDgxMTA3MDY=-flat-prng.c,libtomcrypt-MDEwOlJlcG9zaXRvcnk3NzcwMTE=-flat-lrw_test.c,97,116,19,12,17,5
137401,https://htmlpreview.github.io/?https://github.com/Christina96/boilerplate-sample-matches/blob/main/C/redis-MDEwOlJlcG9zaXRvcnkxMDgxMTA3MDY=-flat-Win32_ANSI.c-libfuse-MDEwOlJlcG9zaXRvcnk0ODI5NjE3Nw==-flat-fuse.c.html,0.022976316719688937,8,redis-MDEwOlJlcG9zaXRvcnkxMDgxMTA3MDY=-flat-Win32_ANSI.c,libfuse-MDEwOlJlcG9zaXRvcnk0ODI5NjE3Nw==-flat-fuse.c,490,498,8,3778,3785,7
137474,https://htmlpreview.github.io/?https://github.com/Christina96/boilerplate-sample-matches/blob/main/C/libpcap-MDEwOlJlcG9zaXRvcnk5NDM1ODg3-flat-sf-pcap.c-libfuse-MDEwOlJlcG9zaXRvcnk0ODI5NjE3Nw==-flat-fuse_lowlevel.c.html,0.033140016570008285,9,libpcap-MDEwOlJlcG9zaXRvcnk5NDM1ODg3-flat-sf-pcap.c,libfuse-MDEwOlJlcG9zaXRvcnk0ODI5NjE3Nw==-flat-fuse_lowlevel.c,309,317,8,1556,1566,10
139868,https://htmlpreview.github.io/?https://github.com/Christina96/boilerplate-sample-matches/blob/main/C/redis-MDEwOlJlcG9zaXRvcnkxMDgxMTA3MDY=-flat-mutex_pool.h-redis-MDEwOlJlcG9zaXRvcnkxMDgxMTA3MDY=-flat-slowlog.c.html,0.0903954802259887,8,redis-MDEwOlJlcG9zaXRvcnkxMDgxMTA3MDY=-flat-mutex_pool.h,redis-MDEwOlJlcG9zaXRvcnkxMDgxMTA3MDY=-flat-slowlog.c,42,47,5,76,81,5
140366,https://htmlpreview.github.io/?https://github.com/Christina96/boilerplate-sample-matches/blob/main/C/xmrig-MDEwOlJlcG9zaXRvcnk4ODMyNzQwNg==-flat-OclLaunchData.h-Adafruit_nRF52_Arduino-MDEwOlJlcG9zaXRvcnk3NDM1NDcyOQ==-flat-nrf_ccm.h.html,0.07920792079207921,8,xmrig-MDEwOlJlcG9zaXRvcnk4ODMyNzQwNg==-flat-OclLaunchData.h,Adafruit_nRF52_Arduino-MDEwOlJlcG9zaXRvcnk3NDM1NDcyOQ==-flat-nrf_ccm.h,16,17,1,64,86,22
140584,https://htmlpreview.github.io/?https://github.com/Christina96/boilerplate-sample-matches/blob/main/C/fftw3-MDEwOlJlcG9zaXRvcnk4ODQzMzg4-flat-tensor5.c-xmrig-MDEwOlJlcG9zaXRvcnk4ODMyNzQwNg==-flat-c_jh.c.html,0.05154639175257732,10,fftw3-MDEwOlJlcG9zaXRvcnk4ODQzMzg4-flat-tensor5.c,xmrig-MDEwOlJlcG9zaXRvcnk4ODMyNzQwNg==-flat-c_jh.c,20,25,5,224,227,3
141996,https://htmlpreview.github.io/?https://github.com/Christina96/boilerplate-sample-matches/blob/main/C/libtomcrypt-MDEwOlJlcG9zaXRvcnk3NzcwMTE=-flat-eax_test.c-libtomcrypt-MDEwOlJlcG9zaXRvcnk3NzcwMTE=-flat-rmd160.c.html,0.05263157894736842,9,libtomcrypt-MDEwOlJlcG9zaXRvcnk3NzcwMTE=-flat-eax_test.c,libtomcrypt-MDEwOlJlcG9zaXRvcnk3NzcwMTE=-flat-rmd160.c,9,23,14,304,309,5
144389,https://htmlpreview.github.io/?https://github.com/Christina96/boilerplate-sample-matches/blob/main/C/Adafruit_nRF52_Arduino-MDEwOlJlcG9zaXRvcnk3NDM1NDcyOQ==-flat-SEGGER_SYSVIEW.c-small-MDEwOlJlcG9zaXRvcnkyNTY3NjMxNjk=-flat-encrypt.c.html,0.05398457583547558,9,Adafruit_nRF52_Arduino-MDEwOlJlcG9zaXRvcnk3NDM1NDcyOQ==-flat-SEGGER_SYSVIEW.c,small-MDEwOlJlcG9zaXRvcnkyNTY3NjMxNjk=-flat-encrypt.c,1136,1142,6,277,283,6
148597,https://htmlpreview.github.io/?https://github.com/Christina96/boilerplate-sample-matches/blob/main/C/libtomcrypt-MDEwOlJlcG9zaXRvcnk3NzcwMTE=-flat-khazad.c-PINRemoteImage-MDEwOlJlcG9zaXRvcnkzOTUzNzEwMw==-flat-lossless_enc.c.html,0.04392523364485981,14,libtomcrypt-MDEwOlJlcG9zaXRvcnk3NzcwMTE=-flat-khazad.c,PINRemoteImage-MDEwOlJlcG9zaXRvcnkzOTUzNzEwMw==-flat-lossless_enc.c,13,13,0,863,876,13
151093,https://htmlpreview.github.io/?https://github.com/Christina96/boilerplate-sample-matches/blob/main/C/libtomcrypt-MDEwOlJlcG9zaXRvcnk3NzcwMTE=-flat-omac_memory.c-libtomcrypt-MDEwOlJlcG9zaXRvcnk3NzcwMTE=-flat-ocb3_encrypt_authenticate_memory.c.html,0.6386554621848739,13,libtomcrypt-MDEwOlJlcG9zaXRvcnk3NzcwMTE=-flat-omac_memory.c,libtomcrypt-MDEwOlJlcG9zaXRvcnk3NzcwMTE=-flat-ocb3_encrypt_authenticate_memory.c,20,27,7,14,21,7
152704,https://htmlpreview.github.io/?https://github.com/Christina96/boilerplate-sample-matches/blob/main/C/xmrig-MDEwOlJlcG9zaXRvcnk4ODMyNzQwNg==-flat-uri.h-xmrig-MDEwOlJlcG9zaXRvcnk4ODMyNzQwNg==-flat-pointer.h.html,0.08427672955974842,11,xmrig-MDEwOlJlcG9zaXRvcnk4ODMyNzQwNg==-flat-uri.h,xmrig-MDEwOlJlcG9zaXRvcnk4ODMyNzQwNg==-flat-pointer.h,18,25,7,33,40,7
153013,https://htmlpreview.github.io/?https://github.com/Christina96/boilerplate-sample-matches/blob/main/C/redis-MDEwOlJlcG9zaXRvcnkxMDgxMTA3MDY=-flat-arena_inlines_b.h-libpcap-MDEwOlJlcG9zaXRvcnk5NDM1ODg3-flat-selpolltest.c.html,0.05492730210016155,8,redis-MDEwOlJlcG9zaXRvcnkxMDgxMTA3MDY=-flat-arena_inlines_b.h,libpcap-MDEwOlJlcG9zaXRvcnk5NDM1ODg3-flat-selpolltest.c,128,135,7,82,89,7
157214,https://htmlpreview.github.io/?https://github.com/Christina96/boilerplate-sample-matches/blob/main/C/redis-MDEwOlJlcG9zaXRvcnkxMDgxMTA3MDY=-flat-decay.c-Adafruit_nRF52_Arduino-MDEwOlJlcG9zaXRvcnk3NDM1NDcyOQ==-flat-bignum.c.html,0.04787812840043525,10,redis-MDEwOlJlcG9zaXRvcnkxMDgxMTA3MDY=-flat-decay.c,Adafruit_nRF52_Arduino-MDEwOlJlcG9zaXRvcnk3NDM1NDcyOQ==-flat-bignum.c,229,245,16,939,948,9
161485,https://htmlpreview.github.io/?https://github.com/Christina96/boilerplate-sample-matches/blob/main/C/PINRemoteImage-MDEwOlJlcG9zaXRvcnkzOTUzNzEwMw==-flat-frame_enc.c-libfuse-MDEwOlJlcG9zaXRvcnk0ODI5NjE3Nw==-flat-fuse_lowlevel.c.html,0.026076260762607627,8,PINRemoteImage-MDEwOlJlcG9zaXRvcnkzOTUzNzEwMw==-flat-frame_enc.c,libfuse-MDEwOlJlcG9zaXRvcnk0ODI5NjE3Nw==-flat-fuse_lowlevel.c,281,288,7,49,55,6
162307,https://htmlpreview.github.io/?https://github.com/Christina96/boilerplate-sample-matches/blob/main/C/fftw3-MDEwOlJlcG9zaXRvcnk4ODQzMzg4-flat-rader.c-small-MDEwOlJlcG9zaXRvcnkyNTY3NjMxNjk=-flat-udprelay.c.html,0.024861878453038673,10,fftw3-MDEwOlJlcG9zaXRvcnk4ODQzMzg4-flat-rader.c,small-MDEwOlJlcG9zaXRvcnkyNTY3NjMxNjk=-flat-udprelay.c,173,183,10,1061,1073,12
162801,https://htmlpreview.github.io/?https://github.com/Christina96/boilerplate-sample-matches/blob/main/C/PINRemoteImage-MDEwOlJlcG9zaXRvcnkzOTUzNzEwMw==-flat-vp8_dec.c-PINRemoteImage-MDEwOlJlcG9zaXRvcnkzOTUzNzEwMw==-flat-vp8l_enc.c.html,0.11893369788106631,10,PINRemoteImage-MDEwOlJlcG9zaXRvcnkzOTUzNzEwMw==-flat-vp8_dec.c,PINRemoteImage-MDEwOlJlcG9zaXRvcnkzOTUzNzEwMw==-flat-vp8l_enc.c,396,403,7,1060,1068,8
164810,https://htmlpreview.github.io/?https://github.com/Christina96/boilerplate-sample-matches/blob/main/C/redis-MDEwOlJlcG9zaXRvcnkxMDgxMTA3MDY=-flat-math.h-PINRemoteImage-MDEwOlJlcG9zaXRvcnkzOTUzNzEwMw==-flat-dec_msa.c.html,0.046255506607929514,12,redis-MDEwOlJlcG9zaXRvcnkxMDgxMTA3MDY=-flat-math.h,PINRemoteImage-MDEwOlJlcG9zaXRvcnkzOTUzNzEwMw==-flat-dec_msa.c,199,213,14,58,77,19
166927,https://htmlpreview.github.io/?https://github.com/Christina96/boilerplate-sample-matches/blob/main/C/libtomcrypt-MDEwOlJlcG9zaXRvcnk3NzcwMTE=-flat-pkcs_1_oaep_encode.c-libtomcrypt-MDEwOlJlcG9zaXRvcnk3NzcwMTE=-flat-hashsum.c.html,0.04054054054054054,9,libtomcrypt-MDEwOlJlcG9zaXRvcnk3NzcwMTE=-flat-pkcs_1_oaep_encode.c,libtomcrypt-MDEwOlJlcG9zaXRvcnk3NzcwMTE=-flat-hashsum.c,64,69,5,77,83,6
167094,https://htmlpreview.github.io/?https://github.com/Christina96/boilerplate-sample-matches/blob/main/C/libtomcrypt-MDEwOlJlcG9zaXRvcnk3NzcwMTE=-flat-ccm_process.c-small-MDEwOlJlcG9zaXRvcnkyNTY3NjMxNjk=-flat-utils.c.html,0.052980132450331126,8,libtomcrypt-MDEwOlJlcG9zaXRvcnk3NzcwMTE=-flat-ccm_process.c,small-MDEwOlJlcG9zaXRvcnkyNTY3NjMxNjk=-flat-utils.c,12,17,5,87,96,9
167430,https://htmlpreview.github.io/?https://github.com/Christina96/boilerplate-sample-matches/blob/main/C/fftw3-MDEwOlJlcG9zaXRvcnk4ODQzMzg4-flat-rader.c-PINRemoteImage-MDEwOlJlcG9zaXRvcnkzOTUzNzEwMw==-flat-anim_encode.c.html,0.07504078303425775,9,fftw3-MDEwOlJlcG9zaXRvcnk4ODQzMzg4-flat-rader.c,PINRemoteImage-MDEwOlJlcG9zaXRvcnkzOTUzNzEwMw==-flat-anim_encode.c,154,171,17,1243,1248,5
167640,https://htmlpreview.github.io/?https://github.com/Christina96/boilerplate-sample-matches/blob/main/C/redis-MDEwOlJlcG9zaXRvcnkxMDgxMTA3MDY=-flat-siphash.c-PINRemoteImage-MDEwOlJlcG9zaXRvcnkzOTUzNzEwMw==-flat-lossless_enc.c.html,0.14611447184737086,8,redis-MDEwOlJlcG9zaXRvcnkxMDgxMTA3MDY=-flat-siphash.c,PINRemoteImage-MDEwOlJlcG9zaXRvcnkzOTUzNzEwMw==-flat-lossless_enc.c,60,70,10,779,789,10
170219,https://htmlpreview.github.io/?https://github.com/Christina96/boilerplate-sample-matches/blob/main/C/small-MDEwOlJlcG9zaXRvcnkyNTY3NjMxNjk=-flat-list.c-redis-MDEwOlJlcG9zaXRvcnkxMDgxMTA3MDY=-flat-win32_wsiocp.c.html,0.07344632768361582,8,small-MDEwOlJlcG9zaXRvcnkyNTY3NjMxNjk=-flat-list.c,redis-MDEwOlJlcG9zaXRvcnkxMDgxMTA3MDY=-flat-win32_wsiocp.c,39,46,7,98,108,10
171253,https://htmlpreview.github.io/?https://github.com/Christina96/boilerplate-sample-matches/blob/main/C/fftw3-MDEwOlJlcG9zaXRvcnk4ODQzMzg4-flat-buffered2.c-PINRemoteImage-MDEwOlJlcG9zaXRvcnkzOTUzNzEwMw==-flat-frame_enc.c.html,0.029298380878951428,10,fftw3-MDEwOlJlcG9zaXRvcnk4ODQzMzg4-flat-buffered2.c,PINRemoteImage-MDEwOlJlcG9zaXRvcnkzOTUzNzEwMw==-flat-frame_enc.c,78,81,3,20,23,3
172255,https://htmlpreview.github.io/?https://github.com/Christina96/boilerplate-sample-matches/blob/main/C/fftw3-MDEwOlJlcG9zaXRvcnk4ODQzMzg4-flat-dftw-generic.c-redis-MDEwOlJlcG9zaXRvcnkxMDgxMTA3MDY=-flat-zmalloc.c.html,0.08830022075055188,8,fftw3-MDEwOlJlcG9zaXRvcnk4ODQzMzg4-flat-dftw-generic.c,redis-MDEwOlJlcG9zaXRvcnkxMDgxMTA3MDY=-flat-zmalloc.c,28,35,7,304,306,2
172723,https://htmlpreview.github.io/?https://github.com/Christina96/boilerplate-sample-matches/blob/main/C/libtomcrypt-MDEwOlJlcG9zaXRvcnk3NzcwMTE=-flat-sha224.c-xmrig-MDEwOlJlcG9zaXRvcnk4ODMyNzQwNg==-flat-keccakf800.c.html,0.0706713780918728,10,libtomcrypt-MDEwOlJlcG9zaXRvcnk3NzcwMTE=-flat-sha224.c,xmrig-MDEwOlJlcG9zaXRvcnk4ODMyNzQwNg==-flat-keccakf800.c,20,29,9,45,54,9
174024,https://htmlpreview.github.io/?https://github.com/Christina96/boilerplate-sample-matches/blob/main/C/PINRemoteImage-MDEwOlJlcG9zaXRvcnkzOTUzNzEwMw==-flat-lossless_enc_mips_dsp_r2.c-fftw3-MDEwOlJlcG9zaXRvcnk4ODQzMzg4-flat-hc2hc-direct.c.html,0.14673913043478262,10,PINRemoteImage-MDEwOlJlcG9zaXRvcnkzOTUzNzEwMw==-flat-lossless_enc_mips_dsp_r2.c,fftw3-MDEwOlJlcG9zaXRvcnk4ODQzMzg4-flat-hc2hc-direct.c,150,158,8,122,128,6
174400,https://htmlpreview.github.io/?https://github.com/Christina96/boilerplate-sample-matches/blob/main/C/redis-MDEwOlJlcG9zaXRvcnkxMDgxMTA3MDY=-flat-geohash_helper.c-PINRemoteImage-MDEwOlJlcG9zaXRvcnkzOTUzNzEwMw==-flat-anim_decode.c.html,0.078003120124805,8,redis-MDEwOlJlcG9zaXRvcnkxMDgxMTA3MDY=-flat-geohash_helper.c,PINRemoteImage-MDEwOlJlcG9zaXRvcnkzOTUzNzEwMw==-flat-anim_decode.c,111,113,2,112,116,4
175260,https://htmlpreview.github.io/?https://github.com/Christina96/boilerplate-sample-matches/blob/main/C/Adafruit_nRF52_Arduino-MDEwOlJlcG9zaXRvcnk3NDM1NDcyOQ==-flat-srp.c-xmrig-MDEwOlJlcG9zaXRvcnk4ODMyNzQwNg==-flat-sph_luffa.c.html,0.08061420345489444,13,Adafruit_nRF52_Arduino-MDEwOlJlcG9zaXRvcnk3NDM1NDcyOQ==-flat-srp.c,xmrig-MDEwOlJlcG9zaXRvcnk4ODMyNzQwNg==-flat-sph_luffa.c,32,49,17,42,54,12
178474,https://htmlpreview.github.io/?https://github.com/Christina96/boilerplate-sample-matches/blob/main/C/libtomcrypt-MDEwOlJlcG9zaXRvcnk3NzcwMTE=-flat-hmac_process.c-libtomcrypt-MDEwOlJlcG9zaXRvcnk3NzcwMTE=-flat-der_encode_bit_string.c.html,0.1927710843373494,8,libtomcrypt-MDEwOlJlcG9zaXRvcnk3NzcwMTE=-flat-hmac_process.c,libtomcrypt-MDEwOlJlcG9zaXRvcnk3NzcwMTE=-flat-der_encode_bit_string.c,5,10,5,9,14,5
179483,https://htmlpreview.github.io/?https://github.com/Christina96/boilerplate-sample-matches/blob/main/C/fftw3-MDEwOlJlcG9zaXRvcnk4ODQzMzg4-flat-cpy2d.c-PINRemoteImage-MDEwOlJlcG9zaXRvcnkzOTUzNzEwMw==-flat-yuv.c.html,0.09542743538767395,8,fftw3-MDEwOlJlcG9zaXRvcnk4ODQzMzg4-flat-cpy2d.c,PINRemoteImage-MDEwOlJlcG9zaXRvcnkzOTUzNzEwMw==-flat-yuv.c,129,136,7,51,58,7
179687,https://htmlpreview.github.io/?https://github.com/Christina96/boilerplate-sample-matches/blob/main/C/libfuse-MDEwOlJlcG9zaXRvcnk0ODI5NjE3Nw==-flat-mount_util.h-fftw3-MDEwOlJlcG9zaXRvcnk4ODQzMzg4-flat-rdft2-pad.c.html,0.23880597014925373,8,libfuse-MDEwOlJlcG9zaXRvcnk0ODI5NjE3Nw==-flat-mount_util.h,fftw3-MDEwOlJlcG9zaXRvcnk4ODQzMzg4-flat-rdft2-pad.c,3,5,2,3,4,1
180158,https://htmlpreview.github.io/?https://github.com/Christina96/boilerplate-sample-matches/blob/main/C/fftw3-MDEwOlJlcG9zaXRvcnk4ODQzMzg4-flat-dft-problem.c-redis-MDEwOlJlcG9zaXRvcnkxMDgxMTA3MDY=-flat-ziplist.c.html,0.018702513150204558,8,fftw3-MDEwOlJlcG9zaXRvcnk4ODQzMzg4-flat-dft-problem.c,redis-MDEwOlJlcG9zaXRvcnkxMDgxMTA3MDY=-flat-ziplist.c,74,80,6,445,451,6
180259,https://htmlpreview.github.io/?https://github.com/Christina96/boilerplate-sample-matches/blob/main/C/libfuse-MDEwOlJlcG9zaXRvcnk0ODI5NjE3Nw==-flat-notify_store_retrieve.c-redis-MDEwOlJlcG9zaXRvcnkxMDgxMTA3MDY=-flat-Win32_ANSI.c.html,0.06779661016949153,13,libfuse-MDEwOlJlcG9zaXRvcnk0ODI5NjE3Nw==-flat-notify_store_retrieve.c,redis-MDEwOlJlcG9zaXRvcnkxMDgxMTA3MDY=-flat-Win32_ANSI.c,37,46,9,574,582,8
181183,https://htmlpreview.github.io/?https://github.com/Christina96/boilerplate-sample-matches/blob/main/C/libtomcrypt-MDEwOlJlcG9zaXRvcnk3NzcwMTE=-flat-ecc_decrypt_key.c-PINRemoteImage-MDEwOlJlcG9zaXRvcnkzOTUzNzEwMw==-flat-alpha_enc.c.html,0.03345724907063197,9,libtomcrypt-MDEwOlJlcG9zaXRvcnk3NzcwMTE=-flat-ecc_decrypt_key.c,PINRemoteImage-MDEwOlJlcG9zaXRvcnkzOTUzNzEwMw==-flat-alpha_enc.c,10,19,9,217,224,7
181531,https://htmlpreview.github.io/?https://github.com/Christina96/boilerplate-sample-matches/blob/main/C/libfuse-MDEwOlJlcG9zaXRvcnk0ODI5NjE3Nw==-flat-passthrough_helpers.h-libfuse-MDEwOlJlcG9zaXRvcnk0ODI5NjE3Nw==-flat-passthrough.c.html,0.0274442538593482,8,libfuse-MDEwOlJlcG9zaXRvcnk0ODI5NjE3Nw==-flat-passthrough_helpers.h,libfuse-MDEwOlJlcG9zaXRvcnk0ODI5NjE3Nw==-flat-passthrough.c,1,4,3,286,289,3
182759,https://htmlpreview.github.io/?https://github.com/Christina96/boilerplate-sample-matches/blob/main/C/fftw3-MDEwOlJlcG9zaXRvcnk4ODQzMzg4-flat-simd-avx2-128.h-fftw3-MDEwOlJlcG9zaXRvcnk4ODQzMzg4-flat-dft-vrank-geq1.c.html,0.047244094488188976,9,fftw3-MDEwOlJlcG9zaXRvcnk4ODQzMzg4-flat-simd-avx2-128.h,fftw3-MDEwOlJlcG9zaXRvcnk4ODQzMzg4-flat-dft-vrank-geq1.c,188,194,6,32,39,7
186514,https://htmlpreview.github.io/?https://github.com/Christina96/boilerplate-sample-matches/blob/main/C/libtomcrypt-MDEwOlJlcG9zaXRvcnk3NzcwMTE=-flat-base32_encode.c-PINRemoteImage-MDEwOlJlcG9zaXRvcnkzOTUzNzEwMw==-flat-histogram_enc.c.html,0.01092896174863388,8,libtomcrypt-MDEwOlJlcG9zaXRvcnk3NzcwMTE=-flat-base32_encode.c,PINRemoteImage-MDEwOlJlcG9zaXRvcnkzOTUzNzEwMw==-flat-histogram_enc.c,52,56,4,848,854,6
186573,https://htmlpreview.github.io/?https://github.com/Christina96/boilerplate-sample-matches/blob/main/C/xmrig-MDEwOlJlcG9zaXRvcnk4ODMyNzQwNg==-flat-Config_platform.h-libtomcrypt-MDEwOlJlcG9zaXRvcnk3NzcwMTE=-flat-oaep-vect.c.html,0.3329907502569373,16,xmrig-MDEwOlJlcG9zaXRvcnk4ODMyNzQwNg==-flat-Config_platform.h,libtomcrypt-MDEwOlJlcG9zaXRvcnk3NzcwMTE=-flat-oaep-vect.c,80,91,11,979,1000,21
187364,https://htmlpreview.github.io/?https://github.com/Christina96/boilerplate-sample-matches/blob/main/C/libtomcrypt-MDEwOlJlcG9zaXRvcnk3NzcwMTE=-flat-md2.c-libtomcrypt-MDEwOlJlcG9zaXRvcnk3NzcwMTE=-flat-timing.c.html,0.011339475549255847,8,libtomcrypt-MDEwOlJlcG9zaXRvcnk3NzcwMTE=-flat-md2.c,libtomcrypt-MDEwOlJlcG9zaXRvcnk3NzcwMTE=-flat-timing.c,80,89,9,1186,1196,10
189120,https://htmlpreview.github.io/?https://github.com/Christina96/boilerplate-sample-matches/blob/main/C/fftw3-MDEwOlJlcG9zaXRvcnk4ODQzMzg4-flat-direct-r2c.c-redis-MDEwOlJlcG9zaXRvcnkxMDgxMTA3MDY=-flat-object.c.html,0.01019108280254777,8,fftw3-MDEwOlJlcG9zaXRvcnk4ODQzMzg4-flat-direct-r2c.c,redis-MDEwOlJlcG9zaXRvcnkxMDgxMTA3MDY=-flat-object.c,39,57,18,175,181,6
189926,https://htmlpreview.github.io/?https://github.com/Christina96/boilerplate-sample-matches/blob/main/C/xmrig-MDEwOlJlcG9zaXRvcnk4ODMyNzQwNg==-flat-aes_helper.c-xmrig-MDEwOlJlcG9zaXRvcnk4ODMyNzQwNg==-flat-sph_fugue.c.html,0.1588447653429603,22,xmrig-MDEwOlJlcG9zaXRvcnk4ODMyNzQwNg==-flat-aes_helper.c,xmrig-MDEwOlJlcG9zaXRvcnk4ODMyNzQwNg==-flat-sph_fugue.c,3,324,321,5,34,29
191436,https://htmlpreview.github.io/?https://github.com/Christina96/boilerplate-sample-matches/blob/main/C/libtomcrypt-MDEwOlJlcG9zaXRvcnk3NzcwMTE=-flat-khazad.c-libtomcrypt-MDEwOlJlcG9zaXRvcnk3NzcwMTE=-flat-safer.c.html,0.20436507936507936,9,libtomcrypt-MDEwOlJlcG9zaXRvcnk3NzcwMTE=-flat-khazad.c,libtomcrypt-MDEwOlJlcG9zaXRvcnk3NzcwMTE=-flat-safer.c,554,557,3,144,147,3
193372,https://htmlpreview.github.io/?https://github.com/Christina96/boilerplate-sample-matches/blob/main/C/libtomcrypt-MDEwOlJlcG9zaXRvcnk3NzcwMTE=-flat-ccm_test.c-PINRemoteImage-MDEwOlJlcG9zaXRvcnkzOTUzNzEwMw==-flat-cwebp.c.html,0.022054556006964595,8,libtomcrypt-MDEwOlJlcG9zaXRvcnk3NzcwMTE=-flat-ccm_test.c,PINRemoteImage-MDEwOlJlcG9zaXRvcnkzOTUzNzEwMw==-flat-cwebp.c,38,47,9,982,986,4
195498,https://htmlpreview.github.io/?https://github.com/Christina96/boilerplate-sample-matches/blob/main/C/xmrig-MDEwOlJlcG9zaXRvcnk4ODMyNzQwNg==-flat-stack.h-Adafruit_nRF52_Arduino-MDEwOlJlcG9zaXRvcnk3NDM1NDcyOQ==-flat-nrf_pwm.h.html,0.04712041884816754,9,xmrig-MDEwOlJlcG9zaXRvcnk4ODMyNzQwNg==-flat-stack.h,Adafruit_nRF52_Arduino-MDEwOlJlcG9zaXRvcnk3NDM1NDcyOQ==-flat-nrf_pwm.h,40,49,9,51,59,8
195512,https://htmlpreview.github.io/?https://github.com/Christina96/boilerplate-sample-matches/blob/main/C/PINRemoteImage-MDEwOlJlcG9zaXRvcnkzOTUzNzEwMw==-flat-vp8_dec.c-redis-MDEwOlJlcG9zaXRvcnkxMDgxMTA3MDY=-flat-ctl.c.html,0.06147418680990749,8,PINRemoteImage-MDEwOlJlcG9zaXRvcnkzOTUzNzEwMw==-flat-vp8_dec.c,redis-MDEwOlJlcG9zaXRvcnkxMDgxMTA3MDY=-flat-ctl.c,271,278,7,813,822,9
197906,https://htmlpreview.github.io/?https://github.com/Christina96/boilerplate-sample-matches/blob/main/C/Adafruit_nRF52_Arduino-MDEwOlJlcG9zaXRvcnk3NDM1NDcyOQ==-flat-flash_nrf5x.c-redis-MDEwOlJlcG9zaXRvcnkxMDgxMTA3MDY=-flat-junk.c.html,0.08791208791208792,8,Adafruit_nRF52_Arduino-MDEwOlJlcG9zaXRvcnk3NDM1NDcyOQ==-flat-flash_nrf5x.c,redis-MDEwOlJlcG9zaXRvcnkxMDgxMTA3MDY=-flat-junk.c,24,31,7,50,57,7
198055,https://htmlpreview.github.io/?https://github.com/Christina96/boilerplate-sample-matches/blob/main/C/redis-MDEwOlJlcG9zaXRvcnkxMDgxMTA3MDY=-flat-Win32_PThread.c-PINRemoteImage-MDEwOlJlcG9zaXRvcnkzOTUzNzEwMw==-flat-libwebp_java_wrap.c.html,0.01935116676152533,8,redis-MDEwOlJlcG9zaXRvcnkxMDgxMTA3MDY=-flat-Win32_PThread.c,PINRemoteImage-MDEwOlJlcG9zaXRvcnkzOTUzNzEwMw==-flat-libwebp_java_wrap.c,125,132,7,401,407,6
198703,https://htmlpreview.github.io/?https://github.com/Christina96/boilerplate-sample-matches/blob/main/C/xmrig-MDEwOlJlcG9zaXRvcnk4ODMyNzQwNg==-flat-biginteger.h-libtomcrypt-MDEwOlJlcG9zaXRvcnk3NzcwMTE=-flat-safer.c.html,0.04178537511870845,14,xmrig-MDEwOlJlcG9zaXRvcnk4ODMyNzQwNg==-flat-biginteger.h,libtomcrypt-MDEwOlJlcG9zaXRvcnk3NzcwMTE=-flat-safer.c,207,215,8,249,254,5
204115,https://htmlpreview.github.io/?https://github.com/Christina96/boilerplate-sample-matches/blob/main/C/fftw3-MDEwOlJlcG9zaXRvcnk4ODQzMzg4-flat-rodft00e-r2hc.c-small-MDEwOlJlcG9zaXRvcnkyNTY3NjMxNjk=-flat-server.c.html,0.015525114155251141,8,fftw3-MDEwOlJlcG9zaXRvcnk4ODQzMzg4-flat-rodft00e-r2hc.c,small-MDEwOlJlcG9zaXRvcnkyNTY3NjMxNjk=-flat-server.c,45,51,6,1591,1596,5
204433,https://htmlpreview.github.io/?https://github.com/Christina96/boilerplate-sample-matches/blob/main/C/Adafruit_nRF52_Arduino-MDEwOlJlcG9zaXRvcnk3NDM1NDcyOQ==-flat-nrf_regulators.h-PINRemoteImage-MDEwOlJlcG9zaXRvcnkzOTUzNzEwMw==-flat-extras.c.html,0.14705882352941177,11,Adafruit_nRF52_Arduino-MDEwOlJlcG9zaXRvcnk3NDM1NDcyOQ==-flat-nrf_regulators.h,PINRemoteImage-MDEwOlJlcG9zaXRvcnkzOTUzNzEwMw==-flat-extras.c,42,52,10,76,87,11
205335,https://htmlpreview.github.io/?https://github.com/Christina96/boilerplate-sample-matches/blob/main/C/xmrig-MDEwOlJlcG9zaXRvcnk4ODMyNzQwNg==-flat-argon2_6.h-libtomcrypt-MDEwOlJlcG9zaXRvcnk3NzcwMTE=-flat-tiger.c.html,0.0845771144278607,17,xmrig-MDEwOlJlcG9zaXRvcnk4ODMyNzQwNg==-flat-argon2_6.h,libtomcrypt-MDEwOlJlcG9zaXRvcnk3NzcwMTE=-flat-tiger.c,39,55,16,558,574,16
206760,https://htmlpreview.github.io/?https://github.com/Christina96/boilerplate-sample-matches/blob/main/C/libtomcrypt-MDEwOlJlcG9zaXRvcnk3NzcwMTE=-flat-chacha_setup.c-libtomcrypt-MDEwOlJlcG9zaXRvcnk3NzcwMTE=-flat-dsa_set.c.html,0.10256410256410256,8,libtomcrypt-MDEwOlJlcG9zaXRvcnk3NzcwMTE=-flat-chacha_setup.c,libtomcrypt-MDEwOlJlcG9zaXRvcnk3NzcwMTE=-flat-dsa_set.c,5,6,1,30,31,1
206918,https://htmlpreview.github.io/?https://github.com/Christina96/boilerplate-sample-matches/blob/main/C/libtomcrypt-MDEwOlJlcG9zaXRvcnk3NzcwMTE=-flat-yarrow.c-PINRemoteImage-MDEwOlJlcG9zaXRvcnkzOTUzNzEwMw==-flat-iterator_enc.c.html,0.08238636363636363,11,libtomcrypt-MDEwOlJlcG9zaXRvcnk3NzcwMTE=-flat-yarrow.c,PINRemoteImage-MDEwOlJlcG9zaXRvcnkzOTUzNzEwMw==-flat-iterator_enc.c,65,85,20,50,60,10
207129,https://htmlpreview.github.io/?https://github.com/Christina96/boilerplate-sample-matches/blob/main/C/libtomcrypt-MDEwOlJlcG9zaXRvcnk3NzcwMTE=-flat-hmac_memory.c-libtomcrypt-MDEwOlJlcG9zaXRvcnk3NzcwMTE=-flat-ccm_memory.c.html,0.14042553191489363,8,libtomcrypt-MDEwOlJlcG9zaXRvcnk3NzcwMTE=-flat-hmac_memory.c,libtomcrypt-MDEwOlJlcG9zaXRvcnk3NzcwMTE=-flat-ccm_memory.c,14,19,5,41,54,13
207227,https://htmlpreview.github.io/?https://github.com/Christina96/boilerplate-sample-matches/blob/main/C/Adafruit_nRF52_Arduino-MDEwOlJlcG9zaXRvcnk3NDM1NDcyOQ==-flat-SEGGER_RTT.c-xmrig-MDEwOlJlcG9zaXRvcnk4ODMyNzQwNg==-flat-sse2neon.h.html,0.01649746192893401,8,Adafruit_nRF52_Arduino-MDEwOlJlcG9zaXRvcnk3NDM1NDcyOQ==-flat-SEGGER_RTT.c,xmrig-MDEwOlJlcG9zaXRvcnk4ODMyNzQwNg==-flat-sse2neon.h,260,267,7,4648,4660,12
207746,https://htmlpreview.github.io/?https://github.com/Christina96/boilerplate-sample-matches/blob/main/C/small-MDEwOlJlcG9zaXRvcnkyNTY3NjMxNjk=-flat-verify.c-fftw3-MDEwOlJlcG9zaXRvcnk4ODQzMzg4-flat-f77funcs_20.h.html,0.07796101949025487,9,small-MDEwOlJlcG9zaXRvcnkyNTY3NjMxNjk=-flat-verify.c,fftw3-MDEwOlJlcG9zaXRvcnk4ODQzMzg4-flat-f77funcs_20.h,102,104,2,170,175,5
208052,https://htmlpreview.github.io/?https://github.com/Christina96/boilerplate-sample-matches/blob/main/C/fftw3-MDEwOlJlcG9zaXRvcnk4ODQzMzg4-flat-caset.c-redis-MDEwOlJlcG9zaXRvcnkxMDgxMTA3MDY=-flat-prng.c.html,0.11851851851851852,8,fftw3-MDEwOlJlcG9zaXRvcnk4ODQzMzg4-flat-caset.c,redis-MDEwOlJlcG9zaXRvcnkxMDgxMTA3MDY=-flat-prng.c,5,9,4,55,64,9
208373,https://htmlpreview.github.io/?https://github.com/Christina96/boilerplate-sample-matches/blob/main/C/xmrig-MDEwOlJlcG9zaXRvcnk4ODMyNzQwNg==-flat-core.h-android-gpuimage-plus-MDEwOlJlcG9zaXRvcnk0NjU0NzQxNw==-flat-swscale.h.html,0.1360544217687075,10,xmrig-MDEwOlJlcG9zaXRvcnk4ODMyNzQwNg==-flat-core.h,android-gpuimage-plus-MDEwOlJlcG9zaXRvcnk0NjU0NzQxNw==-flat-swscale.h,24,43,19,42,51,9
208825,https://htmlpreview.github.io/?https://github.com/Christina96/boilerplate-sample-matches/blob/main/C/PINRemoteImage-MDEwOlJlcG9zaXRvcnkzOTUzNzEwMw==-flat-rescaler_utils.c-redis-MDEwOlJlcG9zaXRvcnkxMDgxMTA3MDY=-flat-dict_27.c.html,0.030977734753146177,8,PINRemoteImage-MDEwOlJlcG9zaXRvcnkzOTUzNzEwMw==-flat-rescaler_utils.c,redis-MDEwOlJlcG9zaXRvcnkxMDgxMTA3MDY=-flat-dict_27.c,54,59,5,685,689,4
208985,https://htmlpreview.github.io/?https://github.com/Christina96/boilerplate-sample-matches/blob/main/C/redis-MDEwOlJlcG9zaXRvcnkxMDgxMTA3MDY=-flat-ph.c-PINRemoteImage-MDEwOlJlcG9zaXRvcnkzOTUzNzEwMw==-flat-image_enc.c.html,0.023835319609967497,11,redis-MDEwOlJlcG9zaXRvcnkxMDgxMTA3MDY=-flat-ph.c,PINRemoteImage-MDEwOlJlcG9zaXRvcnkzOTUzNzEwMw==-flat-image_enc.c,165,169,4,421,425,4
209294,https://htmlpreview.github.io/?https://github.com/Christina96/boilerplate-sample-matches/blob/main/C/libtomcrypt-MDEwOlJlcG9zaXRvcnk3NzcwMTE=-flat-des.c-redis-MDEwOlJlcG9zaXRvcnkxMDgxMTA3MDY=-flat-jemalloc.c.html,0.06345848757271286,8,libtomcrypt-MDEwOlJlcG9zaXRvcnk3NzcwMTE=-flat-des.c,redis-MDEwOlJlcG9zaXRvcnkxMDgxMTA3MDY=-flat-jemalloc.c,1353,1361,8,1434,1441,7
211001,https://htmlpreview.github.io/?https://github.com/Christina96/boilerplate-sample-matches/blob/main/C/fftw3-MDEwOlJlcG9zaXRvcnk4ODQzMzg4-flat-rdft-rank1-bigvec.c-fftw3-MDEwOlJlcG9zaXRvcnk4ODQzMzg4-flat-transpose-alltoall.c.html,0.5031446540880503,16,fftw3-MDEwOlJlcG9zaXRvcnk4ODQzMzg4-flat-rdft-rank1-bigvec.c,fftw3-MDEwOlJlcG9zaXRvcnk4ODQzMzg4-flat-transpose-alltoall.c,46,63,17,74,95,21
211682,https://htmlpreview.github.io/?https://github.com/Christina96/boilerplate-sample-matches/blob/main/C/PINRemoteImage-MDEwOlJlcG9zaXRvcnkzOTUzNzEwMw==-flat-decode_39.h-libfuse-MDEwOlJlcG9zaXRvcnk0ODI5NjE3Nw==-flat-hello_ll.c.html,0.04390243902439024,9,PINRemoteImage-MDEwOlJlcG9zaXRvcnkzOTUzNzEwMw==-flat-decode_39.h,libfuse-MDEwOlJlcG9zaXRvcnk0ODI5NjE3Nw==-flat-hello_ll.c,52,57,5,159,167,8
212340,https://htmlpreview.github.io/?https://github.com/Christina96/boilerplate-sample-matches/blob/main/C/fftw3-MDEwOlJlcG9zaXRvcnk4ODQzMzg4-flat-transpose-alltoall.c-libtomcrypt-MDEwOlJlcG9zaXRvcnk3NzcwMTE=-flat-tiger.c.html,0.041237113402061855,8,fftw3-MDEwOlJlcG9zaXRvcnk4ODQzMzg4-flat-transpose-alltoall.c,libtomcrypt-MDEwOlJlcG9zaXRvcnk3NzcwMTE=-flat-tiger.c,147,155,8,559,566,7
214912,https://htmlpreview.github.io/?https://github.com/Christina96/boilerplate-sample-matches/blob/main/C/redis-MDEwOlJlcG9zaXRvcnkxMDgxMTA3MDY=-flat-dlfcn.c-PINRemoteImage-MDEwOlJlcG9zaXRvcnkzOTUzNzEwMw==-flat-webp_enc.c.html,0.024024024024024024,8,redis-MDEwOlJlcG9zaXRvcnkxMDgxMTA3MDY=-flat-dlfcn.c,PINRemoteImage-MDEwOlJlcG9zaXRvcnkzOTUzNzEwMw==-flat-webp_enc.c,281,287,6,122,127,5
215309,https://htmlpreview.github.io/?https://github.com/Christina96/boilerplate-sample-matches/blob/main/C/libfuse-MDEwOlJlcG9zaXRvcnk0ODI5NjE3Nw==-flat-passthrough.c-libfuse-MDEwOlJlcG9zaXRvcnk0ODI5NjE3Nw==-flat-subdir.c.html,0.3490909090909091,9,libfuse-MDEwOlJlcG9zaXRvcnk0ODI5NjE3Nw==-flat-passthrough.c,libfuse-MDEwOlJlcG9zaXRvcnk0ODI5NjE3Nw==-flat-subdir.c,132,135,3,230,233,3
215612,https://htmlpreview.github.io/?https://github.com/Christina96/boilerplate-sample-matches/blob/main/C/libtomcrypt-MDEwOlJlcG9zaXRvcnk3NzcwMTE=-flat-ecc_shared_secret.c-libtomcrypt-MDEwOlJlcG9zaXRvcnk3NzcwMTE=-flat-pkcs_5_2.c.html,0.2111801242236025,8,libtomcrypt-MDEwOlJlcG9zaXRvcnk3NzcwMTE=-flat-ecc_shared_secret.c,libtomcrypt-MDEwOlJlcG9zaXRvcnk3NzcwMTE=-flat-pkcs_5_2.c,28,32,4,46,51,5
216176,https://htmlpreview.github.io/?https://github.com/Christina96/boilerplate-sample-matches/blob/main/C/fftw3-MDEwOlJlcG9zaXRvcnk4ODQzMzg4-flat-transpose-recurse.c-fftw3-MDEwOlJlcG9zaXRvcnk4ODQzMzg4-flat-rdft2-rdft.c.html,0.1510204081632653,8,fftw3-MDEwOlJlcG9zaXRvcnk4ODQzMzg4-flat-transpose-recurse.c,fftw3-MDEwOlJlcG9zaXRvcnk4ODQzMzg4-flat-rdft2-rdft.c,15,20,5,35,39,4
216468,https://htmlpreview.github.io/?https://github.com/Christina96/boilerplate-sample-matches/blob/main/C/libtomcrypt-MDEwOlJlcG9zaXRvcnk3NzcwMTE=-flat-der_decode_bit_string.c-libtomcrypt-MDEwOlJlcG9zaXRvcnk3NzcwMTE=-flat-xts_encrypt.c.html,0.09615384615384616,10,libtomcrypt-MDEwOlJlcG9zaXRvcnk3NzcwMTE=-flat-der_decode_bit_string.c,libtomcrypt-MDEwOlJlcG9zaXRvcnk3NzcwMTE=-flat-xts_encrypt.c,3,4,1,31,31,0
217926,https://htmlpreview.github.io/?https://github.com/Christina96/boilerplate-sample-matches/blob/main/C/redis-MDEwOlJlcG9zaXRvcnkxMDgxMTA3MDY=-flat-extent_dss.c-PINRemoteImage-MDEwOlJlcG9zaXRvcnkzOTUzNzEwMw==-flat-cwebp.c.html,0.010158730158730159,8,redis-MDEwOlJlcG9zaXRvcnkxMDgxMTA3MDY=-flat-extent_dss.c,PINRemoteImage-MDEwOlJlcG9zaXRvcnkzOTUzNzEwMw==-flat-cwebp.c,121,129,8,999,1004,5
218833,https://htmlpreview.github.io/?https://github.com/Christina96/boilerplate-sample-matches/blob/main/C/PINRemoteImage-MDEwOlJlcG9zaXRvcnkzOTUzNzEwMw==-flat-anim_encode.c-redis-MDEwOlJlcG9zaXRvcnkxMDgxMTA3MDY=-flat-networking.c.html,0.041112454655380895,8,PINRemoteImage-MDEwOlJlcG9zaXRvcnkzOTUzNzEwMw==-flat-anim_encode.c,redis-MDEwOlJlcG9zaXRvcnkxMDgxMTA3MDY=-flat-networking.c,624,632,8,1113,1117,4
219053,https://htmlpreview.github.io/?https://github.com/Christina96/boilerplate-sample-matches/blob/main/C/fftw3-MDEwOlJlcG9zaXRvcnk4ODQzMzg4-flat-dftw-genericbuf.c-PINRemoteImage-MDEwOlJlcG9zaXRvcnkzOTUzNzEwMw==-flat-muxinternal.c.html,0.02099737532808399,8,fftw3-MDEwOlJlcG9zaXRvcnk4ODQzMzg4-flat-dftw-genericbuf.c,PINRemoteImage-MDEwOlJlcG9zaXRvcnkzOTUzNzEwMw==-flat-muxinternal.c,102,104,2,332,339,7
219696,https://htmlpreview.github.io/?https://github.com/Christina96/boilerplate-sample-matches/blob/main/C/libtomcrypt-MDEwOlJlcG9zaXRvcnk3NzcwMTE=-flat-base64_encode.c-PINRemoteImage-MDEwOlJlcG9zaXRvcnkzOTUzNzEwMw==-flat-enc_neon.c.html,0.02336448598130841,10,libtomcrypt-MDEwOlJlcG9zaXRvcnk3NzcwMTE=-flat-base64_encode.c,PINRemoteImage-MDEwOlJlcG9zaXRvcnkzOTUzNzEwMw==-flat-enc_neon.c,44,49,5,423,433,10
222925,https://htmlpreview.github.io/?https://github.com/Christina96/boilerplate-sample-matches/blob/main/C/xmrig-MDEwOlJlcG9zaXRvcnk4ODMyNzQwNg==-flat-argon2-template-64.h-PINRemoteImage-MDEwOlJlcG9zaXRvcnkzOTUzNzEwMw==-flat-cwebp.c.html,0.031788079470198675,8,xmrig-MDEwOlJlcG9zaXRvcnk4ODMyNzQwNg==-flat-argon2-template-64.h,PINRemoteImage-MDEwOlJlcG9zaXRvcnkzOTUzNzEwMw==-flat-cwebp.c,138,144,6,242,249,7
224586,https://htmlpreview.github.io/?https://github.com/Christina96/boilerplate-sample-matches/blob/main/C/libtomcrypt-MDEwOlJlcG9zaXRvcnk3NzcwMTE=-flat-der_decode_ia5_string.c-redis-MDEwOlJlcG9zaXRvcnkxMDgxMTA3MDY=-flat-tsd_19.c.html,0.04678362573099415,8,libtomcrypt-MDEwOlJlcG9zaXRvcnk3NzcwMTE=-flat-der_decode_ia5_string.c,redis-MDEwOlJlcG9zaXRvcnkxMDgxMTA3MDY=-flat-tsd_19.c,11,16,5,108,113,5
225397,https://htmlpreview.github.io/?https://github.com/Christina96/boilerplate-sample-matches/blob/main/C/PINRemoteImage-MDEwOlJlcG9zaXRvcnkzOTUzNzEwMw==-flat-decode_13.h-PINRemoteImage-MDEwOlJlcG9zaXRvcnkzOTUzNzEwMw==-flat-decode_27.h.html,1.0,200,PINRemoteImage-MDEwOlJlcG9zaXRvcnkzOTUzNzEwMw==-flat-decode_13.h,PINRemoteImage-MDEwOlJlcG9zaXRvcnkzOTUzNzEwMw==-flat-decode_27.h,5,193,188,5,193,188
226865,https://htmlpreview.github.io/?https://github.com/Christina96/boilerplate-sample-matches/blob/main/C/xmrig-MDEwOlJlcG9zaXRvcnk4ODMyNzQwNg==-flat-usage.h-Adafruit_nRF52_Arduino-MDEwOlJlcG9zaXRvcnk3NDM1NDcyOQ==-flat-nrf_ipc.h.html,0.45229681978798586,16,xmrig-MDEwOlJlcG9zaXRvcnk4ODMyNzQwNg==-flat-usage.h,Adafruit_nRF52_Arduino-MDEwOlJlcG9zaXRvcnk3NDM1NDcyOQ==-flat-nrf_ipc.h,31,47,16,30,46,16
226999,https://htmlpreview.github.io/?https://github.com/Christina96/boilerplate-sample-matches/blob/main/C/libtomcrypt-MDEwOlJlcG9zaXRvcnk3NzcwMTE=-flat-poly1305_memory_multi.c-libtomcrypt-MDEwOlJlcG9zaXRvcnk3NzcwMTE=-flat-der_encode_raw_bit_string.c.html,0.29508196721311475,8,libtomcrypt-MDEwOlJlcG9zaXRvcnk3NzcwMTE=-flat-poly1305_memory_multi.c,libtomcrypt-MDEwOlJlcG9zaXRvcnk3NzcwMTE=-flat-der_encode_raw_bit_string.c,9,14,5,7,12,5
227888,https://htmlpreview.github.io/?https://github.com/Christina96/boilerplate-sample-matches/blob/main/C/Adafruit_nRF52_Arduino-MDEwOlJlcG9zaXRvcnk3NDM1NDcyOQ==-flat-nrfx_nfct.h-fftw3-MDEwOlJlcG9zaXRvcnk4ODQzMzg4-flat-indirect_6.c.html,0.0703125,9,Adafruit_nRF52_Arduino-MDEwOlJlcG9zaXRvcnk3NDM1NDcyOQ==-flat-nrfx_nfct.h,fftw3-MDEwOlJlcG9zaXRvcnk4ODQzMzg4-flat-indirect_6.c,45,52,7,7,12,5
227962,https://htmlpreview.github.io/?https://github.com/Christina96/boilerplate-sample-matches/blob/main/C/fftw3-MDEwOlJlcG9zaXRvcnk4ODQzMzg4-flat-tensor2.c-libpcap-MDEwOlJlcG9zaXRvcnk5NDM1ODg3-flat-sockutils.h.html,0.1267605633802817,9,fftw3-MDEwOlJlcG9zaXRvcnk4ODQzMzg4-flat-tensor2.c,libpcap-MDEwOlJlcG9zaXRvcnk5NDM1ODg3-flat-sockutils.h,14,16,2,41,45,4
227986,https://htmlpreview.github.io/?https://github.com/Christina96/boilerplate-sample-matches/blob/main/C/libtomcrypt-MDEwOlJlcG9zaXRvcnk3NzcwMTE=-flat-ocb3_add_aad.c-libtomcrypt-MDEwOlJlcG9zaXRvcnk3NzcwMTE=-flat-rc5.c.html,0.04215456674473068,9,libtomcrypt-MDEwOlJlcG9zaXRvcnk3NzcwMTE=-flat-ocb3_add_aad.c,libtomcrypt-MDEwOlJlcG9zaXRvcnk3NzcwMTE=-flat-rc5.c,13,16,3,159,165,6
228100,https://htmlpreview.github.io/?https://github.com/Christina96/boilerplate-sample-matches/blob/main/C/PINRemoteImage-MDEwOlJlcG9zaXRvcnkzOTUzNzEwMw==-flat-lossless_enc_sse2.c-PINRemoteImage-MDEwOlJlcG9zaXRvcnkzOTUzNzEwMw==-flat-webpinfo.c.html,0.044,9,PINRemoteImage-MDEwOlJlcG9zaXRvcnkzOTUzNzEwMw==-flat-lossless_enc_sse2.c,PINRemoteImage-MDEwOlJlcG9zaXRvcnkzOTUzNzEwMw==-flat-webpinfo.c,545,553,8,671,679,8
229706,https://htmlpreview.github.io/?https://github.com/Christina96/boilerplate-sample-matches/blob/main/C/fftw3-MDEwOlJlcG9zaXRvcnk4ODQzMzg4-flat-problem2.c-fftw3-MDEwOlJlcG9zaXRvcnk4ODQzMzg4-flat-dftw-direct.c.html,0.11479028697571744,8,fftw3-MDEwOlJlcG9zaXRvcnk4ODQzMzg4-flat-problem2.c,fftw3-MDEwOlJlcG9zaXRvcnk4ODQzMzg4-flat-dftw-direct.c,81,85,4,27,31,4
230723,https://htmlpreview.github.io/?https://github.com/Christina96/boilerplate-sample-matches/blob/main/C/PINRemoteImage-MDEwOlJlcG9zaXRvcnkzOTUzNzEwMw==-flat-decode_45.h-libtomcrypt-MDEwOlJlcG9zaXRvcnk3NzcwMTE=-flat-des.c.html,0.048467569493941556,8,PINRemoteImage-MDEwOlJlcG9zaXRvcnkzOTUzNzEwMw==-flat-decode_45.h,libtomcrypt-MDEwOlJlcG9zaXRvcnk3NzcwMTE=-flat-des.c,119,128,9,29,29,0
231814,https://htmlpreview.github.io/?https://github.com/Christina96/boilerplate-sample-matches/blob/main/C/Adafruit_nRF52_Arduino-MDEwOlJlcG9zaXRvcnk3NDM1NDcyOQ==-flat-flash_cache.c-Adafruit_nRF52_Arduino-MDEwOlJlcG9zaXRvcnk3NDM1NDcyOQ==-flat-itoa.c.html,0.0851063829787234,8,Adafruit_nRF52_Arduino-MDEwOlJlcG9zaXRvcnk3NDM1NDcyOQ==-flat-flash_cache.c,Adafruit_nRF52_Arduino-MDEwOlJlcG9zaXRvcnk3NDM1NDcyOQ==-flat-itoa.c,56,64,8,26,33,7
233267,https://htmlpreview.github.io/?https://github.com/Christina96/boilerplate-sample-matches/blob/main/C/Adafruit_nRF52_Arduino-MDEwOlJlcG9zaXRvcnk3NDM1NDcyOQ==-flat-event_groups.c-redis-MDEwOlJlcG9zaXRvcnkxMDgxMTA3MDY=-flat-prof.c.html,0.047524752475247525,9,Adafruit_nRF52_Arduino-MDEwOlJlcG9zaXRvcnk3NDM1NDcyOQ==-flat-event_groups.c,redis-MDEwOlJlcG9zaXRvcnkxMDgxMTA3MDY=-flat-prof.c,138,147,9,1113,1121,8
233704,https://htmlpreview.github.io/?https://github.com/Christina96/boilerplate-sample-matches/blob/main/C/redis-MDEwOlJlcG9zaXRvcnkxMDgxMTA3MDY=-flat-ae_30.h-fftw3-MDEwOlJlcG9zaXRvcnk4ODQzMzg4-flat-dftw-directsq.c.html,0.2033898305084746,8,redis-MDEwOlJlcG9zaXRvcnkxMDgxMTA3MDY=-flat-ae_30.h,fftw3-MDEwOlJlcG9zaXRvcnk4ODQzMzg4-flat-dftw-directsq.c,71,78,7,63,65,2
233830,https://htmlpreview.github.io/?https://github.com/Christina96/boilerplate-sample-matches/blob/main/C/fftw3-MDEwOlJlcG9zaXRvcnk4ODQzMzg4-flat-rdft-vrank-geq1.c-fftw3-MDEwOlJlcG9zaXRvcnk4ODQzMzg4-flat-reodft11e-r2hc-odd.c.html,0.20568927789934355,9,fftw3-MDEwOlJlcG9zaXRvcnk4ODQzMzg4-flat-rdft-vrank-geq1.c,fftw3-MDEwOlJlcG9zaXRvcnk4ODQzMzg4-flat-reodft11e-r2hc-odd.c,114,118,4,22,25,3
235210,https://htmlpreview.github.io/?https://github.com/Christina96/boilerplate-sample-matches/blob/main/C/libtomcrypt-MDEwOlJlcG9zaXRvcnk3NzcwMTE=-flat-ecb_encrypt.c-libpcap-MDEwOlJlcG9zaXRvcnk5NDM1ODg3-flat-pcap-dag.c.html,0.016981132075471698,9,libtomcrypt-MDEwOlJlcG9zaXRvcnk3NzcwMTE=-flat-ecb_encrypt.c,libpcap-MDEwOlJlcG9zaXRvcnk5NDM1ODg3-flat-pcap-dag.c,9,15,6,238,245,7
235689,https://htmlpreview.github.io/?https://github.com/Christina96/boilerplate-sample-matches/blob/main/C/xmrig-MDEwOlJlcG9zaXRvcnk4ODMyNzQwNg==-flat-c_groestl.c-xmrig-MDEwOlJlcG9zaXRvcnk4ODMyNzQwNg==-flat-format-inl.h.html,0.0194853859605296,9,xmrig-MDEwOlJlcG9zaXRvcnk4ODMyNzQwNg==-flat-c_groestl.c,xmrig-MDEwOlJlcG9zaXRvcnk4ODMyNzQwNg==-flat-format-inl.h,49,57,8,1059,1062,3
236108,https://htmlpreview.github.io/?https://github.com/Christina96/boilerplate-sample-matches/blob/main/C/redis-MDEwOlJlcG9zaXRvcnkxMDgxMTA3MDY=-flat-malloc_io_7.c-redis-MDEwOlJlcG9zaXRvcnkxMDgxMTA3MDY=-flat-hyperloglog.c.html,0.02937576499388005,8,redis-MDEwOlJlcG9zaXRvcnkxMDgxMTA3MDY=-flat-malloc_io_7.c,redis-MDEwOlJlcG9zaXRvcnkxMDgxMTA3MDY=-flat-hyperloglog.c,520,524,4,299,305,6
236546,https://htmlpreview.github.io/?https://github.com/Christina96/boilerplate-sample-matches/blob/main/C/libtomcrypt-MDEwOlJlcG9zaXRvcnk3NzcwMTE=-flat-gcm_mult_h.c-PINRemoteImage-MDEwOlJlcG9zaXRvcnkzOTUzNzEwMw==-flat-webp_enc.c.html,0.044226044226044224,9,libtomcrypt-MDEwOlJlcG9zaXRvcnk3NzcwMTE=-flat-gcm_mult_h.c,PINRemoteImage-MDEwOlJlcG9zaXRvcnkzOTUzNzEwMw==-flat-webp_enc.c,19,25,6,32,37,5
236945,https://htmlpreview.github.io/?https://github.com/Christina96/boilerplate-sample-matches/blob/main/C/redis-MDEwOlJlcG9zaXRvcnkxMDgxMTA3MDY=-flat-lundump.c-xmrig-MDEwOlJlcG9zaXRvcnk4ODMyNzQwNg==-flat-sse2neon.h.html,0.017254503933011926,8,redis-MDEwOlJlcG9zaXRvcnkxMDgxMTA3MDY=-flat-lundump.c,xmrig-MDEwOlJlcG9zaXRvcnk4ODMyNzQwNg==-flat-sse2neon.h,144,150,6,5004,5012,8
238219,https://htmlpreview.github.io/?https://github.com/Christina96/boilerplate-sample-matches/blob/main/C/libtomcrypt-MDEwOlJlcG9zaXRvcnk3NzcwMTE=-flat-ecc_ansi_x963_import.c-libtomcrypt-MDEwOlJlcG9zaXRvcnk3NzcwMTE=-flat-der_length_sequence.c.html,0.13793103448275862,16,libtomcrypt-MDEwOlJlcG9zaXRvcnk3NzcwMTE=-flat-ecc_ansi_x963_import.c,libtomcrypt-MDEwOlJlcG9zaXRvcnk3NzcwMTE=-flat-der_length_sequence.c,3,7,4,3,9,6
240095,https://htmlpreview.github.io/?https://github.com/Christina96/boilerplate-sample-matches/blob/main/C/libtomcrypt-MDEwOlJlcG9zaXRvcnk3NzcwMTE=-flat-der_length_teletex_string.c-redis-MDEwOlJlcG9zaXRvcnkxMDgxMTA3MDY=-flat-networking.c.html,0.010983524712930605,11,libtomcrypt-MDEwOlJlcG9zaXRvcnk3NzcwMTE=-flat-der_length_teletex_string.c,redis-MDEwOlJlcG9zaXRvcnkxMDgxMTA3MDY=-flat-networking.c,151,156,5,1317,1326,9
241025,https://htmlpreview.github.io/?https://github.com/Christina96/boilerplate-sample-matches/blob/main/C/PINRemoteImage-MDEwOlJlcG9zaXRvcnkzOTUzNzEwMw==-flat-neon.h-PINRemoteImage-MDEwOlJlcG9zaXRvcnkzOTUzNzEwMw==-flat-lossless_enc.c.html,0.01798941798941799,8,PINRemoteImage-MDEwOlJlcG9zaXRvcnkzOTUzNzEwMw==-flat-neon.h,PINRemoteImage-MDEwOlJlcG9zaXRvcnkzOTUzNzEwMw==-flat-lossless_enc.c,42,50,8,488,493,5
244638,https://htmlpreview.github.io/?https://github.com/Christina96/boilerplate-sample-matches/blob/main/C/xmrig-MDEwOlJlcG9zaXRvcnk4ODMyNzQwNg==-flat-soft_aes_1.h-Adafruit_nRF52_Arduino-MDEwOlJlcG9zaXRvcnk3NDM1NDcyOQ==-flat-nrf_saadc.h.html,0.14678899082568808,16,xmrig-MDEwOlJlcG9zaXRvcnk4ODMyNzQwNg==-flat-soft_aes_1.h,Adafruit_nRF52_Arduino-MDEwOlJlcG9zaXRvcnk3NDM1NDcyOQ==-flat-nrf_saadc.h,40,55,15,118,133,15
245495,https://htmlpreview.github.io/?https://github.com/Christina96/boilerplate-sample-matches/blob/main/C/libtomcrypt-MDEwOlJlcG9zaXRvcnk3NzcwMTE=-flat-crypt_prng_descriptor.c-redis-MDEwOlJlcG9zaXRvcnkxMDgxMTA3MDY=-flat-Win32_fdapi_crt.h.html,0.33962264150943394,9,libtomcrypt-MDEwOlJlcG9zaXRvcnk3NzcwMTE=-flat-crypt_prng_descriptor.c,redis-MDEwOlJlcG9zaXRvcnkxMDgxMTA3MDY=-flat-Win32_fdapi_crt.h,3,3,0,8,11,3
245627,https://htmlpreview.github.io/?https://github.com/Christina96/boilerplate-sample-matches/blob/main/C/redis-MDEwOlJlcG9zaXRvcnkxMDgxMTA3MDY=-flat-Win32_QFork_impl.c-libtomcrypt-MDEwOlJlcG9zaXRvcnk3NzcwMTE=-flat-xtea.c.html,0.04804804804804805,8,redis-MDEwOlJlcG9zaXRvcnkxMDgxMTA3MDY=-flat-Win32_QFork_impl.c,libtomcrypt-MDEwOlJlcG9zaXRvcnk3NzcwMTE=-flat-xtea.c,68,70,2,50,54,4
246742,https://htmlpreview.github.io/?https://github.com/Christina96/boilerplate-sample-matches/blob/main/C/Adafruit_nRF52_Arduino-MDEwOlJlcG9zaXRvcnk3NDM1NDcyOQ==-flat-nrf_reset.h-Adafruit_nRF52_Arduino-MDEwOlJlcG9zaXRvcnk3NDM1NDcyOQ==-flat-nrf_clock.h.html,0.11796246648793565,14,Adafruit_nRF52_Arduino-MDEwOlJlcG9zaXRvcnk3NDM1NDcyOQ==-flat-nrf_reset.h,Adafruit_nRF52_Arduino-MDEwOlJlcG9zaXRvcnk3NDM1NDcyOQ==-flat-nrf_clock.h,7,19,12,134,153,19
248015,https://htmlpreview.github.io/?https://github.com/Christina96/boilerplate-sample-matches/blob/main/C/redis-MDEwOlJlcG9zaXRvcnkxMDgxMTA3MDY=-flat-SFMT_1.c-libtomcrypt-MDEwOlJlcG9zaXRvcnk3NzcwMTE=-flat-aes.c.html,0.15224191866527634,9,redis-MDEwOlJlcG9zaXRvcnkxMDgxMTA3MDY=-flat-SFMT_1.c,libtomcrypt-MDEwOlJlcG9zaXRvcnk3NzcwMTE=-flat-aes.c,423,429,6,376,396,20
248434,https://htmlpreview.github.io/?https://github.com/Christina96/boilerplate-sample-matches/blob/main/C/Adafruit_nRF52_Arduino-MDEwOlJlcG9zaXRvcnk3NDM1NDcyOQ==-flat-nrf_lpcomp.h-Adafruit_nRF52_Arduino-MDEwOlJlcG9zaXRvcnk3NDM1NDcyOQ==-flat-nrf_pdm.h.html,0.5395894428152492,9,Adafruit_nRF52_Arduino-MDEwOlJlcG9zaXRvcnk3NDM1NDcyOQ==-flat-nrf_lpcomp.h,Adafruit_nRF52_Arduino-MDEwOlJlcG9zaXRvcnk3NDM1NDcyOQ==-flat-nrf_pdm.h,173,183,10,132,140,8
248931,https://htmlpreview.github.io/?https://github.com/Christina96/boilerplate-sample-matches/blob/main/C/Adafruit_nRF52_Arduino-MDEwOlJlcG9zaXRvcnk3NDM1NDcyOQ==-flat-nrfx_pwm.c-xmrig-MDEwOlJlcG9zaXRvcnk4ODMyNzQwNg==-flat-printf.h.html,0.03849855630413859,8,Adafruit_nRF52_Arduino-MDEwOlJlcG9zaXRvcnk3NDM1NDcyOQ==-flat-nrfx_pwm.c,xmrig-MDEwOlJlcG9zaXRvcnk4ODMyNzQwNg==-flat-printf.h,231,237,6,329,333,4
249307,https://htmlpreview.github.io/?https://github.com/Christina96/boilerplate-sample-matches/blob/main/C/fftw3-MDEwOlJlcG9zaXRvcnk4ODQzMzg4-flat-trigtest.c-libpcap-MDEwOlJlcG9zaXRvcnk5NDM1ODg3-flat-pcap-dpdk.c.html,0.03648068669527897,8,fftw3-MDEwOlJlcG9zaXRvcnk4ODQzMzg4-flat-trigtest.c,libpcap-MDEwOlJlcG9zaXRvcnk5NDM1ODg3-flat-pcap-dpdk.c,91,99,8,123,128,5
249735,https://htmlpreview.github.io/?https://github.com/Christina96/boilerplate-sample-matches/blob/main/C/xmrig-MDEwOlJlcG9zaXRvcnk4ODMyNzQwNg==-flat-blake2-impl_9.h-Adafruit_nRF52_Arduino-MDEwOlJlcG9zaXRvcnk3NDM1NDcyOQ==-flat-nrf_i2s.h.html,0.23052959501557632,10,xmrig-MDEwOlJlcG9zaXRvcnk4ODMyNzQwNg==-flat-blake2-impl_9.h,Adafruit_nRF52_Arduino-MDEwOlJlcG9zaXRvcnk3NDM1NDcyOQ==-flat-nrf_i2s.h,40,49,9,74,83,9
252228,https://htmlpreview.github.io/?https://github.com/Christina96/boilerplate-sample-matches/blob/main/C/fftw3-MDEwOlJlcG9zaXRvcnk4ODQzMzg4-flat-timer_23.c-xmrig-MDEwOlJlcG9zaXRvcnk4ODMyNzQwNg==-flat-cpukinds.c.html,0.024896265560165973,9,fftw3-MDEwOlJlcG9zaXRvcnk4ODQzMzg4-flat-timer_23.c,xmrig-MDEwOlJlcG9zaXRvcnk4ODMyNzQwNg==-flat-cpukinds.c,94,98,4,134,137,3
252359,https://htmlpreview.github.io/?https://github.com/Christina96/boilerplate-sample-matches/blob/main/C/android-gpuimage-plus-MDEwOlJlcG9zaXRvcnk0NjU0NzQxNw==-flat-pixfmt.h-fftw3-MDEwOlJlcG9zaXRvcnk4ODQzMzg4-flat-dht-rader.c.html,0.14325068870523416,11,android-gpuimage-plus-MDEwOlJlcG9zaXRvcnk0NjU0NzQxNw==-flat-pixfmt.h,fftw3-MDEwOlJlcG9zaXRvcnk4ODQzMzg4-flat-dht-rader.c,309,319,10,42,55,13
252643,https://htmlpreview.github.io/?https://github.com/Christina96/boilerplate-sample-matches/blob/main/C/xmrig-MDEwOlJlcG9zaXRvcnk4ODMyNzQwNg==-flat-impl-select.c-small-MDEwOlJlcG9zaXRvcnkyNTY3NjMxNjk=-flat-auth.c.html,0.029008863819500404,8,xmrig-MDEwOlJlcG9zaXRvcnk4ODMyNzQwNg==-flat-impl-select.c,small-MDEwOlJlcG9zaXRvcnkyNTY3NjMxNjk=-flat-auth.c,50,55,5,691,698,7
256164,https://htmlpreview.github.io/?https://github.com/Christina96/boilerplate-sample-matches/blob/main/C/libtomcrypt-MDEwOlJlcG9zaXRvcnk3NzcwMTE=-flat-dsa_import.c-libtomcrypt-MDEwOlJlcG9zaXRvcnk3NzcwMTE=-flat-dh_test.c.html,0.13691931540342298,8,libtomcrypt-MDEwOlJlcG9zaXRvcnk3NzcwMTE=-flat-dsa_import.c,libtomcrypt-MDEwOlJlcG9zaXRvcnk3NzcwMTE=-flat-dh_test.c,74,81,7,10,11,1
256208,https://htmlpreview.github.io/?https://github.com/Christina96/boilerplate-sample-matches/blob/main/C/libtomcrypt-MDEwOlJlcG9zaXRvcnk3NzcwMTE=-flat-tweetnacl.c-redis-MDEwOlJlcG9zaXRvcnkxMDgxMTA3MDY=-flat-jemalloc.c.html,0.016784155756965426,8,libtomcrypt-MDEwOlJlcG9zaXRvcnk3NzcwMTE=-flat-tweetnacl.c,redis-MDEwOlJlcG9zaXRvcnkxMDgxMTA3MDY=-flat-jemalloc.c,66,70,4,373,377,4
256995,https://htmlpreview.github.io/?https://github.com/Christina96/boilerplate-sample-matches/blob/main/C/xmrig-MDEwOlJlcG9zaXRvcnk4ODMyNzQwNg==-flat-WorkerJob.h-fftw3-MDEwOlJlcG9zaXRvcnk4ODQzMzg4-flat-md5.c.html,0.042328042328042326,8,xmrig-MDEwOlJlcG9zaXRvcnk4ODMyNzQwNg==-flat-WorkerJob.h,fftw3-MDEwOlJlcG9zaXRvcnk4ODQzMzg4-flat-md5.c,53,58,5,51,52,1
257878,https://htmlpreview.github.io/?https://github.com/Christina96/boilerplate-sample-matches/blob/main/C/PINRemoteImage-MDEwOlJlcG9zaXRvcnkzOTUzNzEwMw==-flat-picture_psnr_enc.c-PINRemoteImage-MDEwOlJlcG9zaXRvcnkzOTUzNzEwMw==-flat-analysis_enc.c.html,0.09297297297297297,8,PINRemoteImage-MDEwOlJlcG9zaXRvcnkzOTUzNzEwMw==-flat-picture_psnr_enc.c,PINRemoteImage-MDEwOlJlcG9zaXRvcnkzOTUzNzEwMw==-flat-analysis_enc.c,81,86,5,265,272,7
257972,https://htmlpreview.github.io/?https://github.com/Christina96/boilerplate-sample-matches/blob/main/C/redis-MDEwOlJlcG9zaXRvcnkxMDgxMTA3MDY=-flat-t_list.c-Adafruit_nRF52_Arduino-MDEwOlJlcG9zaXRvcnk3NDM1NDcyOQ==-flat-bignum.c.html,0.03946719289590528,8,redis-MDEwOlJlcG9zaXRvcnkxMDgxMTA3MDY=-flat-t_list.c,Adafruit_nRF52_Arduino-MDEwOlJlcG9zaXRvcnk3NDM1NDcyOQ==-flat-bignum.c,302,306,4,222,226,4
258118,https://htmlpreview.github.io/?https://github.com/Christina96/boilerplate-sample-matches/blob/main/C/libpcap-MDEwOlJlcG9zaXRvcnk5NDM1ODg3-flat-bpf_image.c-PINRemoteImage-MDEwOlJlcG9zaXRvcnkzOTUzNzEwMw==-flat-alpha_processing.c.html,0.03513513513513514,13,libpcap-MDEwOlJlcG9zaXRvcnk5NDM1ODg3-flat-bpf_image.c,PINRemoteImage-MDEwOlJlcG9zaXRvcnkzOTUzNzEwMw==-flat-alpha_processing.c,20,55,35,335,351,16
258567,https://htmlpreview.github.io/?https://github.com/Christina96/boilerplate-sample-matches/blob/main/C/xmrig-MDEwOlJlcG9zaXRvcnk4ODMyNzQwNg==-flat-sph_groestl.c-PINRemoteImage-MDEwOlJlcG9zaXRvcnkzOTUzNzEwMw==-flat-iterator_enc.c.html,0.06257521058965103,9,xmrig-MDEwOlJlcG9zaXRvcnk4ODMyNzQwNg==-flat-sph_groestl.c,PINRemoteImage-MDEwOlJlcG9zaXRvcnkzOTUzNzEwMw==-flat-iterator_enc.c,2555,2570,15,25,34,9
259267,https://htmlpreview.github.io/?https://github.com/Christina96/boilerplate-sample-matches/blob/main/C/Adafruit_nRF52_Arduino-MDEwOlJlcG9zaXRvcnk3NDM1NDcyOQ==-flat-SEGGER_SYSVIEW_FreeRTOS.c-redis-MDEwOlJlcG9zaXRvcnkxMDgxMTA3MDY=-flat-win32_wsiocp.c.html,0.027303754266211604,8,Adafruit_nRF52_Arduino-MDEwOlJlcG9zaXRvcnk3NDM1NDcyOQ==-flat-SEGGER_SYSVIEW_FreeRTOS.c,redis-MDEwOlJlcG9zaXRvcnkxMDgxMTA3MDY=-flat-win32_wsiocp.c,34,40,6,118,123,5
259421,https://htmlpreview.github.io/?https://github.com/Christina96/boilerplate-sample-matches/blob/main/C/small-MDEwOlJlcG9zaXRvcnkyNTY3NjMxNjk=-flat-check.c-PINRemoteImage-MDEwOlJlcG9zaXRvcnkzOTUzNzEwMw==-flat-dec_mips_dsp_r2.c.html,0.03375527426160337,8,small-MDEwOlJlcG9zaXRvcnkyNTY3NjMxNjk=-flat-check.c,PINRemoteImage-MDEwOlJlcG9zaXRvcnkzOTUzNzEwMw==-flat-dec_mips_dsp_r2.c,84,86,2,409,412,3
260138,https://htmlpreview.github.io/?https://github.com/Christina96/boilerplate-sample-matches/blob/main/C/libtomcrypt-MDEwOlJlcG9zaXRvcnk3NzcwMTE=-flat-pelican_memory.c-libtomcrypt-MDEwOlJlcG9zaXRvcnk3NzcwMTE=-flat-dh_check_pubkey.c.html,0.20253164556962025,8,libtomcrypt-MDEwOlJlcG9zaXRvcnk3NzcwMTE=-flat-pelican_memory.c,libtomcrypt-MDEwOlJlcG9zaXRvcnk3NzcwMTE=-flat-dh_check_pubkey.c,13,17,4,9,12,3
260326,https://htmlpreview.github.io/?https://github.com/Christina96/boilerplate-sample-matches/blob/main/C/libtomcrypt-MDEwOlJlcG9zaXRvcnk3NzcwMTE=-flat-eax_test.c-libfuse-MDEwOlJlcG9zaXRvcnk0ODI5NjE3Nw==-flat-fusermount.c.html,0.054184226369656835,13,libtomcrypt-MDEwOlJlcG9zaXRvcnk3NzcwMTE=-flat-eax_test.c,libfuse-MDEwOlJlcG9zaXRvcnk0ODI5NjE3Nw==-flat-fusermount.c,20,29,9,501,507,6
263079,https://htmlpreview.github.io/?https://github.com/Christina96/boilerplate-sample-matches/blob/main/C/PINRemoteImage-MDEwOlJlcG9zaXRvcnkzOTUzNzEwMw==-flat-enc_sse41.c-PINRemoteImage-MDEwOlJlcG9zaXRvcnkzOTUzNzEwMw==-flat-dec_sse2.c.html,0.2697866483138334,8,PINRemoteImage-MDEwOlJlcG9zaXRvcnkzOTUzNzEwMw==-flat-enc_sse41.c,PINRemoteImage-MDEwOlJlcG9zaXRvcnkzOTUzNzEwMw==-flat-dec_sse2.c,104,107,3,778,781,3
263208,https://htmlpreview.github.io/?https://github.com/Christina96/boilerplate-sample-matches/blob/main/C/xmrig-MDEwOlJlcG9zaXRvcnk4ODMyNzQwNg==-flat-cpuid-x86.h-PINRemoteImage-MDEwOlJlcG9zaXRvcnkzOTUzNzEwMw==-flat-decode_49.h.html,0.07079646017699115,8,xmrig-MDEwOlJlcG9zaXRvcnk4ODMyNzQwNg==-flat-cpuid-x86.h,PINRemoteImage-MDEwOlJlcG9zaXRvcnkzOTUzNzEwMw==-flat-decode_49.h,30,36,6,65,73,8
263851,https://htmlpreview.github.io/?https://github.com/Christina96/boilerplate-sample-matches/blob/main/C/libtomcrypt-MDEwOlJlcG9zaXRvcnk3NzcwMTE=-flat-pkcs_1_i2osp.c-libtomcrypt-MDEwOlJlcG9zaXRvcnk3NzcwMTE=-flat-der_decode_sequence_flexi.c.html,0.028985507246376812,8,libtomcrypt-MDEwOlJlcG9zaXRvcnk3NzcwMTE=-flat-pkcs_1_i2osp.c,libtomcrypt-MDEwOlJlcG9zaXRvcnk3NzcwMTE=-flat-der_decode_sequence_flexi.c,3,5,2,20,23,3
265606,https://htmlpreview.github.io/?https://github.com/Christina96/boilerplate-sample-matches/blob/main/C/libtomcrypt-MDEwOlJlcG9zaXRvcnk3NzcwMTE=-flat-der_encode_set.c-libtomcrypt-MDEwOlJlcG9zaXRvcnk3NzcwMTE=-flat-camellia.c.html,0.07188160676532769,8,libtomcrypt-MDEwOlJlcG9zaXRvcnk3NzcwMTE=-flat-der_encode_set.c,libtomcrypt-MDEwOlJlcG9zaXRvcnk3NzcwMTE=-flat-camellia.c,26,30,4,208,212,4
265953,https://htmlpreview.github.io/?https://github.com/Christina96/boilerplate-sample-matches/blob/main/C/Adafruit_nRF52_Arduino-MDEwOlJlcG9zaXRvcnk3NDM1NDcyOQ==-flat-wiring.c-fftw3-MDEwOlJlcG9zaXRvcnk4ODQzMzg4-flat-rdft-dht.c.html,0.06201550387596899,8,Adafruit_nRF52_Arduino-MDEwOlJlcG9zaXRvcnk3NDM1NDcyOQ==-flat-wiring.c,fftw3-MDEwOlJlcG9zaXRvcnk4ODQzMzg4-flat-rdft-dht.c,10,23,13,39,48,9
266244,https://htmlpreview.github.io/?https://github.com/Christina96/boilerplate-sample-matches/blob/main/C/fftw3-MDEwOlJlcG9zaXRvcnk4ODQzMzg4-flat-amd64-cpuid.h-libpcap-MDEwOlJlcG9zaXRvcnk5NDM1ODg3-flat-pktdrvr.c.html,0.021377672209026127,9,fftw3-MDEwOlJlcG9zaXRvcnk4ODQzMzg4-flat-amd64-cpuid.h,libpcap-MDEwOlJlcG9zaXRvcnk5NDM1ODg3-flat-pktdrvr.c,22,34,12,461,469,8
266670,https://htmlpreview.github.io/?https://github.com/Christina96/boilerplate-sample-matches/blob/main/C/libtomcrypt-MDEwOlJlcG9zaXRvcnk3NzcwMTE=-flat-ccm_memory.c-libfuse-MDEwOlJlcG9zaXRvcnk0ODI5NjE3Nw==-flat-passthrough_ll.c.html,0.017508417508417508,13,libtomcrypt-MDEwOlJlcG9zaXRvcnk3NzcwMTE=-flat-ccm_memory.c,libfuse-MDEwOlJlcG9zaXRvcnk0ODI5NjE3Nw==-flat-passthrough_ll.c,116,122,6,905,917,12
266914,https://htmlpreview.github.io/?https://github.com/Christina96/boilerplate-sample-matches/blob/main/C/fftw3-MDEwOlJlcG9zaXRvcnk4ODQzMzg4-flat-reodft11e-radix2.c-xmrig-MDEwOlJlcG9zaXRvcnk4ODMyNzQwNg==-flat-bind.c.html,0.0282574568288854,10,fftw3-MDEwOlJlcG9zaXRvcnk4ODQzMzg4-flat-reodft11e-radix2.c,xmrig-MDEwOlJlcG9zaXRvcnk4ODMyNzQwNg==-flat-bind.c,386,396,10,665,676,11
270460,https://htmlpreview.github.io/?https://github.com/Christina96/boilerplate-sample-matches/blob/main/C/Adafruit_nRF52_Arduino-MDEwOlJlcG9zaXRvcnk3NDM1NDcyOQ==-flat-nrf_twim.h-Adafruit_nRF52_Arduino-MDEwOlJlcG9zaXRvcnk3NDM1NDcyOQ==-flat-nrf_usbd.h.html,0.2891566265060241,12,Adafruit_nRF52_Arduino-MDEwOlJlcG9zaXRvcnk3NDM1NDcyOQ==-flat-nrf_twim.h,Adafruit_nRF52_Arduino-MDEwOlJlcG9zaXRvcnk3NDM1NDcyOQ==-flat-nrf_usbd.h,250,263,13,173,185,12
273480,https://htmlpreview.github.io/?https://github.com/Christina96/boilerplate-sample-matches/blob/main/C/redis-MDEwOlJlcG9zaXRvcnkxMDgxMTA3MDY=-flat-bin.c-libtomcrypt-MDEwOlJlcG9zaXRvcnk3NzcwMTE=-flat-multi2.c.html,0.09418282548476455,8,redis-MDEwOlJlcG9zaXRvcnkxMDgxMTA3MDY=-flat-bin.c,libtomcrypt-MDEwOlJlcG9zaXRvcnk3NzcwMTE=-flat-multi2.c,28,34,6,201,207,6
274272,https://htmlpreview.github.io/?https://github.com/Christina96/boilerplate-sample-matches/blob/main/C/Adafruit_nRF52_Arduino-MDEwOlJlcG9zaXRvcnk3NDM1NDcyOQ==-flat-SEGGER_RTT.c-xmrig-MDEwOlJlcG9zaXRvcnk4ODMyNzQwNg==-flat-CryptoNight_x86.h.html,0.07047387606318348,14,Adafruit_nRF52_Arduino-MDEwOlJlcG9zaXRvcnk3NDM1NDcyOQ==-flat-SEGGER_RTT.c,xmrig-MDEwOlJlcG9zaXRvcnk4ODMyNzQwNg==-flat-CryptoNight_x86.h,390,397,7,611,618,7
275849,https://htmlpreview.github.io/?https://github.com/Christina96/boilerplate-sample-matches/blob/main/C/libfuse-MDEwOlJlcG9zaXRvcnk0ODI5NjE3Nw==-flat-passthrough.c-PINRemoteImage-MDEwOlJlcG9zaXRvcnkzOTUzNzEwMw==-flat-io_dec.c.html,0.06368460955269144,8,libfuse-MDEwOlJlcG9zaXRvcnk0ODI5NjE3Nw==-flat-passthrough.c,PINRemoteImage-MDEwOlJlcG9zaXRvcnkzOTUzNzEwMw==-flat-io_dec.c,80,85,5,280,283,3
276957,https://htmlpreview.github.io/?https://github.com/Christina96/boilerplate-sample-matches/blob/main/C/libtomcrypt-MDEwOlJlcG9zaXRvcnk3NzcwMTE=-flat-der_decode_bit_string.c-libpcap-MDEwOlJlcG9zaXRvcnk5NDM1ODg3-flat-pcap-tc.c.html,0.025404157043879907,11,libtomcrypt-MDEwOlJlcG9zaXRvcnk3NzcwMTE=-flat-der_decode_bit_string.c,libpcap-MDEwOlJlcG9zaXRvcnk5NDM1ODg3-flat-pcap-tc.c,11,19,8,202,212,10
277743,https://htmlpreview.github.io/?https://github.com/Christina96/boilerplate-sample-matches/blob/main/C/fftw3-MDEwOlJlcG9zaXRvcnk4ODQzMzg4-flat-redft00e-r2hc.c-xmrig-MDEwOlJlcG9zaXRvcnk4ODMyNzQwNg==-flat-reader.h.html,0.024413145539906103,8,fftw3-MDEwOlJlcG9zaXRvcnk4ODQzMzg4-flat-redft00e-r2hc.c,xmrig-MDEwOlJlcG9zaXRvcnk4ODMyNzQwNg==-flat-reader.h,61,64,3,1338,1361,23
278536,https://htmlpreview.github.io/?https://github.com/Christina96/boilerplate-sample-matches/blob/main/C/android-gpuimage-plus-MDEwOlJlcG9zaXRvcnk0NjU0NzQxNw==-flat-cgeVideoDecoder.h-redis-MDEwOlJlcG9zaXRvcnkxMDgxMTA3MDY=-flat-lzf_c.c.html,0.07092198581560284,10,android-gpuimage-plus-MDEwOlJlcG9zaXRvcnk0NjU0NzQxNw==-flat-cgeVideoDecoder.h,redis-MDEwOlJlcG9zaXRvcnkxMDgxMTA3MDY=-flat-lzf_c.c,190,199,9,136,150,14
280471,https://htmlpreview.github.io/?https://github.com/Christina96/boilerplate-sample-matches/blob/main/C/xmrig-MDEwOlJlcG9zaXRvcnk4ODMyNzQwNg==-flat-blake2.c-xmrig-MDEwOlJlcG9zaXRvcnk4ODMyNzQwNg==-flat-stack.h.html,0.07624633431085044,13,xmrig-MDEwOlJlcG9zaXRvcnk4ODMyNzQwNg==-flat-blake2.c,xmrig-MDEwOlJlcG9zaXRvcnk4ODMyNzQwNg==-flat-stack.h,80,104,24,42,54,12
280782,https://htmlpreview.github.io/?https://github.com/Christina96/boilerplate-sample-matches/blob/main/C/libtomcrypt-MDEwOlJlcG9zaXRvcnk3NzcwMTE=-flat-rmd128.c-fftw3-MDEwOlJlcG9zaXRvcnk4ODQzMzg4-flat-dht-rader.c.html,0.04054054054054054,9,libtomcrypt-MDEwOlJlcG9zaXRvcnk3NzcwMTE=-flat-rmd128.c,fftw3-MDEwOlJlcG9zaXRvcnk4ODQzMzg4-flat-dht-rader.c,56,188,132,44,54,10
282027,https://htmlpreview.github.io/?https://github.com/Christina96/boilerplate-sample-matches/blob/main/C/libtomcrypt-MDEwOlJlcG9zaXRvcnk3NzcwMTE=-flat-cfb_encrypt.c-libtomcrypt-MDEwOlJlcG9zaXRvcnk3NzcwMTE=-flat-der_decode_custom_type.c.html,0.028070175438596492,8,libtomcrypt-MDEwOlJlcG9zaXRvcnk3NzcwMTE=-flat-cfb_encrypt.c,libtomcrypt-MDEwOlJlcG9zaXRvcnk3NzcwMTE=-flat-der_decode_custom_type.c,3,3,0,9,11,2
283094,https://htmlpreview.github.io/?https://github.com/Christina96/boilerplate-sample-matches/blob/main/C/xmrig-MDEwOlJlcG9zaXRvcnk4ODMyNzQwNg==-flat-Signatures.h-xmrig-MDEwOlJlcG9zaXRvcnk4ODMyNzQwNg==-flat-c_blake256.h.html,0.6486486486486487,12,xmrig-MDEwOlJlcG9zaXRvcnk4ODMyNzQwNg==-flat-Signatures.h,xmrig-MDEwOlJlcG9zaXRvcnk4ODMyNzQwNg==-flat-c_blake256.h,5,9,4,15,28,13
285712,https://htmlpreview.github.io/?https://github.com/Christina96/boilerplate-sample-matches/blob/main/C/libfuse-MDEwOlJlcG9zaXRvcnk0ODI5NjE3Nw==-flat-passthrough_fh.c-PINRemoteImage-MDEwOlJlcG9zaXRvcnkzOTUzNzEwMw==-flat-lossless.c.html,0.061708860759493674,9,libfuse-MDEwOlJlcG9zaXRvcnk0ODI5NjE3Nw==-flat-passthrough_fh.c,PINRemoteImage-MDEwOlJlcG9zaXRvcnkzOTUzNzEwMw==-flat-lossless.c,454,463,9,382,388,6
287190,https://htmlpreview.github.io/?https://github.com/Christina96/boilerplate-sample-matches/blob/main/C/xmrig-MDEwOlJlcG9zaXRvcnk4ODMyNzQwNg==-flat-llhttp.h-Adafruit_nRF52_Arduino-MDEwOlJlcG9zaXRvcnk3NDM1NDcyOQ==-flat-nrf_uart.h.html,0.20365535248041775,9,xmrig-MDEwOlJlcG9zaXRvcnk4ODMyNzQwNg==-flat-llhttp.h,Adafruit_nRF52_Arduino-MDEwOlJlcG9zaXRvcnk3NDM1NDcyOQ==-flat-nrf_uart.h,81,88,7,18,25,7
289083,https://htmlpreview.github.io/?https://github.com/Christina96/boilerplate-sample-matches/blob/main/C/libtomcrypt-MDEwOlJlcG9zaXRvcnk3NzcwMTE=-flat-pkcs_1_pss_decode.c-libtomcrypt-MDEwOlJlcG9zaXRvcnk3NzcwMTE=-flat-ecc_import_pkcs8.c.html,0.26229508196721313,9,libtomcrypt-MDEwOlJlcG9zaXRvcnk3NzcwMTE=-flat-pkcs_1_pss_decode.c,libtomcrypt-MDEwOlJlcG9zaXRvcnk3NzcwMTE=-flat-ecc_import_pkcs8.c,3,4,1,30,31,1
290994,https://htmlpreview.github.io/?https://github.com/Christina96/boilerplate-sample-matches/blob/main/C/fftw3-MDEwOlJlcG9zaXRvcnk4ODQzMzg4-flat-dht-rader.c-libtomcrypt-MDEwOlJlcG9zaXRvcnk3NzcwMTE=-flat-tweetnacl.c.html,0.047337278106508875,8,fftw3-MDEwOlJlcG9zaXRvcnk4ODQzMzg4-flat-dht-rader.c,libtomcrypt-MDEwOlJlcG9zaXRvcnk3NzcwMTE=-flat-tweetnacl.c,41,46,5,304,308,4
292003,https://htmlpreview.github.io/?https://github.com/Christina96/boilerplate-sample-matches/blob/main/C/redis-MDEwOlJlcG9zaXRvcnkxMDgxMTA3MDY=-flat-lualib.h-android-gpuimage-plus-MDEwOlJlcG9zaXRvcnk0NjU0NzQxNw==-flat-cgeLerpblurFilter.h.html,0.5333333333333333,8,redis-MDEwOlJlcG9zaXRvcnkxMDgxMTA3MDY=-flat-lualib.h,android-gpuimage-plus-MDEwOlJlcG9zaXRvcnk0NjU0NzQxNw==-flat-cgeLerpblurFilter.h,6,20,14,26,33,7
292694,https://htmlpreview.github.io/?https://github.com/Christina96/boilerplate-sample-matches/blob/main/C/libtomcrypt-MDEwOlJlcG9zaXRvcnk3NzcwMTE=-flat-skipjack.c-libtomcrypt-MDEwOlJlcG9zaXRvcnk3NzcwMTE=-flat-safer.c.html,0.3435700575815739,21,libtomcrypt-MDEwOlJlcG9zaXRvcnk3NzcwMTE=-flat-skipjack.c,libtomcrypt-MDEwOlJlcG9zaXRvcnk3NzcwMTE=-flat-safer.c,127,138,11,230,243,13
293538,https://htmlpreview.github.io/?https://github.com/Christina96/boilerplate-sample-matches/blob/main/C/Adafruit_nRF52_Arduino-MDEwOlJlcG9zaXRvcnk3NDM1NDcyOQ==-flat-nrfx_gpiote.c-redis-MDEwOlJlcG9zaXRvcnkxMDgxMTA3MDY=-flat-t_stream.c.html,0.03498779495524817,11,Adafruit_nRF52_Arduino-MDEwOlJlcG9zaXRvcnk3NDM1NDcyOQ==-flat-nrfx_gpiote.c,redis-MDEwOlJlcG9zaXRvcnkxMDgxMTA3MDY=-flat-t_stream.c,540,550,10,43,51,8
294354,https://htmlpreview.github.io/?https://github.com/Christina96/boilerplate-sample-matches/blob/main/C/libtomcrypt-MDEwOlJlcG9zaXRvcnk3NzcwMTE=-flat-rsa_import_pkcs8.c-libtomcrypt-MDEwOlJlcG9zaXRvcnk3NzcwMTE=-flat-rsa_exptmod.c.html,0.1893939393939394,12,libtomcrypt-MDEwOlJlcG9zaXRvcnk3NzcwMTE=-flat-rsa_import_pkcs8.c,libtomcrypt-MDEwOlJlcG9zaXRvcnk3NzcwMTE=-flat-rsa_exptmod.c,26,30,4,65,67,2
296787,https://htmlpreview.github.io/?https://github.com/Christina96/boilerplate-sample-matches/blob/main/C/libtomcrypt-MDEwOlJlcG9zaXRvcnk3NzcwMTE=-flat-rmd128.c-libtomcrypt-MDEwOlJlcG9zaXRvcnk3NzcwMTE=-flat-sosemanuk.c.html,0.10982658959537572,9,libtomcrypt-MDEwOlJlcG9zaXRvcnk3NzcwMTE=-flat-rmd128.c,libtomcrypt-MDEwOlJlcG9zaXRvcnk3NzcwMTE=-flat-sosemanuk.c,56,188,132,250,270,20
298499,https://htmlpreview.github.io/?https://github.com/Christina96/boilerplate-sample-matches/blob/main/C/libtomcrypt-MDEwOlJlcG9zaXRvcnk3NzcwMTE=-flat-der_decode_object_identifier.c-PINRemoteImage-MDEwOlJlcG9zaXRvcnkzOTUzNzEwMw==-flat-frame_dec.c.html,0.034,8,libtomcrypt-MDEwOlJlcG9zaXRvcnk3NzcwMTE=-flat-der_decode_object_identifier.c,PINRemoteImage-MDEwOlJlcG9zaXRvcnkzOTUzNzEwMw==-flat-frame_dec.c,54,58,4,232,236,4
298934,https://htmlpreview.github.io/?https://github.com/Christina96/boilerplate-sample-matches/blob/main/C/libtomcrypt-MDEwOlJlcG9zaXRvcnk3NzcwMTE=-flat-eax_addheader.c-libtomcrypt-MDEwOlJlcG9zaXRvcnk3NzcwMTE=-flat-x25519_import_x509.c.html,0.391304347826087,9,libtomcrypt-MDEwOlJlcG9zaXRvcnk3NzcwMTE=-flat-eax_addheader.c,libtomcrypt-MDEwOlJlcG9zaXRvcnk3NzcwMTE=-flat-x25519_import_x509.c,3,7,4,9,12,3
298954,https://htmlpreview.github.io/?https://github.com/Christina96/boilerplate-sample-matches/blob/main/C/redis-MDEwOlJlcG9zaXRvcnkxMDgxMTA3MDY=-flat-stats_13.c-PINRemoteImage-MDEwOlJlcG9zaXRvcnkzOTUzNzEwMw==-flat-anim_encode.c.html,0.06787330316742081,9,redis-MDEwOlJlcG9zaXRvcnkxMDgxMTA3MDY=-flat-stats_13.c,PINRemoteImage-MDEwOlJlcG9zaXRvcnkzOTUzNzEwMw==-flat-anim_encode.c,438,446,8,779,787,8
300095,https://htmlpreview.github.io/?https://github.com/Christina96/boilerplate-sample-matches/blob/main/C/PINRemoteImage-MDEwOlJlcG9zaXRvcnkzOTUzNzEwMw==-flat-lossless.c-libfuse-MDEwOlJlcG9zaXRvcnk0ODI5NjE3Nw==-flat-iconv.c.html,0.060170045781556575,9,PINRemoteImage-MDEwOlJlcG9zaXRvcnkzOTUzNzEwMw==-flat-lossless.c,libfuse-MDEwOlJlcG9zaXRvcnk0ODI5NjE3Nw==-flat-iconv.c,382,388,6,543,551,8
300249,https://htmlpreview.github.io/?https://github.com/Christina96/boilerplate-sample-matches/blob/main/C/PINRemoteImage-MDEwOlJlcG9zaXRvcnkzOTUzNzEwMw==-flat-decode_39.h-fftw3-MDEwOlJlcG9zaXRvcnk4ODQzMzg4-flat-ct-hc2c-direct.c.html,0.12678936605316973,13,PINRemoteImage-MDEwOlJlcG9zaXRvcnkzOTUzNzEwMw==-flat-decode_39.h,fftw3-MDEwOlJlcG9zaXRvcnk4ODQzMzg4-flat-ct-hc2c-direct.c,53,61,8,263,272,9
300340,https://htmlpreview.github.io/?https://github.com/Christina96/boilerplate-sample-matches/blob/main/C/redis-MDEwOlJlcG9zaXRvcnkxMDgxMTA3MDY=-flat-tsd_win.h-redis-MDEwOlJlcG9zaXRvcnkxMDgxMTA3MDY=-flat-extent_24.c.html,0.04481434058898848,9,redis-MDEwOlJlcG9zaXRvcnkxMDgxMTA3MDY=-flat-tsd_win.h,redis-MDEwOlJlcG9zaXRvcnkxMDgxMTA3MDY=-flat-extent_24.c,58,67,9,187,199,12
301585,https://htmlpreview.github.io/?https://github.com/Christina96/boilerplate-sample-matches/blob/main/C/PINRemoteImage-MDEwOlJlcG9zaXRvcnkzOTUzNzEwMw==-flat-decode_45.h-Adafruit_nRF52_Arduino-MDEwOlJlcG9zaXRvcnk3NDM1NDcyOQ==-flat-nrf_clock.h.html,0.05204460966542751,14,PINRemoteImage-MDEwOlJlcG9zaXRvcnkzOTUzNzEwMw==-flat-decode_45.h,Adafruit_nRF52_Arduino-MDEwOlJlcG9zaXRvcnk3NDM1NDcyOQ==-flat-nrf_clock.h,52,60,8,134,153,19
302850,https://htmlpreview.github.io/?https://github.com/Christina96/boilerplate-sample-matches/blob/main/C/android-gpuimage-plus-MDEwOlJlcG9zaXRvcnk0NjU0NzQxNw==-flat-dict.h-PINRemoteImage-MDEwOlJlcG9zaXRvcnkzOTUzNzEwMw==-flat-decode_13.h.html,0.13991769547325103,8,android-gpuimage-plus-MDEwOlJlcG9zaXRvcnk0NjU0NzQxNw==-flat-dict.h,PINRemoteImage-MDEwOlJlcG9zaXRvcnkzOTUzNzEwMw==-flat-decode_13.h,25,27,2,29,39,10
304121,https://htmlpreview.github.io/?https://github.com/Christina96/boilerplate-sample-matches/blob/main/C/fftw3-MDEwOlJlcG9zaXRvcnk4ODQzMzg4-flat-amd64-cpuid.h-Adafruit_nRF52_Arduino-MDEwOlJlcG9zaXRvcnk3NDM1NDcyOQ==-flat-system_nrf52840.c.html,0.10526315789473684,9,fftw3-MDEwOlJlcG9zaXRvcnk4ODQzMzg4-flat-amd64-cpuid.h,Adafruit_nRF52_Arduino-MDEwOlJlcG9zaXRvcnk3NDM1NDcyOQ==-flat-system_nrf52840.c,22,34,12,50,58,8
304499,https://htmlpreview.github.io/?https://github.com/Christina96/boilerplate-sample-matches/blob/main/C/Adafruit_nRF52_Arduino-MDEwOlJlcG9zaXRvcnk3NDM1NDcyOQ==-flat-nrf_timer.h-PINRemoteImage-MDEwOlJlcG9zaXRvcnkzOTUzNzEwMw==-flat-vp8l_enc.c.html,0.01762891141472014,9,Adafruit_nRF52_Arduino-MDEwOlJlcG9zaXRvcnk3NDM1NDcyOQ==-flat-nrf_timer.h,PINRemoteImage-MDEwOlJlcG9zaXRvcnkzOTUzNzEwMw==-flat-vp8l_enc.c,79,91,12,199,223,24
305318,https://htmlpreview.github.io/?https://github.com/Christina96/boilerplate-sample-matches/blob/main/C/libtomcrypt-MDEwOlJlcG9zaXRvcnk3NzcwMTE=-flat-f8_encrypt.c-libtomcrypt-MDEwOlJlcG9zaXRvcnk3NzcwMTE=-flat-der_length_ia5_string.c.html,0.047872340425531915,9,libtomcrypt-MDEwOlJlcG9zaXRvcnk3NzcwMTE=-flat-f8_encrypt.c,libtomcrypt-MDEwOlJlcG9zaXRvcnk3NzcwMTE=-flat-der_length_ia5_string.c,3,4,1,129,130,1
306542,https://htmlpreview.github.io/?https://github.com/Christina96/boilerplate-sample-matches/blob/main/C/xmrig-MDEwOlJlcG9zaXRvcnk4ODMyNzQwNg==-flat-blake2b_sse41.c-redis-MDEwOlJlcG9zaXRvcnkxMDgxMTA3MDY=-flat-libevent.h.html,0.15,9,xmrig-MDEwOlJlcG9zaXRvcnk4ODMyNzQwNg==-flat-blake2b_sse41.c,redis-MDEwOlJlcG9zaXRvcnkxMDgxMTA3MDY=-flat-libevent.h,35,43,8,48,56,8
306643,https://htmlpreview.github.io/?https://github.com/Christina96/boilerplate-sample-matches/blob/main/C/fftw3-MDEwOlJlcG9zaXRvcnk4ODQzMzg4-flat-bench-main.c-redis-MDEwOlJlcG9zaXRvcnkxMDgxMTA3MDY=-flat-object.c.html,0.023653088042049936,10,fftw3-MDEwOlJlcG9zaXRvcnk4ODQzMzg4-flat-bench-main.c,redis-MDEwOlJlcG9zaXRvcnkxMDgxMTA3MDY=-flat-object.c,54,69,15,237,242,5
306747,https://htmlpreview.github.io/?https://github.com/Christina96/boilerplate-sample-matches/blob/main/C/xmrig-MDEwOlJlcG9zaXRvcnk4ODMyNzQwNg==-flat-FailoverStrategy.h-xmrig-MDEwOlJlcG9zaXRvcnk4ODMyNzQwNg==-flat-BlockTemplate.h.html,0.06593406593406594,9,xmrig-MDEwOlJlcG9zaXRvcnk4ODMyNzQwNg==-flat-FailoverStrategy.h,xmrig-MDEwOlJlcG9zaXRvcnk4ODMyNzQwNg==-flat-BlockTemplate.h,20,21,1,35,36,1
307929,https://htmlpreview.github.io/?https://github.com/Christina96/boilerplate-sample-matches/blob/main/C/PINRemoteImage-MDEwOlJlcG9zaXRvcnkzOTUzNzEwMw==-flat-gifdec.c-PINRemoteImage-MDEwOlJlcG9zaXRvcnkzOTUzNzEwMw==-flat-dec.c.html,0.035555555555555556,11,PINRemoteImage-MDEwOlJlcG9zaXRvcnkzOTUzNzEwMw==-flat-gifdec.c,PINRemoteImage-MDEwOlJlcG9zaXRvcnkzOTUzNzEwMw==-flat-dec.c,47,50,3,51,54,3
307931,https://htmlpreview.github.io/?https://github.com/Christina96/boilerplate-sample-matches/blob/main/C/PINRemoteImage-MDEwOlJlcG9zaXRvcnkzOTUzNzEwMw==-flat-gifdec.c-PINRemoteImage-MDEwOlJlcG9zaXRvcnkzOTUzNzEwMw==-flat-dec.c.html,0.035555555555555556,8,PINRemoteImage-MDEwOlJlcG9zaXRvcnkzOTUzNzEwMw==-flat-gifdec.c,PINRemoteImage-MDEwOlJlcG9zaXRvcnkzOTUzNzEwMw==-flat-dec.c,118,120,2,194,201,7
308172,https://htmlpreview.github.io/?https://github.com/Christina96/boilerplate-sample-matches/blob/main/C/libtomcrypt-MDEwOlJlcG9zaXRvcnk3NzcwMTE=-flat-sober128_stream_memory.c-redis-MDEwOlJlcG9zaXRvcnkxMDgxMTA3MDY=-flat-db.c.html,0.01288244766505636,8,libtomcrypt-MDEwOlJlcG9zaXRvcnk3NzcwMTE=-flat-sober128_stream_memory.c,redis-MDEwOlJlcG9zaXRvcnkxMDgxMTA3MDY=-flat-db.c,5,9,4,916,918,2
308613,https://htmlpreview.github.io/?https://github.com/Christina96/boilerplate-sample-matches/blob/main/C/libtomcrypt-MDEwOlJlcG9zaXRvcnk3NzcwMTE=-flat-hash_file.c-PINRemoteImage-MDEwOlJlcG9zaXRvcnkzOTUzNzEwMw==-flat-vp8_dec.c.html,0.018018018018018018,8,libtomcrypt-MDEwOlJlcG9zaXRvcnk3NzcwMTE=-flat-hash_file.c,PINRemoteImage-MDEwOlJlcG9zaXRvcnkzOTUzNzEwMw==-flat-vp8_dec.c,14,20,6,283,290,7
308978,https://htmlpreview.github.io/?https://github.com/Christina96/boilerplate-sample-matches/blob/main/C/fftw3-MDEwOlJlcG9zaXRvcnk4ODQzMzg4-flat-direct2.c-fftw3-MDEwOlJlcG9zaXRvcnk4ODQzMzg4-flat-generic_9.c.html,0.2719033232628399,8,fftw3-MDEwOlJlcG9zaXRvcnk4ODQzMzg4-flat-direct2.c,fftw3-MDEwOlJlcG9zaXRvcnk4ODQzMzg4-flat-generic_9.c,23,27,4,43,47,4
309857,https://htmlpreview.github.io/?https://github.com/Christina96/boilerplate-sample-matches/blob/main/C/PINRemoteImage-MDEwOlJlcG9zaXRvcnkzOTUzNzEwMw==-flat-demux_24.h-libtomcrypt-MDEwOlJlcG9zaXRvcnk3NzcwMTE=-flat-rc2.c.html,0.0300187617260788,8,PINRemoteImage-MDEwOlJlcG9zaXRvcnkzOTUzNzEwMw==-flat-demux_24.h,libtomcrypt-MDEwOlJlcG9zaXRvcnk3NzcwMTE=-flat-rc2.c,41,50,9,3,12,9
310013,https://htmlpreview.github.io/?https://github.com/Christina96/boilerplate-sample-matches/blob/main/C/Adafruit_nRF52_Arduino-MDEwOlJlcG9zaXRvcnk3NDM1NDcyOQ==-flat-nrfx_gppi.h-libtomcrypt-MDEwOlJlcG9zaXRvcnk3NzcwMTE=-flat-blake2bmac_test.c.html,0.16085790884718498,34,Adafruit_nRF52_Arduino-MDEwOlJlcG9zaXRvcnk3NDM1NDcyOQ==-flat-nrfx_gppi.h,libtomcrypt-MDEwOlJlcG9zaXRvcnk3NzcwMTE=-flat-blake2bmac_test.c,120,199,79,9,26,17
310039,https://htmlpreview.github.io/?https://github.com/Christina96/boilerplate-sample-matches/blob/main/C/redis-MDEwOlJlcG9zaXRvcnkxMDgxMTA3MDY=-flat-rdb.h-libtomcrypt-MDEwOlJlcG9zaXRvcnk3NzcwMTE=-flat-kseed.c.html,0.12121212121212122,14,redis-MDEwOlJlcG9zaXRvcnkxMDgxMTA3MDY=-flat-rdb.h,libtomcrypt-MDEwOlJlcG9zaXRvcnk3NzcwMTE=-flat-kseed.c,55,67,12,13,13,0
310695,https://htmlpreview.github.io/?https://github.com/Christina96/boilerplate-sample-matches/blob/main/C/Adafruit_nRF52_Arduino-MDEwOlJlcG9zaXRvcnk3NDM1NDcyOQ==-flat-nrfx_uarte.h-Adafruit_nRF52_Arduino-MDEwOlJlcG9zaXRvcnk3NDM1NDcyOQ==-flat-nrfx_power.h.html,0.25862068965517243,15,Adafruit_nRF52_Arduino-MDEwOlJlcG9zaXRvcnk3NDM1NDcyOQ==-flat-nrfx_uarte.h,Adafruit_nRF52_Arduino-MDEwOlJlcG9zaXRvcnk3NDM1NDcyOQ==-flat-nrfx_power.h,41,91,50,64,91,27
310801,https://htmlpreview.github.io/?https://github.com/Christina96/boilerplate-sample-matches/blob/main/C/PINRemoteImage-MDEwOlJlcG9zaXRvcnkzOTUzNzEwMw==-flat-iterator_enc.c-PINRemoteImage-MDEwOlJlcG9zaXRvcnkzOTUzNzEwMw==-flat-webpmux.c.html,0.0567741935483871,9,PINRemoteImage-MDEwOlJlcG9zaXRvcnkzOTUzNzEwMw==-flat-iterator_enc.c,PINRemoteImage-MDEwOlJlcG9zaXRvcnkzOTUzNzEwMw==-flat-webpmux.c,210,214,4,133,143,10
312324,https://htmlpreview.github.io/?https://github.com/Christina96/boilerplate-sample-matches/blob/main/C/Adafruit_nRF52_Arduino-MDEwOlJlcG9zaXRvcnk3NDM1NDcyOQ==-flat-nrf_pwm.h-Adafruit_nRF52_Arduino-MDEwOlJlcG9zaXRvcnk3NDM1NDcyOQ==-flat-nrf_spim.h.html,0.6342592592592593,18,Adafruit_nRF52_Arduino-MDEwOlJlcG9zaXRvcnk3NDM1NDcyOQ==-flat-nrf_pwm.h,Adafruit_nRF52_Arduino-MDEwOlJlcG9zaXRvcnk3NDM1NDcyOQ==-flat-nrf_spim.h,294,335,41,372,397,25
316510,https://htmlpreview.github.io/?https://github.com/Christina96/boilerplate-sample-matches/blob/main/C/redis-MDEwOlJlcG9zaXRvcnkxMDgxMTA3MDY=-flat-tsd_win.h-libfuse-MDEwOlJlcG9zaXRvcnk0ODI5NjE3Nw==-flat-fuse_opt.c.html,0.026143790849673203,8,redis-MDEwOlJlcG9zaXRvcnkxMDgxMTA3MDY=-flat-tsd_win.h,libfuse-MDEwOlJlcG9zaXRvcnk0ODI5NjE3Nw==-flat-fuse_opt.c,59,67,8,285,293,8
318226,https://htmlpreview.github.io/?https://github.com/Christina96/boilerplate-sample-matches/blob/main/C/fftw3-MDEwOlJlcG9zaXRvcnk4ODQzMzg4-flat-vrank-geq1-rdft2_18.c-fftw3-MDEwOlJlcG9zaXRvcnk4ODQzMzg4-flat-simd-altivec.h.html,0.03364485981308411,9,fftw3-MDEwOlJlcG9zaXRvcnk4ODQzMzg4-flat-vrank-geq1-rdft2_18.c,fftw3-MDEwOlJlcG9zaXRvcnk4ODQzMzg4-flat-simd-altivec.h,32,39,7,182,188,6
318429,https://htmlpreview.github.io/?https://github.com/Christina96/boilerplate-sample-matches/blob/main/C/libtomcrypt-MDEwOlJlcG9zaXRvcnk3NzcwMTE=-flat-rsa_verify_hash.c-redis-MDEwOlJlcG9zaXRvcnkxMDgxMTA3MDY=-flat-pages_20.c.html,0.02877697841726619,8,libtomcrypt-MDEwOlJlcG9zaXRvcnk3NzcwMTE=-flat-rsa_verify_hash.c,redis-MDEwOlJlcG9zaXRvcnkxMDgxMTA3MDY=-flat-pages_20.c,30,35,5,163,169,6
318484,https://htmlpreview.github.io/?https://github.com/Christina96/boilerplate-sample-matches/blob/main/C/libtomcrypt-MDEwOlJlcG9zaXRvcnk3NzcwMTE=-flat-saferp_optimizer.c-PINRemoteImage-MDEwOlJlcG9zaXRvcnkzOTUzNzEwMw==-flat-frame_enc.c.html,0.05173951828724353,10,libtomcrypt-MDEwOlJlcG9zaXRvcnk3NzcwMTE=-flat-saferp_optimizer.c,PINRemoteImage-MDEwOlJlcG9zaXRvcnkzOTUzNzEwMw==-flat-frame_enc.c,100,110,10,300,304,4
319420,https://htmlpreview.github.io/?https://github.com/Christina96/boilerplate-sample-matches/blob/main/C/Adafruit_nRF52_Arduino-MDEwOlJlcG9zaXRvcnk3NDM1NDcyOQ==-flat-wiring.c-xmrig-MDEwOlJlcG9zaXRvcnk4ODMyNzQwNg==-flat-c_blake256.c.html,0.13134328358208955,8,Adafruit_nRF52_Arduino-MDEwOlJlcG9zaXRvcnk3NDM1NDcyOQ==-flat-wiring.c,xmrig-MDEwOlJlcG9zaXRvcnk4ODMyNzQwNg==-flat-c_blake256.c,50,64,14,12,16,4
321097,https://htmlpreview.github.io/?https://github.com/Christina96/boilerplate-sample-matches/blob/main/C/xmrig-MDEwOlJlcG9zaXRvcnk4ODMyNzQwNg==-flat-reciprocal.c-libfuse-MDEwOlJlcG9zaXRvcnk0ODI5NjE3Nw==-flat-fusermount.c.html,0.013131976362442548,10,xmrig-MDEwOlJlcG9zaXRvcnk4ODMyNzQwNg==-flat-reciprocal.c,libfuse-MDEwOlJlcG9zaXRvcnk0ODI5NjE3Nw==-flat-fusermount.c,11,18,7,314,320,6
321110,https://htmlpreview.github.io/?https://github.com/Christina96/boilerplate-sample-matches/blob/main/C/fftw3-MDEwOlJlcG9zaXRvcnk4ODQzMzg4-flat-rank-geq2-rdft2.c-fftw3-MDEwOlJlcG9zaXRvcnk4ODQzMzg4-flat-generic_9.c.html,0.29292929292929293,8,fftw3-MDEwOlJlcG9zaXRvcnk4ODQzMzg4-flat-rank-geq2-rdft2.c,fftw3-MDEwOlJlcG9zaXRvcnk4ODQzMzg4-flat-generic_9.c,33,40,7,100,108,8
321235,https://htmlpreview.github.io/?https://github.com/Christina96/boilerplate-sample-matches/blob/main/C/Adafruit_nRF52_Arduino-MDEwOlJlcG9zaXRvcnk3NDM1NDcyOQ==-flat-BLECharacteristic.h-PINRemoteImage-MDEwOlJlcG9zaXRvcnkzOTUzNzEwMw==-flat-backward_references_enc.c.html,0.028169014084507043,8,Adafruit_nRF52_Arduino-MDEwOlJlcG9zaXRvcnk3NDM1NDcyOQ==-flat-BLECharacteristic.h,PINRemoteImage-MDEwOlJlcG9zaXRvcnkzOTUzNzEwMw==-flat-backward_references_enc.c,8,15,7,201,206,5
322481,https://htmlpreview.github.io/?https://github.com/Christina96/boilerplate-sample-matches/blob/main/C/xmrig-MDEwOlJlcG9zaXRvcnk4ODMyNzQwNg==-flat-plugins.h-xmrig-MDEwOlJlcG9zaXRvcnk4ODMyNzQwNg==-flat-uri.h.html,0.022889842632331903,8,xmrig-MDEwOlJlcG9zaXRvcnk4ODMyNzQwNg==-flat-plugins.h,xmrig-MDEwOlJlcG9zaXRvcnk4ODMyNzQwNg==-flat-uri.h,22,29,7,167,174,7
323157,https://htmlpreview.github.io/?https://github.com/Christina96/boilerplate-sample-matches/blob/main/C/libtomcrypt-MDEwOlJlcG9zaXRvcnk3NzcwMTE=-flat-ocb_test.c-redis-MDEwOlJlcG9zaXRvcnkxMDgxMTA3MDY=-flat-config.c.html,0.05221052631578947,11,libtomcrypt-MDEwOlJlcG9zaXRvcnk3NzcwMTE=-flat-ocb_test.c,redis-MDEwOlJlcG9zaXRvcnkxMDgxMTA3MDY=-flat-config.c,23,32,9,27,32,5
324632,https://htmlpreview.github.io/?https://github.com/Christina96/boilerplate-sample-matches/blob/main/C/redis-MDEwOlJlcG9zaXRvcnkxMDgxMTA3MDY=-flat-pubsub.c-Adafruit_nRF52_Arduino-MDEwOlJlcG9zaXRvcnk3NDM1NDcyOQ==-flat-nrfx_gpiote.c.html,0.04576043068640646,9,redis-MDEwOlJlcG9zaXRvcnkxMDgxMTA3MDY=-flat-pubsub.c,Adafruit_nRF52_Arduino-MDEwOlJlcG9zaXRvcnk3NDM1NDcyOQ==-flat-nrfx_gpiote.c,25,38,13,544,552,8
326278,https://htmlpreview.github.io/?https://github.com/Christina96/boilerplate-sample-matches/blob/main/C/android-gpuimage-plus-MDEwOlJlcG9zaXRvcnk0NjU0NzQxNw==-flat-hwcontext.h-fftw3-MDEwOlJlcG9zaXRvcnk4ODQzMzg4-flat-transpose-pairwise.c.html,0.034858387799564274,8,android-gpuimage-plus-MDEwOlJlcG9zaXRvcnk0NjU0NzQxNw==-flat-hwcontext.h,fftw3-MDEwOlJlcG9zaXRvcnk4ODQzMzg4-flat-transpose-pairwise.c,77,82,5,173,180,7
327953,https://htmlpreview.github.io/?https://github.com/Christina96/boilerplate-sample-matches/blob/main/C/small-MDEwOlJlcG9zaXRvcnkyNTY3NjMxNjk=-flat-list.c-libpcap-MDEwOlJlcG9zaXRvcnk5NDM1ODg3-flat-pcap-tc.c.html,0.030217186024551465,16,small-MDEwOlJlcG9zaXRvcnkyNTY3NjMxNjk=-flat-list.c,libpcap-MDEwOlJlcG9zaXRvcnk5NDM1ODg3-flat-pcap-tc.c,12,26,14,422,437,15
328148,https://htmlpreview.github.io/?https://github.com/Christina96/boilerplate-sample-matches/blob/main/C/libtomcrypt-MDEwOlJlcG9zaXRvcnk3NzcwMTE=-flat-rsa_make_key.c-libtomcrypt-MDEwOlJlcG9zaXRvcnk3NzcwMTE=-flat-des.c.html,0.02564102564102564,9,libtomcrypt-MDEwOlJlcG9zaXRvcnk3NzcwMTE=-flat-rsa_make_key.c,libtomcrypt-MDEwOlJlcG9zaXRvcnk3NzcwMTE=-flat-des.c,50,57,7,1861,1867,6
328525,https://htmlpreview.github.io/?https://github.com/Christina96/boilerplate-sample-matches/blob/main/C/redis-MDEwOlJlcG9zaXRvcnkxMDgxMTA3MDY=-flat-t_list.c-small-MDEwOlJlcG9zaXRvcnkyNTY3NjMxNjk=-flat-server.c.html,0.0486322188449848,9,redis-MDEwOlJlcG9zaXRvcnkxMDgxMTA3MDY=-flat-t_list.c,small-MDEwOlJlcG9zaXRvcnkyNTY3NjMxNjk=-flat-server.c,75,82,7,1133,1143,10
328620,https://htmlpreview.github.io/?https://github.com/Christina96/boilerplate-sample-matches/blob/main/C/android-gpuimage-plus-MDEwOlJlcG9zaXRvcnk0NjU0NzQxNw==-flat-pixfmt.h-redis-MDEwOlJlcG9zaXRvcnkxMDgxMTA3MDY=-flat-hyperloglog.c.html,0.11775043936731107,22,android-gpuimage-plus-MDEwOlJlcG9zaXRvcnk0NjU0NzQxNw==-flat-pixfmt.h,redis-MDEwOlJlcG9zaXRvcnkxMDgxMTA3MDY=-flat-hyperloglog.c,309,330,21,156,177,21
329494,https://htmlpreview.github.io/?https://github.com/Christina96/boilerplate-sample-matches/blob/main/C/libtomcrypt-MDEwOlJlcG9zaXRvcnk3NzcwMTE=-flat-blake2bmac_memory_multi.c-libtomcrypt-MDEwOlJlcG9zaXRvcnk3NzcwMTE=-flat-pmac_memory_multi.c.html,0.6507936507936508,28,libtomcrypt-MDEwOlJlcG9zaXRvcnk3NzcwMTE=-flat-blake2bmac_memory_multi.c,libtomcrypt-MDEwOlJlcG9zaXRvcnk3NzcwMTE=-flat-pmac_memory_multi.c,4,16,12,4,18,14
329519,https://htmlpreview.github.io/?https://github.com/Christina96/boilerplate-sample-matches/blob/main/C/fftw3-MDEwOlJlcG9zaXRvcnk4ODQzMzg4-flat-rdft.h-Adafruit_nRF52_Arduino-MDEwOlJlcG9zaXRvcnk3NDM1NDcyOQ==-flat-nrf_power.h.html,0.03587443946188341,8,fftw3-MDEwOlJlcG9zaXRvcnk4ODQzMzg4-flat-rdft.h,Adafruit_nRF52_Arduino-MDEwOlJlcG9zaXRvcnk3NDM1NDcyOQ==-flat-nrf_power.h,20,31,11,267,297,30
330528,https://htmlpreview.github.io/?https://github.com/Christina96/boilerplate-sample-matches/blob/main/C/PINRemoteImage-MDEwOlJlcG9zaXRvcnkzOTUzNzEwMw==-flat-picture_csp_enc.c-redis-MDEwOlJlcG9zaXRvcnkxMDgxMTA3MDY=-flat-ctl.c.html,0.04367271770586688,8,PINRemoteImage-MDEwOlJlcG9zaXRvcnkzOTUzNzEwMw==-flat-picture_csp_enc.c,redis-MDEwOlJlcG9zaXRvcnkxMDgxMTA3MDY=-flat-ctl.c,79,84,5,1916,1923,7
332427,https://htmlpreview.github.io/?https://github.com/Christina96/boilerplate-sample-matches/blob/main/C/Adafruit_nRF52_Arduino-MDEwOlJlcG9zaXRvcnk3NDM1NDcyOQ==-flat-nrf_ccm.h-Adafruit_nRF52_Arduino-MDEwOlJlcG9zaXRvcnk3NDM1NDcyOQ==-flat-nrf_clock.h.html,0.42362525458248473,13,Adafruit_nRF52_Arduino-MDEwOlJlcG9zaXRvcnk3NDM1NDcyOQ==-flat-nrf_ccm.h,Adafruit_nRF52_Arduino-MDEwOlJlcG9zaXRvcnk3NDM1NDcyOQ==-flat-nrf_clock.h,151,176,25,235,263,28
332933,https://htmlpreview.github.io/?https://github.com/Christina96/boilerplate-sample-matches/blob/main/C/libtomcrypt-MDEwOlJlcG9zaXRvcnk3NzcwMTE=-flat-eax_encrypt_authenticate_memory.c-libtomcrypt-MDEwOlJlcG9zaXRvcnk3NzcwMTE=-flat-gcm_test.c.html,0.06430868167202572,10,libtomcrypt-MDEwOlJlcG9zaXRvcnk3NzcwMTE=-flat-eax_encrypt_authenticate_memory.c,libtomcrypt-MDEwOlJlcG9zaXRvcnk3NzcwMTE=-flat-gcm_test.c,7,9,2,11,15,4
333820,https://htmlpreview.github.io/?https://github.com/Christina96/boilerplate-sample-matches/blob/main/C/libtomcrypt-MDEwOlJlcG9zaXRvcnk3NzcwMTE=-flat-ccm_test.c-libtomcrypt-MDEwOlJlcG9zaXRvcnk3NzcwMTE=-flat-padding_test.c.html,0.22012578616352202,11,libtomcrypt-MDEwOlJlcG9zaXRvcnk3NzcwMTE=-flat-ccm_test.c,libtomcrypt-MDEwOlJlcG9zaXRvcnk3NzcwMTE=-flat-padding_test.c,212,216,4,179,183,4
334458,https://htmlpreview.github.io/?https://github.com/Christina96/boilerplate-sample-matches/blob/main/C/libpcap-MDEwOlJlcG9zaXRvcnk5NDM1ODg3-flat-sslutils.c-libfuse-MDEwOlJlcG9zaXRvcnk0ODI5NjE3Nw==-flat-buffer.c.html,0.04435483870967742,11,libpcap-MDEwOlJlcG9zaXRvcnk5NDM1ODg3-flat-sslutils.c,libfuse-MDEwOlJlcG9zaXRvcnk0ODI5NjE3Nw==-flat-buffer.c,142,151,9,197,201,4
336199,https://htmlpreview.github.io/?https://github.com/Christina96/boilerplate-sample-matches/blob/main/C/libtomcrypt-MDEwOlJlcG9zaXRvcnk3NzcwMTE=-flat-yarrow.c-libfuse-MDEwOlJlcG9zaXRvcnk0ODI5NjE3Nw==-flat-helper.c.html,0.03143418467583497,8,libtomcrypt-MDEwOlJlcG9zaXRvcnk3NzcwMTE=-flat-yarrow.c,libfuse-MDEwOlJlcG9zaXRvcnk0ODI5NjE3Nw==-flat-helper.c,154,161,7,258,265,7
337361,https://htmlpreview.github.io/?https://github.com/Christina96/boilerplate-sample-matches/blob/main/C/PINRemoteImage-MDEwOlJlcG9zaXRvcnkzOTUzNzEwMw==-flat-delta_palettization_enc.c-PINRemoteImage-MDEwOlJlcG9zaXRvcnkzOTUzNzEwMw==-flat-vp8l_dec.c.html,0.049491825011047284,8,PINRemoteImage-MDEwOlJlcG9zaXRvcnkzOTUzNzEwMw==-flat-delta_palettization_enc.c,PINRemoteImage-MDEwOlJlcG9zaXRvcnkzOTUzNzEwMw==-flat-vp8l_dec.c,264,270,6,108,113,5
337798,https://htmlpreview.github.io/?https://github.com/Christina96/boilerplate-sample-matches/blob/main/C/redis-MDEwOlJlcG9zaXRvcnkxMDgxMTA3MDY=-flat-hash.h-libpcap-MDEwOlJlcG9zaXRvcnk5NDM1ODg3-flat-pcap-tc.c.html,0.06408094435075885,20,redis-MDEwOlJlcG9zaXRvcnkxMDgxMTA3MDY=-flat-hash.h,libpcap-MDEwOlJlcG9zaXRvcnk5NDM1ODg3-flat-pcap-tc.c,99,109,10,213,232,19
337804,https://htmlpreview.github.io/?https://github.com/Christina96/boilerplate-sample-matches/blob/main/C/libtomcrypt-MDEwOlJlcG9zaXRvcnk3NzcwMTE=-flat-cbc_decrypt.c-libtomcrypt-MDEwOlJlcG9zaXRvcnk3NzcwMTE=-flat-pmac_test.c.html,0.08791208791208792,8,libtomcrypt-MDEwOlJlcG9zaXRvcnk3NzcwMTE=-flat-cbc_decrypt.c,libtomcrypt-MDEwOlJlcG9zaXRvcnk3NzcwMTE=-flat-pmac_test.c,21,27,6,81,86,5
340229,https://htmlpreview.github.io/?https://github.com/Christina96/boilerplate-sample-matches/blob/main/C/libtomcrypt-MDEwOlJlcG9zaXRvcnk3NzcwMTE=-flat-padding_test.c-PINRemoteImage-MDEwOlJlcG9zaXRvcnkzOTUzNzEwMw==-flat-histogram_enc.c.html,0.01061320754716981,9,libtomcrypt-MDEwOlJlcG9zaXRvcnk3NzcwMTE=-flat-padding_test.c,PINRemoteImage-MDEwOlJlcG9zaXRvcnkzOTUzNzEwMw==-flat-histogram_enc.c,79,86,7,119,125,6
340684,https://htmlpreview.github.io/?https://github.com/Christina96/boilerplate-sample-matches/blob/main/C/Adafruit_nRF52_Arduino-MDEwOlJlcG9zaXRvcnk3NDM1NDcyOQ==-flat-SEGGER_RTT_printf.c-libfuse-MDEwOlJlcG9zaXRvcnk0ODI5NjE3Nw==-flat-passthrough.c.html,0.017640573318632856,8,Adafruit_nRF52_Arduino-MDEwOlJlcG9zaXRvcnk3NDM1NDcyOQ==-flat-SEGGER_RTT_printf.c,libfuse-MDEwOlJlcG9zaXRvcnk0ODI5NjE3Nw==-flat-passthrough.c,27,31,4,414,418,4
341904,https://htmlpreview.github.io/?https://github.com/Christina96/boilerplate-sample-matches/blob/main/C/redis-MDEwOlJlcG9zaXRvcnkxMDgxMTA3MDY=-flat-ql.c-xmrig-MDEwOlJlcG9zaXRvcnk4ODMyNzQwNg==-flat-argon2-avx512f.c.html,0.13043478260869565,8,redis-MDEwOlJlcG9zaXRvcnkxMDgxMTA3MDY=-flat-ql.c,xmrig-MDEwOlJlcG9zaXRvcnk4ODMyNzQwNg==-flat-argon2-avx512f.c,37,42,5,165,170,5
342611,https://htmlpreview.github.io/?https://github.com/Christina96/boilerplate-sample-matches/blob/main/C/xmrig-MDEwOlJlcG9zaXRvcnk4ODMyNzQwNg==-flat-usage.h-libfuse-MDEwOlJlcG9zaXRvcnk0ODI5NjE3Nw==-flat-passthrough_ll.c.html,0.07750631844987363,36,xmrig-MDEwOlJlcG9zaXRvcnk4ODMyNzQwNg==-flat-usage.h,libfuse-MDEwOlJlcG9zaXRvcnk0ODI5NjE3Nw==-flat-passthrough_ll.c,12,51,39,906,943,37
343423,https://htmlpreview.github.io/?https://github.com/Christina96/boilerplate-sample-matches/blob/main/C/PINRemoteImage-MDEwOlJlcG9zaXRvcnkzOTUzNzEwMw==-flat-backward_references_cost_enc.c-libfuse-MDEwOlJlcG9zaXRvcnk0ODI5NjE3Nw==-flat-test_syscalls.c.html,0.028561476837338905,8,PINRemoteImage-MDEwOlJlcG9zaXRvcnkzOTUzNzEwMw==-flat-backward_references_cost_enc.c,libfuse-MDEwOlJlcG9zaXRvcnk0ODI5NjE3Nw==-flat-test_syscalls.c,218,222,4,692,696,4
344795,https://htmlpreview.github.io/?https://github.com/Christina96/boilerplate-sample-matches/blob/main/C/redis-MDEwOlJlcG9zaXRvcnkxMDgxMTA3MDY=-flat-expire.c-PINRemoteImage-MDEwOlJlcG9zaXRvcnkzOTUzNzEwMw==-flat-webp_dec.c.html,0.058355437665782495,9,redis-MDEwOlJlcG9zaXRvcnkxMDgxMTA3MDY=-flat-expire.c,PINRemoteImage-MDEwOlJlcG9zaXRvcnkzOTUzNzEwMw==-flat-webp_dec.c,103,108,5,403,411,8
345196,https://htmlpreview.github.io/?https://github.com/Christina96/boilerplate-sample-matches/blob/main/C/PINRemoteImage-MDEwOlJlcG9zaXRvcnkzOTUzNzEwMw==-flat-decode_33.h-PINRemoteImage-MDEwOlJlcG9zaXRvcnkzOTUzNzEwMw==-flat-idec_dec.c.html,0.02280130293159609,14,PINRemoteImage-MDEwOlJlcG9zaXRvcnkzOTUzNzEwMw==-flat-decode_33.h,PINRemoteImage-MDEwOlJlcG9zaXRvcnkzOTUzNzEwMw==-flat-idec_dec.c,53,62,9,576,589,13
345230,https://htmlpreview.github.io/?https://github.com/Christina96/boilerplate-sample-matches/blob/main/C/libpcap-MDEwOlJlcG9zaXRvcnk5NDM1ODg3-flat-sslutils.h-redis-MDEwOlJlcG9zaXRvcnkxMDgxMTA3MDY=-flat-geohash_32.h.html,0.2857142857142857,11,libpcap-MDEwOlJlcG9zaXRvcnk5NDM1ODg3-flat-sslutils.h,redis-MDEwOlJlcG9zaXRvcnkxMDgxMTA3MDY=-flat-geohash_32.h,8,12,4,51,58,7
345332,https://htmlpreview.github.io/?https://github.com/Christina96/boilerplate-sample-matches/blob/main/C/fftw3-MDEwOlJlcG9zaXRvcnk4ODQzMzg4-flat-rodft00e-r2hc.c-fftw3-MDEwOlJlcG9zaXRvcnk4ODQzMzg4-flat-dftw-direct.c.html,0.23529411764705882,14,fftw3-MDEwOlJlcG9zaXRvcnk4ODQzMzg4-flat-rodft00e-r2hc.c,fftw3-MDEwOlJlcG9zaXRvcnk4ODQzMzg4-flat-dftw-direct.c,13,19,6,60,67,7
347413,https://htmlpreview.github.io/?https://github.com/Christina96/boilerplate-sample-matches/blob/main/C/libfuse-MDEwOlJlcG9zaXRvcnk0ODI5NjE3Nw==-flat-passthrough.c-libfuse-MDEwOlJlcG9zaXRvcnk0ODI5NjE3Nw==-flat-fuse.c.html,0.03339917399892261,9,libfuse-MDEwOlJlcG9zaXRvcnk0ODI5NjE3Nw==-flat-passthrough.c,libfuse-MDEwOlJlcG9zaXRvcnk0ODI5NjE3Nw==-flat-fuse.c,83,87,4,201,205,4
348531,https://htmlpreview.github.io/?https://github.com/Christina96/boilerplate-sample-matches/blob/main/C/small-MDEwOlJlcG9zaXRvcnkyNTY3NjMxNjk=-flat-tls1.2_ticket.c-PINRemoteImage-MDEwOlJlcG9zaXRvcnkzOTUzNzEwMw==-flat-picture_csp_enc.c.html,0.07001044932079414,8,small-MDEwOlJlcG9zaXRvcnkyNTY3NjMxNjk=-flat-tls1.2_ticket.c,PINRemoteImage-MDEwOlJlcG9zaXRvcnkzOTUzNzEwMw==-flat-picture_csp_enc.c,267,275,8,664,670,6
348692,https://htmlpreview.github.io/?https://github.com/Christina96/boilerplate-sample-matches/blob/main/C/libtomcrypt-MDEwOlJlcG9zaXRvcnk3NzcwMTE=-flat-yarrow.c-libtomcrypt-MDEwOlJlcG9zaXRvcnk3NzcwMTE=-flat-rsa_make_key.c.html,0.31876606683804626,11,libtomcrypt-MDEwOlJlcG9zaXRvcnk3NzcwMTE=-flat-yarrow.c,libtomcrypt-MDEwOlJlcG9zaXRvcnk3NzcwMTE=-flat-rsa_make_key.c,129,135,6,22,23,1
349389,https://htmlpreview.github.io/?https://github.com/Christina96/boilerplate-sample-matches/blob/main/C/fftw3-MDEwOlJlcG9zaXRvcnk4ODQzMzg4-flat-avx2.c-fftw3-MDEwOlJlcG9zaXRvcnk4ODQzMzg4-flat-neon.c.html,0.25396825396825395,8,fftw3-MDEwOlJlcG9zaXRvcnk4ODQzMzg4-flat-avx2.c,fftw3-MDEwOlJlcG9zaXRvcnk4ODQzMzg4-flat-neon.c,24,31,7,30,38,8
349744,https://htmlpreview.github.io/?https://github.com/Christina96/boilerplate-sample-matches/blob/main/C/libtomcrypt-MDEwOlJlcG9zaXRvcnk3NzcwMTE=-flat-pelican_memory.c-libtomcrypt-MDEwOlJlcG9zaXRvcnk3NzcwMTE=-flat-dsa_generate_pqg.c.html,0.05099150141643059,9,libtomcrypt-MDEwOlJlcG9zaXRvcnk3NzcwMTE=-flat-pelican_memory.c,libtomcrypt-MDEwOlJlcG9zaXRvcnk3NzcwMTE=-flat-dsa_generate_pqg.c,13,21,8,37,41,4
350842,https://htmlpreview.github.io/?https://github.com/Christina96/boilerplate-sample-matches/blob/main/C/redis-MDEwOlJlcG9zaXRvcnkxMDgxMTA3MDY=-flat-lua_bit.c-libfuse-MDEwOlJlcG9zaXRvcnk0ODI5NjE3Nw==-flat-mount.fuse.c.html,0.031936127744510975,8,redis-MDEwOlJlcG9zaXRvcnkxMDgxMTA3MDY=-flat-lua_bit.c,libfuse-MDEwOlJlcG9zaXRvcnk0ODI5NjE3Nw==-flat-mount.fuse.c,44,58,14,48,55,7
351384,https://htmlpreview.github.io/?https://github.com/Christina96/boilerplate-sample-matches/blob/main/C/PINRemoteImage-MDEwOlJlcG9zaXRvcnkzOTUzNzEwMw==-flat-picture_enc.c-PINRemoteImage-MDEwOlJlcG9zaXRvcnkzOTUzNzEwMw==-flat-frame_enc.c.html,0.015360983102918587,10,PINRemoteImage-MDEwOlJlcG9zaXRvcnkzOTUzNzEwMw==-flat-picture_enc.c,PINRemoteImage-MDEwOlJlcG9zaXRvcnkzOTUzNzEwMw==-flat-frame_enc.c,95,104,9,74,83,9
351886,https://htmlpreview.github.io/?https://github.com/Christina96/boilerplate-sample-matches/blob/main/C/redis-MDEwOlJlcG9zaXRvcnkxMDgxMTA3MDY=-flat-microbench.c-xmrig-MDEwOlJlcG9zaXRvcnk4ODMyNzQwNg==-flat-sph_fugue.c.html,0.049315068493150684,9,redis-MDEwOlJlcG9zaXRvcnkxMDgxMTA3MDY=-flat-microbench.c,xmrig-MDEwOlJlcG9zaXRvcnk4ODMyNzQwNg==-flat-sph_fugue.c,6,10,4,906,911,5
352542,https://htmlpreview.github.io/?https://github.com/Christina96/boilerplate-sample-matches/blob/main/C/PINRemoteImage-MDEwOlJlcG9zaXRvcnkzOTUzNzEwMw==-flat-alpha_enc.c-redis-MDEwOlJlcG9zaXRvcnkxMDgxMTA3MDY=-flat-t_set.c.html,0.06640926640926641,8,PINRemoteImage-MDEwOlJlcG9zaXRvcnkzOTUzNzEwMw==-flat-alpha_enc.c,redis-MDEwOlJlcG9zaXRvcnkxMDgxMTA3MDY=-flat-t_set.c,64,68,4,165,169,4
352626,https://htmlpreview.github.io/?https://github.com/Christina96/boilerplate-sample-matches/blob/main/C/libtomcrypt-MDEwOlJlcG9zaXRvcnk3NzcwMTE=-flat-openssl-enc.c-PINRemoteImage-MDEwOlJlcG9zaXRvcnkzOTUzNzEwMw==-flat-get_disto.c.html,0.023564064801178203,8,libtomcrypt-MDEwOlJlcG9zaXRvcnk3NzcwMTE=-flat-openssl-enc.c,PINRemoteImage-MDEwOlJlcG9zaXRvcnkzOTUzNzEwMw==-flat-get_disto.c,143,146,3,180,184,4
352665,https://htmlpreview.github.io/?https://github.com/Christina96/boilerplate-sample-matches/blob/main/C/Adafruit_nRF52_Arduino-MDEwOlJlcG9zaXRvcnk3NDM1NDcyOQ==-flat-system_nrf52840.c-libtomcrypt-MDEwOlJlcG9zaXRvcnk3NzcwMTE=-flat-kseed.c.html,0.053691275167785234,8,Adafruit_nRF52_Arduino-MDEwOlJlcG9zaXRvcnk3NDM1NDcyOQ==-flat-system_nrf52840.c,libtomcrypt-MDEwOlJlcG9zaXRvcnk3NzcwMTE=-flat-kseed.c,32,39,7,183,189,6
353462,https://htmlpreview.github.io/?https://github.com/Christina96/boilerplate-sample-matches/blob/main/C/PINRemoteImage-MDEwOlJlcG9zaXRvcnkzOTUzNzEwMw==-flat-idec_dec.c-libpcap-MDEwOlJlcG9zaXRvcnk5NDM1ODg3-flat-daemon.c.html,0.07803163444639719,8,PINRemoteImage-MDEwOlJlcG9zaXRvcnkzOTUzNzEwMw==-flat-idec_dec.c,libpcap-MDEwOlJlcG9zaXRvcnk5NDM1ODg3-flat-daemon.c,711,717,6,932,942,10
354217,https://htmlpreview.github.io/?https://github.com/Christina96/boilerplate-sample-matches/blob/main/C/fftw3-MDEwOlJlcG9zaXRvcnk4ODQzMzg4-flat-api.h-fftw3-MDEwOlJlcG9zaXRvcnk4ODQzMzg4-flat-codelet-dft.h.html,0.20481927710843373,9,fftw3-MDEwOlJlcG9zaXRvcnk4ODQzMzg4-flat-api.h,fftw3-MDEwOlJlcG9zaXRvcnk4ODQzMzg4-flat-codelet-dft.h,31,33,2,30,33,3
355019,https://htmlpreview.github.io/?https://github.com/Christina96/boilerplate-sample-matches/blob/main/C/PINRemoteImage-MDEwOlJlcG9zaXRvcnkzOTUzNzEwMw==-flat-dec.c-PINRemoteImage-MDEwOlJlcG9zaXRvcnkzOTUzNzEwMw==-flat-dec_neon.c.html,0.2001527883880825,12,PINRemoteImage-MDEwOlJlcG9zaXRvcnkzOTUzNzEwMw==-flat-dec.c,PINRemoteImage-MDEwOlJlcG9zaXRvcnkzOTUzNzEwMw==-flat-dec_neon.c,180,194,14,1032,1038,6
355189,https://htmlpreview.github.io/?https://github.com/Christina96/boilerplate-sample-matches/blob/main/C/libtomcrypt-MDEwOlJlcG9zaXRvcnk3NzcwMTE=-flat-gcm_gf_mult.c-PINRemoteImage-MDEwOlJlcG9zaXRvcnkzOTUzNzEwMw==-flat-webpinfo.c.html,0.013215859030837005,9,libtomcrypt-MDEwOlJlcG9zaXRvcnk3NzcwMTE=-flat-gcm_gf_mult.c,PINRemoteImage-MDEwOlJlcG9zaXRvcnkzOTUzNzEwMw==-flat-webpinfo.c,98,106,8,671,679,8
358465,https://htmlpreview.github.io/?https://github.com/Christina96/boilerplate-sample-matches/blob/main/C/PINRemoteImage-MDEwOlJlcG9zaXRvcnkzOTUzNzEwMw==-flat-iterator_enc.c-libtomcrypt-MDEwOlJlcG9zaXRvcnk3NzcwMTE=-flat-blake2b.c.html,0.07307692307692308,8,PINRemoteImage-MDEwOlJlcG9zaXRvcnkzOTUzNzEwMw==-flat-iterator_enc.c,libtomcrypt-MDEwOlJlcG9zaXRvcnk3NzcwMTE=-flat-blake2b.c,243,248,5,127,134,7
358854,https://htmlpreview.github.io/?https://github.com/Christina96/boilerplate-sample-matches/blob/main/C/libtomcrypt-MDEwOlJlcG9zaXRvcnk3NzcwMTE=-flat-ec25519_import_pkcs8.c-libtomcrypt-MDEwOlJlcG9zaXRvcnk3NzcwMTE=-flat-pkcs_5_2.c.html,0.2994652406417112,11,libtomcrypt-MDEwOlJlcG9zaXRvcnk3NzcwMTE=-flat-ec25519_import_pkcs8.c,libtomcrypt-MDEwOlJlcG9zaXRvcnk3NzcwMTE=-flat-pkcs_5_2.c,32,38,6,44,50,6
359740,https://htmlpreview.github.io/?https://github.com/Christina96/boilerplate-sample-matches/blob/main/C/xmrig-MDEwOlJlcG9zaXRvcnk4ODMyNzQwNg==-flat-argon2-template-128.h-PINRemoteImage-MDEwOlJlcG9zaXRvcnkzOTUzNzEwMw==-flat-picture_enc.c.html,0.08740359897172237,8,xmrig-MDEwOlJlcG9zaXRvcnk4ODMyNzQwNg==-flat-argon2-template-128.h,PINRemoteImage-MDEwOlJlcG9zaXRvcnkzOTUzNzEwMw==-flat-picture_enc.c,47,54,7,27,31,4
360699,https://htmlpreview.github.io/?https://github.com/Christina96/boilerplate-sample-matches/blob/main/C/libtomcrypt-MDEwOlJlcG9zaXRvcnk3NzcwMTE=-flat-no_prng.c-xmrig-MDEwOlJlcG9zaXRvcnk4ODMyNzQwNg==-flat-distances.c.html,0.014230271668822769,11,libtomcrypt-MDEwOlJlcG9zaXRvcnk3NzcwMTE=-flat-no_prng.c,xmrig-MDEwOlJlcG9zaXRvcnk4ODMyNzQwNg==-flat-distances.c,44,54,10,1048,1056,8
361156,https://htmlpreview.github.io/?https://github.com/Christina96/boilerplate-sample-matches/blob/main/C/libfuse-MDEwOlJlcG9zaXRvcnk0ODI5NjE3Nw==-flat-mount_util.h-redis-MDEwOlJlcG9zaXRvcnkxMDgxMTA3MDY=-flat-mallctl.c.html,0.028169014084507043,8,libfuse-MDEwOlJlcG9zaXRvcnk0ODI5NjE3Nw==-flat-mount_util.h,redis-MDEwOlJlcG9zaXRvcnkxMDgxMTA3MDY=-flat-mallctl.c,2,3,1,136,151,15
362618,https://htmlpreview.github.io/?https://github.com/Christina96/boilerplate-sample-matches/blob/main/C/PINRemoteImage-MDEwOlJlcG9zaXRvcnkzOTUzNzEwMw==-flat-image_enc.c-PINRemoteImage-MDEwOlJlcG9zaXRvcnkzOTUzNzEwMw==-flat-idec_dec.c.html,0.08189910979228486,8,PINRemoteImage-MDEwOlJlcG9zaXRvcnkzOTUzNzEwMw==-flat-image_enc.c,PINRemoteImage-MDEwOlJlcG9zaXRvcnkzOTUzNzEwMw==-flat-idec_dec.c,348,350,2,646,648,2
366737,https://htmlpreview.github.io/?https://github.com/Christina96/boilerplate-sample-matches/blob/main/C/libtomcrypt-MDEwOlJlcG9zaXRvcnk3NzcwMTE=-flat-eax_test.c-libtomcrypt-MDEwOlJlcG9zaXRvcnk3NzcwMTE=-flat-twofish.c.html,0.18265895953757225,18,libtomcrypt-MDEwOlJlcG9zaXRvcnk3NzcwMTE=-flat-eax_test.c,libtomcrypt-MDEwOlJlcG9zaXRvcnk3NzcwMTE=-flat-twofish.c,37,50,13,48,57,9
368918,https://htmlpreview.github.io/?https://github.com/Christina96/boilerplate-sample-matches/blob/main/C/fftw3-MDEwOlJlcG9zaXRvcnk4ODQzMzg4-flat-avx2.c-PINRemoteImage-MDEwOlJlcG9zaXRvcnkzOTUzNzEwMw==-flat-webpmux.c.html,0.016965127238454288,9,fftw3-MDEwOlJlcG9zaXRvcnk4ODQzMzg4-flat-avx2.c,PINRemoteImage-MDEwOlJlcG9zaXRvcnkzOTUzNzEwMw==-flat-webpmux.c,14,21,7,479,484,5
369912,https://htmlpreview.github.io/?https://github.com/Christina96/boilerplate-sample-matches/blob/main/C/fftw3-MDEwOlJlcG9zaXRvcnk4ODQzMzg4-flat-dft-rank1.c-PINRemoteImage-MDEwOlJlcG9zaXRvcnkzOTUzNzEwMw==-flat-predictor_enc.c.html,0.056179775280898875,9,fftw3-MDEwOlJlcG9zaXRvcnk4ODQzMzg4-flat-dft-rank1.c,PINRemoteImage-MDEwOlJlcG9zaXRvcnkzOTUzNzEwMw==-flat-predictor_enc.c,83,87,4,345,349,4
370164,https://htmlpreview.github.io/?https://github.com/Christina96/boilerplate-sample-matches/blob/main/C/PINRemoteImage-MDEwOlJlcG9zaXRvcnkzOTUzNzEwMw==-flat-vp8_dec.c-xmrig-MDEwOlJlcG9zaXRvcnk4ODMyNzQwNg==-flat-sph_shavite.c.html,0.11366485582950271,9,PINRemoteImage-MDEwOlJlcG9zaXRvcnkzOTUzNzEwMw==-flat-vp8_dec.c,xmrig-MDEwOlJlcG9zaXRvcnk4ODMyNzQwNg==-flat-sph_shavite.c,477,485,8,637,645,8
372543,https://htmlpreview.github.io/?https://github.com/Christina96/boilerplate-sample-matches/blob/main/C/PINRemoteImage-MDEwOlJlcG9zaXRvcnkzOTUzNzEwMw==-flat-dec_sse2.c-xmrig-MDEwOlJlcG9zaXRvcnk4ODMyNzQwNg==-flat-reader.h.html,0.09653385163589245,9,PINRemoteImage-MDEwOlJlcG9zaXRvcnkzOTUzNzEwMw==-flat-dec_sse2.c,xmrig-MDEwOlJlcG9zaXRvcnk4ODMyNzQwNg==-flat-reader.h,37,41,4,914,918,4
373732,https://htmlpreview.github.io/?https://github.com/Christina96/boilerplate-sample-matches/blob/main/C/libtomcrypt-MDEwOlJlcG9zaXRvcnk3NzcwMTE=-flat-crc32.c-libtomcrypt-MDEwOlJlcG9zaXRvcnk3NzcwMTE=-flat-chacha20.c.html,0.11764705882352941,9,libtomcrypt-MDEwOlJlcG9zaXRvcnk3NzcwMTE=-flat-crc32.c,libtomcrypt-MDEwOlJlcG9zaXRvcnk3NzcwMTE=-flat-chacha20.c,139,145,6,25,30,5
374349,https://htmlpreview.github.io/?https://github.com/Christina96/boilerplate-sample-matches/blob/main/C/redis-MDEwOlJlcG9zaXRvcnkxMDgxMTA3MDY=-flat-tsd.h-PINRemoteImage-MDEwOlJlcG9zaXRvcnkzOTUzNzEwMw==-flat-decode_27.h.html,0.06896551724137931,10,redis-MDEwOlJlcG9zaXRvcnkxMDgxMTA3MDY=-flat-tsd.h,PINRemoteImage-MDEwOlJlcG9zaXRvcnkzOTUzNzEwMw==-flat-decode_27.h,78,86,8,52,57,5
375319,https://htmlpreview.github.io/?https://github.com/Christina96/boilerplate-sample-matches/blob/main/C/libtomcrypt-MDEwOlJlcG9zaXRvcnk3NzcwMTE=-flat-xcbc_done.c-Adafruit_nRF52_Arduino-MDEwOlJlcG9zaXRvcnk3NDM1NDcyOQ==-flat-nrf_egu.h.html,0.08144796380090498,9,libtomcrypt-MDEwOlJlcG9zaXRvcnk3NzcwMTE=-flat-xcbc_done.c,Adafruit_nRF52_Arduino-MDEwOlJlcG9zaXRvcnk3NDM1NDcyOQ==-flat-nrf_egu.h,8,15,7,94,103,9
375928,https://htmlpreview.github.io/?https://github.com/Christina96/boilerplate-sample-matches/blob/main/C/fftw3-MDEwOlJlcG9zaXRvcnk4ODQzMzg4-flat-vrank-geq1.c-PINRemoteImage-MDEwOlJlcG9zaXRvcnkzOTUzNzEwMw==-flat-webpinfo.c.html,0.0237741456166419,8,fftw3-MDEwOlJlcG9zaXRvcnk4ODQzMzg4-flat-vrank-geq1.c,PINRemoteImage-MDEwOlJlcG9zaXRvcnkzOTUzNzEwMw==-flat-webpinfo.c,105,114,9,673,680,7
376295,https://htmlpreview.github.io/?https://github.com/Christina96/boilerplate-sample-matches/blob/main/C/redis-MDEwOlJlcG9zaXRvcnkxMDgxMTA3MDY=-flat-lopcodes.h-libpcap-MDEwOlJlcG9zaXRvcnk5NDM1ODg3-flat-pcap-tc.c.html,0.048834628190899,13,redis-MDEwOlJlcG9zaXRvcnkxMDgxMTA3MDY=-flat-lopcodes.h,libpcap-MDEwOlJlcG9zaXRvcnk5NDM1ODg3-flat-pcap-tc.c,68,79,11,213,225,12
376512,https://htmlpreview.github.io/?https://github.com/Christina96/boilerplate-sample-matches/blob/main/C/redis-MDEwOlJlcG9zaXRvcnkxMDgxMTA3MDY=-flat-ziplist.c-redis-MDEwOlJlcG9zaXRvcnkxMDgxMTA3MDY=-flat-jemalloc.c.html,0.09535104364326376,11,redis-MDEwOlJlcG9zaXRvcnkxMDgxMTA3MDY=-flat-ziplist.c,redis-MDEwOlJlcG9zaXRvcnkxMDgxMTA3MDY=-flat-jemalloc.c,342,355,13,1926,1939,13
378355,https://htmlpreview.github.io/?https://github.com/Christina96/boilerplate-sample-matches/blob/main/C/Adafruit_nRF52_Arduino-MDEwOlJlcG9zaXRvcnk3NDM1NDcyOQ==-flat-nrf_uarte.h-Adafruit_nRF52_Arduino-MDEwOlJlcG9zaXRvcnk3NDM1NDcyOQ==-flat-nrf_power.h.html,0.5741626794258373,24,Adafruit_nRF52_Arduino-MDEwOlJlcG9zaXRvcnk3NDM1NDcyOQ==-flat-nrf_uarte.h,Adafruit_nRF52_Arduino-MDEwOlJlcG9zaXRvcnk3NDM1NDcyOQ==-flat-nrf_power.h,194,227,33,397,428,31
379156,https://htmlpreview.github.io/?https://github.com/Christina96/boilerplate-sample-matches/blob/main/C/xmrig-MDEwOlJlcG9zaXRvcnk4ODMyNzQwNg==-flat-c_skein.c-Adafruit_nRF52_Arduino-MDEwOlJlcG9zaXRvcnk3NDM1NDcyOQ==-flat-nrf_usbd.h.html,0.1595238095238095,10,xmrig-MDEwOlJlcG9zaXRvcnk4ODMyNzQwNg==-flat-c_skein.c,Adafruit_nRF52_Arduino-MDEwOlJlcG9zaXRvcnk3NDM1NDcyOQ==-flat-nrf_usbd.h,193,198,5,37,46,9
379284,https://htmlpreview.github.io/?https://github.com/Christina96/boilerplate-sample-matches/blob/main/C/PINRemoteImage-MDEwOlJlcG9zaXRvcnkzOTUzNzEwMw==-flat-anim_encode.c-PINRemoteImage-MDEwOlJlcG9zaXRvcnkzOTUzNzEwMw==-flat-lossless_enc.c.html,0.11332755131540907,9,PINRemoteImage-MDEwOlJlcG9zaXRvcnkzOTUzNzEwMw==-flat-anim_encode.c,PINRemoteImage-MDEwOlJlcG9zaXRvcnkzOTUzNzEwMw==-flat-lossless_enc.c,440,445,5,633,636,3
380887,https://htmlpreview.github.io/?https://github.com/Christina96/boilerplate-sample-matches/blob/main/C/fftw3-MDEwOlJlcG9zaXRvcnk4ODQzMzg4-flat-dftw-directsq.c-PINRemoteImage-MDEwOlJlcG9zaXRvcnkzOTUzNzEwMw==-flat-yuv_sse41.c.html,0.08307692307692308,8,fftw3-MDEwOlJlcG9zaXRvcnk4ODQzMzg4-flat-dftw-directsq.c,PINRemoteImage-MDEwOlJlcG9zaXRvcnkzOTUzNzEwMw==-flat-yuv_sse41.c,14,18,4,38,42,4
383879,https://htmlpreview.github.io/?https://github.com/Christina96/boilerplate-sample-matches/blob/main/C/PINRemoteImage-MDEwOlJlcG9zaXRvcnkzOTUzNzEwMw==-flat-backward_references_cost_enc.c-PINRemoteImage-MDEwOlJlcG9zaXRvcnkzOTUzNzEwMw==-flat-vp8_dec.c.html,0.07159904534606205,8,PINRemoteImage-MDEwOlJlcG9zaXRvcnkzOTUzNzEwMw==-flat-backward_references_cost_enc.c,PINRemoteImage-MDEwOlJlcG9zaXRvcnkzOTUzNzEwMw==-flat-vp8_dec.c,187,191,4,157,161,4
384281,https://htmlpreview.github.io/?https://github.com/Christina96/boilerplate-sample-matches/blob/main/C/libtomcrypt-MDEwOlJlcG9zaXRvcnk3NzcwMTE=-flat-lrw_test.c-libtomcrypt-MDEwOlJlcG9zaXRvcnk3NzcwMTE=-flat-oaep-vect.c.html,0.125,13,libtomcrypt-MDEwOlJlcG9zaXRvcnk3NzcwMTE=-flat-lrw_test.c,libtomcrypt-MDEwOlJlcG9zaXRvcnk3NzcwMTE=-flat-oaep-vect.c,20,27,7,257,275,18
384421,https://htmlpreview.github.io/?https://github.com/Christina96/boilerplate-sample-matches/blob/main/C/redis-MDEwOlJlcG9zaXRvcnkxMDgxMTA3MDY=-flat-stats_13.c-PINRemoteImage-MDEwOlJlcG9zaXRvcnkzOTUzNzEwMw==-flat-webpinfo.c.html,0.08103545301069218,8,redis-MDEwOlJlcG9zaXRvcnkxMDgxMTA3MDY=-flat-stats_13.c,PINRemoteImage-MDEwOlJlcG9zaXRvcnkzOTUzNzEwMw==-flat-webpinfo.c,56,62,6,740,749,9
385201,https://htmlpreview.github.io/?https://github.com/Christina96/boilerplate-sample-matches/blob/main/C/Adafruit_nRF52_Arduino-MDEwOlJlcG9zaXRvcnk3NDM1NDcyOQ==-flat-nrfx_spim.c-libtomcrypt-MDEwOlJlcG9zaXRvcnk3NzcwMTE=-flat-saferp.c.html,0.11320754716981132,8,Adafruit_nRF52_Arduino-MDEwOlJlcG9zaXRvcnk3NDM1NDcyOQ==-flat-nrfx_spim.c,libtomcrypt-MDEwOlJlcG9zaXRvcnk3NzcwMTE=-flat-saferp.c,142,149,7,297,303,6
387794,https://htmlpreview.github.io/?https://github.com/Christina96/boilerplate-sample-matches/blob/main/C/fftw3-MDEwOlJlcG9zaXRvcnk4ODQzMzg4-flat-transpose-pairwise.c-small-MDEwOlJlcG9zaXRvcnkyNTY3NjMxNjk=-flat-tls1.2_ticket.c.html,0.0547112462006079,9,fftw3-MDEwOlJlcG9zaXRvcnk4ODQzMzg4-flat-transpose-pairwise.c,small-MDEwOlJlcG9zaXRvcnkyNTY3NjMxNjk=-flat-tls1.2_ticket.c,310,317,7,118,126,8
387860,https://htmlpreview.github.io/?https://github.com/Christina96/boilerplate-sample-matches/blob/main/C/Adafruit_nRF52_Arduino-MDEwOlJlcG9zaXRvcnk3NDM1NDcyOQ==-flat-nrf_pwm.h-libpcap-MDEwOlJlcG9zaXRvcnk5NDM1ODg3-flat-pcap-dpdk.c.html,0.03563941299790356,9,Adafruit_nRF52_Arduino-MDEwOlJlcG9zaXRvcnk3NDM1NDcyOQ==-flat-nrf_pwm.h,libpcap-MDEwOlJlcG9zaXRvcnk5NDM1ODg3-flat-pcap-dpdk.c,52,60,8,124,131,7
388344,https://htmlpreview.github.io/?https://github.com/Christina96/boilerplate-sample-matches/blob/main/C/PINRemoteImage-MDEwOlJlcG9zaXRvcnkzOTUzNzEwMw==-flat-filters_msa.c-libtomcrypt-MDEwOlJlcG9zaXRvcnk3NzcwMTE=-flat-md5.c.html,0.08465608465608465,8,PINRemoteImage-MDEwOlJlcG9zaXRvcnkzOTUzNzEwMw==-flat-filters_msa.c,libtomcrypt-MDEwOlJlcG9zaXRvcnk3NzcwMTE=-flat-md5.c,26,33,7,82,84,2
389945,https://htmlpreview.github.io/?https://github.com/Christina96/boilerplate-sample-matches/blob/main/C/libpcap-MDEwOlJlcG9zaXRvcnk5NDM1ODg3-flat-fmtutils.c-fftw3-MDEwOlJlcG9zaXRvcnk4ODQzMzg4-flat-simd-generic256.h.html,0.17209302325581396,9,libpcap-MDEwOlJlcG9zaXRvcnk5NDM1ODg3-flat-fmtutils.c,fftw3-MDEwOlJlcG9zaXRvcnk4ODQzMzg4-flat-simd-generic256.h,124,132,8,95,103,8
391935,https://htmlpreview.github.io/?https://github.com/Christina96/boilerplate-sample-matches/blob/main/C/xmrig-MDEwOlJlcG9zaXRvcnk4ODMyNzQwNg==-flat-blake2b.c-xmrig-MDEwOlJlcG9zaXRvcnk4ODMyNzQwNg==-flat-core.c.html,0.11813186813186813,8,xmrig-MDEwOlJlcG9zaXRvcnk4ODMyNzQwNg==-flat-blake2b.c,xmrig-MDEwOlJlcG9zaXRvcnk4ODMyNzQwNg==-flat-core.c,200,205,5,56,61,5
393006,https://htmlpreview.github.io/?https://github.com/Christina96/boilerplate-sample-matches/blob/main/C/libtomcrypt-MDEwOlJlcG9zaXRvcnk3NzcwMTE=-flat-ltc_ecc_map.c-libtomcrypt-MDEwOlJlcG9zaXRvcnk3NzcwMTE=-flat-gcm_add_aad.c.html,0.11695906432748537,10,libtomcrypt-MDEwOlJlcG9zaXRvcnk3NzcwMTE=-flat-ltc_ecc_map.c,libtomcrypt-MDEwOlJlcG9zaXRvcnk3NzcwMTE=-flat-gcm_add_aad.c,10,16,6,15,21,6
393869,https://htmlpreview.github.io/?https://github.com/Christina96/boilerplate-sample-matches/blob/main/C/PINRemoteImage-MDEwOlJlcG9zaXRvcnkzOTUzNzEwMw==-flat-quality_estimate.c-PINRemoteImage-MDEwOlJlcG9zaXRvcnkzOTUzNzEwMw==-flat-image_enc.c.html,0.04071246819338423,8,PINRemoteImage-MDEwOlJlcG9zaXRvcnkzOTUzNzEwMw==-flat-quality_estimate.c,PINRemoteImage-MDEwOlJlcG9zaXRvcnkzOTUzNzEwMw==-flat-image_enc.c,15,21,6,277,286,9
