ID,Link,Tokens,File 1,File 2,Start 1,End 1,Detected Lines 1,Start 2,End 2,Detected Lines 2
0,https://htmlpreview.github.io/?https://github.com/Christina96/boilerplate-sample-matches/blob/main/C/xmrig-MDEwOlJlcG9zaXRvcnk4ODMyNzQwNg==-flat-cl_egl.h-xmrig-MDEwOlJlcG9zaXRvcnk4ODMyNzQwNg==-flat-cl_va_api_media_sharing_intel.h.html,29,xmrig-MDEwOlJlcG9zaXRvcnk4ODMyNzQwNg==-flat-cl_egl.h,xmrig-MDEwOlJlcG9zaXRvcnk4ODMyNzQwNg==-flat-cl_va_api_media_sharing_intel.h,49,55,6,74,80,6
1,https://htmlpreview.github.io/?https://github.com/Christina96/boilerplate-sample-matches/blob/main/C/redis-MDEwOlJlcG9zaXRvcnkxMDgxMTA3MDY=-flat-lstrlib.c-redis-MDEwOlJlcG9zaXRvcnkxMDgxMTA3MDY=-flat-lstrlib.c.html,19,redis-MDEwOlJlcG9zaXRvcnkxMDgxMTA3MDY=-flat-lstrlib.c,redis-MDEwOlJlcG9zaXRvcnkxMDgxMTA3MDY=-flat-lstrlib.c,426,427,1,426,427,1
2,https://htmlpreview.github.io/?https://github.com/Christina96/boilerplate-sample-matches/blob/main/C/xmrig-MDEwOlJlcG9zaXRvcnk4ODMyNzQwNg==-flat-CudaCnRunner.h-xmrig-MDEwOlJlcG9zaXRvcnk4ODMyNzQwNg==-flat-CudaRxRunner.h.html,16,xmrig-MDEwOlJlcG9zaXRvcnk4ODMyNzQwNg==-flat-CudaCnRunner.h,xmrig-MDEwOlJlcG9zaXRvcnk4ODMyNzQwNg==-flat-CudaRxRunner.h,10,11,1,11,12,1
3,https://htmlpreview.github.io/?https://github.com/Christina96/boilerplate-sample-matches/blob/main/C/PINRemoteImage-MDEwOlJlcG9zaXRvcnkzOTUzNzEwMw==-flat-mux_36.h-PINRemoteImage-MDEwOlJlcG9zaXRvcnkzOTUzNzEwMw==-flat-mux_42.h.html,422,PINRemoteImage-MDEwOlJlcG9zaXRvcnkzOTUzNzEwMw==-flat-mux_36.h,PINRemoteImage-MDEwOlJlcG9zaXRvcnkzOTUzNzEwMw==-flat-mux_42.h,48,121,73,48,121,73
4,https://htmlpreview.github.io/?https://github.com/Christina96/boilerplate-sample-matches/blob/main/C/redis-MDEwOlJlcG9zaXRvcnkxMDgxMTA3MDY=-flat-object.c-redis-MDEwOlJlcG9zaXRvcnkxMDgxMTA3MDY=-flat-object.c.html,26,redis-MDEwOlJlcG9zaXRvcnkxMDgxMTA3MDY=-flat-object.c,redis-MDEwOlJlcG9zaXRvcnkxMDgxMTA3MDY=-flat-object.c,39,43,4,39,43,4
5,https://htmlpreview.github.io/?https://github.com/Christina96/boilerplate-sample-matches/blob/main/C/redis-MDEwOlJlcG9zaXRvcnkxMDgxMTA3MDY=-flat-t_stream.c-redis-MDEwOlJlcG9zaXRvcnkxMDgxMTA3MDY=-flat-t_stream.c.html,18,redis-MDEwOlJlcG9zaXRvcnkxMDgxMTA3MDY=-flat-t_stream.c,redis-MDEwOlJlcG9zaXRvcnkxMDgxMTA3MDY=-flat-t_stream.c,1366,1368,2,1366,1368,2
6,https://htmlpreview.github.io/?https://github.com/Christina96/boilerplate-sample-matches/blob/main/C/xmrig-MDEwOlJlcG9zaXRvcnk4ODMyNzQwNg==-flat-memattrs.c-xmrig-MDEwOlJlcG9zaXRvcnk4ODMyNzQwNg==-flat-components.c.html,16,xmrig-MDEwOlJlcG9zaXRvcnk4ODMyNzQwNg==-flat-memattrs.c,xmrig-MDEwOlJlcG9zaXRvcnk4ODMyNzQwNg==-flat-components.c,16,21,5,422,427,5
7,https://htmlpreview.github.io/?https://github.com/Christina96/boilerplate-sample-matches/blob/main/C/libpcap-MDEwOlJlcG9zaXRvcnk5NDM1ODg3-flat-pcap-tc.c-Adafruit_nRF52_Arduino-MDEwOlJlcG9zaXRvcnk3NDM1NDcyOQ==-flat-tasks.c.html,16,libpcap-MDEwOlJlcG9zaXRvcnk5NDM1ODg3-flat-pcap-tc.c,Adafruit_nRF52_Arduino-MDEwOlJlcG9zaXRvcnk3NDM1NDcyOQ==-flat-tasks.c,339,342,3,2256,2259,3
8,https://htmlpreview.github.io/?https://github.com/Christina96/boilerplate-sample-matches/blob/main/C/PINRemoteImage-MDEwOlJlcG9zaXRvcnkzOTUzNzEwMw==-flat-libwebp_java_wrap.c-PINRemoteImage-MDEwOlJlcG9zaXRvcnkzOTUzNzEwMw==-flat-libwebp_java_wrap.c.html,21,PINRemoteImage-MDEwOlJlcG9zaXRvcnkzOTUzNzEwMw==-flat-libwebp_java_wrap.c,PINRemoteImage-MDEwOlJlcG9zaXRvcnkzOTUzNzEwMw==-flat-libwebp_java_wrap.c,1219,1222,3,1219,1222,3
9,https://htmlpreview.github.io/?https://github.com/Christina96/boilerplate-sample-matches/blob/main/C/PINRemoteImage-MDEwOlJlcG9zaXRvcnkzOTUzNzEwMw==-flat-PINOperationGroup.h-PINRemoteImage-MDEwOlJlcG9zaXRvcnkzOTUzNzEwMw==-flat-PINOperationGroup_53.h.html,100,PINRemoteImage-MDEwOlJlcG9zaXRvcnkzOTUzNzEwMw==-flat-PINOperationGroup.h,PINRemoteImage-MDEwOlJlcG9zaXRvcnkzOTUzNzEwMw==-flat-PINOperationGroup_53.h,7,20,13,7,20,13
10,https://htmlpreview.github.io/?https://github.com/Christina96/boilerplate-sample-matches/blob/main/C/libtomcrypt-MDEwOlJlcG9zaXRvcnk3NzcwMTE=-flat-ssh_decode_sequence_multi.c-libtomcrypt-MDEwOlJlcG9zaXRvcnk3NzcwMTE=-flat-ssh_decode_sequence_multi.c.html,21,libtomcrypt-MDEwOlJlcG9zaXRvcnk3NzcwMTE=-flat-ssh_decode_sequence_multi.c,libtomcrypt-MDEwOlJlcG9zaXRvcnk3NzcwMTE=-flat-ssh_decode_sequence_multi.c,75,80,5,80,85,5
11,https://htmlpreview.github.io/?https://github.com/Christina96/boilerplate-sample-matches/blob/main/C/small-MDEwOlJlcG9zaXRvcnkyNTY3NjMxNjk=-flat-server.c-small-MDEwOlJlcG9zaXRvcnkyNTY3NjMxNjk=-flat-server.c.html,162,small-MDEwOlJlcG9zaXRvcnkyNTY3NjMxNjk=-flat-server.c,small-MDEwOlJlcG9zaXRvcnkyNTY3NjMxNjk=-flat-server.c,776,796,20,776,796,20
12,https://htmlpreview.github.io/?https://github.com/Christina96/boilerplate-sample-matches/blob/main/C/libtomcrypt-MDEwOlJlcG9zaXRvcnk3NzcwMTE=-flat-chacha20.c-libtomcrypt-MDEwOlJlcG9zaXRvcnk3NzcwMTE=-flat-sober128.c.html,178,libtomcrypt-MDEwOlJlcG9zaXRvcnk3NzcwMTE=-flat-chacha20.c,libtomcrypt-MDEwOlJlcG9zaXRvcnk3NzcwMTE=-flat-sober128.c,19,37,18,19,37,18
13,https://htmlpreview.github.io/?https://github.com/Christina96/boilerplate-sample-matches/blob/main/C/libpcap-MDEwOlJlcG9zaXRvcnk5NDM1ODg3-flat-pcap-bpf.c-libpcap-MDEwOlJlcG9zaXRvcnk5NDM1ODg3-flat-pcap-bpf.c.html,17,libpcap-MDEwOlJlcG9zaXRvcnk5NDM1ODg3-flat-pcap-bpf.c,libpcap-MDEwOlJlcG9zaXRvcnk5NDM1ODg3-flat-pcap-bpf.c,528,529,1,528,529,1
14,https://htmlpreview.github.io/?https://github.com/Christina96/boilerplate-sample-matches/blob/main/C/redis-MDEwOlJlcG9zaXRvcnkxMDgxMTA3MDY=-flat-t_stream.c-redis-MDEwOlJlcG9zaXRvcnkxMDgxMTA3MDY=-flat-t_stream.c.html,41,redis-MDEwOlJlcG9zaXRvcnkxMDgxMTA3MDY=-flat-t_stream.c,redis-MDEwOlJlcG9zaXRvcnkxMDgxMTA3MDY=-flat-t_stream.c,1138,1144,6,1161,1166,5
15,https://htmlpreview.github.io/?https://github.com/Christina96/boilerplate-sample-matches/blob/main/C/PINRemoteImage-MDEwOlJlcG9zaXRvcnkzOTUzNzEwMw==-flat-backward_references_enc.c-PINRemoteImage-MDEwOlJlcG9zaXRvcnkzOTUzNzEwMw==-flat-backward_references_enc.c.html,41,PINRemoteImage-MDEwOlJlcG9zaXRvcnkzOTUzNzEwMw==-flat-backward_references_enc.c,PINRemoteImage-MDEwOlJlcG9zaXRvcnkzOTUzNzEwMw==-flat-backward_references_enc.c,733,737,4,733,737,4
16,https://htmlpreview.github.io/?https://github.com/Christina96/boilerplate-sample-matches/blob/main/C/redis-MDEwOlJlcG9zaXRvcnkxMDgxMTA3MDY=-flat-size_classes.c-redis-MDEwOlJlcG9zaXRvcnkxMDgxMTA3MDY=-flat-overflow.c.html,44,redis-MDEwOlJlcG9zaXRvcnkxMDgxMTA3MDY=-flat-size_classes.c,redis-MDEwOlJlcG9zaXRvcnkxMDgxMTA3MDY=-flat-overflow.c,13,17,4,15,19,4
17,https://htmlpreview.github.io/?https://github.com/Christina96/boilerplate-sample-matches/blob/main/C/Adafruit_nRF52_Arduino-MDEwOlJlcG9zaXRvcnk3NDM1NDcyOQ==-flat-SEGGER_RTT.c-Adafruit_nRF52_Arduino-MDEwOlJlcG9zaXRvcnk3NDM1NDcyOQ==-flat-SEGGER_RTT.c.html,21,Adafruit_nRF52_Arduino-MDEwOlJlcG9zaXRvcnk3NDM1NDcyOQ==-flat-SEGGER_RTT.c,Adafruit_nRF52_Arduino-MDEwOlJlcG9zaXRvcnk3NDM1NDcyOQ==-flat-SEGGER_RTT.c,825,828,3,825,828,3
18,https://htmlpreview.github.io/?https://github.com/Christina96/boilerplate-sample-matches/blob/main/C/redis-MDEwOlJlcG9zaXRvcnkxMDgxMTA3MDY=-flat-ctl.c-redis-MDEwOlJlcG9zaXRvcnkxMDgxMTA3MDY=-flat-ctl.c.html,20,redis-MDEwOlJlcG9zaXRvcnkxMDgxMTA3MDY=-flat-ctl.c,redis-MDEwOlJlcG9zaXRvcnkxMDgxMTA3MDY=-flat-ctl.c,1424,1430,6,2211,2217,6
19,https://htmlpreview.github.io/?https://github.com/Christina96/boilerplate-sample-matches/blob/main/C/redis-MDEwOlJlcG9zaXRvcnkxMDgxMTA3MDY=-flat-module.c-redis-MDEwOlJlcG9zaXRvcnkxMDgxMTA3MDY=-flat-module.c.html,23,redis-MDEwOlJlcG9zaXRvcnkxMDgxMTA3MDY=-flat-module.c,redis-MDEwOlJlcG9zaXRvcnkxMDgxMTA3MDY=-flat-module.c,1167,1171,4,1167,1171,4
20,https://htmlpreview.github.io/?https://github.com/Christina96/boilerplate-sample-matches/blob/main/C/fftw3-MDEwOlJlcG9zaXRvcnk4ODQzMzg4-flat-hc2hc-generic.c-fftw3-MDEwOlJlcG9zaXRvcnk4ODQzMzg4-flat-redft00e-r2hc-pad.c.html,16,fftw3-MDEwOlJlcG9zaXRvcnk4ODQzMzg4-flat-hc2hc-generic.c,fftw3-MDEwOlJlcG9zaXRvcnk4ODQzMzg4-flat-redft00e-r2hc-pad.c,190,193,3,94,97,3
21,https://htmlpreview.github.io/?https://github.com/Christina96/boilerplate-sample-matches/blob/main/C/small-MDEwOlJlcG9zaXRvcnkyNTY3NjMxNjk=-flat-encrypt.c-small-MDEwOlJlcG9zaXRvcnkyNTY3NjMxNjk=-flat-encrypt.c.html,17,small-MDEwOlJlcG9zaXRvcnkyNTY3NjMxNjk=-flat-encrypt.c,small-MDEwOlJlcG9zaXRvcnkyNTY3NjMxNjk=-flat-encrypt.c,477,478,1,505,506,1
22,https://htmlpreview.github.io/?https://github.com/Christina96/boilerplate-sample-matches/blob/main/C/redis-MDEwOlJlcG9zaXRvcnkxMDgxMTA3MDY=-flat-lbaselib.c-redis-MDEwOlJlcG9zaXRvcnkxMDgxMTA3MDY=-flat-lbaselib.c.html,15,redis-MDEwOlJlcG9zaXRvcnkxMDgxMTA3MDY=-flat-lbaselib.c,redis-MDEwOlJlcG9zaXRvcnkxMDgxMTA3MDY=-flat-lbaselib.c,190,191,1,205,206,1
23,https://htmlpreview.github.io/?https://github.com/Christina96/boilerplate-sample-matches/blob/main/C/xmrig-MDEwOlJlcG9zaXRvcnk4ODMyNzQwNg==-flat-CryptoNight_x86.h-xmrig-MDEwOlJlcG9zaXRvcnk4ODMyNzQwNg==-flat-CryptoNight_x86.h.html,18,xmrig-MDEwOlJlcG9zaXRvcnk4ODMyNzQwNg==-flat-CryptoNight_x86.h,xmrig-MDEwOlJlcG9zaXRvcnk4ODMyNzQwNg==-flat-CryptoNight_x86.h,1303,1304,1,1303,1304,1
24,https://htmlpreview.github.io/?https://github.com/Christina96/boilerplate-sample-matches/blob/main/C/xmrig-MDEwOlJlcG9zaXRvcnk4ODMyNzQwNg==-flat-reader.h-xmrig-MDEwOlJlcG9zaXRvcnk4ODMyNzQwNg==-flat-reader.h.html,147,xmrig-MDEwOlJlcG9zaXRvcnk4ODMyNzQwNg==-flat-reader.h,xmrig-MDEwOlJlcG9zaXRvcnk4ODMyNzQwNg==-flat-reader.h,947,961,14,947,961,14
25,https://htmlpreview.github.io/?https://github.com/Christina96/boilerplate-sample-matches/blob/main/C/PINRemoteImage-MDEwOlJlcG9zaXRvcnkzOTUzNzEwMw==-flat-dec_sse2.c-PINRemoteImage-MDEwOlJlcG9zaXRvcnkzOTUzNzEwMw==-flat-enc_sse2.c.html,686,PINRemoteImage-MDEwOlJlcG9zaXRvcnkzOTUzNzEwMw==-flat-dec_sse2.c,PINRemoteImage-MDEwOlJlcG9zaXRvcnkzOTUzNzEwMw==-flat-enc_sse2.c,14,80,66,14,80,66
26,https://htmlpreview.github.io/?https://github.com/Christina96/boilerplate-sample-matches/blob/main/C/redis-MDEwOlJlcG9zaXRvcnkxMDgxMTA3MDY=-flat-geohash_39.c-redis-MDEwOlJlcG9zaXRvcnkxMDgxMTA3MDY=-flat-geohash_39.c.html,1065,redis-MDEwOlJlcG9zaXRvcnkxMDgxMTA3MDY=-flat-geohash_39.c,redis-MDEwOlJlcG9zaXRvcnkxMDgxMTA3MDY=-flat-geohash_39.c,65,180,115,65,180,115
27,https://htmlpreview.github.io/?https://github.com/Christina96/boilerplate-sample-matches/blob/main/C/PINRemoteImage-MDEwOlJlcG9zaXRvcnkzOTUzNzEwMw==-flat-libwebp_python_wrap.c-PINRemoteImage-MDEwOlJlcG9zaXRvcnkzOTUzNzEwMw==-flat-libwebp_java_wrap.c.html,633,PINRemoteImage-MDEwOlJlcG9zaXRvcnkzOTUzNzEwMw==-flat-libwebp_python_wrap.c,PINRemoteImage-MDEwOlJlcG9zaXRvcnkzOTUzNzEwMw==-flat-libwebp_java_wrap.c,2715,2815,100,714,814,100
28,https://htmlpreview.github.io/?https://github.com/Christina96/boilerplate-sample-matches/blob/main/C/Adafruit_nRF52_Arduino-MDEwOlJlcG9zaXRvcnk3NDM1NDcyOQ==-flat-nrfx_pwm.h-Adafruit_nRF52_Arduino-MDEwOlJlcG9zaXRvcnk3NDM1NDcyOQ==-flat-nrfx_pwm.h.html,20,Adafruit_nRF52_Arduino-MDEwOlJlcG9zaXRvcnk3NDM1NDcyOQ==-flat-nrfx_pwm.h,Adafruit_nRF52_Arduino-MDEwOlJlcG9zaXRvcnk3NDM1NDcyOQ==-flat-nrfx_pwm.h,139,143,4,145,149,4
29,https://htmlpreview.github.io/?https://github.com/Christina96/boilerplate-sample-matches/blob/main/C/libtomcrypt-MDEwOlJlcG9zaXRvcnk3NzcwMTE=-flat-des.c-libtomcrypt-MDEwOlJlcG9zaXRvcnk3NzcwMTE=-flat-des.c.html,134,libtomcrypt-MDEwOlJlcG9zaXRvcnk3NzcwMTE=-flat-des.c,libtomcrypt-MDEwOlJlcG9zaXRvcnk3NzcwMTE=-flat-des.c,1431,1444,13,1431,1444,13
30,https://htmlpreview.github.io/?https://github.com/Christina96/boilerplate-sample-matches/blob/main/C/PINRemoteImage-MDEwOlJlcG9zaXRvcnkzOTUzNzEwMw==-flat-demux_47.h-libfuse-MDEwOlJlcG9zaXRvcnk0ODI5NjE3Nw==-flat-fuse_i.h.html,15,PINRemoteImage-MDEwOlJlcG9zaXRvcnkzOTUzNzEwMw==-flat-demux_47.h,libfuse-MDEwOlJlcG9zaXRvcnk0ODI5NjE3Nw==-flat-fuse_i.h,47,52,5,48,53,5
31,https://htmlpreview.github.io/?https://github.com/Christina96/boilerplate-sample-matches/blob/main/C/PINRemoteImage-MDEwOlJlcG9zaXRvcnkzOTUzNzEwMw==-flat-mux_18.h-PINRemoteImage-MDEwOlJlcG9zaXRvcnkzOTUzNzEwMw==-flat-mux_18.h.html,75,PINRemoteImage-MDEwOlJlcG9zaXRvcnkzOTUzNzEwMw==-flat-mux_18.h,PINRemoteImage-MDEwOlJlcG9zaXRvcnkzOTUzNzEwMw==-flat-mux_18.h,108,121,13,108,121,13
32,https://htmlpreview.github.io/?https://github.com/Christina96/boilerplate-sample-matches/blob/main/C/small-MDEwOlJlcG9zaXRvcnkyNTY3NjMxNjk=-flat-tls1.2_ticket.c-small-MDEwOlJlcG9zaXRvcnkyNTY3NjMxNjk=-flat-tls1.2_ticket.c.html,18,small-MDEwOlJlcG9zaXRvcnkyNTY3NjMxNjk=-flat-tls1.2_ticket.c,small-MDEwOlJlcG9zaXRvcnkyNTY3NjMxNjk=-flat-tls1.2_ticket.c,200,202,2,181,183,2
33,https://htmlpreview.github.io/?https://github.com/Christina96/boilerplate-sample-matches/blob/main/C/redis-MDEwOlJlcG9zaXRvcnkxMDgxMTA3MDY=-flat-emitter.h-redis-MDEwOlJlcG9zaXRvcnkxMDgxMTA3MDY=-flat-emitter.h.html,17,redis-MDEwOlJlcG9zaXRvcnkxMDgxMTA3MDY=-flat-emitter.h,redis-MDEwOlJlcG9zaXRvcnkxMDgxMTA3MDY=-flat-emitter.h,38,43,5,38,43,5
34,https://htmlpreview.github.io/?https://github.com/Christina96/boilerplate-sample-matches/blob/main/C/libtomcrypt-MDEwOlJlcG9zaXRvcnk3NzcwMTE=-flat-ocb3_decrypt_last.c-libtomcrypt-MDEwOlJlcG9zaXRvcnk3NzcwMTE=-flat-ocb3_encrypt_last.c.html,165,libtomcrypt-MDEwOlJlcG9zaXRvcnk3NzcwMTE=-flat-ocb3_decrypt_last.c,libtomcrypt-MDEwOlJlcG9zaXRvcnk3NzcwMTE=-flat-ocb3_encrypt_last.c,9,30,21,9,30,21
35,https://htmlpreview.github.io/?https://github.com/Christina96/boilerplate-sample-matches/blob/main/C/libtomcrypt-MDEwOlJlcG9zaXRvcnk3NzcwMTE=-flat-ltc_ecc_projective_add_point.c-libtomcrypt-MDEwOlJlcG9zaXRvcnk3NzcwMTE=-flat-ltc_ecc_projective_dbl_point.c.html,24,libtomcrypt-MDEwOlJlcG9zaXRvcnk3NzcwMTE=-flat-ltc_ecc_projective_add_point.c,libtomcrypt-MDEwOlJlcG9zaXRvcnk3NzcwMTE=-flat-ltc_ecc_projective_dbl_point.c,30,31,1,35,36,1
36,https://htmlpreview.github.io/?https://github.com/Christina96/boilerplate-sample-matches/blob/main/C/redis-MDEwOlJlcG9zaXRvcnkxMDgxMTA3MDY=-flat-tsd_win.h-redis-MDEwOlJlcG9zaXRvcnkxMDgxMTA3MDY=-flat-tsd_generic.h.html,36,redis-MDEwOlJlcG9zaXRvcnkxMDgxMTA3MDY=-flat-tsd_win.h,redis-MDEwOlJlcG9zaXRvcnkxMDgxMTA3MDY=-flat-tsd_generic.h,114,119,5,135,140,5
37,https://htmlpreview.github.io/?https://github.com/Christina96/boilerplate-sample-matches/blob/main/C/redis-MDEwOlJlcG9zaXRvcnkxMDgxMTA3MDY=-flat-jemalloc.c-redis-MDEwOlJlcG9zaXRvcnkxMDgxMTA3MDY=-flat-jemalloc.c.html,38,redis-MDEwOlJlcG9zaXRvcnkxMDgxMTA3MDY=-flat-jemalloc.c,redis-MDEwOlJlcG9zaXRvcnkxMDgxMTA3MDY=-flat-jemalloc.c,2789,2795,6,2577,2583,6
38,https://htmlpreview.github.io/?https://github.com/Christina96/boilerplate-sample-matches/blob/main/C/xmrig-MDEwOlJlcG9zaXRvcnk4ODMyNzQwNg==-flat-schema.h-xmrig-MDEwOlJlcG9zaXRvcnk4ODMyNzQwNg==-flat-schema.h.html,23,xmrig-MDEwOlJlcG9zaXRvcnk4ODMyNzQwNg==-flat-schema.h,xmrig-MDEwOlJlcG9zaXRvcnk4ODMyNzQwNg==-flat-schema.h,1766,1768,2,1766,1768,2
39,https://htmlpreview.github.io/?https://github.com/Christina96/boilerplate-sample-matches/blob/main/C/redis-MDEwOlJlcG9zaXRvcnkxMDgxMTA3MDY=-flat-qr.c-redis-MDEwOlJlcG9zaXRvcnkxMDgxMTA3MDY=-flat-qr.c.html,19,redis-MDEwOlJlcG9zaXRvcnkxMDgxMTA3MDY=-flat-qr.c,redis-MDEwOlJlcG9zaXRvcnkxMDgxMTA3MDY=-flat-qr.c,43,47,4,37,41,4
40,https://htmlpreview.github.io/?https://github.com/Christina96/boilerplate-sample-matches/blob/main/C/redis-MDEwOlJlcG9zaXRvcnkxMDgxMTA3MDY=-flat-jemalloc.c-redis-MDEwOlJlcG9zaXRvcnkxMDgxMTA3MDY=-flat-jemalloc.c.html,17,redis-MDEwOlJlcG9zaXRvcnkxMDgxMTA3MDY=-flat-jemalloc.c,redis-MDEwOlJlcG9zaXRvcnkxMDgxMTA3MDY=-flat-jemalloc.c,976,982,6,914,919,5
41,https://htmlpreview.github.io/?https://github.com/Christina96/boilerplate-sample-matches/blob/main/C/redis-MDEwOlJlcG9zaXRvcnkxMDgxMTA3MDY=-flat-rtree_tsd.h-redis-MDEwOlJlcG9zaXRvcnkxMDgxMTA3MDY=-flat-sc.h.html,16,redis-MDEwOlJlcG9zaXRvcnkxMDgxMTA3MDY=-flat-rtree_tsd.h,redis-MDEwOlJlcG9zaXRvcnkxMDgxMTA3MDY=-flat-sc.h,16,19,3,76,79,3
42,https://htmlpreview.github.io/?https://github.com/Christina96/boilerplate-sample-matches/blob/main/C/xmrig-MDEwOlJlcG9zaXRvcnk4ODMyNzQwNg==-flat-crypto-ops.c-xmrig-MDEwOlJlcG9zaXRvcnk4ODMyNzQwNg==-flat-crypto-ops.c.html,26,xmrig-MDEwOlJlcG9zaXRvcnk4ODMyNzQwNg==-flat-crypto-ops.c,xmrig-MDEwOlJlcG9zaXRvcnk4ODMyNzQwNg==-flat-crypto-ops.c,1967,1969,2,2205,2207,2
43,https://htmlpreview.github.io/?https://github.com/Christina96/boilerplate-sample-matches/blob/main/C/PINRemoteImage-MDEwOlJlcG9zaXRvcnkzOTUzNzEwMw==-flat-dec_neon.c-PINRemoteImage-MDEwOlJlcG9zaXRvcnkzOTUzNzEwMw==-flat-dec_neon.c.html,17,PINRemoteImage-MDEwOlJlcG9zaXRvcnkzOTUzNzEwMw==-flat-dec_neon.c,PINRemoteImage-MDEwOlJlcG9zaXRvcnkzOTUzNzEwMw==-flat-dec_neon.c,538,540,2,531,533,2
44,https://htmlpreview.github.io/?https://github.com/Christina96/boilerplate-sample-matches/blob/main/C/Adafruit_nRF52_Arduino-MDEwOlJlcG9zaXRvcnk3NDM1NDcyOQ==-flat-nrf52833.h-Adafruit_nRF52_Arduino-MDEwOlJlcG9zaXRvcnk3NDM1NDcyOQ==-flat-nrf52810.h.html,25,Adafruit_nRF52_Arduino-MDEwOlJlcG9zaXRvcnk3NDM1NDcyOQ==-flat-nrf52833.h,Adafruit_nRF52_Arduino-MDEwOlJlcG9zaXRvcnk3NDM1NDcyOQ==-flat-nrf52810.h,355,358,3,1054,1056,2
45,https://htmlpreview.github.io/?https://github.com/Christina96/boilerplate-sample-matches/blob/main/C/redis-MDEwOlJlcG9zaXRvcnkxMDgxMTA3MDY=-flat-ziplist.c-redis-MDEwOlJlcG9zaXRvcnkxMDgxMTA3MDY=-flat-ziplist.c.html,17,redis-MDEwOlJlcG9zaXRvcnkxMDgxMTA3MDY=-flat-ziplist.c,redis-MDEwOlJlcG9zaXRvcnkxMDgxMTA3MDY=-flat-ziplist.c,707,709,2,707,709,2
46,https://htmlpreview.github.io/?https://github.com/Christina96/boilerplate-sample-matches/blob/main/C/libpcap-MDEwOlJlcG9zaXRvcnk5NDM1ODg3-flat-nametoaddr.c-libpcap-MDEwOlJlcG9zaXRvcnk5NDM1ODg3-flat-nametoaddr.c.html,18,libpcap-MDEwOlJlcG9zaXRvcnk5NDM1ODg3-flat-nametoaddr.c,libpcap-MDEwOlJlcG9zaXRvcnk5NDM1ODg3-flat-nametoaddr.c,116,118,2,274,276,2
47,https://htmlpreview.github.io/?https://github.com/Christina96/boilerplate-sample-matches/blob/main/C/redis-MDEwOlJlcG9zaXRvcnkxMDgxMTA3MDY=-flat-ph.h-redis-MDEwOlJlcG9zaXRvcnkxMDgxMTA3MDY=-flat-ph.h.html,36,redis-MDEwOlJlcG9zaXRvcnkxMDgxMTA3MDY=-flat-ph.h,redis-MDEwOlJlcG9zaXRvcnkxMDgxMTA3MDY=-flat-ph.h,24,28,4,24,28,4
48,https://htmlpreview.github.io/?https://github.com/Christina96/boilerplate-sample-matches/blob/main/C/xmrig-MDEwOlJlcG9zaXRvcnk4ODMyNzQwNg==-flat-topology-x86.c-xmrig-MDEwOlJlcG9zaXRvcnk4ODMyNzQwNg==-flat-topology-x86.c.html,23,xmrig-MDEwOlJlcG9zaXRvcnk4ODMyNzQwNg==-flat-topology-x86.c,xmrig-MDEwOlJlcG9zaXRvcnk4ODMyNzQwNg==-flat-topology-x86.c,282,285,3,282,285,3
49,https://htmlpreview.github.io/?https://github.com/Christina96/boilerplate-sample-matches/blob/main/C/xmrig-MDEwOlJlcG9zaXRvcnk4ODMyNzQwNg==-flat-sse2neon.h-xmrig-MDEwOlJlcG9zaXRvcnk4ODMyNzQwNg==-flat-sse2neon.h.html,20,xmrig-MDEwOlJlcG9zaXRvcnk4ODMyNzQwNg==-flat-sse2neon.h,xmrig-MDEwOlJlcG9zaXRvcnk4ODMyNzQwNg==-flat-sse2neon.h,1076,1078,2,4390,4392,2
50,https://htmlpreview.github.io/?https://github.com/Christina96/boilerplate-sample-matches/blob/main/C/xmrig-MDEwOlJlcG9zaXRvcnk4ODMyNzQwNg==-flat-CryptoNight_x86.h-xmrig-MDEwOlJlcG9zaXRvcnk4ODMyNzQwNg==-flat-CryptoNight_x86.h.html,28,xmrig-MDEwOlJlcG9zaXRvcnk4ODMyNzQwNg==-flat-CryptoNight_x86.h,xmrig-MDEwOlJlcG9zaXRvcnk4ODMyNzQwNg==-flat-CryptoNight_x86.h,1315,1316,1,1314,1315,1
51,https://htmlpreview.github.io/?https://github.com/Christina96/boilerplate-sample-matches/blob/main/C/PINRemoteImage-MDEwOlJlcG9zaXRvcnkzOTUzNzEwMw==-flat-dec_neon.c-PINRemoteImage-MDEwOlJlcG9zaXRvcnkzOTUzNzEwMw==-flat-dec_neon.c.html,34,PINRemoteImage-MDEwOlJlcG9zaXRvcnkzOTUzNzEwMw==-flat-dec_neon.c,PINRemoteImage-MDEwOlJlcG9zaXRvcnkzOTUzNzEwMw==-flat-dec_neon.c,841,845,4,841,845,4
52,https://htmlpreview.github.io/?https://github.com/Christina96/boilerplate-sample-matches/blob/main/C/libtomcrypt-MDEwOlJlcG9zaXRvcnk3NzcwMTE=-flat-rsa_export.c-libtomcrypt-MDEwOlJlcG9zaXRvcnk3NzcwMTE=-flat-rsa_export.c.html,29,libtomcrypt-MDEwOlJlcG9zaXRvcnk3NzcwMTE=-flat-rsa_export.c,libtomcrypt-MDEwOlJlcG9zaXRvcnk3NzcwMTE=-flat-rsa_export.c,11,16,5,11,16,5
53,https://htmlpreview.github.io/?https://github.com/Christina96/boilerplate-sample-matches/blob/main/C/small-MDEwOlJlcG9zaXRvcnkyNTY3NjMxNjk=-flat-resolv.c-small-MDEwOlJlcG9zaXRvcnkyNTY3NjMxNjk=-flat-resolv.c.html,47,small-MDEwOlJlcG9zaXRvcnkyNTY3NjMxNjk=-flat-resolv.c,small-MDEwOlJlcG9zaXRvcnkyNTY3NjMxNjk=-flat-resolv.c,123,131,8,123,131,8
54,https://htmlpreview.github.io/?https://github.com/Christina96/boilerplate-sample-matches/blob/main/C/Adafruit_nRF52_Arduino-MDEwOlJlcG9zaXRvcnk3NDM1NDcyOQ==-flat-tasks.c-Adafruit_nRF52_Arduino-MDEwOlJlcG9zaXRvcnk3NDM1NDcyOQ==-flat-tasks.c.html,16,Adafruit_nRF52_Arduino-MDEwOlJlcG9zaXRvcnk3NDM1NDcyOQ==-flat-tasks.c,Adafruit_nRF52_Arduino-MDEwOlJlcG9zaXRvcnk3NDM1NDcyOQ==-flat-tasks.c,2345,2350,5,2345,2350,5
55,https://htmlpreview.github.io/?https://github.com/Christina96/boilerplate-sample-matches/blob/main/C/redis-MDEwOlJlcG9zaXRvcnkxMDgxMTA3MDY=-flat-jemalloc_internal.h-redis-MDEwOlJlcG9zaXRvcnkxMDgxMTA3MDY=-flat-sz.h.html,29,redis-MDEwOlJlcG9zaXRvcnkxMDgxMTA3MDY=-flat-jemalloc_internal.h,redis-MDEwOlJlcG9zaXRvcnkxMDgxMTA3MDY=-flat-sz.h,520,523,3,172,175,3
56,https://htmlpreview.github.io/?https://github.com/Christina96/boilerplate-sample-matches/blob/main/C/libtomcrypt-MDEwOlJlcG9zaXRvcnk3NzcwMTE=-flat-der_encode_setof.c-libtomcrypt-MDEwOlJlcG9zaXRvcnk3NzcwMTE=-flat-der_encode_setof.c.html,27,libtomcrypt-MDEwOlJlcG9zaXRvcnk3NzcwMTE=-flat-der_encode_setof.c,libtomcrypt-MDEwOlJlcG9zaXRvcnk3NzcwMTE=-flat-der_encode_setof.c,28,33,5,28,33,5
57,https://htmlpreview.github.io/?https://github.com/Christina96/boilerplate-sample-matches/blob/main/C/libpcap-MDEwOlJlcG9zaXRvcnk5NDM1ODg3-flat-fileconf.c-libpcap-MDEwOlJlcG9zaXRvcnk5NDM1ODg3-flat-fileconf.c.html,16,libpcap-MDEwOlJlcG9zaXRvcnk5NDM1ODg3-flat-fileconf.c,libpcap-MDEwOlJlcG9zaXRvcnk5NDM1ODg3-flat-fileconf.c,224,229,5,197,202,5
58,https://htmlpreview.github.io/?https://github.com/Christina96/boilerplate-sample-matches/blob/main/C/libpcap-MDEwOlJlcG9zaXRvcnk5NDM1ODg3-flat-pcap-sita.c-libpcap-MDEwOlJlcG9zaXRvcnk5NDM1ODg3-flat-pcap-septel.c.html,17,libpcap-MDEwOlJlcG9zaXRvcnk5NDM1ODg3-flat-pcap-sita.c,libpcap-MDEwOlJlcG9zaXRvcnk5NDM1ODg3-flat-pcap-septel.c,746,749,3,80,83,3
59,https://htmlpreview.github.io/?https://github.com/Christina96/boilerplate-sample-matches/blob/main/C/libfuse-MDEwOlJlcG9zaXRvcnk0ODI5NjE3Nw==-flat-test_syscalls.c-libfuse-MDEwOlJlcG9zaXRvcnk0ODI5NjE3Nw==-flat-test_syscalls.c.html,28,libfuse-MDEwOlJlcG9zaXRvcnk0ODI5NjE3Nw==-flat-test_syscalls.c,libfuse-MDEwOlJlcG9zaXRvcnk0ODI5NjE3Nw==-flat-test_syscalls.c,371,376,5,698,703,5
60,https://htmlpreview.github.io/?https://github.com/Christina96/boilerplate-sample-matches/blob/main/C/libfuse-MDEwOlJlcG9zaXRvcnk0ODI5NjE3Nw==-flat-passthrough_ll.c-libfuse-MDEwOlJlcG9zaXRvcnk0ODI5NjE3Nw==-flat-passthrough_ll.c.html,58,libfuse-MDEwOlJlcG9zaXRvcnk0ODI5NjE3Nw==-flat-passthrough_ll.c,libfuse-MDEwOlJlcG9zaXRvcnk0ODI5NjE3Nw==-flat-passthrough_ll.c,835,845,10,854,864,10
61,https://htmlpreview.github.io/?https://github.com/Christina96/boilerplate-sample-matches/blob/main/C/small-MDEwOlJlcG9zaXRvcnkyNTY3NjMxNjk=-flat-http_simple.c-small-MDEwOlJlcG9zaXRvcnkyNTY3NjMxNjk=-flat-http_simple.c.html,43,small-MDEwOlJlcG9zaXRvcnkyNTY3NjMxNjk=-flat-http_simple.c,small-MDEwOlJlcG9zaXRvcnkyNTY3NjMxNjk=-flat-http_simple.c,521,531,10,521,531,10
62,https://htmlpreview.github.io/?https://github.com/Christina96/boilerplate-sample-matches/blob/main/C/redis-MDEwOlJlcG9zaXRvcnkxMDgxMTA3MDY=-flat-redis-cli.c-redis-MDEwOlJlcG9zaXRvcnkxMDgxMTA3MDY=-flat-dict_30.c.html,18,redis-MDEwOlJlcG9zaXRvcnkxMDgxMTA3MDY=-flat-redis-cli.c,redis-MDEwOlJlcG9zaXRvcnkxMDgxMTA3MDY=-flat-dict_30.c,3251,3253,2,721,723,2
63,https://htmlpreview.github.io/?https://github.com/Christina96/boilerplate-sample-matches/blob/main/C/PINRemoteImage-MDEwOlJlcG9zaXRvcnkzOTUzNzEwMw==-flat-lossless_neon.c-PINRemoteImage-MDEwOlJlcG9zaXRvcnkzOTUzNzEwMw==-flat-lossless_neon.c.html,28,PINRemoteImage-MDEwOlJlcG9zaXRvcnkzOTUzNzEwMw==-flat-lossless_neon.c,PINRemoteImage-MDEwOlJlcG9zaXRvcnkzOTUzNzEwMw==-flat-lossless_neon.c,98,100,2,98,100,2
64,https://htmlpreview.github.io/?https://github.com/Christina96/boilerplate-sample-matches/blob/main/C/Adafruit_nRF52_Arduino-MDEwOlJlcG9zaXRvcnk3NDM1NDcyOQ==-flat-nrfx_usbd.h-Adafruit_nRF52_Arduino-MDEwOlJlcG9zaXRvcnk3NDM1NDcyOQ==-flat-nrfx_usbd.h.html,18,Adafruit_nRF52_Arduino-MDEwOlJlcG9zaXRvcnk3NDM1NDcyOQ==-flat-nrfx_usbd.h,Adafruit_nRF52_Arduino-MDEwOlJlcG9zaXRvcnk3NDM1NDcyOQ==-flat-nrfx_usbd.h,166,169,3,166,169,3
65,https://htmlpreview.github.io/?https://github.com/Christina96/boilerplate-sample-matches/blob/main/C/PINRemoteImage-MDEwOlJlcG9zaXRvcnkzOTUzNzEwMw==-flat-upsampling.c-PINRemoteImage-MDEwOlJlcG9zaXRvcnkzOTUzNzEwMw==-flat-upsampling_mips_dsp_r2.c.html,334,PINRemoteImage-MDEwOlJlcG9zaXRvcnkzOTUzNzEwMw==-flat-upsampling.c,PINRemoteImage-MDEwOlJlcG9zaXRvcnkzOTUzNzEwMw==-flat-upsampling_mips_dsp_r2.c,13,36,23,115,138,23
66,https://htmlpreview.github.io/?https://github.com/Christina96/boilerplate-sample-matches/blob/main/C/xmrig-MDEwOlJlcG9zaXRvcnk4ODMyNzQwNg==-flat-CudaKawPowRunner.h-xmrig-MDEwOlJlcG9zaXRvcnk4ODMyNzQwNg==-flat-CudaCnRunner.h.html,29,xmrig-MDEwOlJlcG9zaXRvcnk4ODMyNzQwNg==-flat-CudaKawPowRunner.h,xmrig-MDEwOlJlcG9zaXRvcnk4ODMyNzQwNg==-flat-CudaCnRunner.h,8,11,3,8,11,3
67,https://htmlpreview.github.io/?https://github.com/Christina96/boilerplate-sample-matches/blob/main/C/xmrig-MDEwOlJlcG9zaXRvcnk4ODMyNzQwNg==-flat-compile.h-xmrig-MDEwOlJlcG9zaXRvcnk4ODMyNzQwNg==-flat-compile.h.html,24,xmrig-MDEwOlJlcG9zaXRvcnk4ODMyNzQwNg==-flat-compile.h,xmrig-MDEwOlJlcG9zaXRvcnk4ODMyNzQwNg==-flat-compile.h,39,42,3,39,42,3
68,https://htmlpreview.github.io/?https://github.com/Christina96/boilerplate-sample-matches/blob/main/C/redis-MDEwOlJlcG9zaXRvcnkxMDgxMTA3MDY=-flat-pages.h-redis-MDEwOlJlcG9zaXRvcnkxMDgxMTA3MDY=-flat-pages.h.html,17,redis-MDEwOlJlcG9zaXRvcnkxMDgxMTA3MDY=-flat-pages.h,redis-MDEwOlJlcG9zaXRvcnkxMDgxMTA3MDY=-flat-pages.h,61,63,2,61,63,2
69,https://htmlpreview.github.io/?https://github.com/Christina96/boilerplate-sample-matches/blob/main/C/xmrig-MDEwOlJlcG9zaXRvcnk4ODMyNzQwNg==-flat-sph_shavite.c-xmrig-MDEwOlJlcG9zaXRvcnk4ODMyNzQwNg==-flat-sph_shavite.c.html,43,xmrig-MDEwOlJlcG9zaXRvcnk4ODMyNzQwNg==-flat-sph_shavite.c,xmrig-MDEwOlJlcG9zaXRvcnk4ODMyNzQwNg==-flat-sph_shavite.c,750,757,7,750,757,7
70,https://htmlpreview.github.io/?https://github.com/Christina96/boilerplate-sample-matches/blob/main/C/libtomcrypt-MDEwOlJlcG9zaXRvcnk3NzcwMTE=-flat-ecc.c-libtomcrypt-MDEwOlJlcG9zaXRvcnk3NzcwMTE=-flat-ecc.c.html,28,libtomcrypt-MDEwOlJlcG9zaXRvcnk3NzcwMTE=-flat-ecc.c,libtomcrypt-MDEwOlJlcG9zaXRvcnk3NzcwMTE=-flat-ecc.c,397,412,15,217,232,15
71,https://htmlpreview.github.io/?https://github.com/Christina96/boilerplate-sample-matches/blob/main/C/redis-MDEwOlJlcG9zaXRvcnkxMDgxMTA3MDY=-flat-ae_kqueue.c-redis-MDEwOlJlcG9zaXRvcnkxMDgxMTA3MDY=-flat-ae_kqueue.c.html,20,redis-MDEwOlJlcG9zaXRvcnkxMDgxMTA3MDY=-flat-ae_kqueue.c,redis-MDEwOlJlcG9zaXRvcnkxMDgxMTA3MDY=-flat-ae_kqueue.c,68,69,1,71,72,1
72,https://htmlpreview.github.io/?https://github.com/Christina96/boilerplate-sample-matches/blob/main/C/libtomcrypt-MDEwOlJlcG9zaXRvcnk3NzcwMTE=-flat-idea.c-libtomcrypt-MDEwOlJlcG9zaXRvcnk3NzcwMTE=-flat-idea.c.html,50,libtomcrypt-MDEwOlJlcG9zaXRvcnk3NzcwMTE=-flat-idea.c,libtomcrypt-MDEwOlJlcG9zaXRvcnk3NzcwMTE=-flat-idea.c,93,97,4,93,97,4
73,https://htmlpreview.github.io/?https://github.com/Christina96/boilerplate-sample-matches/blob/main/C/PINRemoteImage-MDEwOlJlcG9zaXRvcnkzOTUzNzEwMw==-flat-anim_diff.c-PINRemoteImage-MDEwOlJlcG9zaXRvcnkzOTUzNzEwMw==-flat-anim_diff.c.html,75,PINRemoteImage-MDEwOlJlcG9zaXRvcnkzOTUzNzEwMw==-flat-anim_diff.c,PINRemoteImage-MDEwOlJlcG9zaXRvcnkzOTUzNzEwMw==-flat-anim_diff.c,208,217,9,208,217,9
74,https://htmlpreview.github.io/?https://github.com/Christina96/boilerplate-sample-matches/blob/main/C/libpcap-MDEwOlJlcG9zaXRvcnk5NDM1ODg3-flat-daemon.c-libpcap-MDEwOlJlcG9zaXRvcnk5NDM1ODg3-flat-daemon.c.html,16,libpcap-MDEwOlJlcG9zaXRvcnk5NDM1ODg3-flat-daemon.c,libpcap-MDEwOlJlcG9zaXRvcnk5NDM1ODg3-flat-daemon.c,512,515,3,315,318,3
75,https://htmlpreview.github.io/?https://github.com/Christina96/boilerplate-sample-matches/blob/main/C/fftw3-MDEwOlJlcG9zaXRvcnk4ODQzMzg4-flat-codelet-dft.h-fftw3-MDEwOlJlcG9zaXRvcnk4ODQzMzg4-flat-codelet-dft.h.html,8,fftw3-MDEwOlJlcG9zaXRvcnk4ODQzMzg4-flat-codelet-dft.h,fftw3-MDEwOlJlcG9zaXRvcnk4ODQzMzg4-flat-codelet-dft.h,65,66,1,65,66,1
76,https://htmlpreview.github.io/?https://github.com/Christina96/boilerplate-sample-matches/blob/main/C/xmrig-MDEwOlJlcG9zaXRvcnk4ODMyNzQwNg==-flat-sph_echo.h-xmrig-MDEwOlJlcG9zaXRvcnk4ODMyNzQwNg==-flat-sph_echo.h.html,42,xmrig-MDEwOlJlcG9zaXRvcnk4ODMyNzQwNg==-flat-sph_echo.h,xmrig-MDEwOlJlcG9zaXRvcnk4ODMyNzQwNg==-flat-sph_echo.h,29,38,9,29,38,9
77,https://htmlpreview.github.io/?https://github.com/Christina96/boilerplate-sample-matches/blob/main/C/Adafruit_nRF52_Arduino-MDEwOlJlcG9zaXRvcnk3NDM1NDcyOQ==-flat-nrf52833.h-Adafruit_nRF52_Arduino-MDEwOlJlcG9zaXRvcnk3NDM1NDcyOQ==-flat-nrf52840.h.html,26,Adafruit_nRF52_Arduino-MDEwOlJlcG9zaXRvcnk3NDM1NDcyOQ==-flat-nrf52833.h,Adafruit_nRF52_Arduino-MDEwOlJlcG9zaXRvcnk3NDM1NDcyOQ==-flat-nrf52840.h,414,417,3,417,420,3
78,https://htmlpreview.github.io/?https://github.com/Christina96/boilerplate-sample-matches/blob/main/C/Adafruit_nRF52_Arduino-MDEwOlJlcG9zaXRvcnk3NDM1NDcyOQ==-flat-lfs.h-Adafruit_nRF52_Arduino-MDEwOlJlcG9zaXRvcnk3NDM1NDcyOQ==-flat-lfs.h.html,24,Adafruit_nRF52_Arduino-MDEwOlJlcG9zaXRvcnk3NDM1NDcyOQ==-flat-lfs.h,Adafruit_nRF52_Arduino-MDEwOlJlcG9zaXRvcnk3NDM1NDcyOQ==-flat-lfs.h,191,193,2,191,193,2
79,https://htmlpreview.github.io/?https://github.com/Christina96/boilerplate-sample-matches/blob/main/C/redis-MDEwOlJlcG9zaXRvcnkxMDgxMTA3MDY=-flat-sds_35.c-redis-MDEwOlJlcG9zaXRvcnkxMDgxMTA3MDY=-flat-sds.c.html,44,redis-MDEwOlJlcG9zaXRvcnkxMDgxMTA3MDY=-flat-sds_35.c,redis-MDEwOlJlcG9zaXRvcnkxMDgxMTA3MDY=-flat-sds.c,480,487,7,453,460,7
80,https://htmlpreview.github.io/?https://github.com/Christina96/boilerplate-sample-matches/blob/main/C/PINRemoteImage-MDEwOlJlcG9zaXRvcnkzOTUzNzEwMw==-flat-mux_18.h-PINRemoteImage-MDEwOlJlcG9zaXRvcnkzOTUzNzEwMw==-flat-mux_36.h.html,247,PINRemoteImage-MDEwOlJlcG9zaXRvcnkzOTUzNzEwMw==-flat-mux_18.h,PINRemoteImage-MDEwOlJlcG9zaXRvcnkzOTUzNzEwMw==-flat-mux_36.h,77,121,44,77,121,44
81,https://htmlpreview.github.io/?https://github.com/Christina96/boilerplate-sample-matches/blob/main/C/Adafruit_nRF52_Arduino-MDEwOlJlcG9zaXRvcnk3NDM1NDcyOQ==-flat-nrf_lpcomp.h-Adafruit_nRF52_Arduino-MDEwOlJlcG9zaXRvcnk3NDM1NDcyOQ==-flat-nrf_usbd.h.html,23,Adafruit_nRF52_Arduino-MDEwOlJlcG9zaXRvcnk3NDM1NDcyOQ==-flat-nrf_lpcomp.h,Adafruit_nRF52_Arduino-MDEwOlJlcG9zaXRvcnk3NDM1NDcyOQ==-flat-nrf_usbd.h,161,165,4,563,568,5
82,https://htmlpreview.github.io/?https://github.com/Christina96/boilerplate-sample-matches/blob/main/C/libtomcrypt-MDEwOlJlcG9zaXRvcnk3NzcwMTE=-flat-tweetnacl.c-Adafruit_nRF52_Arduino-MDEwOlJlcG9zaXRvcnk3NDM1NDcyOQ==-flat-tweetnacl.c.html,194,libtomcrypt-MDEwOlJlcG9zaXRvcnk3NzcwMTE=-flat-tweetnacl.c,Adafruit_nRF52_Arduino-MDEwOlJlcG9zaXRvcnk3NDM1NDcyOQ==-flat-tweetnacl.c,13,20,7,19,26,7
83,https://htmlpreview.github.io/?https://github.com/Christina96/boilerplate-sample-matches/blob/main/C/libpcap-MDEwOlJlcG9zaXRvcnk5NDM1ODg3-flat-fmtutils.c-libpcap-MDEwOlJlcG9zaXRvcnk5NDM1ODg3-flat-fmtutils.c.html,21,libpcap-MDEwOlJlcG9zaXRvcnk5NDM1ODg3-flat-fmtutils.c,libpcap-MDEwOlJlcG9zaXRvcnk5NDM1ODg3-flat-fmtutils.c,189,191,2,189,191,2
84,https://htmlpreview.github.io/?https://github.com/Christina96/boilerplate-sample-matches/blob/main/C/libpcap-MDEwOlJlcG9zaXRvcnk5NDM1ODg3-flat-capturetest.c-libpcap-MDEwOlJlcG9zaXRvcnk5NDM1ODg3-flat-capturetest.c.html,89,libpcap-MDEwOlJlcG9zaXRvcnk5NDM1ODg3-flat-capturetest.c,libpcap-MDEwOlJlcG9zaXRvcnk5NDM1ODg3-flat-capturetest.c,192,208,16,192,208,16
85,https://htmlpreview.github.io/?https://github.com/Christina96/boilerplate-sample-matches/blob/main/C/redis-MDEwOlJlcG9zaXRvcnkxMDgxMTA3MDY=-flat-defrag.c-redis-MDEwOlJlcG9zaXRvcnkxMDgxMTA3MDY=-flat-defrag.c.html,18,redis-MDEwOlJlcG9zaXRvcnkxMDgxMTA3MDY=-flat-defrag.c,redis-MDEwOlJlcG9zaXRvcnkxMDgxMTA3MDY=-flat-defrag.c,357,359,2,357,359,2
86,https://htmlpreview.github.io/?https://github.com/Christina96/boilerplate-sample-matches/blob/main/C/redis-MDEwOlJlcG9zaXRvcnkxMDgxMTA3MDY=-flat-bit_util.h-redis-MDEwOlJlcG9zaXRvcnkxMDgxMTA3MDY=-flat-bit_util.h.html,16,redis-MDEwOlJlcG9zaXRvcnkxMDgxMTA3MDY=-flat-bit_util.h,redis-MDEwOlJlcG9zaXRvcnkxMDgxMTA3MDY=-flat-bit_util.h,175,177,2,172,174,2
87,https://htmlpreview.github.io/?https://github.com/Christina96/boilerplate-sample-matches/blob/main/C/PINRemoteImage-MDEwOlJlcG9zaXRvcnkzOTUzNzEwMw==-flat-cpu.c-PINRemoteImage-MDEwOlJlcG9zaXRvcnkzOTUzNzEwMw==-flat-cpu.c.html,31,PINRemoteImage-MDEwOlJlcG9zaXRvcnkzOTUzNzEwMw==-flat-cpu.c,PINRemoteImage-MDEwOlJlcG9zaXRvcnkzOTUzNzEwMw==-flat-cpu.c,107,111,4,116,120,4
88,https://htmlpreview.github.io/?https://github.com/Christina96/boilerplate-sample-matches/blob/main/C/libtomcrypt-MDEwOlJlcG9zaXRvcnk3NzcwMTE=-flat-multi2.c-libtomcrypt-MDEwOlJlcG9zaXRvcnk3NzcwMTE=-flat-multi2.c.html,27,libtomcrypt-MDEwOlJlcG9zaXRvcnk3NzcwMTE=-flat-multi2.c,libtomcrypt-MDEwOlJlcG9zaXRvcnk3NzcwMTE=-flat-multi2.c,116,120,4,129,133,4
89,https://htmlpreview.github.io/?https://github.com/Christina96/boilerplate-sample-matches/blob/main/C/Adafruit_nRF52_Arduino-MDEwOlJlcG9zaXRvcnk3NDM1NDcyOQ==-flat-BLEAdafruitButton.h-Adafruit_nRF52_Arduino-MDEwOlJlcG9zaXRvcnk3NDM1NDcyOQ==-flat-BLEAdafruitProximity.h.html,13,Adafruit_nRF52_Arduino-MDEwOlJlcG9zaXRvcnk3NDM1NDcyOQ==-flat-BLEAdafruitButton.h,Adafruit_nRF52_Arduino-MDEwOlJlcG9zaXRvcnk3NDM1NDcyOQ==-flat-BLEAdafruitProximity.h,8,11,3,8,11,3
90,https://htmlpreview.github.io/?https://github.com/Christina96/boilerplate-sample-matches/blob/main/C/PINRemoteImage-MDEwOlJlcG9zaXRvcnkzOTUzNzEwMw==-flat-gif2webp.c-PINRemoteImage-MDEwOlJlcG9zaXRvcnkzOTUzNzEwMw==-flat-gif2webp.c.html,15,PINRemoteImage-MDEwOlJlcG9zaXRvcnkzOTUzNzEwMw==-flat-gif2webp.c,PINRemoteImage-MDEwOlJlcG9zaXRvcnkzOTUzNzEwMw==-flat-gif2webp.c,204,207,3,204,207,3
91,https://htmlpreview.github.io/?https://github.com/Christina96/boilerplate-sample-matches/blob/main/C/redis-MDEwOlJlcG9zaXRvcnkxMDgxMTA3MDY=-flat-cluster.c-redis-MDEwOlJlcG9zaXRvcnkxMDgxMTA3MDY=-flat-cluster.c.html,26,redis-MDEwOlJlcG9zaXRvcnkxMDgxMTA3MDY=-flat-cluster.c,redis-MDEwOlJlcG9zaXRvcnkxMDgxMTA3MDY=-flat-cluster.c,846,851,5,853,858,5
92,https://htmlpreview.github.io/?https://github.com/Christina96/boilerplate-sample-matches/blob/main/C/libtomcrypt-MDEwOlJlcG9zaXRvcnk3NzcwMTE=-flat-chacha20.c-libtomcrypt-MDEwOlJlcG9zaXRvcnk3NzcwMTE=-flat-rabbit.c.html,17,libtomcrypt-MDEwOlJlcG9zaXRvcnk3NzcwMTE=-flat-chacha20.c,libtomcrypt-MDEwOlJlcG9zaXRvcnk3NzcwMTE=-flat-rabbit.c,96,102,6,174,180,6
93,https://htmlpreview.github.io/?https://github.com/Christina96/boilerplate-sample-matches/blob/main/C/libtomcrypt-MDEwOlJlcG9zaXRvcnk3NzcwMTE=-flat-rsa_set.c-libtomcrypt-MDEwOlJlcG9zaXRvcnk3NzcwMTE=-flat-rsa_set.c.html,78,libtomcrypt-MDEwOlJlcG9zaXRvcnk3NzcwMTE=-flat-rsa_set.c,libtomcrypt-MDEwOlJlcG9zaXRvcnk3NzcwMTE=-flat-rsa_set.c,36,40,4,55,59,4
94,https://htmlpreview.github.io/?https://github.com/Christina96/boilerplate-sample-matches/blob/main/C/PINRemoteImage-MDEwOlJlcG9zaXRvcnkzOTUzNzEwMw==-flat-lossless_enc_mips32.c-PINRemoteImage-MDEwOlJlcG9zaXRvcnkzOTUzNzEwMw==-flat-lossless_enc_mips32.c.html,20,PINRemoteImage-MDEwOlJlcG9zaXRvcnkzOTUzNzEwMw==-flat-lossless_enc_mips32.c,PINRemoteImage-MDEwOlJlcG9zaXRvcnkzOTUzNzEwMw==-flat-lossless_enc_mips32.c,256,259,3,256,259,3
95,https://htmlpreview.github.io/?https://github.com/Christina96/boilerplate-sample-matches/blob/main/C/xmrig-MDEwOlJlcG9zaXRvcnk4ODMyNzQwNg==-flat-sph_simd.c-xmrig-MDEwOlJlcG9zaXRvcnk4ODMyNzQwNg==-flat-sph_simd.c.html,94,xmrig-MDEwOlJlcG9zaXRvcnk4ODMyNzQwNg==-flat-sph_simd.c,xmrig-MDEwOlJlcG9zaXRvcnk4ODMyNzQwNg==-flat-sph_simd.c,1223,1231,8,1223,1231,8
96,https://htmlpreview.github.io/?https://github.com/Christina96/boilerplate-sample-matches/blob/main/C/Adafruit_nRF52_Arduino-MDEwOlJlcG9zaXRvcnk3NDM1NDcyOQ==-flat-SEGGER.h-Adafruit_nRF52_Arduino-MDEwOlJlcG9zaXRvcnk3NDM1NDcyOQ==-flat-SEGGER.h.html,17,Adafruit_nRF52_Arduino-MDEwOlJlcG9zaXRvcnk3NDM1NDcyOQ==-flat-SEGGER.h,Adafruit_nRF52_Arduino-MDEwOlJlcG9zaXRvcnk3NDM1NDcyOQ==-flat-SEGGER.h,82,83,1,82,83,1
97,https://htmlpreview.github.io/?https://github.com/Christina96/boilerplate-sample-matches/blob/main/C/PINRemoteImage-MDEwOlJlcG9zaXRvcnkzOTUzNzEwMw==-flat-decode.h-PINRemoteImage-MDEwOlJlcG9zaXRvcnkzOTUzNzEwMw==-flat-decode_40.h.html,379,PINRemoteImage-MDEwOlJlcG9zaXRvcnkzOTUzNzEwMw==-flat-decode.h,PINRemoteImage-MDEwOlJlcG9zaXRvcnkzOTUzNzEwMw==-flat-decode_40.h,134,195,61,134,195,61
98,https://htmlpreview.github.io/?https://github.com/Christina96/boilerplate-sample-matches/blob/main/C/libfuse-MDEwOlJlcG9zaXRvcnk0ODI5NjE3Nw==-flat-passthrough_ll.c-libfuse-MDEwOlJlcG9zaXRvcnk0ODI5NjE3Nw==-flat-passthrough_ll.c.html,16,libfuse-MDEwOlJlcG9zaXRvcnk0ODI5NjE3Nw==-flat-passthrough_ll.c,libfuse-MDEwOlJlcG9zaXRvcnk0ODI5NjE3Nw==-flat-passthrough_ll.c,28,29,1,29,30,1
99,https://htmlpreview.github.io/?https://github.com/Christina96/boilerplate-sample-matches/blob/main/C/xmrig-MDEwOlJlcG9zaXRvcnk4ODMyNzQwNg==-flat-sph_luffa.c-xmrig-MDEwOlJlcG9zaXRvcnk4ODMyNzQwNg==-flat-sph_luffa.c.html,18,xmrig-MDEwOlJlcG9zaXRvcnk4ODMyNzQwNg==-flat-sph_luffa.c,xmrig-MDEwOlJlcG9zaXRvcnk4ODMyNzQwNg==-flat-sph_luffa.c,372,375,3,910,913,3
100,https://htmlpreview.github.io/?https://github.com/Christina96/boilerplate-sample-matches/blob/main/C/fftw3-MDEwOlJlcG9zaXRvcnk4ODQzMzg4-flat-reodft010e-r2hc.c-fftw3-MDEwOlJlcG9zaXRvcnk4ODQzMzg4-flat-reodft010e-r2hc.c.html,26,fftw3-MDEwOlJlcG9zaXRvcnk4ODQzMzg4-flat-reodft010e-r2hc.c,fftw3-MDEwOlJlcG9zaXRvcnk4ODQzMzg4-flat-reodft010e-r2hc.c,167,171,4,167,171,4
101,https://htmlpreview.github.io/?https://github.com/Christina96/boilerplate-sample-matches/blob/main/C/Adafruit_nRF52_Arduino-MDEwOlJlcG9zaXRvcnk3NDM1NDcyOQ==-flat-nrf_mbr_17.h-Adafruit_nRF52_Arduino-MDEwOlJlcG9zaXRvcnk3NDM1NDcyOQ==-flat-nrf_mbr.h.html,479,Adafruit_nRF52_Arduino-MDEwOlJlcG9zaXRvcnk3NDM1NDcyOQ==-flat-nrf_mbr_17.h,Adafruit_nRF52_Arduino-MDEwOlJlcG9zaXRvcnk3NDM1NDcyOQ==-flat-nrf_mbr.h,24,70,46,24,70,46
102,https://htmlpreview.github.io/?https://github.com/Christina96/boilerplate-sample-matches/blob/main/C/Adafruit_nRF52_Arduino-MDEwOlJlcG9zaXRvcnk3NDM1NDcyOQ==-flat-nrf_usbd.h-Adafruit_nRF52_Arduino-MDEwOlJlcG9zaXRvcnk3NDM1NDcyOQ==-flat-nrf_usbd.h.html,35,Adafruit_nRF52_Arduino-MDEwOlJlcG9zaXRvcnk3NDM1NDcyOQ==-flat-nrf_usbd.h,Adafruit_nRF52_Arduino-MDEwOlJlcG9zaXRvcnk3NDM1NDcyOQ==-flat-nrf_usbd.h,623,631,8,623,631,8
103,https://htmlpreview.github.io/?https://github.com/Christina96/boilerplate-sample-matches/blob/main/C/PINRemoteImage-MDEwOlJlcG9zaXRvcnkzOTUzNzEwMw==-flat-enc_mips32.c-PINRemoteImage-MDEwOlJlcG9zaXRvcnkzOTUzNzEwMw==-flat-enc_neon.c.html,15,PINRemoteImage-MDEwOlJlcG9zaXRvcnkzOTUzNzEwMw==-flat-enc_mips32.c,PINRemoteImage-MDEwOlJlcG9zaXRvcnkzOTUzNzEwMw==-flat-enc_neon.c,543,546,3,660,663,3
104,https://htmlpreview.github.io/?https://github.com/Christina96/boilerplate-sample-matches/blob/main/C/xmrig-MDEwOlJlcG9zaXRvcnk4ODMyNzQwNg==-flat-document.h-xmrig-MDEwOlJlcG9zaXRvcnk4ODMyNzQwNg==-flat-document.h.html,31,xmrig-MDEwOlJlcG9zaXRvcnk4ODMyNzQwNg==-flat-document.h,xmrig-MDEwOlJlcG9zaXRvcnk4ODMyNzQwNg==-flat-document.h,687,688,1,687,688,1
105,https://htmlpreview.github.io/?https://github.com/Christina96/boilerplate-sample-matches/blob/main/C/redis-MDEwOlJlcG9zaXRvcnkxMDgxMTA3MDY=-flat-rb.h-redis-MDEwOlJlcG9zaXRvcnkxMDgxMTA3MDY=-flat-rb.h.html,23,redis-MDEwOlJlcG9zaXRvcnkxMDgxMTA3MDY=-flat-rb.h,redis-MDEwOlJlcG9zaXRvcnkxMDgxMTA3MDY=-flat-rb.h,795,797,2,798,800,2
106,https://htmlpreview.github.io/?https://github.com/Christina96/boilerplate-sample-matches/blob/main/C/Adafruit_nRF52_Arduino-MDEwOlJlcG9zaXRvcnk3NDM1NDcyOQ==-flat-nrfx_power.c-Adafruit_nRF52_Arduino-MDEwOlJlcG9zaXRvcnk3NDM1NDcyOQ==-flat-nrfx_power.c.html,15,Adafruit_nRF52_Arduino-MDEwOlJlcG9zaXRvcnk3NDM1NDcyOQ==-flat-nrfx_power.c,Adafruit_nRF52_Arduino-MDEwOlJlcG9zaXRvcnk3NDM1NDcyOQ==-flat-nrfx_power.c,213,217,4,193,197,4
107,https://htmlpreview.github.io/?https://github.com/Christina96/boilerplate-sample-matches/blob/main/C/xmrig-MDEwOlJlcG9zaXRvcnk4ODMyNzQwNg==-flat-sph_blake.h-xmrig-MDEwOlJlcG9zaXRvcnk4ODMyNzQwNg==-flat-sph_groestl.h.html,36,xmrig-MDEwOlJlcG9zaXRvcnk4ODMyNzQwNg==-flat-sph_blake.h,xmrig-MDEwOlJlcG9zaXRvcnk4ODMyNzQwNg==-flat-sph_groestl.h,38,41,3,50,53,3
108,https://htmlpreview.github.io/?https://github.com/Christina96/boilerplate-sample-matches/blob/main/C/small-MDEwOlJlcG9zaXRvcnkyNTY3NjMxNjk=-flat-server.c-small-MDEwOlJlcG9zaXRvcnkyNTY3NjMxNjk=-flat-server.c.html,37,small-MDEwOlJlcG9zaXRvcnkyNTY3NjMxNjk=-flat-server.c,small-MDEwOlJlcG9zaXRvcnkyNTY3NjMxNjk=-flat-server.c,1058,1063,5,673,678,5
109,https://htmlpreview.github.io/?https://github.com/Christina96/boilerplate-sample-matches/blob/main/C/xmrig-MDEwOlJlcG9zaXRvcnk4ODMyNzQwNg==-flat-HwApi.h-xmrig-MDEwOlJlcG9zaXRvcnk4ODMyNzQwNg==-flat-Pool.h.html,22,xmrig-MDEwOlJlcG9zaXRvcnk4ODMyNzQwNg==-flat-HwApi.h,xmrig-MDEwOlJlcG9zaXRvcnk4ODMyNzQwNg==-flat-Pool.h,15,19,4,124,128,4
110,https://htmlpreview.github.io/?https://github.com/Christina96/boilerplate-sample-matches/blob/main/C/xmrig-MDEwOlJlcG9zaXRvcnk4ODMyNzQwNg==-flat-sph_bmw.c-xmrig-MDEwOlJlcG9zaXRvcnk4ODMyNzQwNg==-flat-sph_bmw.c.html,33,xmrig-MDEwOlJlcG9zaXRvcnk4ODMyNzQwNg==-flat-sph_bmw.c,xmrig-MDEwOlJlcG9zaXRvcnk4ODMyNzQwNg==-flat-sph_bmw.c,378,381,3,378,381,3
111,https://htmlpreview.github.io/?https://github.com/Christina96/boilerplate-sample-matches/blob/main/C/PINRemoteImage-MDEwOlJlcG9zaXRvcnkzOTUzNzEwMw==-flat-jpegdec.c-redis-MDEwOlJlcG9zaXRvcnkxMDgxMTA3MDY=-flat-sort.c.html,17,PINRemoteImage-MDEwOlJlcG9zaXRvcnkzOTUzNzEwMw==-flat-jpegdec.c,redis-MDEwOlJlcG9zaXRvcnkxMDgxMTA3MDY=-flat-sort.c,131,133,2,368,370,2
112,https://htmlpreview.github.io/?https://github.com/Christina96/boilerplate-sample-matches/blob/main/C/redis-MDEwOlJlcG9zaXRvcnkxMDgxMTA3MDY=-flat-config.c-redis-MDEwOlJlcG9zaXRvcnkxMDgxMTA3MDY=-flat-config.c.html,28,redis-MDEwOlJlcG9zaXRvcnkxMDgxMTA3MDY=-flat-config.c,redis-MDEwOlJlcG9zaXRvcnkxMDgxMTA3MDY=-flat-config.c,533,537,4,508,512,4
113,https://htmlpreview.github.io/?https://github.com/Christina96/boilerplate-sample-matches/blob/main/C/redis-MDEwOlJlcG9zaXRvcnkxMDgxMTA3MDY=-flat-lvm.c-redis-MDEwOlJlcG9zaXRvcnkxMDgxMTA3MDY=-flat-lvm.c.html,58,redis-MDEwOlJlcG9zaXRvcnkxMDgxMTA3MDY=-flat-lvm.c,redis-MDEwOlJlcG9zaXRvcnkxMDgxMTA3MDY=-flat-lvm.c,485,497,12,477,489,12
114,https://htmlpreview.github.io/?https://github.com/Christina96/boilerplate-sample-matches/blob/main/C/Adafruit_nRF52_Arduino-MDEwOlJlcG9zaXRvcnk3NDM1NDcyOQ==-flat-lfs.c-Adafruit_nRF52_Arduino-MDEwOlJlcG9zaXRvcnk3NDM1NDcyOQ==-flat-lfs.c.html,22,Adafruit_nRF52_Arduino-MDEwOlJlcG9zaXRvcnk3NDM1NDcyOQ==-flat-lfs.c,Adafruit_nRF52_Arduino-MDEwOlJlcG9zaXRvcnk3NDM1NDcyOQ==-flat-lfs.c,157,159,2,41,43,2
115,https://htmlpreview.github.io/?https://github.com/Christina96/boilerplate-sample-matches/blob/main/C/libtomcrypt-MDEwOlJlcG9zaXRvcnk3NzcwMTE=-flat-ecc_test.c-libtomcrypt-MDEwOlJlcG9zaXRvcnk3NzcwMTE=-flat-ecc_test.c.html,18,libtomcrypt-MDEwOlJlcG9zaXRvcnk3NzcwMTE=-flat-ecc_test.c,libtomcrypt-MDEwOlJlcG9zaXRvcnk3NzcwMTE=-flat-ecc_test.c,417,420,3,417,420,3
116,https://htmlpreview.github.io/?https://github.com/Christina96/boilerplate-sample-matches/blob/main/C/libtomcrypt-MDEwOlJlcG9zaXRvcnk3NzcwMTE=-flat-der_decode_utf8_string.c-libtomcrypt-MDEwOlJlcG9zaXRvcnk3NzcwMTE=-flat-der_decode_object_identifier.c.html,14,libtomcrypt-MDEwOlJlcG9zaXRvcnk3NzcwMTE=-flat-der_decode_utf8_string.c,libtomcrypt-MDEwOlJlcG9zaXRvcnk3NzcwMTE=-flat-der_decode_object_identifier.c,52,57,5,57,62,5
117,https://htmlpreview.github.io/?https://github.com/Christina96/boilerplate-sample-matches/blob/main/C/xmrig-MDEwOlJlcG9zaXRvcnk4ODMyNzQwNg==-flat-CryptoNight_x86.h-xmrig-MDEwOlJlcG9zaXRvcnk4ODMyNzQwNg==-flat-CryptoNight_x86.h.html,25,xmrig-MDEwOlJlcG9zaXRvcnk4ODMyNzQwNg==-flat-CryptoNight_x86.h,xmrig-MDEwOlJlcG9zaXRvcnk4ODMyNzQwNg==-flat-CryptoNight_x86.h,1139,1145,6,1139,1145,6
118,https://htmlpreview.github.io/?https://github.com/Christina96/boilerplate-sample-matches/blob/main/C/redis-MDEwOlJlcG9zaXRvcnkxMDgxMTA3MDY=-flat-log.c-redis-MDEwOlJlcG9zaXRvcnkxMDgxMTA3MDY=-flat-log.c.html,23,redis-MDEwOlJlcG9zaXRvcnkxMDgxMTA3MDY=-flat-log.c,redis-MDEwOlJlcG9zaXRvcnkxMDgxMTA3MDY=-flat-log.c,107,110,3,107,110,3
119,https://htmlpreview.github.io/?https://github.com/Christina96/boilerplate-sample-matches/blob/main/C/Adafruit_nRF52_Arduino-MDEwOlJlcG9zaXRvcnk3NDM1NDcyOQ==-flat-nrf_saadc.h-Adafruit_nRF52_Arduino-MDEwOlJlcG9zaXRvcnk3NDM1NDcyOQ==-flat-nrf_saadc.h.html,54,Adafruit_nRF52_Arduino-MDEwOlJlcG9zaXRvcnk3NDM1NDcyOQ==-flat-nrf_saadc.h,Adafruit_nRF52_Arduino-MDEwOlJlcG9zaXRvcnk3NDM1NDcyOQ==-flat-nrf_saadc.h,441,459,18,463,481,18
120,https://htmlpreview.github.io/?https://github.com/Christina96/boilerplate-sample-matches/blob/main/C/redis-MDEwOlJlcG9zaXRvcnkxMDgxMTA3MDY=-flat-mallctl.c-redis-MDEwOlJlcG9zaXRvcnkxMDgxMTA3MDY=-flat-mallctl.c.html,17,redis-MDEwOlJlcG9zaXRvcnkxMDgxMTA3MDY=-flat-mallctl.c,redis-MDEwOlJlcG9zaXRvcnkxMDgxMTA3MDY=-flat-mallctl.c,521,527,6,547,553,6
121,https://htmlpreview.github.io/?https://github.com/Christina96/boilerplate-sample-matches/blob/main/C/Adafruit_nRF52_Arduino-MDEwOlJlcG9zaXRvcnk3NDM1NDcyOQ==-flat-nrf_clock.h-Adafruit_nRF52_Arduino-MDEwOlJlcG9zaXRvcnk3NDM1NDcyOQ==-flat-nrf_clock.h.html,18,Adafruit_nRF52_Arduino-MDEwOlJlcG9zaXRvcnk3NDM1NDcyOQ==-flat-nrf_clock.h,Adafruit_nRF52_Arduino-MDEwOlJlcG9zaXRvcnk3NDM1NDcyOQ==-flat-nrf_clock.h,79,80,1,54,55,1
122,https://htmlpreview.github.io/?https://github.com/Christina96/boilerplate-sample-matches/blob/main/C/libtomcrypt-MDEwOlJlcG9zaXRvcnk3NzcwMTE=-flat-dh.c-libtomcrypt-MDEwOlJlcG9zaXRvcnk3NzcwMTE=-flat-dh.c.html,74,libtomcrypt-MDEwOlJlcG9zaXRvcnk3NzcwMTE=-flat-dh.c,libtomcrypt-MDEwOlJlcG9zaXRvcnk3NzcwMTE=-flat-dh.c,72,105,33,101,134,33
123,https://htmlpreview.github.io/?https://github.com/Christina96/boilerplate-sample-matches/blob/main/C/Adafruit_nRF52_Arduino-MDEwOlJlcG9zaXRvcnk3NDM1NDcyOQ==-flat-Client.h-Adafruit_nRF52_Arduino-MDEwOlJlcG9zaXRvcnk3NDM1NDcyOQ==-flat-Udp.h.html,20,Adafruit_nRF52_Arduino-MDEwOlJlcG9zaXRvcnk3NDM1NDcyOQ==-flat-Client.h,Adafruit_nRF52_Arduino-MDEwOlJlcG9zaXRvcnk3NDM1NDcyOQ==-flat-Udp.h,21,23,2,24,26,2
124,https://htmlpreview.github.io/?https://github.com/Christina96/boilerplate-sample-matches/blob/main/C/small-MDEwOlJlcG9zaXRvcnkyNTY3NjMxNjk=-flat-common.h-small-MDEwOlJlcG9zaXRvcnkyNTY3NjMxNjk=-flat-udprelay.c.html,21,small-MDEwOlJlcG9zaXRvcnkyNTY3NjMxNjk=-flat-common.h,small-MDEwOlJlcG9zaXRvcnkyNTY3NjMxNjk=-flat-udprelay.c,12,17,5,1038,1044,6
125,https://htmlpreview.github.io/?https://github.com/Christina96/boilerplate-sample-matches/blob/main/C/libfuse-MDEwOlJlcG9zaXRvcnk0ODI5NjE3Nw==-flat-poll.c-libfuse-MDEwOlJlcG9zaXRvcnk0ODI5NjE3Nw==-flat-poll.c.html,18,libfuse-MDEwOlJlcG9zaXRvcnk0ODI5NjE3Nw==-flat-poll.c,libfuse-MDEwOlJlcG9zaXRvcnk0ODI5NjE3Nw==-flat-poll.c,41,44,3,41,44,3
126,https://htmlpreview.github.io/?https://github.com/Christina96/boilerplate-sample-matches/blob/main/C/libfuse-MDEwOlJlcG9zaXRvcnk0ODI5NjE3Nw==-flat-fuse.c-libfuse-MDEwOlJlcG9zaXRvcnk0ODI5NjE3Nw==-flat-fuse.c.html,18,libfuse-MDEwOlJlcG9zaXRvcnk0ODI5NjE3Nw==-flat-fuse.c,libfuse-MDEwOlJlcG9zaXRvcnk0ODI5NjE3Nw==-flat-fuse.c,1242,1244,2,1242,1244,2
127,https://htmlpreview.github.io/?https://github.com/Christina96/boilerplate-sample-matches/blob/main/C/redis-MDEwOlJlcG9zaXRvcnkxMDgxMTA3MDY=-flat-t_stream.c-redis-MDEwOlJlcG9zaXRvcnkxMDgxMTA3MDY=-flat-t_stream.c.html,45,redis-MDEwOlJlcG9zaXRvcnkxMDgxMTA3MDY=-flat-t_stream.c,redis-MDEwOlJlcG9zaXRvcnkxMDgxMTA3MDY=-flat-t_stream.c,495,499,4,495,499,4
128,https://htmlpreview.github.io/?https://github.com/Christina96/boilerplate-sample-matches/blob/main/C/fftw3-MDEwOlJlcG9zaXRvcnk4ODQzMzg4-flat-rdft-rank-geq2.c-fftw3-MDEwOlJlcG9zaXRvcnk4ODQzMzg4-flat-dft-rank-geq2-transposed.c.html,17,fftw3-MDEwOlJlcG9zaXRvcnk4ODQzMzg4-flat-rdft-rank-geq2.c,fftw3-MDEwOlJlcG9zaXRvcnk4ODQzMzg4-flat-dft-rank-geq2-transposed.c,83,84,1,97,98,1
129,https://htmlpreview.github.io/?https://github.com/Christina96/boilerplate-sample-matches/blob/main/C/redis-MDEwOlJlcG9zaXRvcnkxMDgxMTA3MDY=-flat-rdb.c-redis-MDEwOlJlcG9zaXRvcnkxMDgxMTA3MDY=-flat-rdb.c.html,41,redis-MDEwOlJlcG9zaXRvcnkxMDgxMTA3MDY=-flat-rdb.c,redis-MDEwOlJlcG9zaXRvcnkxMDgxMTA3MDY=-flat-rdb.c,133,137,4,133,137,4
130,https://htmlpreview.github.io/?https://github.com/Christina96/boilerplate-sample-matches/blob/main/C/xmrig-MDEwOlJlcG9zaXRvcnk4ODMyNzQwNg==-flat-sph_types.h-xmrig-MDEwOlJlcG9zaXRvcnk4ODMyNzQwNg==-flat-sph_types.h.html,40,xmrig-MDEwOlJlcG9zaXRvcnk4ODMyNzQwNg==-flat-sph_types.h,xmrig-MDEwOlJlcG9zaXRvcnk4ODMyNzQwNg==-flat-sph_types.h,710,718,8,515,522,7
131,https://htmlpreview.github.io/?https://github.com/Christina96/boilerplate-sample-matches/blob/main/C/xmrig-MDEwOlJlcG9zaXRvcnk4ODMyNzQwNg==-flat-schema.h-redis-MDEwOlJlcG9zaXRvcnkxMDgxMTA3MDY=-flat-jemalloc.c.html,15,xmrig-MDEwOlJlcG9zaXRvcnk4ODMyNzQwNg==-flat-schema.h,redis-MDEwOlJlcG9zaXRvcnkxMDgxMTA3MDY=-flat-jemalloc.c,2183,2188,5,1425,1430,5
132,https://htmlpreview.github.io/?https://github.com/Christina96/boilerplate-sample-matches/blob/main/C/xmrig-MDEwOlJlcG9zaXRvcnk4ODMyNzQwNg==-flat-llhttp.c-xmrig-MDEwOlJlcG9zaXRvcnk4ODMyNzQwNg==-flat-llhttp.c.html,105,xmrig-MDEwOlJlcG9zaXRvcnk4ODMyNzQwNg==-flat-llhttp.c,xmrig-MDEwOlJlcG9zaXRvcnk4ODMyNzQwNg==-flat-llhttp.c,8718,8746,28,8372,8400,28
133,https://htmlpreview.github.io/?https://github.com/Christina96/boilerplate-sample-matches/blob/main/C/libtomcrypt-MDEwOlJlcG9zaXRvcnk3NzcwMTE=-flat-der_decode_sequence_multi.c-libtomcrypt-MDEwOlJlcG9zaXRvcnk3NzcwMTE=-flat-der_decode_sequence_multi.c.html,24,libtomcrypt-MDEwOlJlcG9zaXRvcnk3NzcwMTE=-flat-der_decode_sequence_multi.c,libtomcrypt-MDEwOlJlcG9zaXRvcnk3NzcwMTE=-flat-der_decode_sequence_multi.c,20,26,6,20,26,6
134,https://htmlpreview.github.io/?https://github.com/Christina96/boilerplate-sample-matches/blob/main/C/redis-MDEwOlJlcG9zaXRvcnkxMDgxMTA3MDY=-flat-sha1.c-redis-MDEwOlJlcG9zaXRvcnkxMDgxMTA3MDY=-flat-sha1.c.html,16,redis-MDEwOlJlcG9zaXRvcnkxMDgxMTA3MDY=-flat-sha1.c,redis-MDEwOlJlcG9zaXRvcnkxMDgxMTA3MDY=-flat-sha1.c,86,87,1,86,87,1
135,https://htmlpreview.github.io/?https://github.com/Christina96/boilerplate-sample-matches/blob/main/C/xmrig-MDEwOlJlcG9zaXRvcnk4ODMyNzQwNg==-flat-adl_structures.h-android-gpuimage-plus-MDEwOlJlcG9zaXRvcnk0NjU0NzQxNw==-flat-hwcontext_drm.h.html,16,xmrig-MDEwOlJlcG9zaXRvcnk4ODMyNzQwNg==-flat-adl_structures.h,android-gpuimage-plus-MDEwOlJlcG9zaXRvcnk0NjU0NzQxNw==-flat-hwcontext_drm.h,341,347,6,10,15,5
136,https://htmlpreview.github.io/?https://github.com/Christina96/boilerplate-sample-matches/blob/main/C/redis-MDEwOlJlcG9zaXRvcnkxMDgxMTA3MDY=-flat-sds.c-redis-MDEwOlJlcG9zaXRvcnkxMDgxMTA3MDY=-flat-sds_35.c.html,20,redis-MDEwOlJlcG9zaXRvcnkxMDgxMTA3MDY=-flat-sds.c,redis-MDEwOlJlcG9zaXRvcnkxMDgxMTA3MDY=-flat-sds_35.c,143,145,2,154,156,2
137,https://htmlpreview.github.io/?https://github.com/Christina96/boilerplate-sample-matches/blob/main/C/redis-MDEwOlJlcG9zaXRvcnkxMDgxMTA3MDY=-flat-quicklist.c-redis-MDEwOlJlcG9zaXRvcnkxMDgxMTA3MDY=-flat-quicklist.c.html,20,redis-MDEwOlJlcG9zaXRvcnkxMDgxMTA3MDY=-flat-quicklist.c,redis-MDEwOlJlcG9zaXRvcnkxMDgxMTA3MDY=-flat-quicklist.c,1309,1311,2,1284,1286,2
138,https://htmlpreview.github.io/?https://github.com/Christina96/boilerplate-sample-matches/blob/main/C/Adafruit_nRF52_Arduino-MDEwOlJlcG9zaXRvcnk3NDM1NDcyOQ==-flat-nrf_radio.h-Adafruit_nRF52_Arduino-MDEwOlJlcG9zaXRvcnk3NDM1NDcyOQ==-flat-nrf_usbreg.h.html,21,Adafruit_nRF52_Arduino-MDEwOlJlcG9zaXRvcnk3NDM1NDcyOQ==-flat-nrf_radio.h,Adafruit_nRF52_Arduino-MDEwOlJlcG9zaXRvcnk3NDM1NDcyOQ==-flat-nrf_usbreg.h,311,313,2,24,27,3
139,https://htmlpreview.github.io/?https://github.com/Christina96/boilerplate-sample-matches/blob/main/C/Adafruit_nRF52_Arduino-MDEwOlJlcG9zaXRvcnk3NDM1NDcyOQ==-flat-nrf52811.h-Adafruit_nRF52_Arduino-MDEwOlJlcG9zaXRvcnk3NDM1NDcyOQ==-flat-nrf52805.h.html,104,Adafruit_nRF52_Arduino-MDEwOlJlcG9zaXRvcnk3NDM1NDcyOQ==-flat-nrf52811.h,Adafruit_nRF52_Arduino-MDEwOlJlcG9zaXRvcnk3NDM1NDcyOQ==-flat-nrf52805.h,113,123,10,109,119,10
140,https://htmlpreview.github.io/?https://github.com/Christina96/boilerplate-sample-matches/blob/main/C/redis-MDEwOlJlcG9zaXRvcnkxMDgxMTA3MDY=-flat-async.c-redis-MDEwOlJlcG9zaXRvcnkxMDgxMTA3MDY=-flat-async.c.html,15,redis-MDEwOlJlcG9zaXRvcnkxMDgxMTA3MDY=-flat-async.c,redis-MDEwOlJlcG9zaXRvcnkxMDgxMTA3MDY=-flat-async.c,210,212,2,210,212,2
141,https://htmlpreview.github.io/?https://github.com/Christina96/boilerplate-sample-matches/blob/main/C/xmrig-MDEwOlJlcG9zaXRvcnk4ODMyNzQwNg==-flat-adl_structures.h-android-gpuimage-plus-MDEwOlJlcG9zaXRvcnk0NjU0NzQxNw==-flat-avformat.h.html,15,xmrig-MDEwOlJlcG9zaXRvcnk4ODMyNzQwNg==-flat-adl_structures.h,android-gpuimage-plus-MDEwOlJlcG9zaXRvcnk0NjU0NzQxNw==-flat-avformat.h,609,614,5,343,348,5
142,https://htmlpreview.github.io/?https://github.com/Christina96/boilerplate-sample-matches/blob/main/C/xmrig-MDEwOlJlcG9zaXRvcnk4ODMyNzQwNg==-flat-sph_simd.c-xmrig-MDEwOlJlcG9zaXRvcnk4ODMyNzQwNg==-flat-sph_simd.c.html,455,xmrig-MDEwOlJlcG9zaXRvcnk4ODMyNzQwNg==-flat-sph_simd.c,xmrig-MDEwOlJlcG9zaXRvcnk4ODMyNzQwNg==-flat-sph_simd.c,988,1033,45,988,1033,45
143,https://htmlpreview.github.io/?https://github.com/Christina96/boilerplate-sample-matches/blob/main/C/xmrig-MDEwOlJlcG9zaXRvcnk4ODMyNzQwNg==-flat-sph_skein.c-xmrig-MDEwOlJlcG9zaXRvcnk4ODMyNzQwNg==-flat-sph_skein.c.html,54,xmrig-MDEwOlJlcG9zaXRvcnk4ODMyNzQwNg==-flat-sph_skein.c,xmrig-MDEwOlJlcG9zaXRvcnk4ODMyNzQwNg==-flat-sph_skein.c,403,408,5,491,496,5
144,https://htmlpreview.github.io/?https://github.com/Christina96/boilerplate-sample-matches/blob/main/C/fftw3-MDEwOlJlcG9zaXRvcnk4ODQzMzg4-flat-ct_4.c-fftw3-MDEwOlJlcG9zaXRvcnk4ODQzMzg4-flat-ct-hc2c.c.html,15,fftw3-MDEwOlJlcG9zaXRvcnk4ODQzMzg4-flat-ct_4.c,fftw3-MDEwOlJlcG9zaXRvcnk4ODQzMzg4-flat-ct-hc2c.c,112,115,3,153,156,3
145,https://htmlpreview.github.io/?https://github.com/Christina96/boilerplate-sample-matches/blob/main/C/libtomcrypt-MDEwOlJlcG9zaXRvcnk3NzcwMTE=-flat-tomcrypt_pk.h-libtomcrypt-MDEwOlJlcG9zaXRvcnk3NzcwMTE=-flat-tomcrypt_pk.h.html,66,libtomcrypt-MDEwOlJlcG9zaXRvcnk3NzcwMTE=-flat-tomcrypt_pk.h,libtomcrypt-MDEwOlJlcG9zaXRvcnk3NzcwMTE=-flat-tomcrypt_pk.h,496,503,7,513,520,7
146,https://htmlpreview.github.io/?https://github.com/Christina96/boilerplate-sample-matches/blob/main/C/redis-MDEwOlJlcG9zaXRvcnkxMDgxMTA3MDY=-flat-atomic_c11.h-redis-MDEwOlJlcG9zaXRvcnkxMDgxMTA3MDY=-flat-atomic_c11.h.html,21,redis-MDEwOlJlcG9zaXRvcnkxMDgxMTA3MDY=-flat-atomic_c11.h,redis-MDEwOlJlcG9zaXRvcnkxMDgxMTA3MDY=-flat-atomic_c11.h,40,43,3,40,43,3
147,https://htmlpreview.github.io/?https://github.com/Christina96/boilerplate-sample-matches/blob/main/C/redis-MDEwOlJlcG9zaXRvcnkxMDgxMTA3MDY=-flat-stats_print.c-redis-MDEwOlJlcG9zaXRvcnkxMDgxMTA3MDY=-flat-stats_print.c.html,16,redis-MDEwOlJlcG9zaXRvcnkxMDgxMTA3MDY=-flat-stats_print.c,redis-MDEwOlJlcG9zaXRvcnkxMDgxMTA3MDY=-flat-stats_print.c,275,280,5,275,280,5
148,https://htmlpreview.github.io/?https://github.com/Christina96/boilerplate-sample-matches/blob/main/C/PINRemoteImage-MDEwOlJlcG9zaXRvcnkzOTUzNzEwMw==-flat-img2webp.c-PINRemoteImage-MDEwOlJlcG9zaXRvcnkzOTUzNzEwMw==-flat-backward_references_enc.c.html,15,PINRemoteImage-MDEwOlJlcG9zaXRvcnkzOTUzNzEwMw==-flat-img2webp.c,PINRemoteImage-MDEwOlJlcG9zaXRvcnkzOTUzNzEwMw==-flat-backward_references_enc.c,56,57,1,681,682,1
149,https://htmlpreview.github.io/?https://github.com/Christina96/boilerplate-sample-matches/blob/main/C/PINRemoteImage-MDEwOlJlcG9zaXRvcnkzOTUzNzEwMw==-flat-lossless_enc_sse2.c-PINRemoteImage-MDEwOlJlcG9zaXRvcnkzOTUzNzEwMw==-flat-lossless_enc_sse2.c.html,51,PINRemoteImage-MDEwOlJlcG9zaXRvcnkzOTUzNzEwMw==-flat-lossless_enc_sse2.c,PINRemoteImage-MDEwOlJlcG9zaXRvcnkzOTUzNzEwMw==-flat-lossless_enc_sse2.c,271,277,6,266,272,6
150,https://htmlpreview.github.io/?https://github.com/Christina96/boilerplate-sample-matches/blob/main/C/redis-MDEwOlJlcG9zaXRvcnkxMDgxMTA3MDY=-flat-rtree.h-redis-MDEwOlJlcG9zaXRvcnkxMDgxMTA3MDY=-flat-rtree.h.html,65,redis-MDEwOlJlcG9zaXRvcnkxMDgxMTA3MDY=-flat-rtree.h,redis-MDEwOlJlcG9zaXRvcnkxMDgxMTA3MDY=-flat-rtree.h,371,380,9,371,380,9
151,https://htmlpreview.github.io/?https://github.com/Christina96/boilerplate-sample-matches/blob/main/C/xmrig-MDEwOlJlcG9zaXRvcnk4ODMyNzQwNg==-flat-chrono.h-xmrig-MDEwOlJlcG9zaXRvcnk4ODMyNzQwNg==-flat-chrono.h.html,16,xmrig-MDEwOlJlcG9zaXRvcnk4ODMyNzQwNg==-flat-chrono.h,xmrig-MDEwOlJlcG9zaXRvcnk4ODMyNzQwNg==-flat-chrono.h,753,754,1,131,132,1
152,https://htmlpreview.github.io/?https://github.com/Christina96/boilerplate-sample-matches/blob/main/C/Adafruit_nRF52_Arduino-MDEwOlJlcG9zaXRvcnk3NDM1NDcyOQ==-flat-nrf_pdm.h-Adafruit_nRF52_Arduino-MDEwOlJlcG9zaXRvcnk3NDM1NDcyOQ==-flat-nrfx_pwm.c.html,19,Adafruit_nRF52_Arduino-MDEwOlJlcG9zaXRvcnk3NDM1NDcyOQ==-flat-nrf_pdm.h,Adafruit_nRF52_Arduino-MDEwOlJlcG9zaXRvcnk3NDM1NDcyOQ==-flat-nrfx_pwm.c,242,247,5,127,132,5
153,https://htmlpreview.github.io/?https://github.com/Christina96/boilerplate-sample-matches/blob/main/C/redis-MDEwOlJlcG9zaXRvcnkxMDgxMTA3MDY=-flat-rallocx.c-redis-MDEwOlJlcG9zaXRvcnkxMDgxMTA3MDY=-flat-rallocx.c.html,16,redis-MDEwOlJlcG9zaXRvcnkxMDgxMTA3MDY=-flat-rallocx.c,redis-MDEwOlJlcG9zaXRvcnkxMDgxMTA3MDY=-flat-rallocx.c,100,102,2,168,170,2
154,https://htmlpreview.github.io/?https://github.com/Christina96/boilerplate-sample-matches/blob/main/C/xmrig-MDEwOlJlcG9zaXRvcnk4ODMyNzQwNg==-flat-sph_simd.c-xmrig-MDEwOlJlcG9zaXRvcnk4ODMyNzQwNg==-flat-sph_simd.c.html,160,xmrig-MDEwOlJlcG9zaXRvcnk4ODMyNzQwNg==-flat-sph_simd.c,xmrig-MDEwOlJlcG9zaXRvcnk4ODMyNzQwNg==-flat-sph_simd.c,1438,1454,16,1418,1434,16
155,https://htmlpreview.github.io/?https://github.com/Christina96/boilerplate-sample-matches/blob/main/C/small-MDEwOlJlcG9zaXRvcnkyNTY3NjMxNjk=-flat-encrypt.c-small-MDEwOlJlcG9zaXRvcnkyNTY3NjMxNjk=-flat-encrypt.c.html,15,small-MDEwOlJlcG9zaXRvcnkyNTY3NjMxNjk=-flat-encrypt.c,small-MDEwOlJlcG9zaXRvcnkyNTY3NjMxNjk=-flat-encrypt.c,583,585,2,583,585,2
156,https://htmlpreview.github.io/?https://github.com/Christina96/boilerplate-sample-matches/blob/main/C/redis-MDEwOlJlcG9zaXRvcnkxMDgxMTA3MDY=-flat-background_thread_22.c-redis-MDEwOlJlcG9zaXRvcnkxMDgxMTA3MDY=-flat-background_thread_22.c.html,16,redis-MDEwOlJlcG9zaXRvcnkxMDgxMTA3MDY=-flat-background_thread_22.c,redis-MDEwOlJlcG9zaXRvcnkxMDgxMTA3MDY=-flat-background_thread_22.c,131,133,2,131,133,2
157,https://htmlpreview.github.io/?https://github.com/Christina96/boilerplate-sample-matches/blob/main/C/xmrig-MDEwOlJlcG9zaXRvcnk4ODMyNzQwNg==-flat-sph_shabal.c-xmrig-MDEwOlJlcG9zaXRvcnk4ODMyNzQwNg==-flat-sph_shavite.c.html,18,xmrig-MDEwOlJlcG9zaXRvcnk4ODMyNzQwNg==-flat-sph_shabal.c,xmrig-MDEwOlJlcG9zaXRvcnk4ODMyNzQwNg==-flat-sph_shavite.c,476,479,3,1415,1418,3
158,https://htmlpreview.github.io/?https://github.com/Christina96/boilerplate-sample-matches/blob/main/C/redis-MDEwOlJlcG9zaXRvcnkxMDgxMTA3MDY=-flat-defrag.c-redis-MDEwOlJlcG9zaXRvcnkxMDgxMTA3MDY=-flat-defrag.c.html,17,redis-MDEwOlJlcG9zaXRvcnkxMDgxMTA3MDY=-flat-defrag.c,redis-MDEwOlJlcG9zaXRvcnkxMDgxMTA3MDY=-flat-defrag.c,554,555,1,552,553,1
159,https://htmlpreview.github.io/?https://github.com/Christina96/boilerplate-sample-matches/blob/main/C/redis-MDEwOlJlcG9zaXRvcnkxMDgxMTA3MDY=-flat-WS2tcpip.h-redis-MDEwOlJlcG9zaXRvcnkxMDgxMTA3MDY=-flat-WS2tcpip.h.html,105,redis-MDEwOlJlcG9zaXRvcnkxMDgxMTA3MDY=-flat-WS2tcpip.h,redis-MDEwOlJlcG9zaXRvcnkxMDgxMTA3MDY=-flat-WS2tcpip.h,597,615,18,597,615,18
160,https://htmlpreview.github.io/?https://github.com/Christina96/boilerplate-sample-matches/blob/main/C/redis-MDEwOlJlcG9zaXRvcnkxMDgxMTA3MDY=-flat-prof_inlines_b.h-libtomcrypt-MDEwOlJlcG9zaXRvcnk3NzcwMTE=-flat-gmp_desc.c.html,18,redis-MDEwOlJlcG9zaXRvcnkxMDgxMTA3MDY=-flat-prof_inlines_b.h,libtomcrypt-MDEwOlJlcG9zaXRvcnk3NzcwMTE=-flat-gmp_desc.c,57,59,2,429,431,2
161,https://htmlpreview.github.io/?https://github.com/Christina96/boilerplate-sample-matches/blob/main/C/redis-MDEwOlJlcG9zaXRvcnkxMDgxMTA3MDY=-flat-sds_38.h-redis-MDEwOlJlcG9zaXRvcnkxMDgxMTA3MDY=-flat-sds.h.html,101,redis-MDEwOlJlcG9zaXRvcnkxMDgxMTA3MDY=-flat-sds_38.h,redis-MDEwOlJlcG9zaXRvcnkxMDgxMTA3MDY=-flat-sds.h,239,246,7,241,248,7
162,https://htmlpreview.github.io/?https://github.com/Christina96/boilerplate-sample-matches/blob/main/C/PINRemoteImage-MDEwOlJlcG9zaXRvcnkzOTUzNzEwMw==-flat-lossless_msa.c-PINRemoteImage-MDEwOlJlcG9zaXRvcnkzOTUzNzEwMw==-flat-lossless_msa.c.html,28,PINRemoteImage-MDEwOlJlcG9zaXRvcnkzOTUzNzEwMw==-flat-lossless_msa.c,PINRemoteImage-MDEwOlJlcG9zaXRvcnkzOTUzNzEwMw==-flat-lossless_msa.c,20,23,3,20,23,3
163,https://htmlpreview.github.io/?https://github.com/Christina96/boilerplate-sample-matches/blob/main/C/redis-MDEwOlJlcG9zaXRvcnkxMDgxMTA3MDY=-flat-ziplist.c-redis-MDEwOlJlcG9zaXRvcnkxMDgxMTA3MDY=-flat-rdb.h.html,16,redis-MDEwOlJlcG9zaXRvcnkxMDgxMTA3MDY=-flat-ziplist.c,redis-MDEwOlJlcG9zaXRvcnkxMDgxMTA3MDY=-flat-rdb.h,20,23,3,25,28,3
164,https://htmlpreview.github.io/?https://github.com/Christina96/boilerplate-sample-matches/blob/main/C/xmrig-MDEwOlJlcG9zaXRvcnk4ODMyNzQwNg==-flat-sph_skein.c-xmrig-MDEwOlJlcG9zaXRvcnk4ODMyNzQwNg==-flat-sph_blake.c.html,18,xmrig-MDEwOlJlcG9zaXRvcnk4ODMyNzQwNg==-flat-sph_skein.c,xmrig-MDEwOlJlcG9zaXRvcnk4ODMyNzQwNg==-flat-sph_blake.c,594,596,2,393,395,2
165,https://htmlpreview.github.io/?https://github.com/Christina96/boilerplate-sample-matches/blob/main/C/PINRemoteImage-MDEwOlJlcG9zaXRvcnkzOTUzNzEwMw==-flat-gif2webp.c-PINRemoteImage-MDEwOlJlcG9zaXRvcnkzOTUzNzEwMw==-flat-cwebp.c.html,15,PINRemoteImage-MDEwOlJlcG9zaXRvcnkzOTUzNzEwMw==-flat-gif2webp.c,PINRemoteImage-MDEwOlJlcG9zaXRvcnkzOTUzNzEwMw==-flat-cwebp.c,222,226,4,813,817,4
166,https://htmlpreview.github.io/?https://github.com/Christina96/boilerplate-sample-matches/blob/main/C/small-MDEwOlJlcG9zaXRvcnkyNTY3NjMxNjk=-flat-auth.c-small-MDEwOlJlcG9zaXRvcnkyNTY3NjMxNjk=-flat-auth.c.html,15,small-MDEwOlJlcG9zaXRvcnkyNTY3NjMxNjk=-flat-auth.c,small-MDEwOlJlcG9zaXRvcnkyNTY3NjMxNjk=-flat-auth.c,457,458,1,562,563,1
167,https://htmlpreview.github.io/?https://github.com/Christina96/boilerplate-sample-matches/blob/main/C/libtomcrypt-MDEwOlJlcG9zaXRvcnk3NzcwMTE=-flat-sha3_test.c-libtomcrypt-MDEwOlJlcG9zaXRvcnk3NzcwMTE=-flat-sha3_test.c.html,35,libtomcrypt-MDEwOlJlcG9zaXRvcnk3NzcwMTE=-flat-sha3_test.c,libtomcrypt-MDEwOlJlcG9zaXRvcnk3NzcwMTE=-flat-sha3_test.c,346,354,8,569,578,9
168,https://htmlpreview.github.io/?https://github.com/Christina96/boilerplate-sample-matches/blob/main/C/redis-MDEwOlJlcG9zaXRvcnkxMDgxMTA3MDY=-flat-sds.c-redis-MDEwOlJlcG9zaXRvcnkxMDgxMTA3MDY=-flat-sds_35.c.html,1443,redis-MDEwOlJlcG9zaXRvcnkxMDgxMTA3MDY=-flat-sds.c,redis-MDEwOlJlcG9zaXRvcnkxMDgxMTA3MDY=-flat-sds_35.c,665,853,188,683,871,188
169,https://htmlpreview.github.io/?https://github.com/Christina96/boilerplate-sample-matches/blob/main/C/Adafruit_nRF52_Arduino-MDEwOlJlcG9zaXRvcnk3NDM1NDcyOQ==-flat-nrfx_pwm.c-Adafruit_nRF52_Arduino-MDEwOlJlcG9zaXRvcnk3NDM1NDcyOQ==-flat-nrfx_spim.c.html,30,Adafruit_nRF52_Arduino-MDEwOlJlcG9zaXRvcnk3NDM1NDcyOQ==-flat-nrfx_pwm.c,Adafruit_nRF52_Arduino-MDEwOlJlcG9zaXRvcnk3NDM1NDcyOQ==-flat-nrfx_spim.c,114,118,4,548,552,4
170,https://htmlpreview.github.io/?https://github.com/Christina96/boilerplate-sample-matches/blob/main/C/PINRemoteImage-MDEwOlJlcG9zaXRvcnkzOTUzNzEwMw==-flat-rescaler.c-PINRemoteImage-MDEwOlJlcG9zaXRvcnkzOTUzNzEwMw==-flat-rescaler.c.html,52,PINRemoteImage-MDEwOlJlcG9zaXRvcnkzOTUzNzEwMw==-flat-rescaler.c,PINRemoteImage-MDEwOlJlcG9zaXRvcnkzOTUzNzEwMw==-flat-rescaler.c,69,75,6,69,75,6
171,https://htmlpreview.github.io/?https://github.com/Christina96/boilerplate-sample-matches/blob/main/C/libtomcrypt-MDEwOlJlcG9zaXRvcnk3NzcwMTE=-flat-rsa_set.c-libtomcrypt-MDEwOlJlcG9zaXRvcnk3NzcwMTE=-flat-rsa_set.c.html,29,libtomcrypt-MDEwOlJlcG9zaXRvcnk3NzcwMTE=-flat-rsa_set.c,libtomcrypt-MDEwOlJlcG9zaXRvcnk3NzcwMTE=-flat-rsa_set.c,6,12,6,30,36,6
172,https://htmlpreview.github.io/?https://github.com/Christina96/boilerplate-sample-matches/blob/main/C/fftw3-MDEwOlJlcG9zaXRvcnk4ODQzMzg4-flat-buffered_21.c-fftw3-MDEwOlJlcG9zaXRvcnk4ODQzMzg4-flat-buffered_5.c.html,34,fftw3-MDEwOlJlcG9zaXRvcnk4ODQzMzg4-flat-buffered_21.c,fftw3-MDEwOlJlcG9zaXRvcnk4ODQzMzg4-flat-buffered_5.c,199,204,5,162,167,5
173,https://htmlpreview.github.io/?https://github.com/Christina96/boilerplate-sample-matches/blob/main/C/fftw3-MDEwOlJlcG9zaXRvcnk4ODQzMzg4-flat-bench.c-redis-MDEwOlJlcG9zaXRvcnkxMDgxMTA3MDY=-flat-arena_reset.c.html,18,fftw3-MDEwOlJlcG9zaXRvcnk4ODQzMzg4-flat-bench.c,redis-MDEwOlJlcG9zaXRvcnkxMDgxMTA3MDY=-flat-arena_reset.c,198,200,2,198,200,2
174,https://htmlpreview.github.io/?https://github.com/Christina96/boilerplate-sample-matches/blob/main/C/redis-MDEwOlJlcG9zaXRvcnkxMDgxMTA3MDY=-flat-qr.c-redis-MDEwOlJlcG9zaXRvcnkxMDgxMTA3MDY=-flat-qr.c.html,29,redis-MDEwOlJlcG9zaXRvcnkxMDgxMTA3MDY=-flat-qr.c,redis-MDEwOlJlcG9zaXRvcnkxMDgxMTA3MDY=-flat-qr.c,25,32,7,25,32,7
175,https://htmlpreview.github.io/?https://github.com/Christina96/boilerplate-sample-matches/blob/main/C/PINRemoteImage-MDEwOlJlcG9zaXRvcnkzOTUzNzEwMw==-flat-lossless_enc_mips32.c-PINRemoteImage-MDEwOlJlcG9zaXRvcnkzOTUzNzEwMw==-flat-lossless_enc_mips32.c.html,33,PINRemoteImage-MDEwOlJlcG9zaXRvcnkzOTUzNzEwMw==-flat-lossless_enc_mips32.c,PINRemoteImage-MDEwOlJlcG9zaXRvcnkzOTUzNzEwMw==-flat-lossless_enc_mips32.c,264,269,5,254,259,5
176,https://htmlpreview.github.io/?https://github.com/Christina96/boilerplate-sample-matches/blob/main/C/Adafruit_nRF52_Arduino-MDEwOlJlcG9zaXRvcnk3NDM1NDcyOQ==-flat-stream_buffer.c-Adafruit_nRF52_Arduino-MDEwOlJlcG9zaXRvcnk3NDM1NDcyOQ==-flat-stream_buffer.c.html,47,Adafruit_nRF52_Arduino-MDEwOlJlcG9zaXRvcnk3NDM1NDcyOQ==-flat-stream_buffer.c,Adafruit_nRF52_Arduino-MDEwOlJlcG9zaXRvcnk3NDM1NDcyOQ==-flat-stream_buffer.c,522,533,11,452,463,11
177,https://htmlpreview.github.io/?https://github.com/Christina96/boilerplate-sample-matches/blob/main/C/redis-MDEwOlJlcG9zaXRvcnkxMDgxMTA3MDY=-flat-emitter.c-redis-MDEwOlJlcG9zaXRvcnkxMDgxMTA3MDY=-flat-emitter.c.html,21,redis-MDEwOlJlcG9zaXRvcnkxMDgxMTA3MDY=-flat-emitter.c,redis-MDEwOlJlcG9zaXRvcnkxMDgxMTA3MDY=-flat-emitter.c,82,84,2,84,86,2
178,https://htmlpreview.github.io/?https://github.com/Christina96/boilerplate-sample-matches/blob/main/C/Adafruit_nRF52_Arduino-MDEwOlJlcG9zaXRvcnk3NDM1NDcyOQ==-flat-nrfx_nvmc.h-Adafruit_nRF52_Arduino-MDEwOlJlcG9zaXRvcnk3NDM1NDcyOQ==-flat-nrfx_nvmc.h.html,15,Adafruit_nRF52_Arduino-MDEwOlJlcG9zaXRvcnk3NDM1NDcyOQ==-flat-nrfx_nvmc.h,Adafruit_nRF52_Arduino-MDEwOlJlcG9zaXRvcnk3NDM1NDcyOQ==-flat-nrfx_nvmc.h,21,22,1,20,21,1
179,https://htmlpreview.github.io/?https://github.com/Christina96/boilerplate-sample-matches/blob/main/C/Adafruit_nRF52_Arduino-MDEwOlJlcG9zaXRvcnk3NDM1NDcyOQ==-flat-nrf_qspi.h-Adafruit_nRF52_Arduino-MDEwOlJlcG9zaXRvcnk3NDM1NDcyOQ==-flat-nrf_qspi.h.html,26,Adafruit_nRF52_Arduino-MDEwOlJlcG9zaXRvcnk3NDM1NDcyOQ==-flat-nrf_qspi.h,Adafruit_nRF52_Arduino-MDEwOlJlcG9zaXRvcnk3NDM1NDcyOQ==-flat-nrf_qspi.h,514,516,2,494,496,2
180,https://htmlpreview.github.io/?https://github.com/Christina96/boilerplate-sample-matches/blob/main/C/xmrig-MDEwOlJlcG9zaXRvcnk4ODMyNzQwNg==-flat-IDnsBackend.h-xmrig-MDEwOlJlcG9zaXRvcnk4ODMyNzQwNg==-flat-Rx.h.html,17,xmrig-MDEwOlJlcG9zaXRvcnk4ODMyNzQwNg==-flat-IDnsBackend.h,xmrig-MDEwOlJlcG9zaXRvcnk4ODMyNzQwNg==-flat-Rx.h,5,11,6,7,13,6
181,https://htmlpreview.github.io/?https://github.com/Christina96/boilerplate-sample-matches/blob/main/C/redis-MDEwOlJlcG9zaXRvcnkxMDgxMTA3MDY=-flat-module.c-redis-MDEwOlJlcG9zaXRvcnkxMDgxMTA3MDY=-flat-module.c.html,67,redis-MDEwOlJlcG9zaXRvcnkxMDgxMTA3MDY=-flat-module.c,redis-MDEwOlJlcG9zaXRvcnkxMDgxMTA3MDY=-flat-module.c,1179,1194,15,1125,1140,15
182,https://htmlpreview.github.io/?https://github.com/Christina96/boilerplate-sample-matches/blob/main/C/libtomcrypt-MDEwOlJlcG9zaXRvcnk3NzcwMTE=-flat-crypt.c-libtomcrypt-MDEwOlJlcG9zaXRvcnk3NzcwMTE=-flat-crypt.c.html,28,libtomcrypt-MDEwOlJlcG9zaXRvcnk3NzcwMTE=-flat-crypt.c,libtomcrypt-MDEwOlJlcG9zaXRvcnk3NzcwMTE=-flat-crypt.c,223,233,10,330,340,10
183,https://htmlpreview.github.io/?https://github.com/Christina96/boilerplate-sample-matches/blob/main/C/xmrig-MDEwOlJlcG9zaXRvcnk4ODMyNzQwNg==-flat-c_groestl.c-xmrig-MDEwOlJlcG9zaXRvcnk4ODMyNzQwNg==-flat-c_groestl.c.html,68,xmrig-MDEwOlJlcG9zaXRvcnk4ODMyNzQwNg==-flat-c_groestl.c,xmrig-MDEwOlJlcG9zaXRvcnk4ODMyNzQwNg==-flat-c_groestl.c,39,45,6,17,23,6
184,https://htmlpreview.github.io/?https://github.com/Christina96/boilerplate-sample-matches/blob/main/C/xmrig-MDEwOlJlcG9zaXRvcnk4ODMyNzQwNg==-flat-sph_hamsi_helper.c-xmrig-MDEwOlJlcG9zaXRvcnk4ODMyNzQwNg==-flat-sph_hamsi_helper.c.html,15,xmrig-MDEwOlJlcG9zaXRvcnk4ODMyNzQwNg==-flat-sph_hamsi_helper.c,xmrig-MDEwOlJlcG9zaXRvcnk4ODMyNzQwNg==-flat-sph_hamsi_helper.c,7821,7823,2,15415,15417,2
185,https://htmlpreview.github.io/?https://github.com/Christina96/boilerplate-sample-matches/blob/main/C/PINRemoteImage-MDEwOlJlcG9zaXRvcnkzOTUzNzEwMw==-flat-encode_38.h-PINRemoteImage-MDEwOlJlcG9zaXRvcnkzOTUzNzEwMw==-flat-encode_44.h.html,230,PINRemoteImage-MDEwOlJlcG9zaXRvcnkzOTUzNzEwMw==-flat-encode_38.h,PINRemoteImage-MDEwOlJlcG9zaXRvcnkzOTUzNzEwMw==-flat-encode_44.h,199,226,27,199,226,27
186,https://htmlpreview.github.io/?https://github.com/Christina96/boilerplate-sample-matches/blob/main/C/libtomcrypt-MDEwOlJlcG9zaXRvcnk3NzcwMTE=-flat-ocb_ntz.c-libtomcrypt-MDEwOlJlcG9zaXRvcnk3NzcwMTE=-flat-ocb_ntz.c.html,42,libtomcrypt-MDEwOlJlcG9zaXRvcnk3NzcwMTE=-flat-ocb_ntz.c,libtomcrypt-MDEwOlJlcG9zaXRvcnk3NzcwMTE=-flat-ocb_ntz.c,3,14,11,3,14,11
187,https://htmlpreview.github.io/?https://github.com/Christina96/boilerplate-sample-matches/blob/main/C/xmrig-MDEwOlJlcG9zaXRvcnk4ODMyNzQwNg==-flat-topology-xml.c-xmrig-MDEwOlJlcG9zaXRvcnk4ODMyNzQwNg==-flat-topology-xml.c.html,16,xmrig-MDEwOlJlcG9zaXRvcnk4ODMyNzQwNg==-flat-topology-xml.c,xmrig-MDEwOlJlcG9zaXRvcnk4ODMyNzQwNg==-flat-topology-xml.c,2760,2761,1,2758,2759,1
188,https://htmlpreview.github.io/?https://github.com/Christina96/boilerplate-sample-matches/blob/main/C/Adafruit_nRF52_Arduino-MDEwOlJlcG9zaXRvcnk3NDM1NDcyOQ==-flat-ble_gap_8.h-Adafruit_nRF52_Arduino-MDEwOlJlcG9zaXRvcnk3NDM1NDcyOQ==-flat-ble_gap_8.h.html,28,Adafruit_nRF52_Arduino-MDEwOlJlcG9zaXRvcnk3NDM1NDcyOQ==-flat-ble_gap_8.h,Adafruit_nRF52_Arduino-MDEwOlJlcG9zaXRvcnk3NDM1NDcyOQ==-flat-ble_gap_8.h,697,698,1,697,698,1
189,https://htmlpreview.github.io/?https://github.com/Christina96/boilerplate-sample-matches/blob/main/C/fftw3-MDEwOlJlcG9zaXRvcnk4ODQzMzg4-flat-mpi-bench.c-fftw3-MDEwOlJlcG9zaXRvcnk4ODQzMzg4-flat-mpi-bench.c.html,91,fftw3-MDEwOlJlcG9zaXRvcnk4ODQzMzg4-flat-mpi-bench.c,fftw3-MDEwOlJlcG9zaXRvcnk4ODQzMzg4-flat-mpi-bench.c,417,425,8,340,348,8
190,https://htmlpreview.github.io/?https://github.com/Christina96/boilerplate-sample-matches/blob/main/C/Adafruit_nRF52_Arduino-MDEwOlJlcG9zaXRvcnk3NDM1NDcyOQ==-flat-nrf_nfct.h-Adafruit_nRF52_Arduino-MDEwOlJlcG9zaXRvcnk3NDM1NDcyOQ==-flat-nrf_nfct.h.html,22,Adafruit_nRF52_Arduino-MDEwOlJlcG9zaXRvcnk3NDM1NDcyOQ==-flat-nrf_nfct.h,Adafruit_nRF52_Arduino-MDEwOlJlcG9zaXRvcnk3NDM1NDcyOQ==-flat-nrf_nfct.h,209,212,3,197,201,4
191,https://htmlpreview.github.io/?https://github.com/Christina96/boilerplate-sample-matches/blob/main/C/libtomcrypt-MDEwOlJlcG9zaXRvcnk3NzcwMTE=-flat-sosemanuk.c-libtomcrypt-MDEwOlJlcG9zaXRvcnk3NzcwMTE=-flat-sosemanuk.c.html,53,libtomcrypt-MDEwOlJlcG9zaXRvcnk3NzcwMTE=-flat-sosemanuk.c,libtomcrypt-MDEwOlJlcG9zaXRvcnk3NzcwMTE=-flat-sosemanuk.c,100,105,5,104,109,5
192,https://htmlpreview.github.io/?https://github.com/Christina96/boilerplate-sample-matches/blob/main/C/fftw3-MDEwOlJlcG9zaXRvcnk4ODQzMzg4-flat-plan-many-dft-c2r.c-fftw3-MDEwOlJlcG9zaXRvcnk4ODQzMzg4-flat-plan-many-dft-c2r.c.html,19,fftw3-MDEwOlJlcG9zaXRvcnk4ODQzMzg4-flat-plan-many-dft-c2r.c,fftw3-MDEwOlJlcG9zaXRvcnk4ODQzMzg4-flat-plan-many-dft-c2r.c,15,17,2,15,17,2
193,https://htmlpreview.github.io/?https://github.com/Christina96/boilerplate-sample-matches/blob/main/C/libtomcrypt-MDEwOlJlcG9zaXRvcnk3NzcwMTE=-flat-sha1.c-libtomcrypt-MDEwOlJlcG9zaXRvcnk3NzcwMTE=-flat-rmd320.c.html,22,libtomcrypt-MDEwOlJlcG9zaXRvcnk3NzcwMTE=-flat-sha1.c,libtomcrypt-MDEwOlJlcG9zaXRvcnk3NzcwMTE=-flat-rmd320.c,115,117,2,279,281,2
194,https://htmlpreview.github.io/?https://github.com/Christina96/boilerplate-sample-matches/blob/main/C/xmrig-MDEwOlJlcG9zaXRvcnk4ODMyNzQwNg==-flat-IStrategyListener.h-xmrig-MDEwOlJlcG9zaXRvcnk4ODMyNzQwNg==-flat-IStrategyListener.h.html,23,xmrig-MDEwOlJlcG9zaXRvcnk4ODMyNzQwNg==-flat-IStrategyListener.h,xmrig-MDEwOlJlcG9zaXRvcnk4ODMyNzQwNg==-flat-IStrategyListener.h,16,18,2,16,18,2
195,https://htmlpreview.github.io/?https://github.com/Christina96/boilerplate-sample-matches/blob/main/C/redis-MDEwOlJlcG9zaXRvcnkxMDgxMTA3MDY=-flat-sz.h-redis-MDEwOlJlcG9zaXRvcnkxMDgxMTA3MDY=-flat-sz.h.html,20,redis-MDEwOlJlcG9zaXRvcnkxMDgxMTA3MDY=-flat-sz.h,redis-MDEwOlJlcG9zaXRvcnkxMDgxMTA3MDY=-flat-sz.h,32,37,5,32,37,5
196,https://htmlpreview.github.io/?https://github.com/Christina96/boilerplate-sample-matches/blob/main/C/fftw3-MDEwOlJlcG9zaXRvcnk4ODQzMzg4-flat-dft-vrank-geq1.c-fftw3-MDEwOlJlcG9zaXRvcnk4ODQzMzg4-flat-vrank-geq1-rdft2.c.html,301,fftw3-MDEwOlJlcG9zaXRvcnk4ODQzMzg4-flat-dft-vrank-geq1.c,fftw3-MDEwOlJlcG9zaXRvcnk4ODQzMzg4-flat-vrank-geq1-rdft2.c,128,165,37,132,169,37
197,https://htmlpreview.github.io/?https://github.com/Christina96/boilerplate-sample-matches/blob/main/C/small-MDEwOlJlcG9zaXRvcnkyNTY3NjMxNjk=-flat-encrypt.c-small-MDEwOlJlcG9zaXRvcnkyNTY3NjMxNjk=-flat-encrypt.c.html,17,small-MDEwOlJlcG9zaXRvcnkyNTY3NjMxNjk=-flat-encrypt.c,small-MDEwOlJlcG9zaXRvcnkyNTY3NjMxNjk=-flat-encrypt.c,1156,1159,3,1020,1023,3
198,https://htmlpreview.github.io/?https://github.com/Christina96/boilerplate-sample-matches/blob/main/C/fftw3-MDEwOlJlcG9zaXRvcnk4ODQzMzg4-flat-transpose-pairwise.c-fftw3-MDEwOlJlcG9zaXRvcnk4ODQzMzg4-flat-transpose-pairwise.c.html,203,fftw3-MDEwOlJlcG9zaXRvcnk4ODQzMzg4-flat-transpose-pairwise.c,fftw3-MDEwOlJlcG9zaXRvcnk4ODQzMzg4-flat-transpose-pairwise.c,141,160,19,141,160,19
199,https://htmlpreview.github.io/?https://github.com/Christina96/boilerplate-sample-matches/blob/main/C/redis-MDEwOlJlcG9zaXRvcnkxMDgxMTA3MDY=-flat-rdb.c-redis-MDEwOlJlcG9zaXRvcnkxMDgxMTA3MDY=-flat-rdb.c.html,16,redis-MDEwOlJlcG9zaXRvcnkxMDgxMTA3MDY=-flat-rdb.c,redis-MDEwOlJlcG9zaXRvcnkxMDgxMTA3MDY=-flat-rdb.c,1839,1842,3,1835,1838,3
200,https://htmlpreview.github.io/?https://github.com/Christina96/boilerplate-sample-matches/blob/main/C/xmrig-MDEwOlJlcG9zaXRvcnk4ODMyNzQwNg==-flat-llhttp.c-xmrig-MDEwOlJlcG9zaXRvcnk4ODMyNzQwNg==-flat-llhttp.c.html,90,xmrig-MDEwOlJlcG9zaXRvcnk4ODMyNzQwNg==-flat-llhttp.c,xmrig-MDEwOlJlcG9zaXRvcnk4ODMyNzQwNg==-flat-llhttp.c,1011,1035,24,8376,8400,24
201,https://htmlpreview.github.io/?https://github.com/Christina96/boilerplate-sample-matches/blob/main/C/PINRemoteImage-MDEwOlJlcG9zaXRvcnkzOTUzNzEwMw==-flat-dsp.h-PINRemoteImage-MDEwOlJlcG9zaXRvcnkzOTUzNzEwMw==-flat-dsp.h.html,18,PINRemoteImage-MDEwOlJlcG9zaXRvcnkzOTUzNzEwMw==-flat-dsp.h,PINRemoteImage-MDEwOlJlcG9zaXRvcnkzOTUzNzEwMw==-flat-dsp.h,215,219,4,215,219,4
202,https://htmlpreview.github.io/?https://github.com/Christina96/boilerplate-sample-matches/blob/main/C/redis-MDEwOlJlcG9zaXRvcnkxMDgxMTA3MDY=-flat-hash.h-PINRemoteImage-MDEwOlJlcG9zaXRvcnkzOTUzNzEwMw==-flat-alpha_processing_mips_dsp_r2.c.html,18,redis-MDEwOlJlcG9zaXRvcnkxMDgxMTA3MDY=-flat-hash.h,PINRemoteImage-MDEwOlJlcG9zaXRvcnkzOTUzNzEwMw==-flat-alpha_processing_mips_dsp_r2.c,92,95,3,64,67,3
203,https://htmlpreview.github.io/?https://github.com/Christina96/boilerplate-sample-matches/blob/main/C/xmrig-MDEwOlJlcG9zaXRvcnk4ODMyNzQwNg==-flat-llhttp.c-xmrig-MDEwOlJlcG9zaXRvcnk4ODMyNzQwNg==-flat-llhttp.c.html,20,xmrig-MDEwOlJlcG9zaXRvcnk4ODMyNzQwNg==-flat-llhttp.c,xmrig-MDEwOlJlcG9zaXRvcnk4ODMyNzQwNg==-flat-llhttp.c,4478,4482,4,11387,11391,4
204,https://htmlpreview.github.io/?https://github.com/Christina96/boilerplate-sample-matches/blob/main/C/libfuse-MDEwOlJlcG9zaXRvcnk0ODI5NjE3Nw==-flat-test_syscalls.c-libfuse-MDEwOlJlcG9zaXRvcnk0ODI5NjE3Nw==-flat-test_syscalls.c.html,16,libfuse-MDEwOlJlcG9zaXRvcnk0ODI5NjE3Nw==-flat-test_syscalls.c,libfuse-MDEwOlJlcG9zaXRvcnk0ODI5NjE3Nw==-flat-test_syscalls.c,853,857,4,853,857,4
205,https://htmlpreview.github.io/?https://github.com/Christina96/boilerplate-sample-matches/blob/main/C/redis-MDEwOlJlcG9zaXRvcnkxMDgxMTA3MDY=-flat-cluster.c-redis-MDEwOlJlcG9zaXRvcnkxMDgxMTA3MDY=-flat-cluster.c.html,17,redis-MDEwOlJlcG9zaXRvcnkxMDgxMTA3MDY=-flat-cluster.c,redis-MDEwOlJlcG9zaXRvcnkxMDgxMTA3MDY=-flat-cluster.c,345,352,7,345,352,7
206,https://htmlpreview.github.io/?https://github.com/Christina96/boilerplate-sample-matches/blob/main/C/PINRemoteImage-MDEwOlJlcG9zaXRvcnkzOTUzNzEwMw==-flat-cwebp.c-PINRemoteImage-MDEwOlJlcG9zaXRvcnkzOTUzNzEwMw==-flat-cwebp.c.html,24,PINRemoteImage-MDEwOlJlcG9zaXRvcnkzOTUzNzEwMw==-flat-cwebp.c,PINRemoteImage-MDEwOlJlcG9zaXRvcnkzOTUzNzEwMw==-flat-cwebp.c,765,767,2,765,767,2
207,https://htmlpreview.github.io/?https://github.com/Christina96/boilerplate-sample-matches/blob/main/C/Adafruit_nRF52_Arduino-MDEwOlJlcG9zaXRvcnk3NDM1NDcyOQ==-flat-memory_buffer_alloc.c-Adafruit_nRF52_Arduino-MDEwOlJlcG9zaXRvcnk3NDM1NDcyOQ==-flat-memory_buffer_alloc.c.html,16,Adafruit_nRF52_Arduino-MDEwOlJlcG9zaXRvcnk3NDM1NDcyOQ==-flat-memory_buffer_alloc.c,Adafruit_nRF52_Arduino-MDEwOlJlcG9zaXRvcnk3NDM1NDcyOQ==-flat-memory_buffer_alloc.c,346,348,2,252,254,2
208,https://htmlpreview.github.io/?https://github.com/Christina96/boilerplate-sample-matches/blob/main/C/Adafruit_nRF52_Arduino-MDEwOlJlcG9zaXRvcnk3NDM1NDcyOQ==-flat-nrf52840.h-Adafruit_nRF52_Arduino-MDEwOlJlcG9zaXRvcnk3NDM1NDcyOQ==-flat-nrf52833.h.html,142,Adafruit_nRF52_Arduino-MDEwOlJlcG9zaXRvcnk3NDM1NDcyOQ==-flat-nrf52840.h,Adafruit_nRF52_Arduino-MDEwOlJlcG9zaXRvcnk3NDM1NDcyOQ==-flat-nrf52833.h,428,439,11,438,448,10
209,https://htmlpreview.github.io/?https://github.com/Christina96/boilerplate-sample-matches/blob/main/C/android-gpuimage-plus-MDEwOlJlcG9zaXRvcnk0NjU0NzQxNw==-flat-vda.h-redis-MDEwOlJlcG9zaXRvcnkxMDgxMTA3MDY=-flat-server.h.html,15,android-gpuimage-plus-MDEwOlJlcG9zaXRvcnk0NjU0NzQxNw==-flat-vda.h,redis-MDEwOlJlcG9zaXRvcnkxMDgxMTA3MDY=-flat-server.h,17,22,5,907,912,5
210,https://htmlpreview.github.io/?https://github.com/Christina96/boilerplate-sample-matches/blob/main/C/redis-MDEwOlJlcG9zaXRvcnkxMDgxMTA3MDY=-flat-Win32_Time.c-redis-MDEwOlJlcG9zaXRvcnkxMDgxMTA3MDY=-flat-Win32_Time.c.html,67,redis-MDEwOlJlcG9zaXRvcnkxMDgxMTA3MDY=-flat-Win32_Time.c,redis-MDEwOlJlcG9zaXRvcnkxMDgxMTA3MDY=-flat-Win32_Time.c,107,120,13,107,120,13
211,https://htmlpreview.github.io/?https://github.com/Christina96/boilerplate-sample-matches/blob/main/C/libpcap-MDEwOlJlcG9zaXRvcnk5NDM1ODg3-flat-pcap-npf.c-libpcap-MDEwOlJlcG9zaXRvcnk5NDM1ODg3-flat-pcap-airpcap.c.html,18,libpcap-MDEwOlJlcG9zaXRvcnk5NDM1ODg3-flat-pcap-npf.c,libpcap-MDEwOlJlcG9zaXRvcnk5NDM1ODg3-flat-pcap-airpcap.c,357,358,1,370,371,1
212,https://htmlpreview.github.io/?https://github.com/Christina96/boilerplate-sample-matches/blob/main/C/redis-MDEwOlJlcG9zaXRvcnkxMDgxMTA3MDY=-flat-net.c-redis-MDEwOlJlcG9zaXRvcnkxMDgxMTA3MDY=-flat-net.c.html,39,redis-MDEwOlJlcG9zaXRvcnkxMDgxMTA3MDY=-flat-net.c,redis-MDEwOlJlcG9zaXRvcnkxMDgxMTA3MDY=-flat-net.c,46,49,3,143,146,3
213,https://htmlpreview.github.io/?https://github.com/Christina96/boilerplate-sample-matches/blob/main/C/Adafruit_nRF52_Arduino-MDEwOlJlcG9zaXRvcnk3NDM1NDcyOQ==-flat-SEGGER_RTT.c-Adafruit_nRF52_Arduino-MDEwOlJlcG9zaXRvcnk3NDM1NDcyOQ==-flat-SEGGER_RTT.c.html,24,Adafruit_nRF52_Arduino-MDEwOlJlcG9zaXRvcnk3NDM1NDcyOQ==-flat-SEGGER_RTT.c,Adafruit_nRF52_Arduino-MDEwOlJlcG9zaXRvcnk3NDM1NDcyOQ==-flat-SEGGER_RTT.c,337,343,6,172,178,6
214,https://htmlpreview.github.io/?https://github.com/Christina96/boilerplate-sample-matches/blob/main/C/libtomcrypt-MDEwOlJlcG9zaXRvcnk3NzcwMTE=-flat-sober128.c-libtomcrypt-MDEwOlJlcG9zaXRvcnk3NzcwMTE=-flat-rc4.c.html,65,libtomcrypt-MDEwOlJlcG9zaXRvcnk3NzcwMTE=-flat-sober128.c,libtomcrypt-MDEwOlJlcG9zaXRvcnk3NzcwMTE=-flat-rc4.c,34,37,3,34,37,3
215,https://htmlpreview.github.io/?https://github.com/Christina96/boilerplate-sample-matches/blob/main/C/fftw3-MDEwOlJlcG9zaXRvcnk4ODQzMzg4-flat-tensor_0.c-fftw3-MDEwOlJlcG9zaXRvcnk4ODQzMzg4-flat-tensor_0.c.html,23,fftw3-MDEwOlJlcG9zaXRvcnk4ODQzMzg4-flat-tensor_0.c,fftw3-MDEwOlJlcG9zaXRvcnk4ODQzMzg4-flat-tensor_0.c,51,53,2,51,53,2
216,https://htmlpreview.github.io/?https://github.com/Christina96/boilerplate-sample-matches/blob/main/C/libfuse-MDEwOlJlcG9zaXRvcnk0ODI5NjE3Nw==-flat-fuse_lowlevel.h-libfuse-MDEwOlJlcG9zaXRvcnk0ODI5NjE3Nw==-flat-fuse_lowlevel.h.html,24,libfuse-MDEwOlJlcG9zaXRvcnk0ODI5NjE3Nw==-flat-fuse_lowlevel.h,libfuse-MDEwOlJlcG9zaXRvcnk0ODI5NjE3Nw==-flat-fuse_lowlevel.h,183,185,2,183,185,2
217,https://htmlpreview.github.io/?https://github.com/Christina96/boilerplate-sample-matches/blob/main/C/redis-MDEwOlJlcG9zaXRvcnkxMDgxMTA3MDY=-flat-dict_29.h-redis-MDEwOlJlcG9zaXRvcnkxMDgxMTA3MDY=-flat-dict_29.h.html,15,redis-MDEwOlJlcG9zaXRvcnkxMDgxMTA3MDY=-flat-dict_29.h,redis-MDEwOlJlcG9zaXRvcnkxMDgxMTA3MDY=-flat-dict_29.h,33,37,4,33,37,4
218,https://htmlpreview.github.io/?https://github.com/Christina96/boilerplate-sample-matches/blob/main/C/xmrig-MDEwOlJlcG9zaXRvcnk4ODMyNzQwNg==-flat-md_helper.c-xmrig-MDEwOlJlcG9zaXRvcnk4ODMyNzQwNg==-flat-md_helper.c.html,16,xmrig-MDEwOlJlcG9zaXRvcnk4ODMyNzQwNg==-flat-md_helper.c,xmrig-MDEwOlJlcG9zaXRvcnk4ODMyNzQwNg==-flat-md_helper.c,59,62,3,59,62,3
219,https://htmlpreview.github.io/?https://github.com/Christina96/boilerplate-sample-matches/blob/main/C/redis-MDEwOlJlcG9zaXRvcnkxMDgxMTA3MDY=-flat-Win32_ANSI.c-redis-MDEwOlJlcG9zaXRvcnkxMDgxMTA3MDY=-flat-Win32_ANSI.c.html,17,redis-MDEwOlJlcG9zaXRvcnkxMDgxMTA3MDY=-flat-Win32_ANSI.c,redis-MDEwOlJlcG9zaXRvcnkxMDgxMTA3MDY=-flat-Win32_ANSI.c,76,82,6,87,92,5
220,https://htmlpreview.github.io/?https://github.com/Christina96/boilerplate-sample-matches/blob/main/C/libtomcrypt-MDEwOlJlcG9zaXRvcnk3NzcwMTE=-flat-der_encode_sequence_multi.c-libtomcrypt-MDEwOlJlcG9zaXRvcnk3NzcwMTE=-flat-der_decode_sequence_multi.c.html,24,libtomcrypt-MDEwOlJlcG9zaXRvcnk3NzcwMTE=-flat-der_encode_sequence_multi.c,libtomcrypt-MDEwOlJlcG9zaXRvcnk3NzcwMTE=-flat-der_decode_sequence_multi.c,56,60,4,51,55,4
221,https://htmlpreview.github.io/?https://github.com/Christina96/boilerplate-sample-matches/blob/main/C/Adafruit_nRF52_Arduino-MDEwOlJlcG9zaXRvcnk3NDM1NDcyOQ==-flat-bignum.c-Adafruit_nRF52_Arduino-MDEwOlJlcG9zaXRvcnk3NDM1NDcyOQ==-flat-bignum.c.html,59,Adafruit_nRF52_Arduino-MDEwOlJlcG9zaXRvcnk3NDM1NDcyOQ==-flat-bignum.c,Adafruit_nRF52_Arduino-MDEwOlJlcG9zaXRvcnk3NDM1NDcyOQ==-flat-bignum.c,639,655,16,639,655,16
222,https://htmlpreview.github.io/?https://github.com/Christina96/boilerplate-sample-matches/blob/main/C/xmrig-MDEwOlJlcG9zaXRvcnk4ODMyNzQwNg==-flat-topology-xml.c-xmrig-MDEwOlJlcG9zaXRvcnk4ODMyNzQwNg==-flat-topology-xml.c.html,16,xmrig-MDEwOlJlcG9zaXRvcnk4ODMyNzQwNg==-flat-topology-xml.c,xmrig-MDEwOlJlcG9zaXRvcnk4ODMyNzQwNg==-flat-topology-xml.c,2760,2761,1,2760,2761,1
223,https://htmlpreview.github.io/?https://github.com/Christina96/boilerplate-sample-matches/blob/main/C/PINRemoteImage-MDEwOlJlcG9zaXRvcnkzOTUzNzEwMw==-flat-backward_references_enc.c-libfuse-MDEwOlJlcG9zaXRvcnk0ODI5NjE3Nw==-flat-fuse.c.html,18,PINRemoteImage-MDEwOlJlcG9zaXRvcnkzOTUzNzEwMw==-flat-backward_references_enc.c,libfuse-MDEwOlJlcG9zaXRvcnk0ODI5NjE3Nw==-flat-fuse.c,175,177,2,822,824,2
224,https://htmlpreview.github.io/?https://github.com/Christina96/boilerplate-sample-matches/blob/main/C/libfuse-MDEwOlJlcG9zaXRvcnk0ODI5NjE3Nw==-flat-mount.fuse.c-libfuse-MDEwOlJlcG9zaXRvcnk0ODI5NjE3Nw==-flat-notify_inval_inode.c.html,24,libfuse-MDEwOlJlcG9zaXRvcnk0ODI5NjE3Nw==-flat-mount.fuse.c,libfuse-MDEwOlJlcG9zaXRvcnk0ODI5NjE3Nw==-flat-notify_inval_inode.c,90,95,5,133,138,5
225,https://htmlpreview.github.io/?https://github.com/Christina96/boilerplate-sample-matches/blob/main/C/Adafruit_nRF52_Arduino-MDEwOlJlcG9zaXRvcnk3NDM1NDcyOQ==-flat-ble.h-Adafruit_nRF52_Arduino-MDEwOlJlcG9zaXRvcnk3NDM1NDcyOQ==-flat-ble_2.h.html,292,Adafruit_nRF52_Arduino-MDEwOlJlcG9zaXRvcnk3NDM1NDcyOQ==-flat-ble.h,Adafruit_nRF52_Arduino-MDEwOlJlcG9zaXRvcnk3NDM1NDcyOQ==-flat-ble_2.h,82,108,26,82,108,26
226,https://htmlpreview.github.io/?https://github.com/Christina96/boilerplate-sample-matches/blob/main/C/xmrig-MDEwOlJlcG9zaXRvcnk4ODMyNzQwNg==-flat-sph_bmw.c-xmrig-MDEwOlJlcG9zaXRvcnk4ODMyNzQwNg==-flat-sph_bmw.c.html,30,xmrig-MDEwOlJlcG9zaXRvcnk4ODMyNzQwNg==-flat-sph_bmw.c,xmrig-MDEwOlJlcG9zaXRvcnk4ODMyNzQwNg==-flat-sph_bmw.c,197,199,2,117,119,2
227,https://htmlpreview.github.io/?https://github.com/Christina96/boilerplate-sample-matches/blob/main/C/redis-MDEwOlJlcG9zaXRvcnkxMDgxMTA3MDY=-flat-module.c-redis-MDEwOlJlcG9zaXRvcnkxMDgxMTA3MDY=-flat-module.c.html,15,redis-MDEwOlJlcG9zaXRvcnkxMDgxMTA3MDY=-flat-module.c,redis-MDEwOlJlcG9zaXRvcnkxMDgxMTA3MDY=-flat-module.c,641,645,4,641,645,4
228,https://htmlpreview.github.io/?https://github.com/Christina96/boilerplate-sample-matches/blob/main/C/libtomcrypt-MDEwOlJlcG9zaXRvcnk3NzcwMTE=-flat-anubis.c-libtomcrypt-MDEwOlJlcG9zaXRvcnk3NzcwMTE=-flat-anubis.c.html,15,libtomcrypt-MDEwOlJlcG9zaXRvcnk3NzcwMTE=-flat-anubis.c,libtomcrypt-MDEwOlJlcG9zaXRvcnk3NzcwMTE=-flat-anubis.c,1357,1359,2,1349,1351,2
229,https://htmlpreview.github.io/?https://github.com/Christina96/boilerplate-sample-matches/blob/main/C/PINRemoteImage-MDEwOlJlcG9zaXRvcnkzOTUzNzEwMw==-flat-encode_38.h-PINRemoteImage-MDEwOlJlcG9zaXRvcnkzOTUzNzEwMw==-flat-encode.h.html,865,PINRemoteImage-MDEwOlJlcG9zaXRvcnkzOTUzNzEwMw==-flat-encode_38.h,PINRemoteImage-MDEwOlJlcG9zaXRvcnkzOTUzNzEwMw==-flat-encode.h,80,226,146,80,226,146
230,https://htmlpreview.github.io/?https://github.com/Christina96/boilerplate-sample-matches/blob/main/C/redis-MDEwOlJlcG9zaXRvcnkxMDgxMTA3MDY=-flat-redis-cli.c-redis-MDEwOlJlcG9zaXRvcnkxMDgxMTA3MDY=-flat-redis-cli.c.html,26,redis-MDEwOlJlcG9zaXRvcnkxMDgxMTA3MDY=-flat-redis-cli.c,redis-MDEwOlJlcG9zaXRvcnkxMDgxMTA3MDY=-flat-redis-cli.c,2840,2845,5,2840,2845,5
231,https://htmlpreview.github.io/?https://github.com/Christina96/boilerplate-sample-matches/blob/main/C/redis-MDEwOlJlcG9zaXRvcnkxMDgxMTA3MDY=-flat-extent.c-redis-MDEwOlJlcG9zaXRvcnkxMDgxMTA3MDY=-flat-extent.c.html,61,redis-MDEwOlJlcG9zaXRvcnkxMDgxMTA3MDY=-flat-extent.c,redis-MDEwOlJlcG9zaXRvcnkxMDgxMTA3MDY=-flat-extent.c,65,72,7,65,72,7
232,https://htmlpreview.github.io/?https://github.com/Christina96/boilerplate-sample-matches/blob/main/C/xmrig-MDEwOlJlcG9zaXRvcnk4ODMyNzQwNg==-flat-Network.h-xmrig-MDEwOlJlcG9zaXRvcnk4ODMyNzQwNg==-flat-Watcher.h.html,17,xmrig-MDEwOlJlcG9zaXRvcnk4ODMyNzQwNg==-flat-Network.h,xmrig-MDEwOlJlcG9zaXRvcnk4ODMyNzQwNg==-flat-Watcher.h,24,26,2,14,16,2
233,https://htmlpreview.github.io/?https://github.com/Christina96/boilerplate-sample-matches/blob/main/C/redis-MDEwOlJlcG9zaXRvcnkxMDgxMTA3MDY=-flat-bitmap.c-redis-MDEwOlJlcG9zaXRvcnkxMDgxMTA3MDY=-flat-bitmap.c.html,63,redis-MDEwOlJlcG9zaXRvcnkxMDgxMTA3MDY=-flat-bitmap.c,redis-MDEwOlJlcG9zaXRvcnkxMDgxMTA3MDY=-flat-bitmap.c,289,300,11,260,271,11
234,https://htmlpreview.github.io/?https://github.com/Christina96/boilerplate-sample-matches/blob/main/C/PINRemoteImage-MDEwOlJlcG9zaXRvcnkzOTUzNzEwMw==-flat-PINOperationQueue_51.h-PINRemoteImage-MDEwOlJlcG9zaXRvcnkzOTUzNzEwMw==-flat-PINOperationQueue_51.h.html,329,PINRemoteImage-MDEwOlJlcG9zaXRvcnkzOTUzNzEwMw==-flat-PINOperationQueue_51.h,PINRemoteImage-MDEwOlJlcG9zaXRvcnkzOTUzNzEwMw==-flat-PINOperationQueue_51.h,4,39,35,4,39,35
235,https://htmlpreview.github.io/?https://github.com/Christina96/boilerplate-sample-matches/blob/main/C/xmrig-MDEwOlJlcG9zaXRvcnk4ODMyNzQwNg==-flat-pci-common.c-xmrig-MDEwOlJlcG9zaXRvcnk4ODMyNzQwNg==-flat-pci-common.c.html,17,xmrig-MDEwOlJlcG9zaXRvcnk4ODMyNzQwNg==-flat-pci-common.c,xmrig-MDEwOlJlcG9zaXRvcnk4ODMyNzQwNg==-flat-pci-common.c,121,123,2,121,123,2
236,https://htmlpreview.github.io/?https://github.com/Christina96/boilerplate-sample-matches/blob/main/C/redis-MDEwOlJlcG9zaXRvcnkxMDgxMTA3MDY=-flat-scripting.c-redis-MDEwOlJlcG9zaXRvcnkxMDgxMTA3MDY=-flat-scripting.c.html,16,redis-MDEwOlJlcG9zaXRvcnkxMDgxMTA3MDY=-flat-scripting.c,redis-MDEwOlJlcG9zaXRvcnkxMDgxMTA3MDY=-flat-scripting.c,76,77,1,1383,1384,1
237,https://htmlpreview.github.io/?https://github.com/Christina96/boilerplate-sample-matches/blob/main/C/Adafruit_nRF52_Arduino-MDEwOlJlcG9zaXRvcnk3NDM1NDcyOQ==-flat-SEGGER.h-Adafruit_nRF52_Arduino-MDEwOlJlcG9zaXRvcnk3NDM1NDcyOQ==-flat-SEGGER.h.html,16,Adafruit_nRF52_Arduino-MDEwOlJlcG9zaXRvcnk3NDM1NDcyOQ==-flat-SEGGER.h,Adafruit_nRF52_Arduino-MDEwOlJlcG9zaXRvcnk3NDM1NDcyOQ==-flat-SEGGER.h,71,72,1,71,72,1
238,https://htmlpreview.github.io/?https://github.com/Christina96/boilerplate-sample-matches/blob/main/C/small-MDEwOlJlcG9zaXRvcnkyNTY3NjMxNjk=-flat-http_simple.c-small-MDEwOlJlcG9zaXRvcnkyNTY3NjMxNjk=-flat-http_simple.c.html,120,small-MDEwOlJlcG9zaXRvcnkyNTY3NjMxNjk=-flat-http_simple.c,small-MDEwOlJlcG9zaXRvcnkyNTY3NjMxNjk=-flat-http_simple.c,218,236,18,218,236,18
239,https://htmlpreview.github.io/?https://github.com/Christina96/boilerplate-sample-matches/blob/main/C/xmrig-MDEwOlJlcG9zaXRvcnk4ODMyNzQwNg==-flat-sse2neon.h-xmrig-MDEwOlJlcG9zaXRvcnk4ODMyNzQwNg==-flat-sse2neon.h.html,155,xmrig-MDEwOlJlcG9zaXRvcnk4ODMyNzQwNg==-flat-sse2neon.h,xmrig-MDEwOlJlcG9zaXRvcnk4ODMyNzQwNg==-flat-sse2neon.h,5702,5712,10,5604,5614,10
240,https://htmlpreview.github.io/?https://github.com/Christina96/boilerplate-sample-matches/blob/main/C/PINRemoteImage-MDEwOlJlcG9zaXRvcnkzOTUzNzEwMw==-flat-picture_csp_enc.c-PINRemoteImage-MDEwOlJlcG9zaXRvcnkzOTUzNzEwMw==-flat-picture_csp_enc.c.html,16,PINRemoteImage-MDEwOlJlcG9zaXRvcnkzOTUzNzEwMw==-flat-picture_csp_enc.c,PINRemoteImage-MDEwOlJlcG9zaXRvcnkzOTUzNzEwMw==-flat-picture_csp_enc.c,354,355,1,354,355,1
241,https://htmlpreview.github.io/?https://github.com/Christina96/boilerplate-sample-matches/blob/main/C/Adafruit_nRF52_Arduino-MDEwOlJlcG9zaXRvcnk3NDM1NDcyOQ==-flat-nrf_soc.h-Adafruit_nRF52_Arduino-MDEwOlJlcG9zaXRvcnk3NDM1NDcyOQ==-flat-nrf_soc_3.h.html,79,Adafruit_nRF52_Arduino-MDEwOlJlcG9zaXRvcnk3NDM1NDcyOQ==-flat-nrf_soc.h,Adafruit_nRF52_Arduino-MDEwOlJlcG9zaXRvcnk3NDM1NDcyOQ==-flat-nrf_soc_3.h,178,183,5,202,207,5
242,https://htmlpreview.github.io/?https://github.com/Christina96/boilerplate-sample-matches/blob/main/C/xmrig-MDEwOlJlcG9zaXRvcnk4ODMyNzQwNg==-flat-levelzero.h-xmrig-MDEwOlJlcG9zaXRvcnk4ODMyNzQwNg==-flat-levelzero.h.html,15,xmrig-MDEwOlJlcG9zaXRvcnk4ODMyNzQwNg==-flat-levelzero.h,xmrig-MDEwOlJlcG9zaXRvcnk4ODMyNzQwNg==-flat-levelzero.h,30,34,4,30,34,4
243,https://htmlpreview.github.io/?https://github.com/Christina96/boilerplate-sample-matches/blob/main/C/redis-MDEwOlJlcG9zaXRvcnkxMDgxMTA3MDY=-flat-t_set.c-redis-MDEwOlJlcG9zaXRvcnkxMDgxMTA3MDY=-flat-t_set.c.html,16,redis-MDEwOlJlcG9zaXRvcnkxMDgxMTA3MDY=-flat-t_set.c,redis-MDEwOlJlcG9zaXRvcnkxMDgxMTA3MDY=-flat-t_set.c,22,23,1,22,23,1
244,https://htmlpreview.github.io/?https://github.com/Christina96/boilerplate-sample-matches/blob/main/C/redis-MDEwOlJlcG9zaXRvcnkxMDgxMTA3MDY=-flat-t_stream.c-redis-MDEwOlJlcG9zaXRvcnkxMDgxMTA3MDY=-flat-t_stream.c.html,21,redis-MDEwOlJlcG9zaXRvcnkxMDgxMTA3MDY=-flat-t_stream.c,redis-MDEwOlJlcG9zaXRvcnkxMDgxMTA3MDY=-flat-t_stream.c,1322,1325,3,587,590,3
245,https://htmlpreview.github.io/?https://github.com/Christina96/boilerplate-sample-matches/blob/main/C/libfuse-MDEwOlJlcG9zaXRvcnk0ODI5NjE3Nw==-flat-mount_util.c-libfuse-MDEwOlJlcG9zaXRvcnk0ODI5NjE3Nw==-flat-mount_util.c.html,16,libfuse-MDEwOlJlcG9zaXRvcnk0ODI5NjE3Nw==-flat-mount_util.c,libfuse-MDEwOlJlcG9zaXRvcnk0ODI5NjE3Nw==-flat-mount_util.c,149,153,4,149,153,4
246,https://htmlpreview.github.io/?https://github.com/Christina96/boilerplate-sample-matches/blob/main/C/redis-MDEwOlJlcG9zaXRvcnkxMDgxMTA3MDY=-flat-lparser.c-redis-MDEwOlJlcG9zaXRvcnkxMDgxMTA3MDY=-flat-ltable.c.html,15,redis-MDEwOlJlcG9zaXRvcnkxMDgxMTA3MDY=-flat-lparser.c,redis-MDEwOlJlcG9zaXRvcnkxMDgxMTA3MDY=-flat-ltable.c,460,461,1,154,155,1
247,https://htmlpreview.github.io/?https://github.com/Christina96/boilerplate-sample-matches/blob/main/C/libpcap-MDEwOlJlcG9zaXRvcnk5NDM1ODg3-flat-threadsignaltest.c-libpcap-MDEwOlJlcG9zaXRvcnk5NDM1ODg3-flat-threadsignaltest.c.html,16,libpcap-MDEwOlJlcG9zaXRvcnk5NDM1ODg3-flat-threadsignaltest.c,libpcap-MDEwOlJlcG9zaXRvcnk5NDM1ODg3-flat-threadsignaltest.c,183,187,4,183,187,4
248,https://htmlpreview.github.io/?https://github.com/Christina96/boilerplate-sample-matches/blob/main/C/redis-MDEwOlJlcG9zaXRvcnkxMDgxMTA3MDY=-flat-lbaselib.c-redis-MDEwOlJlcG9zaXRvcnkxMDgxMTA3MDY=-flat-ldblib.c.html,23,redis-MDEwOlJlcG9zaXRvcnkxMDgxMTA3MDY=-flat-lbaselib.c,redis-MDEwOlJlcG9zaXRvcnkxMDgxMTA3MDY=-flat-ldblib.c,67,70,3,14,16,2
249,https://htmlpreview.github.io/?https://github.com/Christina96/boilerplate-sample-matches/blob/main/C/redis-MDEwOlJlcG9zaXRvcnkxMDgxMTA3MDY=-flat-extent_24.c-redis-MDEwOlJlcG9zaXRvcnkxMDgxMTA3MDY=-flat-extent_24.c.html,22,redis-MDEwOlJlcG9zaXRvcnkxMDgxMTA3MDY=-flat-extent_24.c,redis-MDEwOlJlcG9zaXRvcnkxMDgxMTA3MDY=-flat-extent_24.c,418,421,3,418,421,3
250,https://htmlpreview.github.io/?https://github.com/Christina96/boilerplate-sample-matches/blob/main/C/redis-MDEwOlJlcG9zaXRvcnkxMDgxMTA3MDY=-flat-sz.h-redis-MDEwOlJlcG9zaXRvcnkxMDgxMTA3MDY=-flat-sz.h.html,20,redis-MDEwOlJlcG9zaXRvcnkxMDgxMTA3MDY=-flat-sz.h,redis-MDEwOlJlcG9zaXRvcnkxMDgxMTA3MDY=-flat-sz.h,48,53,5,48,53,5
251,https://htmlpreview.github.io/?https://github.com/Christina96/boilerplate-sample-matches/blob/main/C/libpcap-MDEwOlJlcG9zaXRvcnk5NDM1ODg3-flat-gencode.c-libpcap-MDEwOlJlcG9zaXRvcnk5NDM1ODg3-flat-gencode.c.html,22,libpcap-MDEwOlJlcG9zaXRvcnk5NDM1ODg3-flat-gencode.c,libpcap-MDEwOlJlcG9zaXRvcnk5NDM1ODg3-flat-gencode.c,5821,5825,4,5855,5859,4
252,https://htmlpreview.github.io/?https://github.com/Christina96/boilerplate-sample-matches/blob/main/C/xmrig-MDEwOlJlcG9zaXRvcnk4ODMyNzQwNg==-flat-blake2.c-xmrig-MDEwOlJlcG9zaXRvcnk4ODMyNzQwNg==-flat-blake2.c.html,18,xmrig-MDEwOlJlcG9zaXRvcnk4ODMyNzQwNg==-flat-blake2.c,xmrig-MDEwOlJlcG9zaXRvcnk4ODMyNzQwNg==-flat-blake2.c,178,180,2,178,180,2
253,https://htmlpreview.github.io/?https://github.com/Christina96/boilerplate-sample-matches/blob/main/C/xmrig-MDEwOlJlcG9zaXRvcnk4ODMyNzQwNg==-flat-chrono.h-xmrig-MDEwOlJlcG9zaXRvcnk4ODMyNzQwNg==-flat-chrono.h.html,28,xmrig-MDEwOlJlcG9zaXRvcnk4ODMyNzQwNg==-flat-chrono.h,xmrig-MDEwOlJlcG9zaXRvcnk4ODMyNzQwNg==-flat-chrono.h,56,60,4,56,60,4
254,https://htmlpreview.github.io/?https://github.com/Christina96/boilerplate-sample-matches/blob/main/C/libtomcrypt-MDEwOlJlcG9zaXRvcnk3NzcwMTE=-flat-omac_memory_multi.c-libtomcrypt-MDEwOlJlcG9zaXRvcnk3NzcwMTE=-flat-poly1305_memory_multi.c.html,34,libtomcrypt-MDEwOlJlcG9zaXRvcnk3NzcwMTE=-flat-omac_memory_multi.c,libtomcrypt-MDEwOlJlcG9zaXRvcnk3NzcwMTE=-flat-poly1305_memory_multi.c,11,17,6,8,14,6
255,https://htmlpreview.github.io/?https://github.com/Christina96/boilerplate-sample-matches/blob/main/C/Adafruit_nRF52_Arduino-MDEwOlJlcG9zaXRvcnk3NDM1NDcyOQ==-flat-nrf_radio.h-Adafruit_nRF52_Arduino-MDEwOlJlcG9zaXRvcnk3NDM1NDcyOQ==-flat-nrf_radio.h.html,28,Adafruit_nRF52_Arduino-MDEwOlJlcG9zaXRvcnk3NDM1NDcyOQ==-flat-nrf_radio.h,Adafruit_nRF52_Arduino-MDEwOlJlcG9zaXRvcnk3NDM1NDcyOQ==-flat-nrf_radio.h,725,734,9,725,734,9
256,https://htmlpreview.github.io/?https://github.com/Christina96/boilerplate-sample-matches/blob/main/C/Adafruit_nRF52_Arduino-MDEwOlJlcG9zaXRvcnk3NDM1NDcyOQ==-flat-tasks.c-Adafruit_nRF52_Arduino-MDEwOlJlcG9zaXRvcnk3NDM1NDcyOQ==-flat-tasks.c.html,16,Adafruit_nRF52_Arduino-MDEwOlJlcG9zaXRvcnk3NDM1NDcyOQ==-flat-tasks.c,Adafruit_nRF52_Arduino-MDEwOlJlcG9zaXRvcnk3NDM1NDcyOQ==-flat-tasks.c,1831,1833,2,1798,1800,2
257,https://htmlpreview.github.io/?https://github.com/Christina96/boilerplate-sample-matches/blob/main/C/redis-MDEwOlJlcG9zaXRvcnkxMDgxMTA3MDY=-flat-hiredis.c-redis-MDEwOlJlcG9zaXRvcnkxMDgxMTA3MDY=-flat-hiredis.c.html,25,redis-MDEwOlJlcG9zaXRvcnkxMDgxMTA3MDY=-flat-hiredis.c,redis-MDEwOlJlcG9zaXRvcnkxMDgxMTA3MDY=-flat-hiredis.c,166,169,3,166,169,3
258,https://htmlpreview.github.io/?https://github.com/Christina96/boilerplate-sample-matches/blob/main/C/redis-MDEwOlJlcG9zaXRvcnkxMDgxMTA3MDY=-flat-lstrlib.c-redis-MDEwOlJlcG9zaXRvcnkxMDgxMTA3MDY=-flat-lstrlib.c.html,23,redis-MDEwOlJlcG9zaXRvcnkxMDgxMTA3MDY=-flat-lstrlib.c,redis-MDEwOlJlcG9zaXRvcnkxMDgxMTA3MDY=-flat-lstrlib.c,510,512,2,510,512,2
259,https://htmlpreview.github.io/?https://github.com/Christina96/boilerplate-sample-matches/blob/main/C/libfuse-MDEwOlJlcG9zaXRvcnk0ODI5NjE3Nw==-flat-notify_store_retrieve.c-libfuse-MDEwOlJlcG9zaXRvcnk0ODI5NjE3Nw==-flat-notify_inval_inode.c.html,66,libfuse-MDEwOlJlcG9zaXRvcnk0ODI5NjE3Nw==-flat-notify_store_retrieve.c,libfuse-MDEwOlJlcG9zaXRvcnk0ODI5NjE3Nw==-flat-notify_inval_inode.c,33,44,11,32,43,11
260,https://htmlpreview.github.io/?https://github.com/Christina96/boilerplate-sample-matches/blob/main/C/redis-MDEwOlJlcG9zaXRvcnkxMDgxMTA3MDY=-flat-emitter.c-redis-MDEwOlJlcG9zaXRvcnkxMDgxMTA3MDY=-flat-emitter.c.html,28,redis-MDEwOlJlcG9zaXRvcnkxMDgxMTA3MDY=-flat-emitter.c,redis-MDEwOlJlcG9zaXRvcnkxMDgxMTA3MDY=-flat-emitter.c,183,185,2,185,187,2
261,https://htmlpreview.github.io/?https://github.com/Christina96/boilerplate-sample-matches/blob/main/C/libfuse-MDEwOlJlcG9zaXRvcnk0ODI5NjE3Nw==-flat-fuse_lowlevel.c-libfuse-MDEwOlJlcG9zaXRvcnk0ODI5NjE3Nw==-flat-fuse_lowlevel.c.html,34,libfuse-MDEwOlJlcG9zaXRvcnk0ODI5NjE3Nw==-flat-fuse_lowlevel.c,libfuse-MDEwOlJlcG9zaXRvcnk0ODI5NjE3Nw==-flat-fuse_lowlevel.c,998,1003,5,867,872,5
262,https://htmlpreview.github.io/?https://github.com/Christina96/boilerplate-sample-matches/blob/main/C/xmrig-MDEwOlJlcG9zaXRvcnk4ODMyNzQwNg==-flat-topology-xml.c-xmrig-MDEwOlJlcG9zaXRvcnk4ODMyNzQwNg==-flat-topology-xml.c.html,65,xmrig-MDEwOlJlcG9zaXRvcnk4ODMyNzQwNg==-flat-topology-xml.c,xmrig-MDEwOlJlcG9zaXRvcnk4ODMyNzQwNg==-flat-topology-xml.c,268,283,15,268,283,15
263,https://htmlpreview.github.io/?https://github.com/Christina96/boilerplate-sample-matches/blob/main/C/PINRemoteImage-MDEwOlJlcG9zaXRvcnkzOTUzNzEwMw==-flat-idec_dec.c-PINRemoteImage-MDEwOlJlcG9zaXRvcnkzOTUzNzEwMw==-flat-idec_dec.c.html,19,PINRemoteImage-MDEwOlJlcG9zaXRvcnkzOTUzNzEwMw==-flat-idec_dec.c,PINRemoteImage-MDEwOlJlcG9zaXRvcnkzOTUzNzEwMw==-flat-idec_dec.c,355,357,2,355,357,2
264,https://htmlpreview.github.io/?https://github.com/Christina96/boilerplate-sample-matches/blob/main/C/Adafruit_nRF52_Arduino-MDEwOlJlcG9zaXRvcnk3NDM1NDcyOQ==-flat-nrfx_uart.h-Adafruit_nRF52_Arduino-MDEwOlJlcG9zaXRvcnk3NDM1NDcyOQ==-flat-nrfx_uart.h.html,21,Adafruit_nRF52_Arduino-MDEwOlJlcG9zaXRvcnk3NDM1NDcyOQ==-flat-nrfx_uart.h,Adafruit_nRF52_Arduino-MDEwOlJlcG9zaXRvcnk3NDM1NDcyOQ==-flat-nrfx_uart.h,41,45,4,41,45,4
265,https://htmlpreview.github.io/?https://github.com/Christina96/boilerplate-sample-matches/blob/main/C/Adafruit_nRF52_Arduino-MDEwOlJlcG9zaXRvcnk3NDM1NDcyOQ==-flat-nrf52840.h-Adafruit_nRF52_Arduino-MDEwOlJlcG9zaXRvcnk3NDM1NDcyOQ==-flat-nrf52840.h.html,78,Adafruit_nRF52_Arduino-MDEwOlJlcG9zaXRvcnk3NDM1NDcyOQ==-flat-nrf52840.h,Adafruit_nRF52_Arduino-MDEwOlJlcG9zaXRvcnk3NDM1NDcyOQ==-flat-nrf52840.h,1141,1146,5,1141,1146,5
266,https://htmlpreview.github.io/?https://github.com/Christina96/boilerplate-sample-matches/blob/main/C/xmrig-MDEwOlJlcG9zaXRvcnk4ODMyNzQwNg==-flat-sph_simd.c-xmrig-MDEwOlJlcG9zaXRvcnk4ODMyNzQwNg==-flat-sph_simd.c.html,36,xmrig-MDEwOlJlcG9zaXRvcnk4ODMyNzQwNg==-flat-sph_simd.c,xmrig-MDEwOlJlcG9zaXRvcnk4ODMyNzQwNg==-flat-sph_simd.c,296,297,1,296,297,1
267,https://htmlpreview.github.io/?https://github.com/Christina96/boilerplate-sample-matches/blob/main/C/redis-MDEwOlJlcG9zaXRvcnkxMDgxMTA3MDY=-flat-rdb.c-redis-MDEwOlJlcG9zaXRvcnkxMDgxMTA3MDY=-flat-t_zset.c.html,16,redis-MDEwOlJlcG9zaXRvcnkxMDgxMTA3MDY=-flat-rdb.c,redis-MDEwOlJlcG9zaXRvcnkxMDgxMTA3MDY=-flat-t_zset.c,534,535,1,215,216,1
268,https://htmlpreview.github.io/?https://github.com/Christina96/boilerplate-sample-matches/blob/main/C/redis-MDEwOlJlcG9zaXRvcnkxMDgxMTA3MDY=-flat-posix_memalign.c-redis-MDEwOlJlcG9zaXRvcnkxMDgxMTA3MDY=-flat-xallocx.c.html,15,redis-MDEwOlJlcG9zaXRvcnkxMDgxMTA3MDY=-flat-posix_memalign.c,redis-MDEwOlJlcG9zaXRvcnkxMDgxMTA3MDY=-flat-xallocx.c,23,27,4,102,106,4
269,https://htmlpreview.github.io/?https://github.com/Christina96/boilerplate-sample-matches/blob/main/C/android-gpuimage-plus-MDEwOlJlcG9zaXRvcnk0NjU0NzQxNw==-flat-avio.h-android-gpuimage-plus-MDEwOlJlcG9zaXRvcnk0NjU0NzQxNw==-flat-avcodec.h.html,17,android-gpuimage-plus-MDEwOlJlcG9zaXRvcnk0NjU0NzQxNw==-flat-avio.h,android-gpuimage-plus-MDEwOlJlcG9zaXRvcnk0NjU0NzQxNw==-flat-avcodec.h,50,56,6,760,766,6
270,https://htmlpreview.github.io/?https://github.com/Christina96/boilerplate-sample-matches/blob/main/C/libpcap-MDEwOlJlcG9zaXRvcnk5NDM1ODg3-flat-pcap.c-libpcap-MDEwOlJlcG9zaXRvcnk5NDM1ODg3-flat-pcap.c.html,16,libpcap-MDEwOlJlcG9zaXRvcnk5NDM1ODg3-flat-pcap.c,libpcap-MDEwOlJlcG9zaXRvcnk5NDM1ODg3-flat-pcap.c,1245,1249,4,1197,1201,4
271,https://htmlpreview.github.io/?https://github.com/Christina96/boilerplate-sample-matches/blob/main/C/libfuse-MDEwOlJlcG9zaXRvcnk0ODI5NjE3Nw==-flat-fuse.c-libfuse-MDEwOlJlcG9zaXRvcnk0ODI5NjE3Nw==-flat-fuse.c.html,125,libfuse-MDEwOlJlcG9zaXRvcnk0ODI5NjE3Nw==-flat-fuse.c,libfuse-MDEwOlJlcG9zaXRvcnk0ODI5NjE3Nw==-flat-fuse.c,3030,3053,23,2965,2988,23
272,https://htmlpreview.github.io/?https://github.com/Christina96/boilerplate-sample-matches/blob/main/C/libtomcrypt-MDEwOlJlcG9zaXRvcnk3NzcwMTE=-flat-der_test.c-libtomcrypt-MDEwOlJlcG9zaXRvcnk3NzcwMTE=-flat-der_test.c.html,16,libtomcrypt-MDEwOlJlcG9zaXRvcnk3NzcwMTE=-flat-der_test.c,libtomcrypt-MDEwOlJlcG9zaXRvcnk3NzcwMTE=-flat-der_test.c,1187,1191,4,1187,1191,4
273,https://htmlpreview.github.io/?https://github.com/Christina96/boilerplate-sample-matches/blob/main/C/PINRemoteImage-MDEwOlJlcG9zaXRvcnkzOTUzNzEwMw==-flat-decode_28.h-PINRemoteImage-MDEwOlJlcG9zaXRvcnkzOTUzNzEwMw==-flat-decode_46.h.html,1016,PINRemoteImage-MDEwOlJlcG9zaXRvcnkzOTUzNzEwMw==-flat-decode_28.h,PINRemoteImage-MDEwOlJlcG9zaXRvcnkzOTUzNzEwMw==-flat-decode_46.h,30,195,165,30,195,165
274,https://htmlpreview.github.io/?https://github.com/Christina96/boilerplate-sample-matches/blob/main/C/Adafruit_nRF52_Arduino-MDEwOlJlcG9zaXRvcnk3NDM1NDcyOQ==-flat-nrf_spis.h-Adafruit_nRF52_Arduino-MDEwOlJlcG9zaXRvcnk3NDM1NDcyOQ==-flat-nrf_spis.h.html,15,Adafruit_nRF52_Arduino-MDEwOlJlcG9zaXRvcnk3NDM1NDcyOQ==-flat-nrf_spis.h,Adafruit_nRF52_Arduino-MDEwOlJlcG9zaXRvcnk3NDM1NDcyOQ==-flat-nrf_spis.h,234,236,2,234,236,2
275,https://htmlpreview.github.io/?https://github.com/Christina96/boilerplate-sample-matches/blob/main/C/PINRemoteImage-MDEwOlJlcG9zaXRvcnkzOTUzNzEwMw==-flat-enc_neon.c-PINRemoteImage-MDEwOlJlcG9zaXRvcnkzOTUzNzEwMw==-flat-enc_neon.c.html,40,PINRemoteImage-MDEwOlJlcG9zaXRvcnkzOTUzNzEwMw==-flat-enc_neon.c,PINRemoteImage-MDEwOlJlcG9zaXRvcnkzOTUzNzEwMw==-flat-enc_neon.c,414,420,6,414,420,6
276,https://htmlpreview.github.io/?https://github.com/Christina96/boilerplate-sample-matches/blob/main/C/Adafruit_nRF52_Arduino-MDEwOlJlcG9zaXRvcnk3NDM1NDcyOQ==-flat-tweetnacl.c-libtomcrypt-MDEwOlJlcG9zaXRvcnk3NzcwMTE=-flat-tweetnacl.c.html,108,Adafruit_nRF52_Arduino-MDEwOlJlcG9zaXRvcnk3NDM1NDcyOQ==-flat-tweetnacl.c,libtomcrypt-MDEwOlJlcG9zaXRvcnk3NzcwMTE=-flat-tweetnacl.c,226,234,8,65,73,8
277,https://htmlpreview.github.io/?https://github.com/Christina96/boilerplate-sample-matches/blob/main/C/libfuse-MDEwOlJlcG9zaXRvcnk0ODI5NjE3Nw==-flat-passthrough_ll.c-libfuse-MDEwOlJlcG9zaXRvcnk0ODI5NjE3Nw==-flat-notify_inval_inode.c.html,36,libfuse-MDEwOlJlcG9zaXRvcnk0ODI5NjE3Nw==-flat-passthrough_ll.c,libfuse-MDEwOlJlcG9zaXRvcnk0ODI5NjE3Nw==-flat-notify_inval_inode.c,1036,1042,6,225,231,6
278,https://htmlpreview.github.io/?https://github.com/Christina96/boilerplate-sample-matches/blob/main/C/redis-MDEwOlJlcG9zaXRvcnkxMDgxMTA3MDY=-flat-networking.c-redis-MDEwOlJlcG9zaXRvcnkxMDgxMTA3MDY=-flat-aof.c.html,20,redis-MDEwOlJlcG9zaXRvcnkxMDgxMTA3MDY=-flat-networking.c,redis-MDEwOlJlcG9zaXRvcnkxMDgxMTA3MDY=-flat-aof.c,92,95,3,435,438,3
279,https://htmlpreview.github.io/?https://github.com/Christina96/boilerplate-sample-matches/blob/main/C/redis-MDEwOlJlcG9zaXRvcnkxMDgxMTA3MDY=-flat-hash.h-redis-MDEwOlJlcG9zaXRvcnkxMDgxMTA3MDY=-flat-hash.h.html,16,redis-MDEwOlJlcG9zaXRvcnkxMDgxMTA3MDY=-flat-hash.h,redis-MDEwOlJlcG9zaXRvcnkxMDgxMTA3MDY=-flat-hash.h,34,37,3,34,37,3
280,https://htmlpreview.github.io/?https://github.com/Christina96/boilerplate-sample-matches/blob/main/C/xmrig-MDEwOlJlcG9zaXRvcnk4ODMyNzQwNg==-flat-sse2neon.h-xmrig-MDEwOlJlcG9zaXRvcnk4ODMyNzQwNg==-flat-sse2neon.h.html,15,xmrig-MDEwOlJlcG9zaXRvcnk4ODMyNzQwNg==-flat-sse2neon.h,xmrig-MDEwOlJlcG9zaXRvcnk4ODMyNzQwNg==-flat-sse2neon.h,2663,2665,2,2663,2665,2
281,https://htmlpreview.github.io/?https://github.com/Christina96/boilerplate-sample-matches/blob/main/C/xmrig-MDEwOlJlcG9zaXRvcnk4ODMyNzQwNg==-flat-CryptoNight_x86.h-xmrig-MDEwOlJlcG9zaXRvcnk4ODMyNzQwNg==-flat-CryptoNight_x86.h.html,54,xmrig-MDEwOlJlcG9zaXRvcnk4ODMyNzQwNg==-flat-CryptoNight_x86.h,xmrig-MDEwOlJlcG9zaXRvcnk4ODMyNzQwNg==-flat-CryptoNight_x86.h,825,829,4,825,829,4
282,https://htmlpreview.github.io/?https://github.com/Christina96/boilerplate-sample-matches/blob/main/C/redis-MDEwOlJlcG9zaXRvcnkxMDgxMTA3MDY=-flat-smallocx.c-redis-MDEwOlJlcG9zaXRvcnkxMDgxMTA3MDY=-flat-smallocx.c.html,15,redis-MDEwOlJlcG9zaXRvcnkxMDgxMTA3MDY=-flat-smallocx.c,redis-MDEwOlJlcG9zaXRvcnkxMDgxMTA3MDY=-flat-smallocx.c,80,82,2,80,82,2
283,https://htmlpreview.github.io/?https://github.com/Christina96/boilerplate-sample-matches/blob/main/C/xmrig-MDEwOlJlcG9zaXRvcnk4ODMyNzQwNg==-flat-Config_default.h-xmrig-MDEwOlJlcG9zaXRvcnk4ODMyNzQwNg==-flat-Config_default.h.html,18,xmrig-MDEwOlJlcG9zaXRvcnk4ODMyNzQwNg==-flat-Config_default.h,xmrig-MDEwOlJlcG9zaXRvcnk4ODMyNzQwNg==-flat-Config_default.h,28,37,9,17,26,9
284,https://htmlpreview.github.io/?https://github.com/Christina96/boilerplate-sample-matches/blob/main/C/PINRemoteImage-MDEwOlJlcG9zaXRvcnkzOTUzNzEwMw==-flat-mux_30.h-PINRemoteImage-MDEwOlJlcG9zaXRvcnkzOTUzNzEwMw==-flat-mux_12.h.html,405,PINRemoteImage-MDEwOlJlcG9zaXRvcnkzOTUzNzEwMw==-flat-mux_30.h,PINRemoteImage-MDEwOlJlcG9zaXRvcnkzOTUzNzEwMw==-flat-mux_12.h,49,121,72,49,121,72
285,https://htmlpreview.github.io/?https://github.com/Christina96/boilerplate-sample-matches/blob/main/C/fftw3-MDEwOlJlcG9zaXRvcnk4ODQzMzg4-flat-ct_4.c-fftw3-MDEwOlJlcG9zaXRvcnk4ODQzMzg4-flat-ct-hc2c.c.html,48,fftw3-MDEwOlJlcG9zaXRvcnk4ODQzMzg4-flat-ct_4.c,fftw3-MDEwOlJlcG9zaXRvcnk4ODQzMzg4-flat-ct-hc2c.c,161,168,7,201,209,8
286,https://htmlpreview.github.io/?https://github.com/Christina96/boilerplate-sample-matches/blob/main/C/redis-MDEwOlJlcG9zaXRvcnkxMDgxMTA3MDY=-flat-quicklist.c-redis-MDEwOlJlcG9zaXRvcnkxMDgxMTA3MDY=-flat-dict.c.html,15,redis-MDEwOlJlcG9zaXRvcnkxMDgxMTA3MDY=-flat-quicklist.c,redis-MDEwOlJlcG9zaXRvcnkxMDgxMTA3MDY=-flat-dict.c,102,106,4,122,126,4
287,https://htmlpreview.github.io/?https://github.com/Christina96/boilerplate-sample-matches/blob/main/C/PINRemoteImage-MDEwOlJlcG9zaXRvcnkzOTUzNzEwMw==-flat-yuv.h-PINRemoteImage-MDEwOlJlcG9zaXRvcnkzOTUzNzEwMw==-flat-upsampling_mips_dsp_r2.c.html,28,PINRemoteImage-MDEwOlJlcG9zaXRvcnkzOTUzNzEwMw==-flat-yuv.h,PINRemoteImage-MDEwOlJlcG9zaXRvcnkzOTUzNzEwMw==-flat-upsampling_mips_dsp_r2.c,79,83,4,96,100,4
288,https://htmlpreview.github.io/?https://github.com/Christina96/boilerplate-sample-matches/blob/main/C/android-gpuimage-plus-MDEwOlJlcG9zaXRvcnk0NjU0NzQxNw==-flat-cgeSelectiveColorAdjust.h-android-gpuimage-plus-MDEwOlJlcG9zaXRvcnk0NjU0NzQxNw==-flat-cgeSelectiveColorAdjust.h.html,16,android-gpuimage-plus-MDEwOlJlcG9zaXRvcnk0NjU0NzQxNw==-flat-cgeSelectiveColorAdjust.h,android-gpuimage-plus-MDEwOlJlcG9zaXRvcnk0NjU0NzQxNw==-flat-cgeSelectiveColorAdjust.h,14,15,1,20,21,1
289,https://htmlpreview.github.io/?https://github.com/Christina96/boilerplate-sample-matches/blob/main/C/Adafruit_nRF52_Arduino-MDEwOlJlcG9zaXRvcnk3NDM1NDcyOQ==-flat-nrf_pdm.h-Adafruit_nRF52_Arduino-MDEwOlJlcG9zaXRvcnk3NDM1NDcyOQ==-flat-nrf_saadc.h.html,18,Adafruit_nRF52_Arduino-MDEwOlJlcG9zaXRvcnk3NDM1NDcyOQ==-flat-nrf_pdm.h,Adafruit_nRF52_Arduino-MDEwOlJlcG9zaXRvcnk3NDM1NDcyOQ==-flat-nrf_saadc.h,110,112,2,209,211,2
290,https://htmlpreview.github.io/?https://github.com/Christina96/boilerplate-sample-matches/blob/main/C/redis-MDEwOlJlcG9zaXRvcnkxMDgxMTA3MDY=-flat-lgc.h-redis-MDEwOlJlcG9zaXRvcnkxMDgxMTA3MDY=-flat-lstate.h.html,13,redis-MDEwOlJlcG9zaXRvcnkxMDgxMTA3MDY=-flat-lgc.h,redis-MDEwOlJlcG9zaXRvcnkxMDgxMTA3MDY=-flat-lstate.h,59,60,1,109,110,1
291,https://htmlpreview.github.io/?https://github.com/Christina96/boilerplate-sample-matches/blob/main/C/redis-MDEwOlJlcG9zaXRvcnkxMDgxMTA3MDY=-flat-stats_7.c-redis-MDEwOlJlcG9zaXRvcnkxMDgxMTA3MDY=-flat-stats_7.c.html,15,redis-MDEwOlJlcG9zaXRvcnkxMDgxMTA3MDY=-flat-stats_7.c,redis-MDEwOlJlcG9zaXRvcnkxMDgxMTA3MDY=-flat-stats_7.c,1057,1058,1,1057,1058,1
292,https://htmlpreview.github.io/?https://github.com/Christina96/boilerplate-sample-matches/blob/main/C/Adafruit_nRF52_Arduino-MDEwOlJlcG9zaXRvcnk3NDM1NDcyOQ==-flat-tasks.c-Adafruit_nRF52_Arduino-MDEwOlJlcG9zaXRvcnk3NDM1NDcyOQ==-flat-tasks.c.html,15,Adafruit_nRF52_Arduino-MDEwOlJlcG9zaXRvcnk3NDM1NDcyOQ==-flat-tasks.c,Adafruit_nRF52_Arduino-MDEwOlJlcG9zaXRvcnk3NDM1NDcyOQ==-flat-tasks.c,568,577,9,1017,1026,9
293,https://htmlpreview.github.io/?https://github.com/Christina96/boilerplate-sample-matches/blob/main/C/libpcap-MDEwOlJlcG9zaXRvcnk5NDM1ODg3-flat-pcap-usb-linux.c-libpcap-MDEwOlJlcG9zaXRvcnk5NDM1ODg3-flat-pcap-airpcap.c.html,18,libpcap-MDEwOlJlcG9zaXRvcnk5NDM1ODg3-flat-pcap-usb-linux.c,libpcap-MDEwOlJlcG9zaXRvcnk5NDM1ODg3-flat-pcap-airpcap.c,517,519,2,406,408,2
294,https://htmlpreview.github.io/?https://github.com/Christina96/boilerplate-sample-matches/blob/main/C/redis-MDEwOlJlcG9zaXRvcnkxMDgxMTA3MDY=-flat-module.c-redis-MDEwOlJlcG9zaXRvcnkxMDgxMTA3MDY=-flat-module.c.html,61,redis-MDEwOlJlcG9zaXRvcnkxMDgxMTA3MDY=-flat-module.c,redis-MDEwOlJlcG9zaXRvcnkxMDgxMTA3MDY=-flat-module.c,1126,1140,14,1126,1140,14
295,https://htmlpreview.github.io/?https://github.com/Christina96/boilerplate-sample-matches/blob/main/C/android-gpuimage-plus-MDEwOlJlcG9zaXRvcnk0NjU0NzQxNw==-flat-avcodec.h-android-gpuimage-plus-MDEwOlJlcG9zaXRvcnk0NjU0NzQxNw==-flat-avcodec.h.html,25,android-gpuimage-plus-MDEwOlJlcG9zaXRvcnk0NjU0NzQxNw==-flat-avcodec.h,android-gpuimage-plus-MDEwOlJlcG9zaXRvcnk0NjU0NzQxNw==-flat-avcodec.h,1607,1613,6,1142,1148,6
296,https://htmlpreview.github.io/?https://github.com/Christina96/boilerplate-sample-matches/blob/main/C/xmrig-MDEwOlJlcG9zaXRvcnk4ODMyNzQwNg==-flat-Tls.h-xmrig-MDEwOlJlcG9zaXRvcnk4ODMyNzQwNg==-flat-HttpsClient.h.html,23,xmrig-MDEwOlJlcG9zaXRvcnk4ODMyNzQwNg==-flat-Tls.h,xmrig-MDEwOlJlcG9zaXRvcnk4ODMyNzQwNg==-flat-HttpsClient.h,26,29,3,27,30,3
297,https://htmlpreview.github.io/?https://github.com/Christina96/boilerplate-sample-matches/blob/main/C/libtomcrypt-MDEwOlJlcG9zaXRvcnk3NzcwMTE=-flat-rc6.c-libtomcrypt-MDEwOlJlcG9zaXRvcnk3NzcwMTE=-flat-rc6.c.html,15,libtomcrypt-MDEwOlJlcG9zaXRvcnk3NzcwMTE=-flat-rc6.c,libtomcrypt-MDEwOlJlcG9zaXRvcnk3NzcwMTE=-flat-rc6.c,138,141,3,97,100,3
298,https://htmlpreview.github.io/?https://github.com/Christina96/boilerplate-sample-matches/blob/main/C/xmrig-MDEwOlJlcG9zaXRvcnk4ODMyNzQwNg==-flat-Cn2Kernel.h-xmrig-MDEwOlJlcG9zaXRvcnk4ODMyNzQwNg==-flat-Blake2bInitialHashKernel.h.html,26,xmrig-MDEwOlJlcG9zaXRvcnk4ODMyNzQwNg==-flat-Cn2Kernel.h,xmrig-MDEwOlJlcG9zaXRvcnk4ODMyNzQwNg==-flat-Blake2bInitialHashKernel.h,4,9,5,4,9,5
299,https://htmlpreview.github.io/?https://github.com/Christina96/boilerplate-sample-matches/blob/main/C/xmrig-MDEwOlJlcG9zaXRvcnk4ODMyNzQwNg==-flat-compile.h-xmrig-MDEwOlJlcG9zaXRvcnk4ODMyNzQwNg==-flat-compile.h.html,28,xmrig-MDEwOlJlcG9zaXRvcnk4ODMyNzQwNg==-flat-compile.h,xmrig-MDEwOlJlcG9zaXRvcnk4ODMyNzQwNg==-flat-compile.h,169,172,3,173,175,2
300,https://htmlpreview.github.io/?https://github.com/Christina96/boilerplate-sample-matches/blob/main/C/redis-MDEwOlJlcG9zaXRvcnkxMDgxMTA3MDY=-flat-SFMT_0.c-PINRemoteImage-MDEwOlJlcG9zaXRvcnkzOTUzNzEwMw==-flat-backward_references_cost_enc.c.html,17,redis-MDEwOlJlcG9zaXRvcnkxMDgxMTA3MDY=-flat-SFMT_0.c,PINRemoteImage-MDEwOlJlcG9zaXRvcnkzOTUzNzEwMw==-flat-backward_references_cost_enc.c,432,435,3,185,188,3
301,https://htmlpreview.github.io/?https://github.com/Christina96/boilerplate-sample-matches/blob/main/C/libtomcrypt-MDEwOlJlcG9zaXRvcnk3NzcwMTE=-flat-sprng.c-libtomcrypt-MDEwOlJlcG9zaXRvcnk3NzcwMTE=-flat-sprng.c.html,17,libtomcrypt-MDEwOlJlcG9zaXRvcnk3NzcwMTE=-flat-sprng.c,libtomcrypt-MDEwOlJlcG9zaXRvcnk3NzcwMTE=-flat-sprng.c,45,48,3,45,48,3
302,https://htmlpreview.github.io/?https://github.com/Christina96/boilerplate-sample-matches/blob/main/C/PINRemoteImage-MDEwOlJlcG9zaXRvcnkzOTUzNzEwMw==-flat-libwebp_java_wrap.c-PINRemoteImage-MDEwOlJlcG9zaXRvcnkzOTUzNzEwMw==-flat-libwebp_java_wrap.c.html,62,PINRemoteImage-MDEwOlJlcG9zaXRvcnkzOTUzNzEwMw==-flat-libwebp_java_wrap.c,PINRemoteImage-MDEwOlJlcG9zaXRvcnkzOTUzNzEwMw==-flat-libwebp_java_wrap.c,582,591,9,623,632,9
303,https://htmlpreview.github.io/?https://github.com/Christina96/boilerplate-sample-matches/blob/main/C/PINRemoteImage-MDEwOlJlcG9zaXRvcnkzOTUzNzEwMw==-flat-backward_references_enc.c-PINRemoteImage-MDEwOlJlcG9zaXRvcnkzOTUzNzEwMw==-flat-backward_references_enc.c.html,18,PINRemoteImage-MDEwOlJlcG9zaXRvcnkzOTUzNzEwMw==-flat-backward_references_enc.c,PINRemoteImage-MDEwOlJlcG9zaXRvcnkzOTUzNzEwMw==-flat-backward_references_enc.c,513,515,2,513,515,2
304,https://htmlpreview.github.io/?https://github.com/Christina96/boilerplate-sample-matches/blob/main/C/xmrig-MDEwOlJlcG9zaXRvcnk4ODMyNzQwNg==-flat-sse2neon.h-xmrig-MDEwOlJlcG9zaXRvcnk4ODMyNzQwNg==-flat-sse2neon.h.html,19,xmrig-MDEwOlJlcG9zaXRvcnk4ODMyNzQwNg==-flat-sse2neon.h,xmrig-MDEwOlJlcG9zaXRvcnk4ODMyNzQwNg==-flat-sse2neon.h,4981,4983,2,4981,4983,2
305,https://htmlpreview.github.io/?https://github.com/Christina96/boilerplate-sample-matches/blob/main/C/Adafruit_nRF52_Arduino-MDEwOlJlcG9zaXRvcnk3NDM1NDcyOQ==-flat-nrfx_spis.c-Adafruit_nRF52_Arduino-MDEwOlJlcG9zaXRvcnk3NDM1NDcyOQ==-flat-nrfx_spis.c.html,17,Adafruit_nRF52_Arduino-MDEwOlJlcG9zaXRvcnk3NDM1NDcyOQ==-flat-nrfx_spis.c,Adafruit_nRF52_Arduino-MDEwOlJlcG9zaXRvcnk3NDM1NDcyOQ==-flat-nrfx_spis.c,316,322,6,316,322,6
306,https://htmlpreview.github.io/?https://github.com/Christina96/boilerplate-sample-matches/blob/main/C/redis-MDEwOlJlcG9zaXRvcnkxMDgxMTA3MDY=-flat-module.c-redis-MDEwOlJlcG9zaXRvcnkxMDgxMTA3MDY=-flat-module.c.html,22,redis-MDEwOlJlcG9zaXRvcnkxMDgxMTA3MDY=-flat-module.c,redis-MDEwOlJlcG9zaXRvcnkxMDgxMTA3MDY=-flat-module.c,1721,1724,3,1799,1802,3
307,https://htmlpreview.github.io/?https://github.com/Christina96/boilerplate-sample-matches/blob/main/C/xmrig-MDEwOlJlcG9zaXRvcnk4ODMyNzQwNg==-flat-AdlHealth.h-xmrig-MDEwOlJlcG9zaXRvcnk4ODMyNzQwNg==-flat-Job.h.html,15,xmrig-MDEwOlJlcG9zaXRvcnk4ODMyNzQwNg==-flat-AdlHealth.h,xmrig-MDEwOlJlcG9zaXRvcnk4ODMyNzQwNg==-flat-Job.h,9,12,3,105,108,3
308,https://htmlpreview.github.io/?https://github.com/Christina96/boilerplate-sample-matches/blob/main/C/PINRemoteImage-MDEwOlJlcG9zaXRvcnkzOTUzNzEwMw==-flat-decode_9.h-PINRemoteImage-MDEwOlJlcG9zaXRvcnkzOTUzNzEwMw==-flat-decode_46.h.html,20,PINRemoteImage-MDEwOlJlcG9zaXRvcnkzOTUzNzEwMw==-flat-decode_9.h,PINRemoteImage-MDEwOlJlcG9zaXRvcnkzOTUzNzEwMw==-flat-decode_46.h,177,183,6,177,183,6
309,https://htmlpreview.github.io/?https://github.com/Christina96/boilerplate-sample-matches/blob/main/C/PINRemoteImage-MDEwOlJlcG9zaXRvcnkzOTUzNzEwMw==-flat-lossless_enc.c-PINRemoteImage-MDEwOlJlcG9zaXRvcnkzOTUzNzEwMw==-flat-lossless_enc.c.html,21,PINRemoteImage-MDEwOlJlcG9zaXRvcnkzOTUzNzEwMw==-flat-lossless_enc.c,PINRemoteImage-MDEwOlJlcG9zaXRvcnkzOTUzNzEwMw==-flat-lossless_enc.c,814,817,3,816,819,3
310,https://htmlpreview.github.io/?https://github.com/Christina96/boilerplate-sample-matches/blob/main/C/libpcap-MDEwOlJlcG9zaXRvcnk5NDM1ODg3-flat-pcap-dlpi.c-libpcap-MDEwOlJlcG9zaXRvcnk5NDM1ODg3-flat-pcap-dlpi.c.html,17,libpcap-MDEwOlJlcG9zaXRvcnk5NDM1ODg3-flat-pcap-dlpi.c,libpcap-MDEwOlJlcG9zaXRvcnk5NDM1ODg3-flat-pcap-dlpi.c,443,446,3,378,381,3
311,https://htmlpreview.github.io/?https://github.com/Christina96/boilerplate-sample-matches/blob/main/C/PINRemoteImage-MDEwOlJlcG9zaXRvcnkzOTUzNzEwMw==-flat-predictor_enc.c-PINRemoteImage-MDEwOlJlcG9zaXRvcnkzOTUzNzEwMw==-flat-predictor_enc.c.html,17,PINRemoteImage-MDEwOlJlcG9zaXRvcnkzOTUzNzEwMw==-flat-predictor_enc.c,PINRemoteImage-MDEwOlJlcG9zaXRvcnkzOTUzNzEwMw==-flat-predictor_enc.c,456,459,3,462,465,3
312,https://htmlpreview.github.io/?https://github.com/Christina96/boilerplate-sample-matches/blob/main/C/xmrig-MDEwOlJlcG9zaXRvcnk4ODMyNzQwNg==-flat-CudaBackend.h-xmrig-MDEwOlJlcG9zaXRvcnk4ODMyNzQwNg==-flat-CudaBackend.h.html,16,xmrig-MDEwOlJlcG9zaXRvcnk4ODMyNzQwNg==-flat-CudaBackend.h,xmrig-MDEwOlJlcG9zaXRvcnk4ODMyNzQwNg==-flat-CudaBackend.h,31,32,1,31,32,1
313,https://htmlpreview.github.io/?https://github.com/Christina96/boilerplate-sample-matches/blob/main/C/PINRemoteImage-MDEwOlJlcG9zaXRvcnkzOTUzNzEwMw==-flat-lossless_enc_mips32.c-PINRemoteImage-MDEwOlJlcG9zaXRvcnkzOTUzNzEwMw==-flat-lossless_enc_mips32.c.html,40,PINRemoteImage-MDEwOlJlcG9zaXRvcnkzOTUzNzEwMw==-flat-lossless_enc_mips32.c,PINRemoteImage-MDEwOlJlcG9zaXRvcnkzOTUzNzEwMw==-flat-lossless_enc_mips32.c,61,78,17,61,78,17
314,https://htmlpreview.github.io/?https://github.com/Christina96/boilerplate-sample-matches/blob/main/C/redis-MDEwOlJlcG9zaXRvcnkxMDgxMTA3MDY=-flat-rdb.c-redis-MDEwOlJlcG9zaXRvcnkxMDgxMTA3MDY=-flat-rdb.c.html,15,redis-MDEwOlJlcG9zaXRvcnkxMDgxMTA3MDY=-flat-rdb.c,redis-MDEwOlJlcG9zaXRvcnkxMDgxMTA3MDY=-flat-rdb.c,1482,1484,2,1482,1484,2
315,https://htmlpreview.github.io/?https://github.com/Christina96/boilerplate-sample-matches/blob/main/C/PINRemoteImage-MDEwOlJlcG9zaXRvcnkzOTUzNzEwMw==-flat-rescaler_msa.c-PINRemoteImage-MDEwOlJlcG9zaXRvcnkzOTUzNzEwMw==-flat-rescaler_msa.c.html,88,PINRemoteImage-MDEwOlJlcG9zaXRvcnkzOTUzNzEwMw==-flat-rescaler_msa.c,PINRemoteImage-MDEwOlJlcG9zaXRvcnkzOTUzNzEwMw==-flat-rescaler_msa.c,118,129,11,347,358,11
316,https://htmlpreview.github.io/?https://github.com/Christina96/boilerplate-sample-matches/blob/main/C/xmrig-MDEwOlJlcG9zaXRvcnk4ODMyNzQwNg==-flat-topology-synthetic.c-xmrig-MDEwOlJlcG9zaXRvcnk4ODMyNzQwNg==-flat-topology-synthetic.c.html,19,xmrig-MDEwOlJlcG9zaXRvcnk4ODMyNzQwNg==-flat-topology-synthetic.c,xmrig-MDEwOlJlcG9zaXRvcnk4ODMyNzQwNg==-flat-topology-synthetic.c,273,275,2,282,284,2
317,https://htmlpreview.github.io/?https://github.com/Christina96/boilerplate-sample-matches/blob/main/C/Adafruit_nRF52_Arduino-MDEwOlJlcG9zaXRvcnk3NDM1NDcyOQ==-flat-SEGGER_RTT_printf.c-Adafruit_nRF52_Arduino-MDEwOlJlcG9zaXRvcnk3NDM1NDcyOQ==-flat-SEGGER_SYSVIEW.c.html,46,Adafruit_nRF52_Arduino-MDEwOlJlcG9zaXRvcnk3NDM1NDcyOQ==-flat-SEGGER_RTT_printf.c,Adafruit_nRF52_Arduino-MDEwOlJlcG9zaXRvcnk3NDM1NDcyOQ==-flat-SEGGER_SYSVIEW.c,73,84,11,458,469,11
318,https://htmlpreview.github.io/?https://github.com/Christina96/boilerplate-sample-matches/blob/main/C/redis-MDEwOlJlcG9zaXRvcnkxMDgxMTA3MDY=-flat-extent_24.c-redis-MDEwOlJlcG9zaXRvcnkxMDgxMTA3MDY=-flat-extent_hooks.h.html,27,redis-MDEwOlJlcG9zaXRvcnkxMDgxMTA3MDY=-flat-extent_24.c,redis-MDEwOlJlcG9zaXRvcnkxMDgxMTA3MDY=-flat-extent_hooks.h,1660,1662,2,228,230,2
319,https://htmlpreview.github.io/?https://github.com/Christina96/boilerplate-sample-matches/blob/main/C/PINRemoteImage-MDEwOlJlcG9zaXRvcnkzOTUzNzEwMw==-flat-libwebp_java_wrap.c-PINRemoteImage-MDEwOlJlcG9zaXRvcnkzOTUzNzEwMw==-flat-libwebp_java_wrap.c.html,95,PINRemoteImage-MDEwOlJlcG9zaXRvcnkzOTUzNzEwMw==-flat-libwebp_java_wrap.c,PINRemoteImage-MDEwOlJlcG9zaXRvcnkzOTUzNzEwMw==-flat-libwebp_java_wrap.c,1162,1178,16,1421,1437,16
320,https://htmlpreview.github.io/?https://github.com/Christina96/boilerplate-sample-matches/blob/main/C/redis-MDEwOlJlcG9zaXRvcnkxMDgxMTA3MDY=-flat-scripting.c-redis-MDEwOlJlcG9zaXRvcnkxMDgxMTA3MDY=-flat-scripting.c.html,30,redis-MDEwOlJlcG9zaXRvcnkxMDgxMTA3MDY=-flat-scripting.c,redis-MDEwOlJlcG9zaXRvcnkxMDgxMTA3MDY=-flat-scripting.c,703,709,6,719,725,6
321,https://htmlpreview.github.io/?https://github.com/Christina96/boilerplate-sample-matches/blob/main/C/libpcap-MDEwOlJlcG9zaXRvcnk5NDM1ODg3-flat-selpolltest.c-libpcap-MDEwOlJlcG9zaXRvcnk5NDM1ODg3-flat-reactivatetest.c.html,39,libpcap-MDEwOlJlcG9zaXRvcnk5NDM1ODg3-flat-selpolltest.c,libpcap-MDEwOlJlcG9zaXRvcnk5NDM1ODg3-flat-reactivatetest.c,291,297,6,48,54,6
322,https://htmlpreview.github.io/?https://github.com/Christina96/boilerplate-sample-matches/blob/main/C/PINRemoteImage-MDEwOlJlcG9zaXRvcnkzOTUzNzEwMw==-flat-histogram_enc.c-PINRemoteImage-MDEwOlJlcG9zaXRvcnkzOTUzNzEwMw==-flat-histogram_enc.c.html,16,PINRemoteImage-MDEwOlJlcG9zaXRvcnkzOTUzNzEwMw==-flat-histogram_enc.c,PINRemoteImage-MDEwOlJlcG9zaXRvcnkzOTUzNzEwMw==-flat-histogram_enc.c,522,524,2,539,541,2
323,https://htmlpreview.github.io/?https://github.com/Christina96/boilerplate-sample-matches/blob/main/C/Adafruit_nRF52_Arduino-MDEwOlJlcG9zaXRvcnk3NDM1NDcyOQ==-flat-nrf_ipc.h-Adafruit_nRF52_Arduino-MDEwOlJlcG9zaXRvcnk3NDM1NDcyOQ==-flat-nrf_ipc.h.html,32,Adafruit_nRF52_Arduino-MDEwOlJlcG9zaXRvcnk3NDM1NDcyOQ==-flat-nrf_ipc.h,Adafruit_nRF52_Arduino-MDEwOlJlcG9zaXRvcnk3NDM1NDcyOQ==-flat-nrf_ipc.h,112,117,5,112,117,5
324,https://htmlpreview.github.io/?https://github.com/Christina96/boilerplate-sample-matches/blob/main/C/fftw3-MDEwOlJlcG9zaXRvcnk4ODQzMzg4-flat-x86-cpuid.h-fftw3-MDEwOlJlcG9zaXRvcnk4ODQzMzg4-flat-x86-cpuid.h.html,33,fftw3-MDEwOlJlcG9zaXRvcnk4ODQzMzg4-flat-x86-cpuid.h,fftw3-MDEwOlJlcG9zaXRvcnk4ODQzMzg4-flat-x86-cpuid.h,72,79,7,72,79,7
325,https://htmlpreview.github.io/?https://github.com/Christina96/boilerplate-sample-matches/blob/main/C/PINRemoteImage-MDEwOlJlcG9zaXRvcnkzOTUzNzEwMw==-flat-libwebp_go_wrap.c-PINRemoteImage-MDEwOlJlcG9zaXRvcnkzOTUzNzEwMw==-flat-libwebp_java_wrap.c.html,27,PINRemoteImage-MDEwOlJlcG9zaXRvcnkzOTUzNzEwMw==-flat-libwebp_go_wrap.c,PINRemoteImage-MDEwOlJlcG9zaXRvcnkzOTUzNzEwMw==-flat-libwebp_java_wrap.c,180,183,3,866,869,3
326,https://htmlpreview.github.io/?https://github.com/Christina96/boilerplate-sample-matches/blob/main/C/redis-MDEwOlJlcG9zaXRvcnkxMDgxMTA3MDY=-flat-redis-cli.c-redis-MDEwOlJlcG9zaXRvcnkxMDgxMTA3MDY=-flat-redis-cli.c.html,16,redis-MDEwOlJlcG9zaXRvcnkxMDgxMTA3MDY=-flat-redis-cli.c,redis-MDEwOlJlcG9zaXRvcnkxMDgxMTA3MDY=-flat-redis-cli.c,5107,5110,3,5107,5110,3
327,https://htmlpreview.github.io/?https://github.com/Christina96/boilerplate-sample-matches/blob/main/C/redis-MDEwOlJlcG9zaXRvcnkxMDgxMTA3MDY=-flat-Win32_ANSI.c-redis-MDEwOlJlcG9zaXRvcnkxMDgxMTA3MDY=-flat-Win32_ANSI.c.html,37,redis-MDEwOlJlcG9zaXRvcnkxMDgxMTA3MDY=-flat-Win32_ANSI.c,redis-MDEwOlJlcG9zaXRvcnkxMDgxMTA3MDY=-flat-Win32_ANSI.c,407,410,3,380,383,3
328,https://htmlpreview.github.io/?https://github.com/Christina96/boilerplate-sample-matches/blob/main/C/xmrig-MDEwOlJlcG9zaXRvcnk4ODMyNzQwNg==-flat-bitmap.c-xmrig-MDEwOlJlcG9zaXRvcnk4ODMyNzQwNg==-flat-bitmap.c.html,69,xmrig-MDEwOlJlcG9zaXRvcnk4ODMyNzQwNg==-flat-bitmap.c,xmrig-MDEwOlJlcG9zaXRvcnk4ODMyNzQwNg==-flat-bitmap.c,454,464,10,454,464,10
329,https://htmlpreview.github.io/?https://github.com/Christina96/boilerplate-sample-matches/blob/main/C/libtomcrypt-MDEwOlJlcG9zaXRvcnk3NzcwMTE=-flat-blake2b.c-libtomcrypt-MDEwOlJlcG9zaXRvcnk3NzcwMTE=-flat-blake2s.c.html,15,libtomcrypt-MDEwOlJlcG9zaXRvcnk3NzcwMTE=-flat-blake2b.c,libtomcrypt-MDEwOlJlcG9zaXRvcnk3NzcwMTE=-flat-blake2s.c,122,124,2,115,117,2
330,https://htmlpreview.github.io/?https://github.com/Christina96/boilerplate-sample-matches/blob/main/C/libfuse-MDEwOlJlcG9zaXRvcnk0ODI5NjE3Nw==-flat-fusermount.c-libfuse-MDEwOlJlcG9zaXRvcnk0ODI5NjE3Nw==-flat-fusermount.c.html,16,libfuse-MDEwOlJlcG9zaXRvcnk0ODI5NjE3Nw==-flat-fusermount.c,libfuse-MDEwOlJlcG9zaXRvcnk0ODI5NjE3Nw==-flat-fusermount.c,150,153,3,150,153,3
331,https://htmlpreview.github.io/?https://github.com/Christina96/boilerplate-sample-matches/blob/main/C/libpcap-MDEwOlJlcG9zaXRvcnk5NDM1ODg3-flat-pcap.c-libpcap-MDEwOlJlcG9zaXRvcnk5NDM1ODg3-flat-pcap.c.html,38,libpcap-MDEwOlJlcG9zaXRvcnk5NDM1ODg3-flat-pcap.c,libpcap-MDEwOlJlcG9zaXRvcnk5NDM1ODg3-flat-pcap.c,1216,1223,7,1216,1223,7
332,https://htmlpreview.github.io/?https://github.com/Christina96/boilerplate-sample-matches/blob/main/C/Adafruit_nRF52_Arduino-MDEwOlJlcG9zaXRvcnk3NDM1NDcyOQ==-flat-nrf_twi.h-Adafruit_nRF52_Arduino-MDEwOlJlcG9zaXRvcnk3NDM1NDcyOQ==-flat-nrf_nvmc.h.html,16,Adafruit_nRF52_Arduino-MDEwOlJlcG9zaXRvcnk3NDM1NDcyOQ==-flat-nrf_twi.h,Adafruit_nRF52_Arduino-MDEwOlJlcG9zaXRvcnk3NDM1NDcyOQ==-flat-nrf_nvmc.h,26,31,5,30,35,5
333,https://htmlpreview.github.io/?https://github.com/Christina96/boilerplate-sample-matches/blob/main/C/libpcap-MDEwOlJlcG9zaXRvcnk5NDM1ODg3-flat-sf-pcap.c-libpcap-MDEwOlJlcG9zaXRvcnk5NDM1ODg3-flat-sf-pcap.c.html,20,libpcap-MDEwOlJlcG9zaXRvcnk5NDM1ODg3-flat-sf-pcap.c,libpcap-MDEwOlJlcG9zaXRvcnk5NDM1ODg3-flat-sf-pcap.c,457,461,4,457,461,4
334,https://htmlpreview.github.io/?https://github.com/Christina96/boilerplate-sample-matches/blob/main/C/redis-MDEwOlJlcG9zaXRvcnkxMDgxMTA3MDY=-flat-cluster.c-redis-MDEwOlJlcG9zaXRvcnkxMDgxMTA3MDY=-flat-cluster.c.html,40,redis-MDEwOlJlcG9zaXRvcnkxMDgxMTA3MDY=-flat-cluster.c,redis-MDEwOlJlcG9zaXRvcnkxMDgxMTA3MDY=-flat-cluster.c,499,504,5,499,504,5
335,https://htmlpreview.github.io/?https://github.com/Christina96/boilerplate-sample-matches/blob/main/C/Adafruit_nRF52_Arduino-MDEwOlJlcG9zaXRvcnk3NDM1NDcyOQ==-flat-nrf_gpio.h-Adafruit_nRF52_Arduino-MDEwOlJlcG9zaXRvcnk3NDM1NDcyOQ==-flat-nrf_gpio.h.html,38,Adafruit_nRF52_Arduino-MDEwOlJlcG9zaXRvcnk3NDM1NDcyOQ==-flat-nrf_gpio.h,Adafruit_nRF52_Arduino-MDEwOlJlcG9zaXRvcnk3NDM1NDcyOQ==-flat-nrf_gpio.h,272,278,6,272,278,6
336,https://htmlpreview.github.io/?https://github.com/Christina96/boilerplate-sample-matches/blob/main/C/redis-MDEwOlJlcG9zaXRvcnkxMDgxMTA3MDY=-flat-lstrlib.c-redis-MDEwOlJlcG9zaXRvcnkxMDgxMTA3MDY=-flat-lstrlib.c.html,23,redis-MDEwOlJlcG9zaXRvcnkxMDgxMTA3MDY=-flat-lstrlib.c,redis-MDEwOlJlcG9zaXRvcnkxMDgxMTA3MDY=-flat-lstrlib.c,490,492,2,490,492,2
337,https://htmlpreview.github.io/?https://github.com/Christina96/boilerplate-sample-matches/blob/main/C/Adafruit_nRF52_Arduino-MDEwOlJlcG9zaXRvcnk3NDM1NDcyOQ==-flat-lfs.c-Adafruit_nRF52_Arduino-MDEwOlJlcG9zaXRvcnk3NDM1NDcyOQ==-flat-lfs.c.html,51,Adafruit_nRF52_Arduino-MDEwOlJlcG9zaXRvcnk3NDM1NDcyOQ==-flat-lfs.c,Adafruit_nRF52_Arduino-MDEwOlJlcG9zaXRvcnk3NDM1NDcyOQ==-flat-lfs.c,1217,1227,10,1259,1269,10
338,https://htmlpreview.github.io/?https://github.com/Christina96/boilerplate-sample-matches/blob/main/C/libfuse-MDEwOlJlcG9zaXRvcnk0ODI5NjE3Nw==-flat-test_syscalls.c-libfuse-MDEwOlJlcG9zaXRvcnk0ODI5NjE3Nw==-flat-passthrough_fh.c.html,16,libfuse-MDEwOlJlcG9zaXRvcnk0ODI5NjE3Nw==-flat-test_syscalls.c,libfuse-MDEwOlJlcG9zaXRvcnk0ODI5NjE3Nw==-flat-passthrough_fh.c,469,471,2,321,323,2
339,https://htmlpreview.github.io/?https://github.com/Christina96/boilerplate-sample-matches/blob/main/C/xmrig-MDEwOlJlcG9zaXRvcnk4ODMyNzQwNg==-flat-sph_blake.c-xmrig-MDEwOlJlcG9zaXRvcnk4ODMyNzQwNg==-flat-sph_blake.c.html,215,xmrig-MDEwOlJlcG9zaXRvcnk4ODMyNzQwNg==-flat-sph_blake.c,xmrig-MDEwOlJlcG9zaXRvcnk4ODMyNzQwNg==-flat-sph_blake.c,634,659,25,634,659,25
340,https://htmlpreview.github.io/?https://github.com/Christina96/boilerplate-sample-matches/blob/main/C/redis-MDEwOlJlcG9zaXRvcnkxMDgxMTA3MDY=-flat-qr.c-redis-MDEwOlJlcG9zaXRvcnkxMDgxMTA3MDY=-flat-qr.c.html,29,redis-MDEwOlJlcG9zaXRvcnkxMDgxMTA3MDY=-flat-qr.c,redis-MDEwOlJlcG9zaXRvcnkxMDgxMTA3MDY=-flat-qr.c,34,41,7,25,32,7
341,https://htmlpreview.github.io/?https://github.com/Christina96/boilerplate-sample-matches/blob/main/C/libtomcrypt-MDEwOlJlcG9zaXRvcnk3NzcwMTE=-flat-tweetnacl.c-libtomcrypt-MDEwOlJlcG9zaXRvcnk3NzcwMTE=-flat-tweetnacl.c.html,21,libtomcrypt-MDEwOlJlcG9zaXRvcnk3NzcwMTE=-flat-tweetnacl.c,libtomcrypt-MDEwOlJlcG9zaXRvcnk3NzcwMTE=-flat-tweetnacl.c,240,243,3,300,303,3
342,https://htmlpreview.github.io/?https://github.com/Christina96/boilerplate-sample-matches/blob/main/C/fftw3-MDEwOlJlcG9zaXRvcnk4ODQzMzg4-flat-threads.c-fftw3-MDEwOlJlcG9zaXRvcnk4ODQzMzg4-flat-threads.c.html,27,fftw3-MDEwOlJlcG9zaXRvcnk4ODQzMzg4-flat-threads.c,fftw3-MDEwOlJlcG9zaXRvcnk4ODQzMzg4-flat-threads.c,123,129,6,106,112,6
343,https://htmlpreview.github.io/?https://github.com/Christina96/boilerplate-sample-matches/blob/main/C/libtomcrypt-MDEwOlJlcG9zaXRvcnk3NzcwMTE=-flat-openssl-enc.c-libtomcrypt-MDEwOlJlcG9zaXRvcnk3NzcwMTE=-flat-openssl-enc.c.html,15,libtomcrypt-MDEwOlJlcG9zaXRvcnk3NzcwMTE=-flat-openssl-enc.c,libtomcrypt-MDEwOlJlcG9zaXRvcnk3NzcwMTE=-flat-openssl-enc.c,101,103,2,101,103,2
344,https://htmlpreview.github.io/?https://github.com/Christina96/boilerplate-sample-matches/blob/main/C/xmrig-MDEwOlJlcG9zaXRvcnk4ODMyNzQwNg==-flat-HttpsClient.h-xmrig-MDEwOlJlcG9zaXRvcnk4ODMyNzQwNg==-flat-HttpsClient.h.html,15,xmrig-MDEwOlJlcG9zaXRvcnk4ODMyNzQwNg==-flat-HttpsClient.h,xmrig-MDEwOlJlcG9zaXRvcnk4ODMyNzQwNg==-flat-HttpsClient.h,22,23,1,22,23,1
345,https://htmlpreview.github.io/?https://github.com/Christina96/boilerplate-sample-matches/blob/main/C/fftw3-MDEwOlJlcG9zaXRvcnk4ODQzMzg4-flat-hook.c-fftw3-MDEwOlJlcG9zaXRvcnk4ODQzMzg4-flat-hook.c.html,15,fftw3-MDEwOlJlcG9zaXRvcnk4ODQzMzg4-flat-hook.c,fftw3-MDEwOlJlcG9zaXRvcnk4ODQzMzg4-flat-hook.c,177,183,6,177,183,6
346,https://htmlpreview.github.io/?https://github.com/Christina96/boilerplate-sample-matches/blob/main/C/xmrig-MDEwOlJlcG9zaXRvcnk4ODMyNzQwNg==-flat-CryptoNight_arm.h-xmrig-MDEwOlJlcG9zaXRvcnk4ODMyNzQwNg==-flat-CryptoNight_x86.h.html,81,xmrig-MDEwOlJlcG9zaXRvcnk4ODMyNzQwNg==-flat-CryptoNight_arm.h,xmrig-MDEwOlJlcG9zaXRvcnk4ODMyNzQwNg==-flat-CryptoNight_x86.h,97,108,11,186,197,11
347,https://htmlpreview.github.io/?https://github.com/Christina96/boilerplate-sample-matches/blob/main/C/PINRemoteImage-MDEwOlJlcG9zaXRvcnkzOTUzNzEwMw==-flat-mux_types_25.h-PINRemoteImage-MDEwOlJlcG9zaXRvcnkzOTUzNzEwMw==-flat-mux_types_31.h.html,196,PINRemoteImage-MDEwOlJlcG9zaXRvcnkzOTUzNzEwMw==-flat-mux_types_25.h,PINRemoteImage-MDEwOlJlcG9zaXRvcnkzOTUzNzEwMw==-flat-mux_types_31.h,23,54,31,23,54,31
348,https://htmlpreview.github.io/?https://github.com/Christina96/boilerplate-sample-matches/blob/main/C/redis-MDEwOlJlcG9zaXRvcnkxMDgxMTA3MDY=-flat-tsd_win.h-redis-MDEwOlJlcG9zaXRvcnkxMDgxMTA3MDY=-flat-tsd_win.h.html,18,redis-MDEwOlJlcG9zaXRvcnkxMDgxMTA3MDY=-flat-tsd_win.h,redis-MDEwOlJlcG9zaXRvcnkxMDgxMTA3MDY=-flat-tsd_win.h,40,42,2,40,42,2
349,https://htmlpreview.github.io/?https://github.com/Christina96/boilerplate-sample-matches/blob/main/C/redis-MDEwOlJlcG9zaXRvcnkxMDgxMTA3MDY=-flat-smallocx.c-redis-MDEwOlJlcG9zaXRvcnkxMDgxMTA3MDY=-flat-smallocx.c.html,21,redis-MDEwOlJlcG9zaXRvcnkxMDgxMTA3MDY=-flat-smallocx.c,redis-MDEwOlJlcG9zaXRvcnkxMDgxMTA3MDY=-flat-smallocx.c,212,214,2,212,214,2
350,https://htmlpreview.github.io/?https://github.com/Christina96/boilerplate-sample-matches/blob/main/C/fftw3-MDEwOlJlcG9zaXRvcnk4ODQzMzg4-flat-dftw-generic.c-fftw3-MDEwOlJlcG9zaXRvcnk4ODQzMzg4-flat-dftw-directsq.c.html,25,fftw3-MDEwOlJlcG9zaXRvcnk4ODQzMzg4-flat-dftw-generic.c,fftw3-MDEwOlJlcG9zaXRvcnk4ODQzMzg4-flat-dftw-directsq.c,87,90,3,62,65,3
351,https://htmlpreview.github.io/?https://github.com/Christina96/boilerplate-sample-matches/blob/main/C/xmrig-MDEwOlJlcG9zaXRvcnk4ODMyNzQwNg==-flat-sse2neon.h-xmrig-MDEwOlJlcG9zaXRvcnk4ODMyNzQwNg==-flat-sse2neon.h.html,50,xmrig-MDEwOlJlcG9zaXRvcnk4ODMyNzQwNg==-flat-sse2neon.h,xmrig-MDEwOlJlcG9zaXRvcnk4ODMyNzQwNg==-flat-sse2neon.h,1300,1305,5,1300,1305,5
352,https://htmlpreview.github.io/?https://github.com/Christina96/boilerplate-sample-matches/blob/main/C/redis-MDEwOlJlcG9zaXRvcnkxMDgxMTA3MDY=-flat-ctl.c-redis-MDEwOlJlcG9zaXRvcnkxMDgxMTA3MDY=-flat-ctl.c.html,16,redis-MDEwOlJlcG9zaXRvcnkxMDgxMTA3MDY=-flat-ctl.c,redis-MDEwOlJlcG9zaXRvcnkxMDgxMTA3MDY=-flat-ctl.c,2730,2731,1,2730,2731,1
353,https://htmlpreview.github.io/?https://github.com/Christina96/boilerplate-sample-matches/blob/main/C/redis-MDEwOlJlcG9zaXRvcnkxMDgxMTA3MDY=-flat-tcache.c-redis-MDEwOlJlcG9zaXRvcnkxMDgxMTA3MDY=-flat-tcache.c.html,15,redis-MDEwOlJlcG9zaXRvcnkxMDgxMTA3MDY=-flat-tcache.c,redis-MDEwOlJlcG9zaXRvcnkxMDgxMTA3MDY=-flat-tcache.c,281,286,5,281,286,5
354,https://htmlpreview.github.io/?https://github.com/Christina96/boilerplate-sample-matches/blob/main/C/PINRemoteImage-MDEwOlJlcG9zaXRvcnkzOTUzNzEwMw==-flat-picture_tools_enc.c-PINRemoteImage-MDEwOlJlcG9zaXRvcnkzOTUzNzEwMw==-flat-picture_tools_enc.c.html,17,PINRemoteImage-MDEwOlJlcG9zaXRvcnkzOTUzNzEwMw==-flat-picture_tools_enc.c,PINRemoteImage-MDEwOlJlcG9zaXRvcnkzOTUzNzEwMw==-flat-picture_tools_enc.c,184,185,1,184,185,1
355,https://htmlpreview.github.io/?https://github.com/Christina96/boilerplate-sample-matches/blob/main/C/libtomcrypt-MDEwOlJlcG9zaXRvcnk3NzcwMTE=-flat-gcm_process.c-libtomcrypt-MDEwOlJlcG9zaXRvcnk3NzcwMTE=-flat-gcm_process.c.html,82,libtomcrypt-MDEwOlJlcG9zaXRvcnk3NzcwMTE=-flat-gcm_process.c,libtomcrypt-MDEwOlJlcG9zaXRvcnk3NzcwMTE=-flat-gcm_process.c,54,62,8,54,62,8
356,https://htmlpreview.github.io/?https://github.com/Christina96/boilerplate-sample-matches/blob/main/C/redis-MDEwOlJlcG9zaXRvcnkxMDgxMTA3MDY=-flat-defrag.c-redis-MDEwOlJlcG9zaXRvcnkxMDgxMTA3MDY=-flat-defrag.c.html,44,redis-MDEwOlJlcG9zaXRvcnkxMDgxMTA3MDY=-flat-defrag.c,redis-MDEwOlJlcG9zaXRvcnkxMDgxMTA3MDY=-flat-defrag.c,437,443,6,422,428,6
357,https://htmlpreview.github.io/?https://github.com/Christina96/boilerplate-sample-matches/blob/main/C/Adafruit_nRF52_Arduino-MDEwOlJlcG9zaXRvcnk3NDM1NDcyOQ==-flat-bignum.c-Adafruit_nRF52_Arduino-MDEwOlJlcG9zaXRvcnk3NDM1NDcyOQ==-flat-bignum.c.html,15,Adafruit_nRF52_Arduino-MDEwOlJlcG9zaXRvcnk3NDM1NDcyOQ==-flat-bignum.c,Adafruit_nRF52_Arduino-MDEwOlJlcG9zaXRvcnk3NDM1NDcyOQ==-flat-bignum.c,1455,1458,3,1455,1458,3
358,https://htmlpreview.github.io/?https://github.com/Christina96/boilerplate-sample-matches/blob/main/C/redis-MDEwOlJlcG9zaXRvcnkxMDgxMTA3MDY=-flat-geohash_helper_32.h-redis-MDEwOlJlcG9zaXRvcnkxMDgxMTA3MDY=-flat-geohash_helper.h.html,70,redis-MDEwOlJlcG9zaXRvcnkxMDgxMTA3MDY=-flat-geohash_helper_32.h,redis-MDEwOlJlcG9zaXRvcnkxMDgxMTA3MDY=-flat-geohash_helper.h,24,33,9,25,34,9
359,https://htmlpreview.github.io/?https://github.com/Christina96/boilerplate-sample-matches/blob/main/C/PINRemoteImage-MDEwOlJlcG9zaXRvcnkzOTUzNzEwMw==-flat-wicdec.c-PINRemoteImage-MDEwOlJlcG9zaXRvcnkzOTUzNzEwMw==-flat-wicdec.c.html,27,PINRemoteImage-MDEwOlJlcG9zaXRvcnkzOTUzNzEwMw==-flat-wicdec.c,PINRemoteImage-MDEwOlJlcG9zaXRvcnkzOTUzNzEwMw==-flat-wicdec.c,47,50,3,53,56,3
360,https://htmlpreview.github.io/?https://github.com/Christina96/boilerplate-sample-matches/blob/main/C/PINRemoteImage-MDEwOlJlcG9zaXRvcnkzOTUzNzEwMw==-flat-upsampling_msa.c-PINRemoteImage-MDEwOlJlcG9zaXRvcnkzOTUzNzEwMw==-flat-upsampling_msa.c.html,27,PINRemoteImage-MDEwOlJlcG9zaXRvcnkzOTUzNzEwMw==-flat-upsampling_msa.c,PINRemoteImage-MDEwOlJlcG9zaXRvcnkzOTUzNzEwMw==-flat-upsampling_msa.c,190,193,3,199,202,3
361,https://htmlpreview.github.io/?https://github.com/Christina96/boilerplate-sample-matches/blob/main/C/libtomcrypt-MDEwOlJlcG9zaXRvcnk3NzcwMTE=-flat-omac_init.c-libtomcrypt-MDEwOlJlcG9zaXRvcnk3NzcwMTE=-flat-f8_start.c.html,28,libtomcrypt-MDEwOlJlcG9zaXRvcnk3NzcwMTE=-flat-omac_init.c,libtomcrypt-MDEwOlJlcG9zaXRvcnk3NzcwMTE=-flat-f8_start.c,9,16,7,15,22,7
362,https://htmlpreview.github.io/?https://github.com/Christina96/boilerplate-sample-matches/blob/main/C/xmrig-MDEwOlJlcG9zaXRvcnk4ODMyNzQwNg==-flat-sph_fugue.c-xmrig-MDEwOlJlcG9zaXRvcnk4ODMyNzQwNg==-flat-sph_fugue.c.html,24,xmrig-MDEwOlJlcG9zaXRvcnk4ODMyNzQwNg==-flat-sph_fugue.c,xmrig-MDEwOlJlcG9zaXRvcnk4ODMyNzQwNg==-flat-sph_fugue.c,447,450,3,461,464,3
363,https://htmlpreview.github.io/?https://github.com/Christina96/boilerplate-sample-matches/blob/main/C/PINRemoteImage-MDEwOlJlcG9zaXRvcnkzOTUzNzEwMw==-flat-enc_sse2.c-PINRemoteImage-MDEwOlJlcG9zaXRvcnkzOTUzNzEwMw==-flat-dec_mips32.c.html,19,PINRemoteImage-MDEwOlJlcG9zaXRvcnkzOTUzNzEwMw==-flat-enc_sse2.c,PINRemoteImage-MDEwOlJlcG9zaXRvcnkzOTUzNzEwMw==-flat-dec_mips32.c,1016,1022,6,515,521,6
364,https://htmlpreview.github.io/?https://github.com/Christina96/boilerplate-sample-matches/blob/main/C/libtomcrypt-MDEwOlJlcG9zaXRvcnk3NzcwMTE=-flat-tv_gen.c-libpcap-MDEwOlJlcG9zaXRvcnk5NDM1ODg3-flat-fuzz_both.c.html,16,libtomcrypt-MDEwOlJlcG9zaXRvcnk3NzcwMTE=-flat-tv_gen.c,libpcap-MDEwOlJlcG9zaXRvcnk5NDM1ODg3-flat-fuzz_both.c,8,10,2,46,48,2
365,https://htmlpreview.github.io/?https://github.com/Christina96/boilerplate-sample-matches/blob/main/C/fftw3-MDEwOlJlcG9zaXRvcnk4ODQzMzg4-flat-mp.c-fftw3-MDEwOlJlcG9zaXRvcnk4ODQzMzg4-flat-mp.c.html,27,fftw3-MDEwOlJlcG9zaXRvcnk4ODQzMzg4-flat-mp.c,fftw3-MDEwOlJlcG9zaXRvcnk4ODQzMzg4-flat-mp.c,336,338,2,331,332,1
366,https://htmlpreview.github.io/?https://github.com/Christina96/boilerplate-sample-matches/blob/main/C/redis-MDEwOlJlcG9zaXRvcnkxMDgxMTA3MDY=-flat-redis-cli.c-redis-MDEwOlJlcG9zaXRvcnkxMDgxMTA3MDY=-flat-redis-cli.c.html,33,redis-MDEwOlJlcG9zaXRvcnkxMDgxMTA3MDY=-flat-redis-cli.c,redis-MDEwOlJlcG9zaXRvcnkxMDgxMTA3MDY=-flat-redis-cli.c,1302,1306,4,1302,1306,4
367,https://htmlpreview.github.io/?https://github.com/Christina96/boilerplate-sample-matches/blob/main/C/fftw3-MDEwOlJlcG9zaXRvcnk4ODQzMzg4-flat-rdft-dht.c-Adafruit_nRF52_Arduino-MDEwOlJlcG9zaXRvcnk3NDM1NDcyOQ==-flat-timers.c.html,15,fftw3-MDEwOlJlcG9zaXRvcnk4ODQzMzg4-flat-rdft-dht.c,Adafruit_nRF52_Arduino-MDEwOlJlcG9zaXRvcnk3NDM1NDcyOQ==-flat-timers.c,6,10,4,390,394,4
368,https://htmlpreview.github.io/?https://github.com/Christina96/boilerplate-sample-matches/blob/main/C/redis-MDEwOlJlcG9zaXRvcnkxMDgxMTA3MDY=-flat-stats_7.c-redis-MDEwOlJlcG9zaXRvcnkxMDgxMTA3MDY=-flat-stats_7.c.html,30,redis-MDEwOlJlcG9zaXRvcnkxMDgxMTA3MDY=-flat-stats_7.c,redis-MDEwOlJlcG9zaXRvcnkxMDgxMTA3MDY=-flat-stats_7.c,34,37,3,34,37,3
369,https://htmlpreview.github.io/?https://github.com/Christina96/boilerplate-sample-matches/blob/main/C/redis-MDEwOlJlcG9zaXRvcnkxMDgxMTA3MDY=-flat-hyperloglog.c-redis-MDEwOlJlcG9zaXRvcnkxMDgxMTA3MDY=-flat-hyperloglog.c.html,43,redis-MDEwOlJlcG9zaXRvcnkxMDgxMTA3MDY=-flat-hyperloglog.c,redis-MDEwOlJlcG9zaXRvcnkxMDgxMTA3MDY=-flat-hyperloglog.c,841,847,6,841,847,6
370,https://htmlpreview.github.io/?https://github.com/Christina96/boilerplate-sample-matches/blob/main/C/Adafruit_nRF52_Arduino-MDEwOlJlcG9zaXRvcnk3NDM1NDcyOQ==-flat-nrf_bitmask.h-Adafruit_nRF52_Arduino-MDEwOlJlcG9zaXRvcnk3NDM1NDcyOQ==-flat-nrf_bitmask.h.html,71,Adafruit_nRF52_Arduino-MDEwOlJlcG9zaXRvcnk3NDM1NDcyOQ==-flat-nrf_bitmask.h,Adafruit_nRF52_Arduino-MDEwOlJlcG9zaXRvcnk3NDM1NDcyOQ==-flat-nrf_bitmask.h,43,53,10,43,53,10
371,https://htmlpreview.github.io/?https://github.com/Christina96/boilerplate-sample-matches/blob/main/C/xmrig-MDEwOlJlcG9zaXRvcnk4ODMyNzQwNg==-flat-CudaLib.h-xmrig-MDEwOlJlcG9zaXRvcnk4ODMyNzQwNg==-flat-CudaLib.h.html,17,xmrig-MDEwOlJlcG9zaXRvcnk4ODMyNzQwNg==-flat-CudaLib.h,xmrig-MDEwOlJlcG9zaXRvcnk4ODMyNzQwNg==-flat-CudaLib.h,34,36,2,34,36,2
372,https://htmlpreview.github.io/?https://github.com/Christina96/boilerplate-sample-matches/blob/main/C/PINRemoteImage-MDEwOlJlcG9zaXRvcnkzOTUzNzEwMw==-flat-dec_neon.c-PINRemoteImage-MDEwOlJlcG9zaXRvcnkzOTUzNzEwMw==-flat-dec_neon.c.html,22,PINRemoteImage-MDEwOlJlcG9zaXRvcnkzOTUzNzEwMw==-flat-dec_neon.c,PINRemoteImage-MDEwOlJlcG9zaXRvcnkzOTUzNzEwMw==-flat-dec_neon.c,1112,1116,4,1112,1116,4
373,https://htmlpreview.github.io/?https://github.com/Christina96/boilerplate-sample-matches/blob/main/C/Adafruit_nRF52_Arduino-MDEwOlJlcG9zaXRvcnk3NDM1NDcyOQ==-flat-BLEClientHidAdafruit.h-Adafruit_nRF52_Arduino-MDEwOlJlcG9zaXRvcnk3NDM1NDcyOQ==-flat-BLEClientHidAdafruit.h.html,24,Adafruit_nRF52_Arduino-MDEwOlJlcG9zaXRvcnk3NDM1NDcyOQ==-flat-BLEClientHidAdafruit.h,Adafruit_nRF52_Arduino-MDEwOlJlcG9zaXRvcnk3NDM1NDcyOQ==-flat-BLEClientHidAdafruit.h,10,12,2,11,13,2
374,https://htmlpreview.github.io/?https://github.com/Christina96/boilerplate-sample-matches/blob/main/C/libtomcrypt-MDEwOlJlcG9zaXRvcnk3NzcwMTE=-flat-blake2s.c-libtomcrypt-MDEwOlJlcG9zaXRvcnk3NzcwMTE=-flat-blake2s.c.html,35,libtomcrypt-MDEwOlJlcG9zaXRvcnk3NzcwMTE=-flat-blake2s.c,libtomcrypt-MDEwOlJlcG9zaXRvcnk3NzcwMTE=-flat-blake2s.c,107,110,3,107,110,3
375,https://htmlpreview.github.io/?https://github.com/Christina96/boilerplate-sample-matches/blob/main/C/xmrig-MDEwOlJlcG9zaXRvcnk4ODMyNzQwNg==-flat-sph_simd.c-xmrig-MDEwOlJlcG9zaXRvcnk4ODMyNzQwNg==-flat-sph_simd.c.html,325,xmrig-MDEwOlJlcG9zaXRvcnk4ODMyNzQwNg==-flat-sph_simd.c,xmrig-MDEwOlJlcG9zaXRvcnk4ODMyNzQwNg==-flat-sph_simd.c,1168,1208,40,827,867,40
376,https://htmlpreview.github.io/?https://github.com/Christina96/boilerplate-sample-matches/blob/main/C/xmrig-MDEwOlJlcG9zaXRvcnk4ODMyNzQwNg==-flat-c_blake256.c-xmrig-MDEwOlJlcG9zaXRvcnk4ODMyNzQwNg==-flat-c_blake256.c.html,26,xmrig-MDEwOlJlcG9zaXRvcnk4ODMyNzQwNg==-flat-c_blake256.c,xmrig-MDEwOlJlcG9zaXRvcnk4ODMyNzQwNg==-flat-c_blake256.c,143,145,2,143,145,2
377,https://htmlpreview.github.io/?https://github.com/Christina96/boilerplate-sample-matches/blob/main/C/xmrig-MDEwOlJlcG9zaXRvcnk4ODMyNzQwNg==-flat-CryptoNight_monero.h-xmrig-MDEwOlJlcG9zaXRvcnk4ODMyNzQwNg==-flat-CryptoNight_monero.h.html,44,xmrig-MDEwOlJlcG9zaXRvcnk4ODMyNzQwNg==-flat-CryptoNight_monero.h,xmrig-MDEwOlJlcG9zaXRvcnk4ODMyNzQwNg==-flat-CryptoNight_monero.h,147,149,2,147,149,2
378,https://htmlpreview.github.io/?https://github.com/Christina96/boilerplate-sample-matches/blob/main/C/fftw3-MDEwOlJlcG9zaXRvcnk4ODQzMzg4-flat-simd-avx-128-fma.h-fftw3-MDEwOlJlcG9zaXRvcnk4ODQzMzg4-flat-simd-avx-128-fma.h.html,20,fftw3-MDEwOlJlcG9zaXRvcnk4ODQzMzg4-flat-simd-avx-128-fma.h,fftw3-MDEwOlJlcG9zaXRvcnk4ODQzMzg4-flat-simd-avx-128-fma.h,69,71,2,69,71,2
379,https://htmlpreview.github.io/?https://github.com/Christina96/boilerplate-sample-matches/blob/main/C/xmrig-MDEwOlJlcG9zaXRvcnk4ODMyNzQwNg==-flat-sph_echo.c-xmrig-MDEwOlJlcG9zaXRvcnk4ODMyNzQwNg==-flat-sph_echo.c.html,346,xmrig-MDEwOlJlcG9zaXRvcnk4ODMyNzQwNg==-flat-sph_echo.c,xmrig-MDEwOlJlcG9zaXRvcnk4ODMyNzQwNg==-flat-sph_echo.c,180,207,27,180,207,27
380,https://htmlpreview.github.io/?https://github.com/Christina96/boilerplate-sample-matches/blob/main/C/xmrig-MDEwOlJlcG9zaXRvcnk4ODMyNzQwNg==-flat-topology-synthetic.c-xmrig-MDEwOlJlcG9zaXRvcnk4ODMyNzQwNg==-flat-cpukinds.c.html,20,xmrig-MDEwOlJlcG9zaXRvcnk4ODMyNzQwNg==-flat-topology-synthetic.c,xmrig-MDEwOlJlcG9zaXRvcnk4ODMyNzQwNg==-flat-cpukinds.c,953,955,2,125,126,1
381,https://htmlpreview.github.io/?https://github.com/Christina96/boilerplate-sample-matches/blob/main/C/libtomcrypt-MDEwOlJlcG9zaXRvcnk3NzcwMTE=-flat-skipjack.c-libtomcrypt-MDEwOlJlcG9zaXRvcnk3NzcwMTE=-flat-skipjack.c.html,17,libtomcrypt-MDEwOlJlcG9zaXRvcnk3NzcwMTE=-flat-skipjack.c,libtomcrypt-MDEwOlJlcG9zaXRvcnk3NzcwMTE=-flat-skipjack.c,112,117,5,112,117,5
382,https://htmlpreview.github.io/?https://github.com/Christina96/boilerplate-sample-matches/blob/main/C/redis-MDEwOlJlcG9zaXRvcnkxMDgxMTA3MDY=-flat-sds_35.c-redis-MDEwOlJlcG9zaXRvcnkxMDgxMTA3MDY=-flat-sds.c.html,1419,redis-MDEwOlJlcG9zaXRvcnkxMDgxMTA3MDY=-flat-sds_35.c,redis-MDEwOlJlcG9zaXRvcnkxMDgxMTA3MDY=-flat-sds.c,689,871,182,671,853,182
383,https://htmlpreview.github.io/?https://github.com/Christina96/boilerplate-sample-matches/blob/main/C/xmrig-MDEwOlJlcG9zaXRvcnk4ODMyNzQwNg==-flat-sph_jh.c-xmrig-MDEwOlJlcG9zaXRvcnk4ODMyNzQwNg==-flat-sph_jh.c.html,17,xmrig-MDEwOlJlcG9zaXRvcnk4ODMyNzQwNg==-flat-sph_jh.c,xmrig-MDEwOlJlcG9zaXRvcnk4ODMyNzQwNg==-flat-sph_jh.c,430,432,2,430,432,2
