ID,Link,Tokens,File 1,File 2,Start 1,End 1,Detected Lines 1,Start 2,End 2,Detected Lines 2
0,https://htmlpreview.github.io/?https://github.com/Christina96/boilerplate-sample-matches/blob/main/C/xmrig-MDEwOlJlcG9zaXRvcnk4ODMyNzQwNg==-flat-cl_egl.h-xmrig-MDEwOlJlcG9zaXRvcnk4ODMyNzQwNg==-flat-cl_va_api_media_sharing_intel.h.html,29,xmrig-MDEwOlJlcG9zaXRvcnk4ODMyNzQwNg==-flat-cl_egl.h,xmrig-MDEwOlJlcG9zaXRvcnk4ODMyNzQwNg==-flat-cl_va_api_media_sharing_intel.h,49,55,6,74,80,6
1,https://htmlpreview.github.io/?https://github.com/Christina96/boilerplate-sample-matches/blob/main/C/redis-MDEwOlJlcG9zaXRvcnkxMDgxMTA3MDY=-flat-lstrlib.c-redis-MDEwOlJlcG9zaXRvcnkxMDgxMTA3MDY=-flat-lstrlib.c.html,19,redis-MDEwOlJlcG9zaXRvcnkxMDgxMTA3MDY=-flat-lstrlib.c,redis-MDEwOlJlcG9zaXRvcnkxMDgxMTA3MDY=-flat-lstrlib.c,426,427,1,546,547,1
2,https://htmlpreview.github.io/?https://github.com/Christina96/boilerplate-sample-matches/blob/main/C/libpcap-MDEwOlJlcG9zaXRvcnk5NDM1ODg3-flat-sf-pcapng.c-libpcap-MDEwOlJlcG9zaXRvcnk5NDM1ODg3-flat-sf-pcapng.c.html,18,libpcap-MDEwOlJlcG9zaXRvcnk5NDM1ODg3-flat-sf-pcapng.c,libpcap-MDEwOlJlcG9zaXRvcnk5NDM1ODg3-flat-sf-pcapng.c,22,25,3,45,48,3
3,https://htmlpreview.github.io/?https://github.com/Christina96/boilerplate-sample-matches/blob/main/C/PINRemoteImage-MDEwOlJlcG9zaXRvcnkzOTUzNzEwMw==-flat-lossless_enc.c-PINRemoteImage-MDEwOlJlcG9zaXRvcnkzOTUzNzEwMw==-flat-lossless_enc.c.html,25,PINRemoteImage-MDEwOlJlcG9zaXRvcnkzOTUzNzEwMw==-flat-lossless_enc.c,PINRemoteImage-MDEwOlJlcG9zaXRvcnkzOTUzNzEwMw==-flat-lossless_enc.c,315,320,5,333,338,5
4,https://htmlpreview.github.io/?https://github.com/Christina96/boilerplate-sample-matches/blob/main/C/xmrig-MDEwOlJlcG9zaXRvcnk4ODMyNzQwNg==-flat-topology-xml.c-xmrig-MDEwOlJlcG9zaXRvcnk4ODMyNzQwNg==-flat-topology-xml.c.html,15,xmrig-MDEwOlJlcG9zaXRvcnk4ODMyNzQwNg==-flat-topology-xml.c,xmrig-MDEwOlJlcG9zaXRvcnk4ODMyNzQwNg==-flat-topology-xml.c,1175,1178,3,1234,1237,3
5,https://htmlpreview.github.io/?https://github.com/Christina96/boilerplate-sample-matches/blob/main/C/android-gpuimage-plus-MDEwOlJlcG9zaXRvcnk0NjU0NzQxNw==-flat-cgeThread.h-android-gpuimage-plus-MDEwOlJlcG9zaXRvcnk0NjU0NzQxNw==-flat-cgeThread.h.html,17,android-gpuimage-plus-MDEwOlJlcG9zaXRvcnk0NjU0NzQxNw==-flat-cgeThread.h,android-gpuimage-plus-MDEwOlJlcG9zaXRvcnk0NjU0NzQxNw==-flat-cgeThread.h,64,69,5,68,74,6
6,https://htmlpreview.github.io/?https://github.com/Christina96/boilerplate-sample-matches/blob/main/C/xmrig-MDEwOlJlcG9zaXRvcnk4ODMyNzQwNg==-flat-c_blake256.c-xmrig-MDEwOlJlcG9zaXRvcnk4ODMyNzQwNg==-flat-c_blake256.c.html,93,xmrig-MDEwOlJlcG9zaXRvcnk4ODMyNzQwNg==-flat-c_blake256.c,xmrig-MDEwOlJlcG9zaXRvcnk4ODMyNzQwNg==-flat-c_blake256.c,198,209,11,222,233,11
7,https://htmlpreview.github.io/?https://github.com/Christina96/boilerplate-sample-matches/blob/main/C/redis-MDEwOlJlcG9zaXRvcnkxMDgxMTA3MDY=-flat-object.c-redis-MDEwOlJlcG9zaXRvcnkxMDgxMTA3MDY=-flat-object.c.html,26,redis-MDEwOlJlcG9zaXRvcnkxMDgxMTA3MDY=-flat-object.c,redis-MDEwOlJlcG9zaXRvcnkxMDgxMTA3MDY=-flat-object.c,17,21,4,39,43,4
8,https://htmlpreview.github.io/?https://github.com/Christina96/boilerplate-sample-matches/blob/main/C/xmrig-MDEwOlJlcG9zaXRvcnk4ODMyNzQwNg==-flat-sph_shavite.c-xmrig-MDEwOlJlcG9zaXRvcnk4ODMyNzQwNg==-flat-sph_echo.c.html,21,xmrig-MDEwOlJlcG9zaXRvcnk4ODMyNzQwNg==-flat-sph_shavite.c,xmrig-MDEwOlJlcG9zaXRvcnk4ODMyNzQwNg==-flat-sph_echo.c,1429,1436,7,668,674,6
9,https://htmlpreview.github.io/?https://github.com/Christina96/boilerplate-sample-matches/blob/main/C/fftw3-MDEwOlJlcG9zaXRvcnk4ODQzMzg4-flat-direct-r2r.c-fftw3-MDEwOlJlcG9zaXRvcnk4ODQzMzg4-flat-direct.c.html,22,fftw3-MDEwOlJlcG9zaXRvcnk4ODQzMzg4-flat-direct-r2r.c,fftw3-MDEwOlJlcG9zaXRvcnk4ODQzMzg4-flat-direct.c,49,54,5,148,153,5
10,https://htmlpreview.github.io/?https://github.com/Christina96/boilerplate-sample-matches/blob/main/C/xmrig-MDEwOlJlcG9zaXRvcnk4ODMyNzQwNg==-flat-memattrs.c-xmrig-MDEwOlJlcG9zaXRvcnk4ODMyNzQwNg==-flat-components.c.html,16,xmrig-MDEwOlJlcG9zaXRvcnk4ODMyNzQwNg==-flat-memattrs.c,xmrig-MDEwOlJlcG9zaXRvcnk4ODMyNzQwNg==-flat-components.c,16,21,5,422,427,5
11,https://htmlpreview.github.io/?https://github.com/Christina96/boilerplate-sample-matches/blob/main/C/libpcap-MDEwOlJlcG9zaXRvcnk5NDM1ODg3-flat-pcap-tc.c-Adafruit_nRF52_Arduino-MDEwOlJlcG9zaXRvcnk3NDM1NDcyOQ==-flat-tasks.c.html,16,libpcap-MDEwOlJlcG9zaXRvcnk5NDM1ODg3-flat-pcap-tc.c,Adafruit_nRF52_Arduino-MDEwOlJlcG9zaXRvcnk3NDM1NDcyOQ==-flat-tasks.c,339,342,3,2256,2259,3
12,https://htmlpreview.github.io/?https://github.com/Christina96/boilerplate-sample-matches/blob/main/C/PINRemoteImage-MDEwOlJlcG9zaXRvcnkzOTUzNzEwMw==-flat-libwebp_java_wrap.c-PINRemoteImage-MDEwOlJlcG9zaXRvcnkzOTUzNzEwMw==-flat-libwebp_java_wrap.c.html,21,PINRemoteImage-MDEwOlJlcG9zaXRvcnkzOTUzNzEwMw==-flat-libwebp_java_wrap.c,PINRemoteImage-MDEwOlJlcG9zaXRvcnkzOTUzNzEwMw==-flat-libwebp_java_wrap.c,1219,1222,3,1175,1178,3
13,https://htmlpreview.github.io/?https://github.com/Christina96/boilerplate-sample-matches/blob/main/C/fftw3-MDEwOlJlcG9zaXRvcnk4ODQzMzg4-flat-transpose-alltoall.c-fftw3-MDEwOlJlcG9zaXRvcnk4ODQzMzg4-flat-transpose-pairwise.c.html,16,fftw3-MDEwOlJlcG9zaXRvcnk4ODQzMzg4-flat-transpose-alltoall.c,fftw3-MDEwOlJlcG9zaXRvcnk4ODQzMzg4-flat-transpose-pairwise.c,11,13,2,8,10,2
14,https://htmlpreview.github.io/?https://github.com/Christina96/boilerplate-sample-matches/blob/main/C/Adafruit_nRF52_Arduino-MDEwOlJlcG9zaXRvcnk3NDM1NDcyOQ==-flat-queue.c-Adafruit_nRF52_Arduino-MDEwOlJlcG9zaXRvcnk3NDM1NDcyOQ==-flat-queue.c.html,20,Adafruit_nRF52_Arduino-MDEwOlJlcG9zaXRvcnk3NDM1NDcyOQ==-flat-queue.c,Adafruit_nRF52_Arduino-MDEwOlJlcG9zaXRvcnk3NDM1NDcyOQ==-flat-queue.c,1518,1521,3,1619,1622,3
15,https://htmlpreview.github.io/?https://github.com/Christina96/boilerplate-sample-matches/blob/main/C/Adafruit_nRF52_Arduino-MDEwOlJlcG9zaXRvcnk3NDM1NDcyOQ==-flat-tweetnacl.c-Adafruit_nRF52_Arduino-MDEwOlJlcG9zaXRvcnk3NDM1NDcyOQ==-flat-tweetnacl.c.html,17,Adafruit_nRF52_Arduino-MDEwOlJlcG9zaXRvcnk3NDM1NDcyOQ==-flat-tweetnacl.c,Adafruit_nRF52_Arduino-MDEwOlJlcG9zaXRvcnk3NDM1NDcyOQ==-flat-tweetnacl.c,198,200,2,274,276,2
16,https://htmlpreview.github.io/?https://github.com/Christina96/boilerplate-sample-matches/blob/main/C/small-MDEwOlJlcG9zaXRvcnkyNTY3NjMxNjk=-flat-server.c-small-MDEwOlJlcG9zaXRvcnkyNTY3NjMxNjk=-flat-server.c.html,162,small-MDEwOlJlcG9zaXRvcnkyNTY3NjMxNjk=-flat-server.c,small-MDEwOlJlcG9zaXRvcnkyNTY3NjMxNjk=-flat-server.c,708,727,19,776,796,20
17,https://htmlpreview.github.io/?https://github.com/Christina96/boilerplate-sample-matches/blob/main/C/redis-MDEwOlJlcG9zaXRvcnkxMDgxMTA3MDY=-flat-async.c-redis-MDEwOlJlcG9zaXRvcnkxMDgxMTA3MDY=-flat-sentinel.c.html,18,redis-MDEwOlJlcG9zaXRvcnkxMDgxMTA3MDY=-flat-async.c,redis-MDEwOlJlcG9zaXRvcnkxMDgxMTA3MDY=-flat-sentinel.c,172,178,6,842,848,6
18,https://htmlpreview.github.io/?https://github.com/Christina96/boilerplate-sample-matches/blob/main/C/libpcap-MDEwOlJlcG9zaXRvcnk5NDM1ODg3-flat-daemon.c-libpcap-MDEwOlJlcG9zaXRvcnk5NDM1ODg3-flat-daemon.c.html,20,libpcap-MDEwOlJlcG9zaXRvcnk5NDM1ODg3-flat-daemon.c,libpcap-MDEwOlJlcG9zaXRvcnk5NDM1ODg3-flat-daemon.c,1195,1197,2,1196,1198,2
19,https://htmlpreview.github.io/?https://github.com/Christina96/boilerplate-sample-matches/blob/main/C/xmrig-MDEwOlJlcG9zaXRvcnk4ODMyNzQwNg==-flat-sph_simd.c-xmrig-MDEwOlJlcG9zaXRvcnk4ODMyNzQwNg==-flat-sph_simd.c.html,17,xmrig-MDEwOlJlcG9zaXRvcnk4ODMyNzQwNg==-flat-sph_simd.c,xmrig-MDEwOlJlcG9zaXRvcnk4ODMyNzQwNg==-flat-sph_simd.c,83,84,1,84,85,1
20,https://htmlpreview.github.io/?https://github.com/Christina96/boilerplate-sample-matches/blob/main/C/redis-MDEwOlJlcG9zaXRvcnkxMDgxMTA3MDY=-flat-rb.h-redis-MDEwOlJlcG9zaXRvcnkxMDgxMTA3MDY=-flat-rb.h.html,25,redis-MDEwOlJlcG9zaXRvcnkxMDgxMTA3MDY=-flat-rb.h,redis-MDEwOlJlcG9zaXRvcnkxMDgxMTA3MDY=-flat-rb.h,411,414,3,584,587,3
21,https://htmlpreview.github.io/?https://github.com/Christina96/boilerplate-sample-matches/blob/main/C/redis-MDEwOlJlcG9zaXRvcnkxMDgxMTA3MDY=-flat-hyperloglog.c-redis-MDEwOlJlcG9zaXRvcnkxMDgxMTA3MDY=-flat-sds_35.c.html,18,redis-MDEwOlJlcG9zaXRvcnkxMDgxMTA3MDY=-flat-hyperloglog.c,redis-MDEwOlJlcG9zaXRvcnkxMDgxMTA3MDY=-flat-sds_35.c,505,506,1,410,411,1
22,https://htmlpreview.github.io/?https://github.com/Christina96/boilerplate-sample-matches/blob/main/C/xmrig-MDEwOlJlcG9zaXRvcnk4ODMyNzQwNg==-flat-format.h-xmrig-MDEwOlJlcG9zaXRvcnk4ODMyNzQwNg==-flat-format.h.html,35,xmrig-MDEwOlJlcG9zaXRvcnk4ODMyNzQwNg==-flat-format.h,xmrig-MDEwOlJlcG9zaXRvcnk4ODMyNzQwNg==-flat-format.h,146,151,5,167,172,5
23,https://htmlpreview.github.io/?https://github.com/Christina96/boilerplate-sample-matches/blob/main/C/xmrig-MDEwOlJlcG9zaXRvcnk4ODMyNzQwNg==-flat-sse2neon.h-xmrig-MDEwOlJlcG9zaXRvcnk4ODMyNzQwNg==-flat-sse2neon.h.html,17,xmrig-MDEwOlJlcG9zaXRvcnk4ODMyNzQwNg==-flat-sse2neon.h,xmrig-MDEwOlJlcG9zaXRvcnk4ODMyNzQwNg==-flat-sse2neon.h,1495,1497,2,1486,1488,2
24,https://htmlpreview.github.io/?https://github.com/Christina96/boilerplate-sample-matches/blob/main/C/xmrig-MDEwOlJlcG9zaXRvcnk4ODMyNzQwNg==-flat-topology.c-xmrig-MDEwOlJlcG9zaXRvcnk4ODMyNzQwNg==-flat-topology.c.html,39,xmrig-MDEwOlJlcG9zaXRvcnk4ODMyNzQwNg==-flat-topology.c,xmrig-MDEwOlJlcG9zaXRvcnk4ODMyNzQwNg==-flat-topology.c,1885,1888,3,1888,1891,3
25,https://htmlpreview.github.io/?https://github.com/Christina96/boilerplate-sample-matches/blob/main/C/xmrig-MDEwOlJlcG9zaXRvcnk4ODMyNzQwNg==-flat-adl_structures.h-xmrig-MDEwOlJlcG9zaXRvcnk4ODMyNzQwNg==-flat-adl_structures.h.html,22,xmrig-MDEwOlJlcG9zaXRvcnk4ODMyNzQwNg==-flat-adl_structures.h,xmrig-MDEwOlJlcG9zaXRvcnk4ODMyNzQwNg==-flat-adl_structures.h,447,452,5,435,440,5
26,https://htmlpreview.github.io/?https://github.com/Christina96/boilerplate-sample-matches/blob/main/C/libfuse-MDEwOlJlcG9zaXRvcnk0ODI5NjE3Nw==-flat-test_syscalls.c-libfuse-MDEwOlJlcG9zaXRvcnk0ODI5NjE3Nw==-flat-fusermount.c.html,21,libfuse-MDEwOlJlcG9zaXRvcnk0ODI5NjE3Nw==-flat-test_syscalls.c,libfuse-MDEwOlJlcG9zaXRvcnk0ODI5NjE3Nw==-flat-fusermount.c,739,741,2,109,111,2
27,https://htmlpreview.github.io/?https://github.com/Christina96/boilerplate-sample-matches/blob/main/C/redis-MDEwOlJlcG9zaXRvcnkxMDgxMTA3MDY=-flat-module.c-redis-MDEwOlJlcG9zaXRvcnkxMDgxMTA3MDY=-flat-module.c.html,23,redis-MDEwOlJlcG9zaXRvcnkxMDgxMTA3MDY=-flat-module.c,redis-MDEwOlJlcG9zaXRvcnkxMDgxMTA3MDY=-flat-module.c,1113,1117,4,1167,1171,4
28,https://htmlpreview.github.io/?https://github.com/Christina96/boilerplate-sample-matches/blob/main/C/PINRemoteImage-MDEwOlJlcG9zaXRvcnkzOTUzNzEwMw==-flat-histogram_enc.c-PINRemoteImage-MDEwOlJlcG9zaXRvcnkzOTUzNzEwMw==-flat-histogram_enc.c.html,22,PINRemoteImage-MDEwOlJlcG9zaXRvcnkzOTUzNzEwMw==-flat-histogram_enc.c,PINRemoteImage-MDEwOlJlcG9zaXRvcnkzOTUzNzEwMw==-flat-histogram_enc.c,585,587,2,594,596,2
29,https://htmlpreview.github.io/?https://github.com/Christina96/boilerplate-sample-matches/blob/main/C/fftw3-MDEwOlJlcG9zaXRvcnk4ODQzMzg4-flat-hc2hc-generic.c-fftw3-MDEwOlJlcG9zaXRvcnk4ODQzMzg4-flat-redft00e-r2hc-pad.c.html,16,fftw3-MDEwOlJlcG9zaXRvcnk4ODQzMzg4-flat-hc2hc-generic.c,fftw3-MDEwOlJlcG9zaXRvcnk4ODQzMzg4-flat-redft00e-r2hc-pad.c,190,193,3,94,97,3
30,https://htmlpreview.github.io/?https://github.com/Christina96/boilerplate-sample-matches/blob/main/C/small-MDEwOlJlcG9zaXRvcnkyNTY3NjMxNjk=-flat-encrypt.c-small-MDEwOlJlcG9zaXRvcnkyNTY3NjMxNjk=-flat-encrypt.c.html,17,small-MDEwOlJlcG9zaXRvcnkyNTY3NjMxNjk=-flat-encrypt.c,small-MDEwOlJlcG9zaXRvcnkyNTY3NjMxNjk=-flat-encrypt.c,477,478,1,505,506,1
31,https://htmlpreview.github.io/?https://github.com/Christina96/boilerplate-sample-matches/blob/main/C/redis-MDEwOlJlcG9zaXRvcnkxMDgxMTA3MDY=-flat-lbaselib.c-redis-MDEwOlJlcG9zaXRvcnkxMDgxMTA3MDY=-flat-lbaselib.c.html,15,redis-MDEwOlJlcG9zaXRvcnkxMDgxMTA3MDY=-flat-lbaselib.c,redis-MDEwOlJlcG9zaXRvcnkxMDgxMTA3MDY=-flat-lbaselib.c,190,191,1,205,206,1
32,https://htmlpreview.github.io/?https://github.com/Christina96/boilerplate-sample-matches/blob/main/C/PINRemoteImage-MDEwOlJlcG9zaXRvcnkzOTUzNzEwMw==-flat-libwebp_java_wrap.c-PINRemoteImage-MDEwOlJlcG9zaXRvcnkzOTUzNzEwMw==-flat-libwebp_java_wrap.c.html,28,PINRemoteImage-MDEwOlJlcG9zaXRvcnkzOTUzNzEwMw==-flat-libwebp_java_wrap.c,PINRemoteImage-MDEwOlJlcG9zaXRvcnkzOTUzNzEwMw==-flat-libwebp_java_wrap.c,973,976,3,1271,1274,3
33,https://htmlpreview.github.io/?https://github.com/Christina96/boilerplate-sample-matches/blob/main/C/xmrig-MDEwOlJlcG9zaXRvcnk4ODMyNzQwNg==-flat-CryptoNight_x86.h-xmrig-MDEwOlJlcG9zaXRvcnk4ODMyNzQwNg==-flat-CryptoNight_x86.h.html,18,xmrig-MDEwOlJlcG9zaXRvcnk4ODMyNzQwNg==-flat-CryptoNight_x86.h,xmrig-MDEwOlJlcG9zaXRvcnk4ODMyNzQwNg==-flat-CryptoNight_x86.h,1281,1282,1,1303,1304,1
34,https://htmlpreview.github.io/?https://github.com/Christina96/boilerplate-sample-matches/blob/main/C/Adafruit_nRF52_Arduino-MDEwOlJlcG9zaXRvcnk3NDM1NDcyOQ==-flat-nrfx_gpiote.c-Adafruit_nRF52_Arduino-MDEwOlJlcG9zaXRvcnk3NDM1NDcyOQ==-flat-nrfx_gpiote.c.html,59,Adafruit_nRF52_Arduino-MDEwOlJlcG9zaXRvcnk3NDM1NDcyOQ==-flat-nrfx_gpiote.c,Adafruit_nRF52_Arduino-MDEwOlJlcG9zaXRvcnk3NDM1NDcyOQ==-flat-nrfx_gpiote.c,286,297,11,299,310,11
35,https://htmlpreview.github.io/?https://github.com/Christina96/boilerplate-sample-matches/blob/main/C/libtomcrypt-MDEwOlJlcG9zaXRvcnk3NzcwMTE=-flat-camellia.c-libtomcrypt-MDEwOlJlcG9zaXRvcnk3NzcwMTE=-flat-camellia.c.html,70,libtomcrypt-MDEwOlJlcG9zaXRvcnk3NzcwMTE=-flat-camellia.c,libtomcrypt-MDEwOlJlcG9zaXRvcnk3NzcwMTE=-flat-camellia.c,407,411,4,343,347,4
36,https://htmlpreview.github.io/?https://github.com/Christina96/boilerplate-sample-matches/blob/main/C/xmrig-MDEwOlJlcG9zaXRvcnk4ODMyNzQwNg==-flat-crypto-ops.c-xmrig-MDEwOlJlcG9zaXRvcnk4ODMyNzQwNg==-flat-crypto-ops.c.html,28,xmrig-MDEwOlJlcG9zaXRvcnk4ODMyNzQwNg==-flat-crypto-ops.c,xmrig-MDEwOlJlcG9zaXRvcnk4ODMyNzQwNg==-flat-crypto-ops.c,659,661,2,533,535,2
37,https://htmlpreview.github.io/?https://github.com/Christina96/boilerplate-sample-matches/blob/main/C/redis-MDEwOlJlcG9zaXRvcnkxMDgxMTA3MDY=-flat-geohash.c-redis-MDEwOlJlcG9zaXRvcnkxMDgxMTA3MDY=-flat-geohash_39.c.html,1065,redis-MDEwOlJlcG9zaXRvcnkxMDgxMTA3MDY=-flat-geohash.c,redis-MDEwOlJlcG9zaXRvcnkxMDgxMTA3MDY=-flat-geohash_39.c,68,183,115,65,180,115
38,https://htmlpreview.github.io/?https://github.com/Christina96/boilerplate-sample-matches/blob/main/C/redis-MDEwOlJlcG9zaXRvcnkxMDgxMTA3MDY=-flat-hook.c-redis-MDEwOlJlcG9zaXRvcnkxMDgxMTA3MDY=-flat-hook.c.html,20,redis-MDEwOlJlcG9zaXRvcnkxMDgxMTA3MDY=-flat-hook.c,redis-MDEwOlJlcG9zaXRvcnkxMDgxMTA3MDY=-flat-hook.c,416,418,2,382,384,2
39,https://htmlpreview.github.io/?https://github.com/Christina96/boilerplate-sample-matches/blob/main/C/PINRemoteImage-MDEwOlJlcG9zaXRvcnkzOTUzNzEwMw==-flat-lossless_enc_mips32.c-PINRemoteImage-MDEwOlJlcG9zaXRvcnkzOTUzNzEwMw==-flat-enc_mips32.c.html,15,PINRemoteImage-MDEwOlJlcG9zaXRvcnkzOTUzNzEwMw==-flat-lossless_enc_mips32.c,PINRemoteImage-MDEwOlJlcG9zaXRvcnkzOTUzNzEwMw==-flat-enc_mips32.c,229,233,4,358,361,3
40,https://htmlpreview.github.io/?https://github.com/Christina96/boilerplate-sample-matches/blob/main/C/redis-MDEwOlJlcG9zaXRvcnkxMDgxMTA3MDY=-flat-debug.c-libfuse-MDEwOlJlcG9zaXRvcnk0ODI5NjE3Nw==-flat-fuse.c.html,16,redis-MDEwOlJlcG9zaXRvcnkxMDgxMTA3MDY=-flat-debug.c,libfuse-MDEwOlJlcG9zaXRvcnk0ODI5NjE3Nw==-flat-fuse.c,1126,1128,2,4066,4068,2
41,https://htmlpreview.github.io/?https://github.com/Christina96/boilerplate-sample-matches/blob/main/C/libtomcrypt-MDEwOlJlcG9zaXRvcnk3NzcwMTE=-flat-des.c-libtomcrypt-MDEwOlJlcG9zaXRvcnk3NzcwMTE=-flat-des.c.html,134,libtomcrypt-MDEwOlJlcG9zaXRvcnk3NzcwMTE=-flat-des.c,libtomcrypt-MDEwOlJlcG9zaXRvcnk3NzcwMTE=-flat-des.c,1376,1389,13,1431,1444,13
42,https://htmlpreview.github.io/?https://github.com/Christina96/boilerplate-sample-matches/blob/main/C/redis-MDEwOlJlcG9zaXRvcnkxMDgxMTA3MDY=-flat-SFMT_0.c-redis-MDEwOlJlcG9zaXRvcnkxMDgxMTA3MDY=-flat-SFMT_0.c.html,17,redis-MDEwOlJlcG9zaXRvcnkxMDgxMTA3MDY=-flat-SFMT_0.c,redis-MDEwOlJlcG9zaXRvcnkxMDgxMTA3MDY=-flat-SFMT_0.c,383,386,3,385,388,3
43,https://htmlpreview.github.io/?https://github.com/Christina96/boilerplate-sample-matches/blob/main/C/fftw3-MDEwOlJlcG9zaXRvcnk4ODQzMzg4-flat-ct-hc2c-direct.c-fftw3-MDEwOlJlcG9zaXRvcnk4ODQzMzg4-flat-dftw-direct.c.html,18,fftw3-MDEwOlJlcG9zaXRvcnk4ODQzMzg4-flat-ct-hc2c-direct.c,fftw3-MDEwOlJlcG9zaXRvcnk4ODQzMzg4-flat-dftw-direct.c,235,239,4,192,196,4
44,https://htmlpreview.github.io/?https://github.com/Christina96/boilerplate-sample-matches/blob/main/C/xmrig-MDEwOlJlcG9zaXRvcnk4ODMyNzQwNg==-flat-sph_jh.c-xmrig-MDEwOlJlcG9zaXRvcnk4ODMyNzQwNg==-flat-sph_fugue.c.html,15,xmrig-MDEwOlJlcG9zaXRvcnk4ODMyNzQwNg==-flat-sph_jh.c,xmrig-MDEwOlJlcG9zaXRvcnk4ODMyNzQwNg==-flat-sph_fugue.c,756,760,4,644,648,4
45,https://htmlpreview.github.io/?https://github.com/Christina96/boilerplate-sample-matches/blob/main/C/PINRemoteImage-MDEwOlJlcG9zaXRvcnkzOTUzNzEwMw==-flat-mux_18.h-PINRemoteImage-MDEwOlJlcG9zaXRvcnkzOTUzNzEwMw==-flat-mux_36.h.html,75,PINRemoteImage-MDEwOlJlcG9zaXRvcnkzOTUzNzEwMw==-flat-mux_18.h,PINRemoteImage-MDEwOlJlcG9zaXRvcnkzOTUzNzEwMw==-flat-mux_36.h,108,121,13,108,121,13
46,https://htmlpreview.github.io/?https://github.com/Christina96/boilerplate-sample-matches/blob/main/C/libtomcrypt-MDEwOlJlcG9zaXRvcnk3NzcwMTE=-flat-ccm_test.c-libtomcrypt-MDEwOlJlcG9zaXRvcnk3NzcwMTE=-flat-hkdf_test.c.html,17,libtomcrypt-MDEwOlJlcG9zaXRvcnk3NzcwMTE=-flat-ccm_test.c,libtomcrypt-MDEwOlJlcG9zaXRvcnk3NzcwMTE=-flat-hkdf_test.c,17,20,3,21,24,3
47,https://htmlpreview.github.io/?https://github.com/Christina96/boilerplate-sample-matches/blob/main/C/redis-MDEwOlJlcG9zaXRvcnkxMDgxMTA3MDY=-flat-WS2tcpip.h-redis-MDEwOlJlcG9zaXRvcnkxMDgxMTA3MDY=-flat-WS2tcpip.h.html,18,redis-MDEwOlJlcG9zaXRvcnkxMDgxMTA3MDY=-flat-WS2tcpip.h,redis-MDEwOlJlcG9zaXRvcnkxMDgxMTA3MDY=-flat-WS2tcpip.h,136,145,9,121,129,8
48,https://htmlpreview.github.io/?https://github.com/Christina96/boilerplate-sample-matches/blob/main/C/redis-MDEwOlJlcG9zaXRvcnkxMDgxMTA3MDY=-flat-jemalloc.c-redis-MDEwOlJlcG9zaXRvcnkxMDgxMTA3MDY=-flat-emitter.h.html,17,redis-MDEwOlJlcG9zaXRvcnkxMDgxMTA3MDY=-flat-jemalloc.c,redis-MDEwOlJlcG9zaXRvcnkxMDgxMTA3MDY=-flat-emitter.h,1396,1401,5,38,43,5
49,https://htmlpreview.github.io/?https://github.com/Christina96/boilerplate-sample-matches/blob/main/C/PINRemoteImage-MDEwOlJlcG9zaXRvcnkzOTUzNzEwMw==-flat-dec_msa.c-PINRemoteImage-MDEwOlJlcG9zaXRvcnkzOTUzNzEwMw==-flat-dec_msa.c.html,25,PINRemoteImage-MDEwOlJlcG9zaXRvcnkzOTUzNzEwMw==-flat-dec_msa.c,PINRemoteImage-MDEwOlJlcG9zaXRvcnkzOTUzNzEwMw==-flat-dec_msa.c,265,267,2,267,269,2
50,https://htmlpreview.github.io/?https://github.com/Christina96/boilerplate-sample-matches/blob/main/C/small-MDEwOlJlcG9zaXRvcnkyNTY3NjMxNjk=-flat-acl.c-small-MDEwOlJlcG9zaXRvcnkyNTY3NjMxNjk=-flat-acl.c.html,60,small-MDEwOlJlcG9zaXRvcnkyNTY3NjMxNjk=-flat-acl.c,small-MDEwOlJlcG9zaXRvcnkyNTY3NjMxNjk=-flat-acl.c,387,397,10,444,454,10
51,https://htmlpreview.github.io/?https://github.com/Christina96/boilerplate-sample-matches/blob/main/C/redis-MDEwOlJlcG9zaXRvcnkxMDgxMTA3MDY=-flat-win32_wsiocp.c-xmrig-MDEwOlJlcG9zaXRvcnk4ODMyNzQwNg==-flat-topology.c.html,17,redis-MDEwOlJlcG9zaXRvcnkxMDgxMTA3MDY=-flat-win32_wsiocp.c,xmrig-MDEwOlJlcG9zaXRvcnk4ODMyNzQwNg==-flat-topology.c,267,268,1,2156,2157,1
52,https://htmlpreview.github.io/?https://github.com/Christina96/boilerplate-sample-matches/blob/main/C/PINRemoteImage-MDEwOlJlcG9zaXRvcnkzOTUzNzEwMw==-flat-dwebp.c-PINRemoteImage-MDEwOlJlcG9zaXRvcnkzOTUzNzEwMw==-flat-cwebp.c.html,18,PINRemoteImage-MDEwOlJlcG9zaXRvcnkzOTUzNzEwMw==-flat-dwebp.c,PINRemoteImage-MDEwOlJlcG9zaXRvcnkzOTUzNzEwMw==-flat-cwebp.c,17,24,7,15,22,7
53,https://htmlpreview.github.io/?https://github.com/Christina96/boilerplate-sample-matches/blob/main/C/redis-MDEwOlJlcG9zaXRvcnkxMDgxMTA3MDY=-flat-tsd_win.h-redis-MDEwOlJlcG9zaXRvcnkxMDgxMTA3MDY=-flat-tsd_generic.h.html,36,redis-MDEwOlJlcG9zaXRvcnkxMDgxMTA3MDY=-flat-tsd_win.h,redis-MDEwOlJlcG9zaXRvcnkxMDgxMTA3MDY=-flat-tsd_generic.h,114,119,5,135,140,5
54,https://htmlpreview.github.io/?https://github.com/Christina96/boilerplate-sample-matches/blob/main/C/libfuse-MDEwOlJlcG9zaXRvcnk0ODI5NjE3Nw==-flat-mount_util.c-libfuse-MDEwOlJlcG9zaXRvcnk0ODI5NjE3Nw==-flat-mount_util.c.html,157,libfuse-MDEwOlJlcG9zaXRvcnk0ODI5NjE3Nw==-flat-mount_util.c,libfuse-MDEwOlJlcG9zaXRvcnk0ODI5NjE3Nw==-flat-mount_util.c,168,192,24,108,132,24
55,https://htmlpreview.github.io/?https://github.com/Christina96/boilerplate-sample-matches/blob/main/C/redis-MDEwOlJlcG9zaXRvcnkxMDgxMTA3MDY=-flat-jemalloc.c-redis-MDEwOlJlcG9zaXRvcnkxMDgxMTA3MDY=-flat-jemalloc.c.html,38,redis-MDEwOlJlcG9zaXRvcnkxMDgxMTA3MDY=-flat-jemalloc.c,redis-MDEwOlJlcG9zaXRvcnkxMDgxMTA3MDY=-flat-jemalloc.c,2577,2583,6,2789,2795,6
56,https://htmlpreview.github.io/?https://github.com/Christina96/boilerplate-sample-matches/blob/main/C/fftw3-MDEwOlJlcG9zaXRvcnk4ODQzMzg4-flat-rank0.c-fftw3-MDEwOlJlcG9zaXRvcnk4ODQzMzg4-flat-nop2.c.html,18,fftw3-MDEwOlJlcG9zaXRvcnk4ODQzMzg4-flat-rank0.c,fftw3-MDEwOlJlcG9zaXRvcnk4ODQzMzg4-flat-nop2.c,226,228,2,32,34,2
57,https://htmlpreview.github.io/?https://github.com/Christina96/boilerplate-sample-matches/blob/main/C/libtomcrypt-MDEwOlJlcG9zaXRvcnk3NzcwMTE=-flat-camellia.c-libtomcrypt-MDEwOlJlcG9zaXRvcnk3NzcwMTE=-flat-khazad.c.html,55,libtomcrypt-MDEwOlJlcG9zaXRvcnk3NzcwMTE=-flat-camellia.c,libtomcrypt-MDEwOlJlcG9zaXRvcnk3NzcwMTE=-flat-khazad.c,6,15,9,6,15,9
58,https://htmlpreview.github.io/?https://github.com/Christina96/boilerplate-sample-matches/blob/main/C/libtomcrypt-MDEwOlJlcG9zaXRvcnk3NzcwMTE=-flat-timing.c-libtomcrypt-MDEwOlJlcG9zaXRvcnk3NzcwMTE=-flat-timing.c.html,37,libtomcrypt-MDEwOlJlcG9zaXRvcnk3NzcwMTE=-flat-timing.c,libtomcrypt-MDEwOlJlcG9zaXRvcnk3NzcwMTE=-flat-timing.c,371,376,5,248,253,5
59,https://htmlpreview.github.io/?https://github.com/Christina96/boilerplate-sample-matches/blob/main/C/Adafruit_nRF52_Arduino-MDEwOlJlcG9zaXRvcnk3NDM1NDcyOQ==-flat-ble_gatt.h-Adafruit_nRF52_Arduino-MDEwOlJlcG9zaXRvcnk3NDM1NDcyOQ==-flat-ble_gap.h.html,19,Adafruit_nRF52_Arduino-MDEwOlJlcG9zaXRvcnk3NDM1NDcyOQ==-flat-ble_gatt.h,Adafruit_nRF52_Arduino-MDEwOlJlcG9zaXRvcnk3NDM1NDcyOQ==-flat-ble_gap.h,107,108,1,695,696,1
60,https://htmlpreview.github.io/?https://github.com/Christina96/boilerplate-sample-matches/blob/main/C/redis-MDEwOlJlcG9zaXRvcnkxMDgxMTA3MDY=-flat-sc.h-redis-MDEwOlJlcG9zaXRvcnkxMDgxMTA3MDY=-flat-rtree_tsd.h.html,16,redis-MDEwOlJlcG9zaXRvcnkxMDgxMTA3MDY=-flat-sc.h,redis-MDEwOlJlcG9zaXRvcnkxMDgxMTA3MDY=-flat-rtree_tsd.h,76,79,3,16,19,3
61,https://htmlpreview.github.io/?https://github.com/Christina96/boilerplate-sample-matches/blob/main/C/android-gpuimage-plus-MDEwOlJlcG9zaXRvcnk0NjU0NzQxNw==-flat-channel_layout.h-xmrig-MDEwOlJlcG9zaXRvcnk4ODMyNzQwNg==-flat-BenchClient.h.html,18,android-gpuimage-plus-MDEwOlJlcG9zaXRvcnk0NjU0NzQxNw==-flat-channel_layout.h,xmrig-MDEwOlJlcG9zaXRvcnk4ODMyNzQwNg==-flat-BenchClient.h,63,69,6,55,61,6
62,https://htmlpreview.github.io/?https://github.com/Christina96/boilerplate-sample-matches/blob/main/C/libpcap-MDEwOlJlcG9zaXRvcnk5NDM1ODg3-flat-daemon.c-libpcap-MDEwOlJlcG9zaXRvcnk5NDM1ODg3-flat-daemon.c.html,27,libpcap-MDEwOlJlcG9zaXRvcnk5NDM1ODg3-flat-daemon.c,libpcap-MDEwOlJlcG9zaXRvcnk5NDM1ODg3-flat-daemon.c,828,833,5,767,772,5
63,https://htmlpreview.github.io/?https://github.com/Christina96/boilerplate-sample-matches/blob/main/C/libpcap-MDEwOlJlcG9zaXRvcnk5NDM1ODg3-flat-pcap-haiku.c-libpcap-MDEwOlJlcG9zaXRvcnk5NDM1ODg3-flat-pcap-linux.c.html,17,libpcap-MDEwOlJlcG9zaXRvcnk5NDM1ODg3-flat-pcap-haiku.c,libpcap-MDEwOlJlcG9zaXRvcnk5NDM1ODg3-flat-pcap-linux.c,110,114,4,1163,1167,4
64,https://htmlpreview.github.io/?https://github.com/Christina96/boilerplate-sample-matches/blob/main/C/Adafruit_nRF52_Arduino-MDEwOlJlcG9zaXRvcnk3NDM1NDcyOQ==-flat-nrf52833.h-Adafruit_nRF52_Arduino-MDEwOlJlcG9zaXRvcnk3NDM1NDcyOQ==-flat-nrf52810.h.html,25,Adafruit_nRF52_Arduino-MDEwOlJlcG9zaXRvcnk3NDM1NDcyOQ==-flat-nrf52833.h,Adafruit_nRF52_Arduino-MDEwOlJlcG9zaXRvcnk3NDM1NDcyOQ==-flat-nrf52810.h,355,358,3,1054,1056,2
65,https://htmlpreview.github.io/?https://github.com/Christina96/boilerplate-sample-matches/blob/main/C/redis-MDEwOlJlcG9zaXRvcnkxMDgxMTA3MDY=-flat-ziplist.c-redis-MDEwOlJlcG9zaXRvcnkxMDgxMTA3MDY=-flat-ziplist.c.html,17,redis-MDEwOlJlcG9zaXRvcnkxMDgxMTA3MDY=-flat-ziplist.c,redis-MDEwOlJlcG9zaXRvcnkxMDgxMTA3MDY=-flat-ziplist.c,707,709,2,715,717,2
66,https://htmlpreview.github.io/?https://github.com/Christina96/boilerplate-sample-matches/blob/main/C/redis-MDEwOlJlcG9zaXRvcnkxMDgxMTA3MDY=-flat-atomic_gcc_sync.h-redis-MDEwOlJlcG9zaXRvcnkxMDgxMTA3MDY=-flat-atomic_gcc_sync.h.html,45,redis-MDEwOlJlcG9zaXRvcnkxMDgxMTA3MDY=-flat-atomic_gcc_sync.h,redis-MDEwOlJlcG9zaXRvcnkxMDgxMTA3MDY=-flat-atomic_gcc_sync.h,42,51,9,51,60,9
67,https://htmlpreview.github.io/?https://github.com/Christina96/boilerplate-sample-matches/blob/main/C/android-gpuimage-plus-MDEwOlJlcG9zaXRvcnk0NjU0NzQxNw==-flat-cgeImageHandler.h-android-gpuimage-plus-MDEwOlJlcG9zaXRvcnk0NjU0NzQxNw==-flat-cgeImageFilter.h.html,21,android-gpuimage-plus-MDEwOlJlcG9zaXRvcnk0NjU0NzQxNw==-flat-cgeImageHandler.h,android-gpuimage-plus-MDEwOlJlcG9zaXRvcnk0NjU0NzQxNw==-flat-cgeImageFilter.h,16,23,7,27,34,7
68,https://htmlpreview.github.io/?https://github.com/Christina96/boilerplate-sample-matches/blob/main/C/libtomcrypt-MDEwOlJlcG9zaXRvcnk3NzcwMTE=-flat-ecc_export.c-libtomcrypt-MDEwOlJlcG9zaXRvcnk3NzcwMTE=-flat-dh_export.c.html,22,libtomcrypt-MDEwOlJlcG9zaXRvcnk3NzcwMTE=-flat-ecc_export.c,libtomcrypt-MDEwOlJlcG9zaXRvcnk3NzcwMTE=-flat-dh_export.c,15,18,3,11,14,3
69,https://htmlpreview.github.io/?https://github.com/Christina96/boilerplate-sample-matches/blob/main/C/Adafruit_nRF52_Arduino-MDEwOlJlcG9zaXRvcnk3NDM1NDcyOQ==-flat-SEGGER_SYSVIEW.c-Adafruit_nRF52_Arduino-MDEwOlJlcG9zaXRvcnk3NDM1NDcyOQ==-flat-SEGGER_SYSVIEW.c.html,33,Adafruit_nRF52_Arduino-MDEwOlJlcG9zaXRvcnk3NDM1NDcyOQ==-flat-SEGGER_SYSVIEW.c,Adafruit_nRF52_Arduino-MDEwOlJlcG9zaXRvcnk3NDM1NDcyOQ==-flat-SEGGER_SYSVIEW.c,685,691,6,979,985,6
70,https://htmlpreview.github.io/?https://github.com/Christina96/boilerplate-sample-matches/blob/main/C/redis-MDEwOlJlcG9zaXRvcnkxMDgxMTA3MDY=-flat-ph.h-redis-MDEwOlJlcG9zaXRvcnkxMDgxMTA3MDY=-flat-ph.h.html,36,redis-MDEwOlJlcG9zaXRvcnkxMDgxMTA3MDY=-flat-ph.h,redis-MDEwOlJlcG9zaXRvcnkxMDgxMTA3MDY=-flat-ph.h,24,28,4,14,18,4
71,https://htmlpreview.github.io/?https://github.com/Christina96/boilerplate-sample-matches/blob/main/C/PINRemoteImage-MDEwOlJlcG9zaXRvcnkzOTUzNzEwMw==-flat-vp8i_dec.h-PINRemoteImage-MDEwOlJlcG9zaXRvcnkzOTUzNzEwMw==-flat-webpinfo.c.html,15,PINRemoteImage-MDEwOlJlcG9zaXRvcnkzOTUzNzEwMw==-flat-vp8i_dec.h,PINRemoteImage-MDEwOlJlcG9zaXRvcnkzOTUzNzEwMw==-flat-webpinfo.c,53,57,4,78,82,4
72,https://htmlpreview.github.io/?https://github.com/Christina96/boilerplate-sample-matches/blob/main/C/redis-MDEwOlJlcG9zaXRvcnkxMDgxMTA3MDY=-flat-jemalloc.h-redis-MDEwOlJlcG9zaXRvcnkxMDgxMTA3MDY=-flat-jemalloc_protos_jet.h.html,361,redis-MDEwOlJlcG9zaXRvcnkxMDgxMTA3MDY=-flat-jemalloc.h,redis-MDEwOlJlcG9zaXRvcnkxMDgxMTA3MDY=-flat-jemalloc_protos_jet.h,149,195,46,11,56,45
73,https://htmlpreview.github.io/?https://github.com/Christina96/boilerplate-sample-matches/blob/main/C/xmrig-MDEwOlJlcG9zaXRvcnk4ODMyNzQwNg==-flat-CryptoNight_x86.h-xmrig-MDEwOlJlcG9zaXRvcnk4ODMyNzQwNg==-flat-CryptoNight_x86.h.html,28,xmrig-MDEwOlJlcG9zaXRvcnk4ODMyNzQwNg==-flat-CryptoNight_x86.h,xmrig-MDEwOlJlcG9zaXRvcnk4ODMyNzQwNg==-flat-CryptoNight_x86.h,1314,1315,1,1315,1316,1
74,https://htmlpreview.github.io/?https://github.com/Christina96/boilerplate-sample-matches/blob/main/C/PINRemoteImage-MDEwOlJlcG9zaXRvcnkzOTUzNzEwMw==-flat-dec_sse2.c-PINRemoteImage-MDEwOlJlcG9zaXRvcnkzOTUzNzEwMw==-flat-dec_sse2.c.html,34,PINRemoteImage-MDEwOlJlcG9zaXRvcnkzOTUzNzEwMw==-flat-dec_sse2.c,PINRemoteImage-MDEwOlJlcG9zaXRvcnkzOTUzNzEwMw==-flat-dec_sse2.c,206,210,4,274,278,4
75,https://htmlpreview.github.io/?https://github.com/Christina96/boilerplate-sample-matches/blob/main/C/PINRemoteImage-MDEwOlJlcG9zaXRvcnkzOTUzNzEwMw==-flat-enc_neon.c-PINRemoteImage-MDEwOlJlcG9zaXRvcnkzOTUzNzEwMw==-flat-dec_neon.c.html,34,PINRemoteImage-MDEwOlJlcG9zaXRvcnkzOTUzNzEwMw==-flat-enc_neon.c,PINRemoteImage-MDEwOlJlcG9zaXRvcnkzOTUzNzEwMw==-flat-dec_neon.c,66,70,4,841,845,4
76,https://htmlpreview.github.io/?https://github.com/Christina96/boilerplate-sample-matches/blob/main/C/fftw3-MDEwOlJlcG9zaXRvcnk4ODQzMzg4-flat-ct-hc2c-direct.c-fftw3-MDEwOlJlcG9zaXRvcnk4ODQzMzg4-flat-hc2hc-direct.c.html,19,fftw3-MDEwOlJlcG9zaXRvcnk4ODQzMzg4-flat-ct-hc2c-direct.c,fftw3-MDEwOlJlcG9zaXRvcnk4ODQzMzg4-flat-hc2hc-direct.c,11,12,1,11,12,1
77,https://htmlpreview.github.io/?https://github.com/Christina96/boilerplate-sample-matches/blob/main/C/xmrig-MDEwOlJlcG9zaXRvcnk4ODMyNzQwNg==-flat-OclConfig.h-xmrig-MDEwOlJlcG9zaXRvcnk4ODMyNzQwNg==-flat-CudaConfig.h.html,23,xmrig-MDEwOlJlcG9zaXRvcnk4ODMyNzQwNg==-flat-OclConfig.h,xmrig-MDEwOlJlcG9zaXRvcnk4ODMyNzQwNg==-flat-CudaConfig.h,29,33,4,29,33,4
78,https://htmlpreview.github.io/?https://github.com/Christina96/boilerplate-sample-matches/blob/main/C/libpcap-MDEwOlJlcG9zaXRvcnk5NDM1ODg3-flat-pcap-airpcap.c-libpcap-MDEwOlJlcG9zaXRvcnk5NDM1ODg3-flat-pcap-npf.c.html,130,libpcap-MDEwOlJlcG9zaXRvcnk5NDM1ODg3-flat-pcap-airpcap.c,libpcap-MDEwOlJlcG9zaXRvcnk5NDM1ODg3-flat-pcap-npf.c,350,371,21,337,358,21
79,https://htmlpreview.github.io/?https://github.com/Christina96/boilerplate-sample-matches/blob/main/C/Adafruit_nRF52_Arduino-MDEwOlJlcG9zaXRvcnk3NDM1NDcyOQ==-flat-BLEAncs.h-Adafruit_nRF52_Arduino-MDEwOlJlcG9zaXRvcnk3NDM1NDcyOQ==-flat-BLEAncs.h.html,23,Adafruit_nRF52_Arduino-MDEwOlJlcG9zaXRvcnk3NDM1NDcyOQ==-flat-BLEAncs.h,Adafruit_nRF52_Arduino-MDEwOlJlcG9zaXRvcnk3NDM1NDcyOQ==-flat-BLEAncs.h,21,36,15,27,41,14
80,https://htmlpreview.github.io/?https://github.com/Christina96/boilerplate-sample-matches/blob/main/C/small-MDEwOlJlcG9zaXRvcnkyNTY3NjMxNjk=-flat-resolv.c-small-MDEwOlJlcG9zaXRvcnkyNTY3NjMxNjk=-flat-resolv.c.html,47,small-MDEwOlJlcG9zaXRvcnkyNTY3NjMxNjk=-flat-resolv.c,small-MDEwOlJlcG9zaXRvcnkyNTY3NjMxNjk=-flat-resolv.c,123,131,8,132,140,8
81,https://htmlpreview.github.io/?https://github.com/Christina96/boilerplate-sample-matches/blob/main/C/Adafruit_nRF52_Arduino-MDEwOlJlcG9zaXRvcnk3NDM1NDcyOQ==-flat-verify.h-Adafruit_nRF52_Arduino-MDEwOlJlcG9zaXRvcnk3NDM1NDcyOQ==-flat-verify.h.html,26,Adafruit_nRF52_Arduino-MDEwOlJlcG9zaXRvcnk3NDM1NDcyOQ==-flat-verify.h,Adafruit_nRF52_Arduino-MDEwOlJlcG9zaXRvcnk3NDM1NDcyOQ==-flat-verify.h,35,38,3,40,43,3
82,https://htmlpreview.github.io/?https://github.com/Christina96/boilerplate-sample-matches/blob/main/C/redis-MDEwOlJlcG9zaXRvcnkxMDgxMTA3MDY=-flat-ziplist.c-redis-MDEwOlJlcG9zaXRvcnkxMDgxMTA3MDY=-flat-intset.c.html,16,redis-MDEwOlJlcG9zaXRvcnkxMDgxMTA3MDY=-flat-ziplist.c,redis-MDEwOlJlcG9zaXRvcnkxMDgxMTA3MDY=-flat-intset.c,213,217,4,22,26,4
83,https://htmlpreview.github.io/?https://github.com/Christina96/boilerplate-sample-matches/blob/main/C/small-MDEwOlJlcG9zaXRvcnkyNTY3NjMxNjk=-flat-auth.c-small-MDEwOlJlcG9zaXRvcnkyNTY3NjMxNjk=-flat-auth.c.html,25,small-MDEwOlJlcG9zaXRvcnkyNTY3NjMxNjk=-flat-auth.c,small-MDEwOlJlcG9zaXRvcnkyNTY3NjMxNjk=-flat-auth.c,308,311,3,454,457,3
84,https://htmlpreview.github.io/?https://github.com/Christina96/boilerplate-sample-matches/blob/main/C/redis-MDEwOlJlcG9zaXRvcnkxMDgxMTA3MDY=-flat-jemalloc_internal.h-redis-MDEwOlJlcG9zaXRvcnkxMDgxMTA3MDY=-flat-sz.h.html,29,redis-MDEwOlJlcG9zaXRvcnkxMDgxMTA3MDY=-flat-jemalloc_internal.h,redis-MDEwOlJlcG9zaXRvcnkxMDgxMTA3MDY=-flat-sz.h,520,523,3,172,175,3
85,https://htmlpreview.github.io/?https://github.com/Christina96/boilerplate-sample-matches/blob/main/C/libtomcrypt-MDEwOlJlcG9zaXRvcnk3NzcwMTE=-flat-der_encode_set.c-libtomcrypt-MDEwOlJlcG9zaXRvcnk3NzcwMTE=-flat-der_encode_setof.c.html,27,libtomcrypt-MDEwOlJlcG9zaXRvcnk3NzcwMTE=-flat-der_encode_set.c,libtomcrypt-MDEwOlJlcG9zaXRvcnk3NzcwMTE=-flat-der_encode_setof.c,15,20,5,28,33,5
86,https://htmlpreview.github.io/?https://github.com/Christina96/boilerplate-sample-matches/blob/main/C/PINRemoteImage-MDEwOlJlcG9zaXRvcnkzOTUzNzEwMw==-flat-upsampling_sse41.c-PINRemoteImage-MDEwOlJlcG9zaXRvcnkzOTUzNzEwMw==-flat-upsampling_sse2.c.html,189,PINRemoteImage-MDEwOlJlcG9zaXRvcnkzOTUzNzEwMw==-flat-upsampling_sse41.c,PINRemoteImage-MDEwOlJlcG9zaXRvcnkzOTUzNzEwMw==-flat-upsampling_sse2.c,110,127,17,109,126,17
87,https://htmlpreview.github.io/?https://github.com/Christina96/boilerplate-sample-matches/blob/main/C/redis-MDEwOlJlcG9zaXRvcnkxMDgxMTA3MDY=-flat-background_thread_22.c-libfuse-MDEwOlJlcG9zaXRvcnk0ODI5NjE3Nw==-flat-fuse.c.html,25,redis-MDEwOlJlcG9zaXRvcnkxMDgxMTA3MDY=-flat-background_thread_22.c,libfuse-MDEwOlJlcG9zaXRvcnk0ODI5NjE3Nw==-flat-fuse.c,652,656,4,412,415,3
88,https://htmlpreview.github.io/?https://github.com/Christina96/boilerplate-sample-matches/blob/main/C/PINRemoteImage-MDEwOlJlcG9zaXRvcnkzOTUzNzEwMw==-flat-upsampling_msa.c-PINRemoteImage-MDEwOlJlcG9zaXRvcnkzOTUzNzEwMw==-flat-upsampling_msa.c.html,53,PINRemoteImage-MDEwOlJlcG9zaXRvcnkzOTUzNzEwMw==-flat-upsampling_msa.c,PINRemoteImage-MDEwOlJlcG9zaXRvcnkzOTUzNzEwMw==-flat-upsampling_msa.c,458,466,8,394,402,8
89,https://htmlpreview.github.io/?https://github.com/Christina96/boilerplate-sample-matches/blob/main/C/fftw3-MDEwOlJlcG9zaXRvcnk4ODQzMzg4-flat-mp.c-fftw3-MDEwOlJlcG9zaXRvcnk4ODQzMzg4-flat-mp.c.html,35,fftw3-MDEwOlJlcG9zaXRvcnk4ODQzMzg4-flat-mp.c,fftw3-MDEwOlJlcG9zaXRvcnk4ODQzMzg4-flat-mp.c,120,122,2,141,143,2
90,https://htmlpreview.github.io/?https://github.com/Christina96/boilerplate-sample-matches/blob/main/C/xmrig-MDEwOlJlcG9zaXRvcnk4ODMyNzQwNg==-flat-crypto-ops.c-xmrig-MDEwOlJlcG9zaXRvcnk4ODMyNzQwNg==-flat-crypto-ops.c.html,16,xmrig-MDEwOlJlcG9zaXRvcnk4ODMyNzQwNg==-flat-crypto-ops.c,xmrig-MDEwOlJlcG9zaXRvcnk4ODMyNzQwNg==-flat-crypto-ops.c,714,716,2,246,248,2
91,https://htmlpreview.github.io/?https://github.com/Christina96/boilerplate-sample-matches/blob/main/C/redis-MDEwOlJlcG9zaXRvcnkxMDgxMTA3MDY=-flat-WS2tcpip.h-redis-MDEwOlJlcG9zaXRvcnkxMDgxMTA3MDY=-flat-WS2tcpip.h.html,110,redis-MDEwOlJlcG9zaXRvcnkxMDgxMTA3MDY=-flat-WS2tcpip.h,redis-MDEwOlJlcG9zaXRvcnkxMDgxMTA3MDY=-flat-WS2tcpip.h,596,615,19,682,701,19
92,https://htmlpreview.github.io/?https://github.com/Christina96/boilerplate-sample-matches/blob/main/C/redis-MDEwOlJlcG9zaXRvcnkxMDgxMTA3MDY=-flat-pages_20.c-redis-MDEwOlJlcG9zaXRvcnkxMDgxMTA3MDY=-flat-pages_20.c.html,15,redis-MDEwOlJlcG9zaXRvcnkxMDgxMTA3MDY=-flat-pages_20.c,redis-MDEwOlJlcG9zaXRvcnkxMDgxMTA3MDY=-flat-pages_20.c,166,167,1,129,130,1
93,https://htmlpreview.github.io/?https://github.com/Christina96/boilerplate-sample-matches/blob/main/C/xmrig-MDEwOlJlcG9zaXRvcnk4ODMyNzQwNg==-flat-llhttp.c-xmrig-MDEwOlJlcG9zaXRvcnk4ODMyNzQwNg==-flat-llhttp.c.html,15,xmrig-MDEwOlJlcG9zaXRvcnk4ODMyNzQwNg==-flat-llhttp.c,xmrig-MDEwOlJlcG9zaXRvcnk4ODMyNzQwNg==-flat-llhttp.c,9273,9277,4,2119,2123,4
94,https://htmlpreview.github.io/?https://github.com/Christina96/boilerplate-sample-matches/blob/main/C/xmrig-MDEwOlJlcG9zaXRvcnk4ODMyNzQwNg==-flat-topology-windows.c-android-gpuimage-plus-MDEwOlJlcG9zaXRvcnk0NjU0NzQxNw==-flat-cgeImageHandler.h.html,15,xmrig-MDEwOlJlcG9zaXRvcnk4ODMyNzQwNg==-flat-topology-windows.c,android-gpuimage-plus-MDEwOlJlcG9zaXRvcnk0NjU0NzQxNw==-flat-cgeImageHandler.h,90,94,4,50,54,4
95,https://htmlpreview.github.io/?https://github.com/Christina96/boilerplate-sample-matches/blob/main/C/Adafruit_nRF52_Arduino-MDEwOlJlcG9zaXRvcnk3NDM1NDcyOQ==-flat-nrf_ccm.h-Adafruit_nRF52_Arduino-MDEwOlJlcG9zaXRvcnk3NDM1NDcyOQ==-flat-nrf_power.h.html,21,Adafruit_nRF52_Arduino-MDEwOlJlcG9zaXRvcnk3NDM1NDcyOQ==-flat-nrf_ccm.h,Adafruit_nRF52_Arduino-MDEwOlJlcG9zaXRvcnk3NDM1NDcyOQ==-flat-nrf_power.h,62,65,3,269,271,2
96,https://htmlpreview.github.io/?https://github.com/Christina96/boilerplate-sample-matches/blob/main/C/libtomcrypt-MDEwOlJlcG9zaXRvcnk3NzcwMTE=-flat-der_test.c-libtomcrypt-MDEwOlJlcG9zaXRvcnk3NzcwMTE=-flat-der_test.c.html,18,libtomcrypt-MDEwOlJlcG9zaXRvcnk3NzcwMTE=-flat-der_test.c,libtomcrypt-MDEwOlJlcG9zaXRvcnk3NzcwMTE=-flat-der_test.c,1311,1312,1,1312,1313,1
97,https://htmlpreview.github.io/?https://github.com/Christina96/boilerplate-sample-matches/blob/main/C/Adafruit_nRF52_Arduino-MDEwOlJlcG9zaXRvcnk3NDM1NDcyOQ==-flat-event_groups.c-Adafruit_nRF52_Arduino-MDEwOlJlcG9zaXRvcnk3NDM1NDcyOQ==-flat-event_groups.c.html,69,Adafruit_nRF52_Arduino-MDEwOlJlcG9zaXRvcnk3NDM1NDcyOQ==-flat-event_groups.c,Adafruit_nRF52_Arduino-MDEwOlJlcG9zaXRvcnk3NDM1NDcyOQ==-flat-event_groups.c,45,61,16,68,84,16
98,https://htmlpreview.github.io/?https://github.com/Christina96/boilerplate-sample-matches/blob/main/C/libpcap-MDEwOlJlcG9zaXRvcnk5NDM1ODg3-flat-pcap.c-fftw3-MDEwOlJlcG9zaXRvcnk4ODQzMzg4-flat-allocate.c.html,20,libpcap-MDEwOlJlcG9zaXRvcnk5NDM1ODg3-flat-pcap.c,fftw3-MDEwOlJlcG9zaXRvcnk4ODQzMzg4-flat-allocate.c,782,785,3,83,86,3
99,https://htmlpreview.github.io/?https://github.com/Christina96/boilerplate-sample-matches/blob/main/C/xmrig-MDEwOlJlcG9zaXRvcnk4ODMyNzQwNg==-flat-chrono.h-xmrig-MDEwOlJlcG9zaXRvcnk4ODMyNzQwNg==-flat-core.h.html,17,xmrig-MDEwOlJlcG9zaXRvcnk4ODMyNzQwNg==-flat-chrono.h,xmrig-MDEwOlJlcG9zaXRvcnk4ODMyNzQwNg==-flat-core.h,621,624,3,634,636,2
100,https://htmlpreview.github.io/?https://github.com/Christina96/boilerplate-sample-matches/blob/main/C/libpcap-MDEwOlJlcG9zaXRvcnk5NDM1ODg3-flat-pcap-dag.c-libpcap-MDEwOlJlcG9zaXRvcnk5NDM1ODg3-flat-pcap-dag.c.html,49,libpcap-MDEwOlJlcG9zaXRvcnk5NDM1ODg3-flat-pcap-dag.c,libpcap-MDEwOlJlcG9zaXRvcnk5NDM1ODg3-flat-pcap-dag.c,894,903,9,900,909,9
101,https://htmlpreview.github.io/?https://github.com/Christina96/boilerplate-sample-matches/blob/main/C/fftw3-MDEwOlJlcG9zaXRvcnk4ODQzMzg4-flat-problem_24.c-fftw3-MDEwOlJlcG9zaXRvcnk4ODQzMzg4-flat-problem_7.c.html,24,fftw3-MDEwOlJlcG9zaXRvcnk4ODQzMzg4-flat-problem_24.c,fftw3-MDEwOlJlcG9zaXRvcnk4ODQzMzg4-flat-problem_7.c,151,154,3,68,71,3
102,https://htmlpreview.github.io/?https://github.com/Christina96/boilerplate-sample-matches/blob/main/C/redis-MDEwOlJlcG9zaXRvcnkxMDgxMTA3MDY=-flat-sentinel.c-redis-MDEwOlJlcG9zaXRvcnkxMDgxMTA3MDY=-flat-sentinel.c.html,36,redis-MDEwOlJlcG9zaXRvcnkxMDgxMTA3MDY=-flat-sentinel.c,redis-MDEwOlJlcG9zaXRvcnkxMDgxMTA3MDY=-flat-sentinel.c,2527,2530,3,2546,2549,3
103,https://htmlpreview.github.io/?https://github.com/Christina96/boilerplate-sample-matches/blob/main/C/Adafruit_nRF52_Arduino-MDEwOlJlcG9zaXRvcnk3NDM1NDcyOQ==-flat-nrf_qdec.h-Adafruit_nRF52_Arduino-MDEwOlJlcG9zaXRvcnk3NDM1NDcyOQ==-flat-nrf_spis.h.html,16,Adafruit_nRF52_Arduino-MDEwOlJlcG9zaXRvcnk3NDM1NDcyOQ==-flat-nrf_qdec.h,Adafruit_nRF52_Arduino-MDEwOlJlcG9zaXRvcnk3NDM1NDcyOQ==-flat-nrf_spis.h,146,151,5,213,218,5
104,https://htmlpreview.github.io/?https://github.com/Christina96/boilerplate-sample-matches/blob/main/C/xmrig-MDEwOlJlcG9zaXRvcnk4ODMyNzQwNg==-flat-compile.h-xmrig-MDEwOlJlcG9zaXRvcnk4ODMyNzQwNg==-flat-compile.h.html,24,xmrig-MDEwOlJlcG9zaXRvcnk4ODMyNzQwNg==-flat-compile.h,xmrig-MDEwOlJlcG9zaXRvcnk4ODMyNzQwNg==-flat-compile.h,36,39,3,39,42,3
105,https://htmlpreview.github.io/?https://github.com/Christina96/boilerplate-sample-matches/blob/main/C/xmrig-MDEwOlJlcG9zaXRvcnk4ODMyNzQwNg==-flat-sse2neon.h-xmrig-MDEwOlJlcG9zaXRvcnk4ODMyNzQwNg==-flat-sse2neon.h.html,28,xmrig-MDEwOlJlcG9zaXRvcnk4ODMyNzQwNg==-flat-sse2neon.h,xmrig-MDEwOlJlcG9zaXRvcnk4ODMyNzQwNg==-flat-sse2neon.h,4684,4688,4,4688,4692,4
106,https://htmlpreview.github.io/?https://github.com/Christina96/boilerplate-sample-matches/blob/main/C/small-MDEwOlJlcG9zaXRvcnkyNTY3NjMxNjk=-flat-auth.c-small-MDEwOlJlcG9zaXRvcnkyNTY3NjMxNjk=-flat-auth.c.html,129,small-MDEwOlJlcG9zaXRvcnkyNTY3NjMxNjk=-flat-auth.c,small-MDEwOlJlcG9zaXRvcnkyNTY3NjMxNjk=-flat-auth.c,319,331,12,468,480,12
107,https://htmlpreview.github.io/?https://github.com/Christina96/boilerplate-sample-matches/blob/main/C/Adafruit_nRF52_Arduino-MDEwOlJlcG9zaXRvcnk3NDM1NDcyOQ==-flat-BLECharacteristic.h-Adafruit_nRF52_Arduino-MDEwOlJlcG9zaXRvcnk3NDM1NDcyOQ==-flat-BLEClientCharacteristic.h.html,18,Adafruit_nRF52_Arduino-MDEwOlJlcG9zaXRvcnk3NDM1NDcyOQ==-flat-BLECharacteristic.h,Adafruit_nRF52_Arduino-MDEwOlJlcG9zaXRvcnk3NDM1NDcyOQ==-flat-BLEClientCharacteristic.h,57,59,2,26,28,2
108,https://htmlpreview.github.io/?https://github.com/Christina96/boilerplate-sample-matches/blob/main/C/fftw3-MDEwOlJlcG9zaXRvcnk4ODQzMzg4-flat-my-getopt.c-fftw3-MDEwOlJlcG9zaXRvcnk4ODQzMzg4-flat-my-getopt.c.html,25,fftw3-MDEwOlJlcG9zaXRvcnk4ODQzMzg4-flat-my-getopt.c,fftw3-MDEwOlJlcG9zaXRvcnk4ODQzMzg4-flat-my-getopt.c,81,88,7,113,120,7
109,https://htmlpreview.github.io/?https://github.com/Christina96/boilerplate-sample-matches/blob/main/C/xmrig-MDEwOlJlcG9zaXRvcnk4ODMyNzQwNg==-flat-sph_shavite.c-xmrig-MDEwOlJlcG9zaXRvcnk4ODMyNzQwNg==-flat-sph_shavite.c.html,43,xmrig-MDEwOlJlcG9zaXRvcnk4ODMyNzQwNg==-flat-sph_shavite.c,xmrig-MDEwOlJlcG9zaXRvcnk4ODMyNzQwNg==-flat-sph_shavite.c,178,185,7,750,757,7
110,https://htmlpreview.github.io/?https://github.com/Christina96/boilerplate-sample-matches/blob/main/C/PINRemoteImage-MDEwOlJlcG9zaXRvcnkzOTUzNzEwMw==-flat-upsampling_msa.c-PINRemoteImage-MDEwOlJlcG9zaXRvcnkzOTUzNzEwMw==-flat-upsampling_msa.c.html,18,PINRemoteImage-MDEwOlJlcG9zaXRvcnkzOTUzNzEwMw==-flat-upsampling_msa.c,PINRemoteImage-MDEwOlJlcG9zaXRvcnkzOTUzNzEwMw==-flat-upsampling_msa.c,104,105,1,100,101,1
111,https://htmlpreview.github.io/?https://github.com/Christina96/boilerplate-sample-matches/blob/main/C/libtomcrypt-MDEwOlJlcG9zaXRvcnk3NzcwMTE=-flat-ecc.c-libtomcrypt-MDEwOlJlcG9zaXRvcnk3NzcwMTE=-flat-ecc.c.html,28,libtomcrypt-MDEwOlJlcG9zaXRvcnk3NzcwMTE=-flat-ecc.c,libtomcrypt-MDEwOlJlcG9zaXRvcnk3NzcwMTE=-flat-ecc.c,397,412,15,217,232,15
112,https://htmlpreview.github.io/?https://github.com/Christina96/boilerplate-sample-matches/blob/main/C/redis-MDEwOlJlcG9zaXRvcnkxMDgxMTA3MDY=-flat-ae_kqueue.c-redis-MDEwOlJlcG9zaXRvcnkxMDgxMTA3MDY=-flat-ae_kqueue.c.html,20,redis-MDEwOlJlcG9zaXRvcnkxMDgxMTA3MDY=-flat-ae_kqueue.c,redis-MDEwOlJlcG9zaXRvcnkxMDgxMTA3MDY=-flat-ae_kqueue.c,68,69,1,71,72,1
113,https://htmlpreview.github.io/?https://github.com/Christina96/boilerplate-sample-matches/blob/main/C/PINRemoteImage-MDEwOlJlcG9zaXRvcnkzOTUzNzEwMw==-flat-enc.c-PINRemoteImage-MDEwOlJlcG9zaXRvcnkzOTUzNzEwMw==-flat-analysis_enc.c.html,15,PINRemoteImage-MDEwOlJlcG9zaXRvcnkzOTUzNzEwMw==-flat-enc.c,PINRemoteImage-MDEwOlJlcG9zaXRvcnkzOTUzNzEwMw==-flat-analysis_enc.c,548,551,3,123,126,3
114,https://htmlpreview.github.io/?https://github.com/Christina96/boilerplate-sample-matches/blob/main/C/redis-MDEwOlJlcG9zaXRvcnkxMDgxMTA3MDY=-flat-replication.c-redis-MDEwOlJlcG9zaXRvcnkxMDgxMTA3MDY=-flat-replication.c.html,20,redis-MDEwOlJlcG9zaXRvcnkxMDgxMTA3MDY=-flat-replication.c,redis-MDEwOlJlcG9zaXRvcnkxMDgxMTA3MDY=-flat-replication.c,905,906,1,1034,1036,2
115,https://htmlpreview.github.io/?https://github.com/Christina96/boilerplate-sample-matches/blob/main/C/libtomcrypt-MDEwOlJlcG9zaXRvcnk3NzcwMTE=-flat-idea.c-libtomcrypt-MDEwOlJlcG9zaXRvcnk3NzcwMTE=-flat-idea.c.html,50,libtomcrypt-MDEwOlJlcG9zaXRvcnk3NzcwMTE=-flat-idea.c,libtomcrypt-MDEwOlJlcG9zaXRvcnk3NzcwMTE=-flat-idea.c,78,82,4,93,97,4
116,https://htmlpreview.github.io/?https://github.com/Christina96/boilerplate-sample-matches/blob/main/C/redis-MDEwOlJlcG9zaXRvcnkxMDgxMTA3MDY=-flat-extent_quantize.c-redis-MDEwOlJlcG9zaXRvcnkxMDgxMTA3MDY=-flat-extent_quantize.c.html,18,redis-MDEwOlJlcG9zaXRvcnkxMDgxMTA3MDY=-flat-extent_quantize.c,redis-MDEwOlJlcG9zaXRvcnkxMDgxMTA3MDY=-flat-extent_quantize.c,97,100,3,100,103,3
117,https://htmlpreview.github.io/?https://github.com/Christina96/boilerplate-sample-matches/blob/main/C/xmrig-MDEwOlJlcG9zaXRvcnk4ODMyNzQwNg==-flat-topology-xml.c-Adafruit_nRF52_Arduino-MDEwOlJlcG9zaXRvcnk3NDM1NDcyOQ==-flat-tasks.c.html,15,xmrig-MDEwOlJlcG9zaXRvcnk4ODMyNzQwNg==-flat-topology-xml.c,Adafruit_nRF52_Arduino-MDEwOlJlcG9zaXRvcnk3NDM1NDcyOQ==-flat-tasks.c,2824,2827,3,1078,1081,3
118,https://htmlpreview.github.io/?https://github.com/Christina96/boilerplate-sample-matches/blob/main/C/libtomcrypt-MDEwOlJlcG9zaXRvcnk3NzcwMTE=-flat-aes.c-libtomcrypt-MDEwOlJlcG9zaXRvcnk3NzcwMTE=-flat-aes.c.html,448,libtomcrypt-MDEwOlJlcG9zaXRvcnk3NzcwMTE=-flat-aes.c,libtomcrypt-MDEwOlJlcG9zaXRvcnk3NzcwMTE=-flat-aes.c,236,301,65,385,450,65
119,https://htmlpreview.github.io/?https://github.com/Christina96/boilerplate-sample-matches/blob/main/C/redis-MDEwOlJlcG9zaXRvcnkxMDgxMTA3MDY=-flat-tsd_malloc_thread_cleanup.h-redis-MDEwOlJlcG9zaXRvcnkxMDgxMTA3MDY=-flat-tsd_win.h.html,15,redis-MDEwOlJlcG9zaXRvcnkxMDgxMTA3MDY=-flat-tsd_malloc_thread_cleanup.h,redis-MDEwOlJlcG9zaXRvcnkxMDgxMTA3MDY=-flat-tsd_win.h,32,38,6,90,97,7
120,https://htmlpreview.github.io/?https://github.com/Christina96/boilerplate-sample-matches/blob/main/C/PINRemoteImage-MDEwOlJlcG9zaXRvcnkzOTUzNzEwMw==-flat-yuv_sse41.c-PINRemoteImage-MDEwOlJlcG9zaXRvcnkzOTUzNzEwMw==-flat-yuv_sse2.c.html,27,PINRemoteImage-MDEwOlJlcG9zaXRvcnkzOTUzNzEwMw==-flat-yuv_sse41.c,PINRemoteImage-MDEwOlJlcG9zaXRvcnkzOTUzNzEwMw==-flat-yuv_sse2.c,189,191,2,368,370,2
121,https://htmlpreview.github.io/?https://github.com/Christina96/boilerplate-sample-matches/blob/main/C/Adafruit_nRF52_Arduino-MDEwOlJlcG9zaXRvcnk3NDM1NDcyOQ==-flat-nrf_qdec.h-Adafruit_nRF52_Arduino-MDEwOlJlcG9zaXRvcnk3NDM1NDcyOQ==-flat-nrf_spi.h.html,21,Adafruit_nRF52_Arduino-MDEwOlJlcG9zaXRvcnk3NDM1NDcyOQ==-flat-nrf_qdec.h,Adafruit_nRF52_Arduino-MDEwOlJlcG9zaXRvcnk3NDM1NDcyOQ==-flat-nrf_spi.h,163,168,5,123,128,5
122,https://htmlpreview.github.io/?https://github.com/Christina96/boilerplate-sample-matches/blob/main/C/redis-MDEwOlJlcG9zaXRvcnkxMDgxMTA3MDY=-flat-sentinel.c-redis-MDEwOlJlcG9zaXRvcnkxMDgxMTA3MDY=-flat-config.c.html,18,redis-MDEwOlJlcG9zaXRvcnkxMDgxMTA3MDY=-flat-sentinel.c,redis-MDEwOlJlcG9zaXRvcnkxMDgxMTA3MDY=-flat-config.c,1197,1198,1,136,137,1
123,https://htmlpreview.github.io/?https://github.com/Christina96/boilerplate-sample-matches/blob/main/C/xmrig-MDEwOlJlcG9zaXRvcnk4ODMyNzQwNg==-flat-topology-x86.c-PINRemoteImage-MDEwOlJlcG9zaXRvcnkzOTUzNzEwMw==-flat-yuv_sse2.c.html,17,xmrig-MDEwOlJlcG9zaXRvcnk4ODMyNzQwNg==-flat-topology-x86.c,PINRemoteImage-MDEwOlJlcG9zaXRvcnkzOTUzNzEwMw==-flat-yuv_sse2.c,559,560,1,157,158,1
124,https://htmlpreview.github.io/?https://github.com/Christina96/boilerplate-sample-matches/blob/main/C/libtomcrypt-MDEwOlJlcG9zaXRvcnk3NzcwMTE=-flat-hkdf.c-xmrig-MDEwOlJlcG9zaXRvcnk4ODMyNzQwNg==-flat-argon2.c.html,16,libtomcrypt-MDEwOlJlcG9zaXRvcnk3NzcwMTE=-flat-hkdf.c,xmrig-MDEwOlJlcG9zaXRvcnk4ODMyNzQwNg==-flat-argon2.c,53,57,4,135,139,4
125,https://htmlpreview.github.io/?https://github.com/Christina96/boilerplate-sample-matches/blob/main/C/Adafruit_nRF52_Arduino-MDEwOlJlcG9zaXRvcnk3NDM1NDcyOQ==-flat-nrf52833.h-Adafruit_nRF52_Arduino-MDEwOlJlcG9zaXRvcnk3NDM1NDcyOQ==-flat-nrf52840.h.html,26,Adafruit_nRF52_Arduino-MDEwOlJlcG9zaXRvcnk3NDM1NDcyOQ==-flat-nrf52833.h,Adafruit_nRF52_Arduino-MDEwOlJlcG9zaXRvcnk3NDM1NDcyOQ==-flat-nrf52840.h,414,417,3,417,420,3
126,https://htmlpreview.github.io/?https://github.com/Christina96/boilerplate-sample-matches/blob/main/C/Adafruit_nRF52_Arduino-MDEwOlJlcG9zaXRvcnk3NDM1NDcyOQ==-flat-lfs.h-Adafruit_nRF52_Arduino-MDEwOlJlcG9zaXRvcnk3NDM1NDcyOQ==-flat-lfs.h.html,24,Adafruit_nRF52_Arduino-MDEwOlJlcG9zaXRvcnk3NDM1NDcyOQ==-flat-lfs.h,Adafruit_nRF52_Arduino-MDEwOlJlcG9zaXRvcnk3NDM1NDcyOQ==-flat-lfs.h,183,185,2,191,193,2
127,https://htmlpreview.github.io/?https://github.com/Christina96/boilerplate-sample-matches/blob/main/C/libtomcrypt-MDEwOlJlcG9zaXRvcnk3NzcwMTE=-flat-ecc_import_openssl.c-libtomcrypt-MDEwOlJlcG9zaXRvcnk3NzcwMTE=-flat-ecc_import_openssl.c.html,76,libtomcrypt-MDEwOlJlcG9zaXRvcnk3NzcwMTE=-flat-ecc_import_openssl.c,libtomcrypt-MDEwOlJlcG9zaXRvcnk3NzcwMTE=-flat-ecc_import_openssl.c,13,17,4,42,46,4
128,https://htmlpreview.github.io/?https://github.com/Christina96/boilerplate-sample-matches/blob/main/C/libtomcrypt-MDEwOlJlcG9zaXRvcnk3NzcwMTE=-flat-chacha20poly1305_add_aad.c-libtomcrypt-MDEwOlJlcG9zaXRvcnk3NzcwMTE=-flat-chacha20poly1305_encrypt.c.html,13,libtomcrypt-MDEwOlJlcG9zaXRvcnk3NzcwMTE=-flat-chacha20poly1305_add_aad.c,libtomcrypt-MDEwOlJlcG9zaXRvcnk3NzcwMTE=-flat-chacha20poly1305_encrypt.c,10,13,3,18,21,3
129,https://htmlpreview.github.io/?https://github.com/Christina96/boilerplate-sample-matches/blob/main/C/redis-MDEwOlJlcG9zaXRvcnkxMDgxMTA3MDY=-flat-read.c-redis-MDEwOlJlcG9zaXRvcnkxMDgxMTA3MDY=-flat-hiredis.c.html,15,redis-MDEwOlJlcG9zaXRvcnkxMDgxMTA3MDY=-flat-read.c,redis-MDEwOlJlcG9zaXRvcnkxMDgxMTA3MDY=-flat-hiredis.c,337,339,2,465,467,2
130,https://htmlpreview.github.io/?https://github.com/Christina96/boilerplate-sample-matches/blob/main/C/Adafruit_nRF52_Arduino-MDEwOlJlcG9zaXRvcnk3NDM1NDcyOQ==-flat-nrf52840.h-Adafruit_nRF52_Arduino-MDEwOlJlcG9zaXRvcnk3NDM1NDcyOQ==-flat-nrf52833.h.html,280,Adafruit_nRF52_Arduino-MDEwOlJlcG9zaXRvcnk3NDM1NDcyOQ==-flat-nrf52840.h,Adafruit_nRF52_Arduino-MDEwOlJlcG9zaXRvcnk3NDM1NDcyOQ==-flat-nrf52833.h,1120,1141,21,1114,1135,21
131,https://htmlpreview.github.io/?https://github.com/Christina96/boilerplate-sample-matches/blob/main/C/redis-MDEwOlJlcG9zaXRvcnkxMDgxMTA3MDY=-flat-extent_inlines.h-redis-MDEwOlJlcG9zaXRvcnkxMDgxMTA3MDY=-flat-extent_inlines.h.html,38,redis-MDEwOlJlcG9zaXRvcnkxMDgxMTA3MDY=-flat-extent_inlines.h,redis-MDEwOlJlcG9zaXRvcnkxMDgxMTA3MDY=-flat-extent_inlines.h,375,380,5,381,386,5
132,https://htmlpreview.github.io/?https://github.com/Christina96/boilerplate-sample-matches/blob/main/C/small-MDEwOlJlcG9zaXRvcnkyNTY3NjMxNjk=-flat-resolv.c-small-MDEwOlJlcG9zaXRvcnkyNTY3NjMxNjk=-flat-resolv.c.html,61,small-MDEwOlJlcG9zaXRvcnkyNTY3NjMxNjk=-flat-resolv.c,small-MDEwOlJlcG9zaXRvcnkyNTY3NjMxNjk=-flat-resolv.c,198,213,15,238,253,15
133,https://htmlpreview.github.io/?https://github.com/Christina96/boilerplate-sample-matches/blob/main/C/Adafruit_nRF52_Arduino-MDEwOlJlcG9zaXRvcnk3NDM1NDcyOQ==-flat-tweetnacl.c-libtomcrypt-MDEwOlJlcG9zaXRvcnk3NzcwMTE=-flat-tweetnacl.c.html,194,Adafruit_nRF52_Arduino-MDEwOlJlcG9zaXRvcnk3NDM1NDcyOQ==-flat-tweetnacl.c,libtomcrypt-MDEwOlJlcG9zaXRvcnk3NzcwMTE=-flat-tweetnacl.c,19,26,7,13,20,7
134,https://htmlpreview.github.io/?https://github.com/Christina96/boilerplate-sample-matches/blob/main/C/PINRemoteImage-MDEwOlJlcG9zaXRvcnkzOTUzNzEwMw==-flat-backward_references_enc.c-libtomcrypt-MDEwOlJlcG9zaXRvcnk3NzcwMTE=-flat-sober128_stream.c.html,23,PINRemoteImage-MDEwOlJlcG9zaXRvcnkzOTUzNzEwMw==-flat-backward_references_enc.c,libtomcrypt-MDEwOlJlcG9zaXRvcnk3NzcwMTE=-flat-sober128_stream.c,453,455,2,110,112,2
135,https://htmlpreview.github.io/?https://github.com/Christina96/boilerplate-sample-matches/blob/main/C/fftw3-MDEwOlJlcG9zaXRvcnk4ODQzMzg4-flat-rdft-vrank-geq1.c-fftw3-MDEwOlJlcG9zaXRvcnk4ODQzMzg4-flat-dft-rank1-bigvec.c.html,21,fftw3-MDEwOlJlcG9zaXRvcnk4ODQzMzg4-flat-rdft-vrank-geq1.c,fftw3-MDEwOlJlcG9zaXRvcnk4ODQzMzg4-flat-dft-rank1-bigvec.c,155,159,4,141,145,4
136,https://htmlpreview.github.io/?https://github.com/Christina96/boilerplate-sample-matches/blob/main/C/redis-MDEwOlJlcG9zaXRvcnkxMDgxMTA3MDY=-flat-cluster.c-redis-MDEwOlJlcG9zaXRvcnkxMDgxMTA3MDY=-flat-cluster.c.html,25,redis-MDEwOlJlcG9zaXRvcnkxMDgxMTA3MDY=-flat-cluster.c,redis-MDEwOlJlcG9zaXRvcnkxMDgxMTA3MDY=-flat-cluster.c,630,632,2,773,775,2
137,https://htmlpreview.github.io/?https://github.com/Christina96/boilerplate-sample-matches/blob/main/C/libtomcrypt-MDEwOlJlcG9zaXRvcnk3NzcwMTE=-flat-safer.c-libtomcrypt-MDEwOlJlcG9zaXRvcnk3NzcwMTE=-flat-safer.c.html,22,libtomcrypt-MDEwOlJlcG9zaXRvcnk3NzcwMTE=-flat-safer.c,libtomcrypt-MDEwOlJlcG9zaXRvcnk3NzcwMTE=-flat-safer.c,265,266,1,267,268,1
138,https://htmlpreview.github.io/?https://github.com/Christina96/boilerplate-sample-matches/blob/main/C/Adafruit_nRF52_Arduino-MDEwOlJlcG9zaXRvcnk3NDM1NDcyOQ==-flat-nrf_power.h-Adafruit_nRF52_Arduino-MDEwOlJlcG9zaXRvcnk3NDM1NDcyOQ==-flat-nrf_power.h.html,15,Adafruit_nRF52_Arduino-MDEwOlJlcG9zaXRvcnk3NDM1NDcyOQ==-flat-nrf_power.h,Adafruit_nRF52_Arduino-MDEwOlJlcG9zaXRvcnk3NDM1NDcyOQ==-flat-nrf_power.h,593,596,3,587,590,3
139,https://htmlpreview.github.io/?https://github.com/Christina96/boilerplate-sample-matches/blob/main/C/redis-MDEwOlJlcG9zaXRvcnkxMDgxMTA3MDY=-flat-bit_util.h-redis-MDEwOlJlcG9zaXRvcnkxMDgxMTA3MDY=-flat-bit_util.h.html,16,redis-MDEwOlJlcG9zaXRvcnkxMDgxMTA3MDY=-flat-bit_util.h,redis-MDEwOlJlcG9zaXRvcnkxMDgxMTA3MDY=-flat-bit_util.h,175,177,2,172,174,2
140,https://htmlpreview.github.io/?https://github.com/Christina96/boilerplate-sample-matches/blob/main/C/PINRemoteImage-MDEwOlJlcG9zaXRvcnkzOTUzNzEwMw==-flat-cpu.c-PINRemoteImage-MDEwOlJlcG9zaXRvcnkzOTUzNzEwMw==-flat-cpu.c.html,31,PINRemoteImage-MDEwOlJlcG9zaXRvcnkzOTUzNzEwMw==-flat-cpu.c,PINRemoteImage-MDEwOlJlcG9zaXRvcnkzOTUzNzEwMw==-flat-cpu.c,107,111,4,116,120,4
141,https://htmlpreview.github.io/?https://github.com/Christina96/boilerplate-sample-matches/blob/main/C/libtomcrypt-MDEwOlJlcG9zaXRvcnk3NzcwMTE=-flat-multi2.c-libtomcrypt-MDEwOlJlcG9zaXRvcnk3NzcwMTE=-flat-multi2.c.html,27,libtomcrypt-MDEwOlJlcG9zaXRvcnk3NzcwMTE=-flat-multi2.c,libtomcrypt-MDEwOlJlcG9zaXRvcnk3NzcwMTE=-flat-multi2.c,116,120,4,129,133,4
142,https://htmlpreview.github.io/?https://github.com/Christina96/boilerplate-sample-matches/blob/main/C/Adafruit_nRF52_Arduino-MDEwOlJlcG9zaXRvcnk3NDM1NDcyOQ==-flat-BLEAdafruitButton.h-Adafruit_nRF52_Arduino-MDEwOlJlcG9zaXRvcnk3NDM1NDcyOQ==-flat-BLEAdafruitProximity.h.html,13,Adafruit_nRF52_Arduino-MDEwOlJlcG9zaXRvcnk3NDM1NDcyOQ==-flat-BLEAdafruitButton.h,Adafruit_nRF52_Arduino-MDEwOlJlcG9zaXRvcnk3NDM1NDcyOQ==-flat-BLEAdafruitProximity.h,8,11,3,8,11,3
143,https://htmlpreview.github.io/?https://github.com/Christina96/boilerplate-sample-matches/blob/main/C/PINRemoteImage-MDEwOlJlcG9zaXRvcnkzOTUzNzEwMw==-flat-dec_neon.c-PINRemoteImage-MDEwOlJlcG9zaXRvcnkzOTUzNzEwMw==-flat-gif2webp.c.html,15,PINRemoteImage-MDEwOlJlcG9zaXRvcnkzOTUzNzEwMw==-flat-dec_neon.c,PINRemoteImage-MDEwOlJlcG9zaXRvcnkzOTUzNzEwMw==-flat-gif2webp.c,1192,1195,3,204,207,3
144,https://htmlpreview.github.io/?https://github.com/Christina96/boilerplate-sample-matches/blob/main/C/Adafruit_nRF52_Arduino-MDEwOlJlcG9zaXRvcnk3NDM1NDcyOQ==-flat-nrfx_gppi.h-Adafruit_nRF52_Arduino-MDEwOlJlcG9zaXRvcnk3NDM1NDcyOQ==-flat-nrf_gpio.h.html,15,Adafruit_nRF52_Arduino-MDEwOlJlcG9zaXRvcnk3NDM1NDcyOQ==-flat-nrfx_gppi.h,Adafruit_nRF52_Arduino-MDEwOlJlcG9zaXRvcnk3NDM1NDcyOQ==-flat-nrf_gpio.h,105,108,3,103,106,3
145,https://htmlpreview.github.io/?https://github.com/Christina96/boilerplate-sample-matches/blob/main/C/xmrig-MDEwOlJlcG9zaXRvcnk4ODMyNzQwNg==-flat-document.h-xmrig-MDEwOlJlcG9zaXRvcnk4ODMyNzQwNg==-flat-document.h.html,25,xmrig-MDEwOlJlcG9zaXRvcnk4ODMyNzQwNg==-flat-document.h,xmrig-MDEwOlJlcG9zaXRvcnk4ODMyNzQwNg==-flat-document.h,1608,1613,5,1686,1692,6
146,https://htmlpreview.github.io/?https://github.com/Christina96/boilerplate-sample-matches/blob/main/C/libtomcrypt-MDEwOlJlcG9zaXRvcnk3NzcwMTE=-flat-chacha20.c-libtomcrypt-MDEwOlJlcG9zaXRvcnk3NzcwMTE=-flat-rabbit.c.html,17,libtomcrypt-MDEwOlJlcG9zaXRvcnk3NzcwMTE=-flat-chacha20.c,libtomcrypt-MDEwOlJlcG9zaXRvcnk3NzcwMTE=-flat-rabbit.c,96,102,6,174,180,6
147,https://htmlpreview.github.io/?https://github.com/Christina96/boilerplate-sample-matches/blob/main/C/libtomcrypt-MDEwOlJlcG9zaXRvcnk3NzcwMTE=-flat-rsa_set.c-libtomcrypt-MDEwOlJlcG9zaXRvcnk3NzcwMTE=-flat-rsa_set.c.html,78,libtomcrypt-MDEwOlJlcG9zaXRvcnk3NzcwMTE=-flat-rsa_set.c,libtomcrypt-MDEwOlJlcG9zaXRvcnk3NzcwMTE=-flat-rsa_set.c,36,40,4,55,59,4
148,https://htmlpreview.github.io/?https://github.com/Christina96/boilerplate-sample-matches/blob/main/C/redis-MDEwOlJlcG9zaXRvcnkxMDgxMTA3MDY=-flat-redis-cli.c-redis-MDEwOlJlcG9zaXRvcnkxMDgxMTA3MDY=-flat-redis-cli.c.html,51,redis-MDEwOlJlcG9zaXRvcnkxMDgxMTA3MDY=-flat-redis-cli.c,redis-MDEwOlJlcG9zaXRvcnkxMDgxMTA3MDY=-flat-redis-cli.c,4413,4424,11,4430,4441,11
149,https://htmlpreview.github.io/?https://github.com/Christina96/boilerplate-sample-matches/blob/main/C/PINRemoteImage-MDEwOlJlcG9zaXRvcnkzOTUzNzEwMw==-flat-lossless_enc_mips32.c-PINRemoteImage-MDEwOlJlcG9zaXRvcnkzOTUzNzEwMw==-flat-lossless_enc_mips32.c.html,20,PINRemoteImage-MDEwOlJlcG9zaXRvcnkzOTUzNzEwMw==-flat-lossless_enc_mips32.c,PINRemoteImage-MDEwOlJlcG9zaXRvcnkzOTUzNzEwMw==-flat-lossless_enc_mips32.c,256,259,3,266,269,3
150,https://htmlpreview.github.io/?https://github.com/Christina96/boilerplate-sample-matches/blob/main/C/redis-MDEwOlJlcG9zaXRvcnkxMDgxMTA3MDY=-flat-hook.c-redis-MDEwOlJlcG9zaXRvcnkxMDgxMTA3MDY=-flat-hook.c.html,16,redis-MDEwOlJlcG9zaXRvcnkxMDgxMTA3MDY=-flat-hook.c,redis-MDEwOlJlcG9zaXRvcnkxMDgxMTA3MDY=-flat-hook.c,114,116,2,132,134,2
151,https://htmlpreview.github.io/?https://github.com/Christina96/boilerplate-sample-matches/blob/main/C/xmrig-MDEwOlJlcG9zaXRvcnk4ODMyNzQwNg==-flat-schema.h-xmrig-MDEwOlJlcG9zaXRvcnk4ODMyNzQwNg==-flat-schema.h.html,18,xmrig-MDEwOlJlcG9zaXRvcnk4ODMyNzQwNg==-flat-schema.h,xmrig-MDEwOlJlcG9zaXRvcnk4ODMyNzQwNg==-flat-schema.h,299,304,5,1259,1264,5
152,https://htmlpreview.github.io/?https://github.com/Christina96/boilerplate-sample-matches/blob/main/C/xmrig-MDEwOlJlcG9zaXRvcnk4ODMyNzQwNg==-flat-sph_simd.c-xmrig-MDEwOlJlcG9zaXRvcnk4ODMyNzQwNg==-flat-sph_simd.c.html,94,xmrig-MDEwOlJlcG9zaXRvcnk4ODMyNzQwNg==-flat-sph_simd.c,xmrig-MDEwOlJlcG9zaXRvcnk4ODMyNzQwNg==-flat-sph_simd.c,866,873,7,1223,1231,8
153,https://htmlpreview.github.io/?https://github.com/Christina96/boilerplate-sample-matches/blob/main/C/redis-MDEwOlJlcG9zaXRvcnkxMDgxMTA3MDY=-flat-base.c-redis-MDEwOlJlcG9zaXRvcnkxMDgxMTA3MDY=-flat-arena_reset.c.html,17,redis-MDEwOlJlcG9zaXRvcnkxMDgxMTA3MDY=-flat-base.c,redis-MDEwOlJlcG9zaXRvcnkxMDgxMTA3MDY=-flat-arena_reset.c,17,22,5,230,236,6
154,https://htmlpreview.github.io/?https://github.com/Christina96/boilerplate-sample-matches/blob/main/C/redis-MDEwOlJlcG9zaXRvcnkxMDgxMTA3MDY=-flat-object.c-redis-MDEwOlJlcG9zaXRvcnkxMDgxMTA3MDY=-flat-object.c.html,33,redis-MDEwOlJlcG9zaXRvcnkxMDgxMTA3MDY=-flat-object.c,redis-MDEwOlJlcG9zaXRvcnkxMDgxMTA3MDY=-flat-object.c,421,428,7,460,467,7
155,https://htmlpreview.github.io/?https://github.com/Christina96/boilerplate-sample-matches/blob/main/C/redis-MDEwOlJlcG9zaXRvcnkxMDgxMTA3MDY=-flat-emitter.c-redis-MDEwOlJlcG9zaXRvcnkxMDgxMTA3MDY=-flat-emitter.c.html,32,redis-MDEwOlJlcG9zaXRvcnkxMDgxMTA3MDY=-flat-emitter.c,redis-MDEwOlJlcG9zaXRvcnkxMDgxMTA3MDY=-flat-emitter.c,247,258,11,99,110,11
156,https://htmlpreview.github.io/?https://github.com/Christina96/boilerplate-sample-matches/blob/main/C/small-MDEwOlJlcG9zaXRvcnkyNTY3NjMxNjk=-flat-udprelay.c-small-MDEwOlJlcG9zaXRvcnkyNTY3NjMxNjk=-flat-udprelay.c.html,73,small-MDEwOlJlcG9zaXRvcnkyNTY3NjMxNjk=-flat-udprelay.c,small-MDEwOlJlcG9zaXRvcnkyNTY3NjMxNjk=-flat-udprelay.c,175,185,10,216,227,11
157,https://htmlpreview.github.io/?https://github.com/Christina96/boilerplate-sample-matches/blob/main/C/fftw3-MDEwOlJlcG9zaXRvcnk4ODQzMzg4-flat-rank-geq2-rdft2.c-fftw3-MDEwOlJlcG9zaXRvcnk4ODQzMzg4-flat-rank-geq2.c.html,199,fftw3-MDEwOlJlcG9zaXRvcnk4ODQzMzg4-flat-rank-geq2-rdft2.c,fftw3-MDEwOlJlcG9zaXRvcnk4ODQzMzg4-flat-rank-geq2.c,141,164,23,107,130,23
158,https://htmlpreview.github.io/?https://github.com/Christina96/boilerplate-sample-matches/blob/main/C/Adafruit_nRF52_Arduino-MDEwOlJlcG9zaXRvcnk3NDM1NDcyOQ==-flat-nrf52833.h-Adafruit_nRF52_Arduino-MDEwOlJlcG9zaXRvcnk3NDM1NDcyOQ==-flat-nrf52810.h.html,1451,Adafruit_nRF52_Arduino-MDEwOlJlcG9zaXRvcnk3NDM1NDcyOQ==-flat-nrf52833.h,Adafruit_nRF52_Arduino-MDEwOlJlcG9zaXRvcnk3NDM1NDcyOQ==-flat-nrf52810.h,1261,1356,95,925,1020,95
159,https://htmlpreview.github.io/?https://github.com/Christina96/boilerplate-sample-matches/blob/main/C/fftw3-MDEwOlJlcG9zaXRvcnk4ODQzMzg4-flat-reodft010e-r2hc.c-fftw3-MDEwOlJlcG9zaXRvcnk4ODQzMzg4-flat-reodft010e-r2hc.c.html,26,fftw3-MDEwOlJlcG9zaXRvcnk4ODQzMzg4-flat-reodft010e-r2hc.c,fftw3-MDEwOlJlcG9zaXRvcnk4ODQzMzg4-flat-reodft010e-r2hc.c,124,128,4,167,171,4
160,https://htmlpreview.github.io/?https://github.com/Christina96/boilerplate-sample-matches/blob/main/C/Adafruit_nRF52_Arduino-MDEwOlJlcG9zaXRvcnk3NDM1NDcyOQ==-flat-nrfx_spis.c-Adafruit_nRF52_Arduino-MDEwOlJlcG9zaXRvcnk3NDM1NDcyOQ==-flat-nrfx_spis.c.html,17,Adafruit_nRF52_Arduino-MDEwOlJlcG9zaXRvcnk3NDM1NDcyOQ==-flat-nrfx_spis.c,Adafruit_nRF52_Arduino-MDEwOlJlcG9zaXRvcnk3NDM1NDcyOQ==-flat-nrfx_spis.c,132,139,7,146,153,7
161,https://htmlpreview.github.io/?https://github.com/Christina96/boilerplate-sample-matches/blob/main/C/small-MDEwOlJlcG9zaXRvcnkyNTY3NjMxNjk=-flat-auth.c-small-MDEwOlJlcG9zaXRvcnkyNTY3NjMxNjk=-flat-auth.c.html,62,small-MDEwOlJlcG9zaXRvcnkyNTY3NjMxNjk=-flat-auth.c,small-MDEwOlJlcG9zaXRvcnkyNTY3NjMxNjk=-flat-auth.c,515,522,7,364,371,7
162,https://htmlpreview.github.io/?https://github.com/Christina96/boilerplate-sample-matches/blob/main/C/redis-MDEwOlJlcG9zaXRvcnkxMDgxMTA3MDY=-flat-stats_7.c-redis-MDEwOlJlcG9zaXRvcnkxMDgxMTA3MDY=-flat-stats_7.c.html,22,redis-MDEwOlJlcG9zaXRvcnkxMDgxMTA3MDY=-flat-stats_7.c,redis-MDEwOlJlcG9zaXRvcnkxMDgxMTA3MDY=-flat-stats_7.c,721,723,2,741,743,2
163,https://htmlpreview.github.io/?https://github.com/Christina96/boilerplate-sample-matches/blob/main/C/xmrig-MDEwOlJlcG9zaXRvcnk4ODMyNzQwNg==-flat-api.h-xmrig-MDEwOlJlcG9zaXRvcnk4ODMyNzQwNg==-flat-llhttp.h.html,228,xmrig-MDEwOlJlcG9zaXRvcnk4ODMyNzQwNg==-flat-api.h,xmrig-MDEwOlJlcG9zaXRvcnk4ODMyNzQwNg==-flat-llhttp.h,50,91,41,284,326,42
164,https://htmlpreview.github.io/?https://github.com/Christina96/boilerplate-sample-matches/blob/main/C/xmrig-MDEwOlJlcG9zaXRvcnk4ODMyNzQwNg==-flat-sse2neon.h-xmrig-MDEwOlJlcG9zaXRvcnk4ODMyNzQwNg==-flat-sse2neon.h.html,36,xmrig-MDEwOlJlcG9zaXRvcnk4ODMyNzQwNg==-flat-sse2neon.h,xmrig-MDEwOlJlcG9zaXRvcnk4ODMyNzQwNg==-flat-sse2neon.h,2012,2013,1,2011,2012,1
165,https://htmlpreview.github.io/?https://github.com/Christina96/boilerplate-sample-matches/blob/main/C/xmrig-MDEwOlJlcG9zaXRvcnk4ODMyNzQwNg==-flat-topology-synthetic.c-redis-MDEwOlJlcG9zaXRvcnkxMDgxMTA3MDY=-flat-t_stream.c.html,18,xmrig-MDEwOlJlcG9zaXRvcnk4ODMyNzQwNg==-flat-topology-synthetic.c,redis-MDEwOlJlcG9zaXRvcnkxMDgxMTA3MDY=-flat-t_stream.c,211,213,2,908,910,2
166,https://htmlpreview.github.io/?https://github.com/Christina96/boilerplate-sample-matches/blob/main/C/libtomcrypt-MDEwOlJlcG9zaXRvcnk3NzcwMTE=-flat-aes.c-libtomcrypt-MDEwOlJlcG9zaXRvcnk3NzcwMTE=-flat-aesni.c.html,61,libtomcrypt-MDEwOlJlcG9zaXRvcnk3NzcwMTE=-flat-aes.c,libtomcrypt-MDEwOlJlcG9zaXRvcnk3NzcwMTE=-flat-aesni.c,69,75,6,37,43,6
167,https://htmlpreview.github.io/?https://github.com/Christina96/boilerplate-sample-matches/blob/main/C/redis-MDEwOlJlcG9zaXRvcnkxMDgxMTA3MDY=-flat-rb.h-redis-MDEwOlJlcG9zaXRvcnkxMDgxMTA3MDY=-flat-rb.h.html,23,redis-MDEwOlJlcG9zaXRvcnkxMDgxMTA3MDY=-flat-rb.h,redis-MDEwOlJlcG9zaXRvcnkxMDgxMTA3MDY=-flat-rb.h,795,797,2,798,800,2
168,https://htmlpreview.github.io/?https://github.com/Christina96/boilerplate-sample-matches/blob/main/C/PINRemoteImage-MDEwOlJlcG9zaXRvcnkzOTUzNzEwMw==-flat-yuv_mips_dsp_r2.c-PINRemoteImage-MDEwOlJlcG9zaXRvcnkzOTUzNzEwMw==-flat-yuv_mips32.c.html,21,PINRemoteImage-MDEwOlJlcG9zaXRvcnkzOTUzNzEwMw==-flat-yuv_mips_dsp_r2.c,PINRemoteImage-MDEwOlJlcG9zaXRvcnkzOTUzNzEwMw==-flat-yuv_mips32.c,75,79,4,37,41,4
169,https://htmlpreview.github.io/?https://github.com/Christina96/boilerplate-sample-matches/blob/main/C/redis-MDEwOlJlcG9zaXRvcnkxMDgxMTA3MDY=-flat-t_stream.c-redis-MDEwOlJlcG9zaXRvcnkxMDgxMTA3MDY=-flat-sentinel.c.html,19,redis-MDEwOlJlcG9zaXRvcnkxMDgxMTA3MDY=-flat-t_stream.c,redis-MDEwOlJlcG9zaXRvcnkxMDgxMTA3MDY=-flat-sentinel.c,1606,1608,2,2052,2054,2
170,https://htmlpreview.github.io/?https://github.com/Christina96/boilerplate-sample-matches/blob/main/C/redis-MDEwOlJlcG9zaXRvcnkxMDgxMTA3MDY=-flat-async.c-redis-MDEwOlJlcG9zaXRvcnkxMDgxMTA3MDY=-flat-ae.h.html,53,redis-MDEwOlJlcG9zaXRvcnkxMDgxMTA3MDY=-flat-async.c,redis-MDEwOlJlcG9zaXRvcnkxMDgxMTA3MDY=-flat-ae.h,86,94,8,83,91,8
171,https://htmlpreview.github.io/?https://github.com/Christina96/boilerplate-sample-matches/blob/main/C/xmrig-MDEwOlJlcG9zaXRvcnk4ODMyNzQwNg==-flat-format.h-xmrig-MDEwOlJlcG9zaXRvcnk4ODMyNzQwNg==-flat-format-inl.h.html,17,xmrig-MDEwOlJlcG9zaXRvcnk4ODMyNzQwNg==-flat-format.h,xmrig-MDEwOlJlcG9zaXRvcnk4ODMyNzQwNg==-flat-format-inl.h,567,568,1,1034,1035,1
172,https://htmlpreview.github.io/?https://github.com/Christina96/boilerplate-sample-matches/blob/main/C/small-MDEwOlJlcG9zaXRvcnkyNTY3NjMxNjk=-flat-server.c-small-MDEwOlJlcG9zaXRvcnkyNTY3NjMxNjk=-flat-server.c.html,37,small-MDEwOlJlcG9zaXRvcnkyNTY3NjMxNjk=-flat-server.c,small-MDEwOlJlcG9zaXRvcnkyNTY3NjMxNjk=-flat-server.c,673,678,5,1058,1063,5
173,https://htmlpreview.github.io/?https://github.com/Christina96/boilerplate-sample-matches/blob/main/C/Adafruit_nRF52_Arduino-MDEwOlJlcG9zaXRvcnk3NDM1NDcyOQ==-flat-flash_nrf5x.c-Adafruit_nRF52_Arduino-MDEwOlJlcG9zaXRvcnk3NDM1NDcyOQ==-flat-flash_nrf5x.c.html,24,Adafruit_nRF52_Arduino-MDEwOlJlcG9zaXRvcnk3NDM1NDcyOQ==-flat-flash_nrf5x.c,Adafruit_nRF52_Arduino-MDEwOlJlcG9zaXRvcnk3NDM1NDcyOQ==-flat-flash_nrf5x.c,76,80,4,83,87,4
174,https://htmlpreview.github.io/?https://github.com/Christina96/boilerplate-sample-matches/blob/main/C/PINRemoteImage-MDEwOlJlcG9zaXRvcnkzOTUzNzEwMw==-flat-dec_neon.c-PINRemoteImage-MDEwOlJlcG9zaXRvcnkzOTUzNzEwMw==-flat-dec_neon.c.html,22,PINRemoteImage-MDEwOlJlcG9zaXRvcnkzOTUzNzEwMw==-flat-dec_neon.c,PINRemoteImage-MDEwOlJlcG9zaXRvcnkzOTUzNzEwMw==-flat-dec_neon.c,1112,1116,4,1184,1188,4
175,https://htmlpreview.github.io/?https://github.com/Christina96/boilerplate-sample-matches/blob/main/C/PINRemoteImage-MDEwOlJlcG9zaXRvcnkzOTUzNzEwMw==-flat-cost_neon.c-PINRemoteImage-MDEwOlJlcG9zaXRvcnkzOTUzNzEwMw==-flat-cost_sse2.c.html,100,PINRemoteImage-MDEwOlJlcG9zaXRvcnkzOTUzNzEwMw==-flat-cost_neon.c,PINRemoteImage-MDEwOlJlcG9zaXRvcnkzOTUzNzEwMw==-flat-cost_sse2.c,69,86,17,59,76,17
176,https://htmlpreview.github.io/?https://github.com/Christina96/boilerplate-sample-matches/blob/main/C/redis-MDEwOlJlcG9zaXRvcnkxMDgxMTA3MDY=-flat-quicklist.c-redis-MDEwOlJlcG9zaXRvcnkxMDgxMTA3MDY=-flat-quicklist.c.html,110,redis-MDEwOlJlcG9zaXRvcnkxMDgxMTA3MDY=-flat-quicklist.c,redis-MDEwOlJlcG9zaXRvcnkxMDgxMTA3MDY=-flat-quicklist.c,338,352,14,355,369,14
177,https://htmlpreview.github.io/?https://github.com/Christina96/boilerplate-sample-matches/blob/main/C/xmrig-MDEwOlJlcG9zaXRvcnk4ODMyNzQwNg==-flat-sph_shavite.c-xmrig-MDEwOlJlcG9zaXRvcnk4ODMyNzQwNg==-flat-sph_shavite.c.html,18,xmrig-MDEwOlJlcG9zaXRvcnk4ODMyNzQwNg==-flat-sph_shavite.c,xmrig-MDEwOlJlcG9zaXRvcnk4ODMyNzQwNg==-flat-sph_shavite.c,1262,1266,4,1049,1053,4
178,https://htmlpreview.github.io/?https://github.com/Christina96/boilerplate-sample-matches/blob/main/C/Adafruit_nRF52_Arduino-MDEwOlJlcG9zaXRvcnk3NDM1NDcyOQ==-flat-SEGGER_RTT.c-Adafruit_nRF52_Arduino-MDEwOlJlcG9zaXRvcnk3NDM1NDcyOQ==-flat-SEGGER_RTT.c.html,29,Adafruit_nRF52_Arduino-MDEwOlJlcG9zaXRvcnk3NDM1NDcyOQ==-flat-SEGGER_RTT.c,Adafruit_nRF52_Arduino-MDEwOlJlcG9zaXRvcnk3NDM1NDcyOQ==-flat-SEGGER_RTT.c,503,510,7,534,541,7
179,https://htmlpreview.github.io/?https://github.com/Christina96/boilerplate-sample-matches/blob/main/C/PINRemoteImage-MDEwOlJlcG9zaXRvcnkzOTUzNzEwMw==-flat-jpegdec.c-redis-MDEwOlJlcG9zaXRvcnkxMDgxMTA3MDY=-flat-sort.c.html,17,PINRemoteImage-MDEwOlJlcG9zaXRvcnkzOTUzNzEwMw==-flat-jpegdec.c,redis-MDEwOlJlcG9zaXRvcnkxMDgxMTA3MDY=-flat-sort.c,131,133,2,368,370,2
180,https://htmlpreview.github.io/?https://github.com/Christina96/boilerplate-sample-matches/blob/main/C/redis-MDEwOlJlcG9zaXRvcnkxMDgxMTA3MDY=-flat-config.c-redis-MDEwOlJlcG9zaXRvcnkxMDgxMTA3MDY=-flat-config.c.html,28,redis-MDEwOlJlcG9zaXRvcnkxMDgxMTA3MDY=-flat-config.c,redis-MDEwOlJlcG9zaXRvcnkxMDgxMTA3MDY=-flat-config.c,533,537,4,508,512,4
181,https://htmlpreview.github.io/?https://github.com/Christina96/boilerplate-sample-matches/blob/main/C/redis-MDEwOlJlcG9zaXRvcnkxMDgxMTA3MDY=-flat-lvm.c-redis-MDEwOlJlcG9zaXRvcnkxMDgxMTA3MDY=-flat-lvm.c.html,58,redis-MDEwOlJlcG9zaXRvcnkxMDgxMTA3MDY=-flat-lvm.c,redis-MDEwOlJlcG9zaXRvcnkxMDgxMTA3MDY=-flat-lvm.c,477,489,12,485,497,12
182,https://htmlpreview.github.io/?https://github.com/Christina96/boilerplate-sample-matches/blob/main/C/redis-MDEwOlJlcG9zaXRvcnkxMDgxMTA3MDY=-flat-stats_7.c-redis-MDEwOlJlcG9zaXRvcnkxMDgxMTA3MDY=-flat-stats_7.c.html,20,redis-MDEwOlJlcG9zaXRvcnkxMDgxMTA3MDY=-flat-stats_7.c,redis-MDEwOlJlcG9zaXRvcnkxMDgxMTA3MDY=-flat-stats_7.c,218,220,2,225,227,2
183,https://htmlpreview.github.io/?https://github.com/Christina96/boilerplate-sample-matches/blob/main/C/PINRemoteImage-MDEwOlJlcG9zaXRvcnkzOTUzNzEwMw==-flat-demux_41.h-PINRemoteImage-MDEwOlJlcG9zaXRvcnkzOTUzNzEwMw==-flat-demux_29.h.html,318,PINRemoteImage-MDEwOlJlcG9zaXRvcnkzOTUzNzEwMw==-flat-demux_41.h,PINRemoteImage-MDEwOlJlcG9zaXRvcnkzOTUzNzEwMw==-flat-demux_29.h,55,113,58,55,113,58
184,https://htmlpreview.github.io/?https://github.com/Christina96/boilerplate-sample-matches/blob/main/C/libtomcrypt-MDEwOlJlcG9zaXRvcnk3NzcwMTE=-flat-aesni.c-libtomcrypt-MDEwOlJlcG9zaXRvcnk3NzcwMTE=-flat-aesni.c.html,17,libtomcrypt-MDEwOlJlcG9zaXRvcnk3NzcwMTE=-flat-aesni.c,libtomcrypt-MDEwOlJlcG9zaXRvcnk3NzcwMTE=-flat-aesni.c,69,72,3,91,94,3
185,https://htmlpreview.github.io/?https://github.com/Christina96/boilerplate-sample-matches/blob/main/C/xmrig-MDEwOlJlcG9zaXRvcnk4ODMyNzQwNg==-flat-sse2neon.h-xmrig-MDEwOlJlcG9zaXRvcnk4ODMyNzQwNg==-flat-sse2neon.h.html,25,xmrig-MDEwOlJlcG9zaXRvcnk4ODMyNzQwNg==-flat-sse2neon.h,xmrig-MDEwOlJlcG9zaXRvcnk4ODMyNzQwNg==-flat-sse2neon.h,3595,3600,5,1211,1216,5
186,https://htmlpreview.github.io/?https://github.com/Christina96/boilerplate-sample-matches/blob/main/C/xmrig-MDEwOlJlcG9zaXRvcnk4ODMyNzQwNg==-flat-sph_fugue.c-xmrig-MDEwOlJlcG9zaXRvcnk4ODMyNzQwNg==-flat-sph_fugue.c.html,88,xmrig-MDEwOlJlcG9zaXRvcnk4ODMyNzQwNg==-flat-sph_fugue.c,xmrig-MDEwOlJlcG9zaXRvcnk4ODMyNzQwNg==-flat-sph_fugue.c,720,727,7,728,735,7
187,https://htmlpreview.github.io/?https://github.com/Christina96/boilerplate-sample-matches/blob/main/C/xmrig-MDEwOlJlcG9zaXRvcnk4ODMyNzQwNg==-flat-CryptoNight_x86.h-xmrig-MDEwOlJlcG9zaXRvcnk4ODMyNzQwNg==-flat-CryptoNight_x86.h.html,25,xmrig-MDEwOlJlcG9zaXRvcnk4ODMyNzQwNg==-flat-CryptoNight_x86.h,xmrig-MDEwOlJlcG9zaXRvcnk4ODMyNzQwNg==-flat-CryptoNight_x86.h,1139,1145,6,1185,1191,6
188,https://htmlpreview.github.io/?https://github.com/Christina96/boilerplate-sample-matches/blob/main/C/xmrig-MDEwOlJlcG9zaXRvcnk4ODMyNzQwNg==-flat-topology.c-xmrig-MDEwOlJlcG9zaXRvcnk4ODMyNzQwNg==-flat-topology.c.html,21,xmrig-MDEwOlJlcG9zaXRvcnk4ODMyNzQwNg==-flat-topology.c,xmrig-MDEwOlJlcG9zaXRvcnk4ODMyNzQwNg==-flat-topology.c,2536,2537,1,2534,2535,1
189,https://htmlpreview.github.io/?https://github.com/Christina96/boilerplate-sample-matches/blob/main/C/xmrig-MDEwOlJlcG9zaXRvcnk4ODMyNzQwNg==-flat-CryptoNight_x86.h-xmrig-MDEwOlJlcG9zaXRvcnk4ODMyNzQwNg==-flat-CryptoNight_x86.h.html,28,xmrig-MDEwOlJlcG9zaXRvcnk4ODMyNzQwNg==-flat-CryptoNight_x86.h,xmrig-MDEwOlJlcG9zaXRvcnk4ODMyNzQwNg==-flat-CryptoNight_x86.h,588,589,1,589,590,1
190,https://htmlpreview.github.io/?https://github.com/Christina96/boilerplate-sample-matches/blob/main/C/redis-MDEwOlJlcG9zaXRvcnkxMDgxMTA3MDY=-flat-mallctl.c-redis-MDEwOlJlcG9zaXRvcnkxMDgxMTA3MDY=-flat-mallctl.c.html,17,redis-MDEwOlJlcG9zaXRvcnkxMDgxMTA3MDY=-flat-mallctl.c,redis-MDEwOlJlcG9zaXRvcnkxMDgxMTA3MDY=-flat-mallctl.c,521,527,6,547,553,6
191,https://htmlpreview.github.io/?https://github.com/Christina96/boilerplate-sample-matches/blob/main/C/Adafruit_nRF52_Arduino-MDEwOlJlcG9zaXRvcnk3NDM1NDcyOQ==-flat-nrf_clock.h-Adafruit_nRF52_Arduino-MDEwOlJlcG9zaXRvcnk3NDM1NDcyOQ==-flat-nrf_clock.h.html,18,Adafruit_nRF52_Arduino-MDEwOlJlcG9zaXRvcnk3NDM1NDcyOQ==-flat-nrf_clock.h,Adafruit_nRF52_Arduino-MDEwOlJlcG9zaXRvcnk3NDM1NDcyOQ==-flat-nrf_clock.h,79,80,1,54,55,1
192,https://htmlpreview.github.io/?https://github.com/Christina96/boilerplate-sample-matches/blob/main/C/libtomcrypt-MDEwOlJlcG9zaXRvcnk3NzcwMTE=-flat-dh.c-libtomcrypt-MDEwOlJlcG9zaXRvcnk3NzcwMTE=-flat-dh.c.html,74,libtomcrypt-MDEwOlJlcG9zaXRvcnk3NzcwMTE=-flat-dh.c,libtomcrypt-MDEwOlJlcG9zaXRvcnk3NzcwMTE=-flat-dh.c,72,105,33,101,134,33
193,https://htmlpreview.github.io/?https://github.com/Christina96/boilerplate-sample-matches/blob/main/C/Adafruit_nRF52_Arduino-MDEwOlJlcG9zaXRvcnk3NDM1NDcyOQ==-flat-Udp.h-Adafruit_nRF52_Arduino-MDEwOlJlcG9zaXRvcnk3NDM1NDcyOQ==-flat-Client.h.html,20,Adafruit_nRF52_Arduino-MDEwOlJlcG9zaXRvcnk3NDM1NDcyOQ==-flat-Udp.h,Adafruit_nRF52_Arduino-MDEwOlJlcG9zaXRvcnk3NDM1NDcyOQ==-flat-Client.h,24,26,2,21,23,2
194,https://htmlpreview.github.io/?https://github.com/Christina96/boilerplate-sample-matches/blob/main/C/Adafruit_nRF52_Arduino-MDEwOlJlcG9zaXRvcnk3NDM1NDcyOQ==-flat-memory_buffer_alloc.c-Adafruit_nRF52_Arduino-MDEwOlJlcG9zaXRvcnk3NDM1NDcyOQ==-flat-memory_buffer_alloc.c.html,37,Adafruit_nRF52_Arduino-MDEwOlJlcG9zaXRvcnk3NDM1NDcyOQ==-flat-memory_buffer_alloc.c,Adafruit_nRF52_Arduino-MDEwOlJlcG9zaXRvcnk3NDM1NDcyOQ==-flat-memory_buffer_alloc.c,216,221,5,339,344,5
195,https://htmlpreview.github.io/?https://github.com/Christina96/boilerplate-sample-matches/blob/main/C/xmrig-MDEwOlJlcG9zaXRvcnk4ODMyNzQwNg==-flat-Config_default.h-xmrig-MDEwOlJlcG9zaXRvcnk4ODMyNzQwNg==-flat-Config_default.h.html,18,xmrig-MDEwOlJlcG9zaXRvcnk4ODMyNzQwNg==-flat-Config_default.h,xmrig-MDEwOlJlcG9zaXRvcnk4ODMyNzQwNg==-flat-Config_default.h,35,40,5,81,87,6
196,https://htmlpreview.github.io/?https://github.com/Christina96/boilerplate-sample-matches/blob/main/C/small-MDEwOlJlcG9zaXRvcnkyNTY3NjMxNjk=-flat-common.h-small-MDEwOlJlcG9zaXRvcnkyNTY3NjMxNjk=-flat-udprelay.c.html,21,small-MDEwOlJlcG9zaXRvcnkyNTY3NjMxNjk=-flat-common.h,small-MDEwOlJlcG9zaXRvcnkyNTY3NjMxNjk=-flat-udprelay.c,12,17,5,1038,1044,6
197,https://htmlpreview.github.io/?https://github.com/Christina96/boilerplate-sample-matches/blob/main/C/PINRemoteImage-MDEwOlJlcG9zaXRvcnkzOTUzNzEwMw==-flat-picture_enc.c-PINRemoteImage-MDEwOlJlcG9zaXRvcnkzOTUzNzEwMw==-flat-picture_enc.c.html,17,PINRemoteImage-MDEwOlJlcG9zaXRvcnkzOTUzNzEwMw==-flat-picture_enc.c,PINRemoteImage-MDEwOlJlcG9zaXRvcnkzOTUzNzEwMw==-flat-picture_enc.c,206,210,4,218,221,3
198,https://htmlpreview.github.io/?https://github.com/Christina96/boilerplate-sample-matches/blob/main/C/libfuse-MDEwOlJlcG9zaXRvcnk0ODI5NjE3Nw==-flat-poll.c-libfuse-MDEwOlJlcG9zaXRvcnk0ODI5NjE3Nw==-flat-null.c.html,18,libfuse-MDEwOlJlcG9zaXRvcnk0ODI5NjE3Nw==-flat-poll.c,libfuse-MDEwOlJlcG9zaXRvcnk0ODI5NjE3Nw==-flat-null.c,41,44,3,15,18,3
199,https://htmlpreview.github.io/?https://github.com/Christina96/boilerplate-sample-matches/blob/main/C/redis-MDEwOlJlcG9zaXRvcnkxMDgxMTA3MDY=-flat-blocked.c-redis-MDEwOlJlcG9zaXRvcnkxMDgxMTA3MDY=-flat-blocked.c.html,22,redis-MDEwOlJlcG9zaXRvcnkxMDgxMTA3MDY=-flat-blocked.c,redis-MDEwOlJlcG9zaXRvcnkxMDgxMTA3MDY=-flat-blocked.c,112,115,3,151,154,3
200,https://htmlpreview.github.io/?https://github.com/Christina96/boilerplate-sample-matches/blob/main/C/libpcap-MDEwOlJlcG9zaXRvcnk5NDM1ODg3-flat-pcap-linux.c-libfuse-MDEwOlJlcG9zaXRvcnk0ODI5NjE3Nw==-flat-fuse.c.html,18,libpcap-MDEwOlJlcG9zaXRvcnk5NDM1ODg3-flat-pcap-linux.c,libfuse-MDEwOlJlcG9zaXRvcnk0ODI5NjE3Nw==-flat-fuse.c,580,582,2,1242,1244,2
201,https://htmlpreview.github.io/?https://github.com/Christina96/boilerplate-sample-matches/blob/main/C/PINRemoteImage-MDEwOlJlcG9zaXRvcnkzOTUzNzEwMw==-flat-encode_38.h-PINRemoteImage-MDEwOlJlcG9zaXRvcnkzOTUzNzEwMw==-flat-encode_20.h.html,542,PINRemoteImage-MDEwOlJlcG9zaXRvcnkzOTUzNzEwMw==-flat-encode_38.h,PINRemoteImage-MDEwOlJlcG9zaXRvcnkzOTUzNzEwMw==-flat-encode_20.h,145,226,81,145,226,81
202,https://htmlpreview.github.io/?https://github.com/Christina96/boilerplate-sample-matches/blob/main/C/redis-MDEwOlJlcG9zaXRvcnkxMDgxMTA3MDY=-flat-stats_7.c-redis-MDEwOlJlcG9zaXRvcnkxMDgxMTA3MDY=-flat-stats_7.c.html,16,redis-MDEwOlJlcG9zaXRvcnkxMDgxMTA3MDY=-flat-stats_7.c,redis-MDEwOlJlcG9zaXRvcnkxMDgxMTA3MDY=-flat-stats_7.c,749,752,3,746,748,2
203,https://htmlpreview.github.io/?https://github.com/Christina96/boilerplate-sample-matches/blob/main/C/redis-MDEwOlJlcG9zaXRvcnkxMDgxMTA3MDY=-flat-rdb.c-redis-MDEwOlJlcG9zaXRvcnkxMDgxMTA3MDY=-flat-rdb.c.html,41,redis-MDEwOlJlcG9zaXRvcnkxMDgxMTA3MDY=-flat-rdb.c,redis-MDEwOlJlcG9zaXRvcnkxMDgxMTA3MDY=-flat-rdb.c,129,133,4,133,137,4
204,https://htmlpreview.github.io/?https://github.com/Christina96/boilerplate-sample-matches/blob/main/C/xmrig-MDEwOlJlcG9zaXRvcnk4ODMyNzQwNg==-flat-sph_skein.c-xmrig-MDEwOlJlcG9zaXRvcnk4ODMyNzQwNg==-flat-sph_skein.c.html,15,xmrig-MDEwOlJlcG9zaXRvcnk4ODMyNzQwNg==-flat-sph_skein.c,xmrig-MDEwOlJlcG9zaXRvcnk4ODMyNzQwNg==-flat-sph_skein.c,467,468,1,466,467,1
205,https://htmlpreview.github.io/?https://github.com/Christina96/boilerplate-sample-matches/blob/main/C/xmrig-MDEwOlJlcG9zaXRvcnk4ODMyNzQwNg==-flat-sph_types.h-xmrig-MDEwOlJlcG9zaXRvcnk4ODMyNzQwNg==-flat-sph_types.h.html,40,xmrig-MDEwOlJlcG9zaXRvcnk4ODMyNzQwNg==-flat-sph_types.h,xmrig-MDEwOlJlcG9zaXRvcnk4ODMyNzQwNg==-flat-sph_types.h,710,718,8,515,522,7
206,https://htmlpreview.github.io/?https://github.com/Christina96/boilerplate-sample-matches/blob/main/C/xmrig-MDEwOlJlcG9zaXRvcnk4ODMyNzQwNg==-flat-schema.h-redis-MDEwOlJlcG9zaXRvcnkxMDgxMTA3MDY=-flat-jemalloc.c.html,15,xmrig-MDEwOlJlcG9zaXRvcnk4ODMyNzQwNg==-flat-schema.h,redis-MDEwOlJlcG9zaXRvcnkxMDgxMTA3MDY=-flat-jemalloc.c,2183,2188,5,1425,1430,5
207,https://htmlpreview.github.io/?https://github.com/Christina96/boilerplate-sample-matches/blob/main/C/redis-MDEwOlJlcG9zaXRvcnkxMDgxMTA3MDY=-flat-ziplist.c-redis-MDEwOlJlcG9zaXRvcnkxMDgxMTA3MDY=-flat-ziplist.c.html,24,redis-MDEwOlJlcG9zaXRvcnkxMDgxMTA3MDY=-flat-ziplist.c,redis-MDEwOlJlcG9zaXRvcnkxMDgxMTA3MDY=-flat-ziplist.c,439,441,2,462,464,2
208,https://htmlpreview.github.io/?https://github.com/Christina96/boilerplate-sample-matches/blob/main/C/xmrig-MDEwOlJlcG9zaXRvcnk4ODMyNzQwNg==-flat-llhttp.c-xmrig-MDEwOlJlcG9zaXRvcnk4ODMyNzQwNg==-flat-llhttp.c.html,105,xmrig-MDEwOlJlcG9zaXRvcnk4ODMyNzQwNg==-flat-llhttp.c,xmrig-MDEwOlJlcG9zaXRvcnk4ODMyNzQwNg==-flat-llhttp.c,8718,8746,28,8372,8400,28
209,https://htmlpreview.github.io/?https://github.com/Christina96/boilerplate-sample-matches/blob/main/C/libtomcrypt-MDEwOlJlcG9zaXRvcnk3NzcwMTE=-flat-der_decode_sequence_multi.c-redis-MDEwOlJlcG9zaXRvcnkxMDgxMTA3MDY=-flat-Win32_PThread.c.html,24,libtomcrypt-MDEwOlJlcG9zaXRvcnk3NzcwMTE=-flat-der_decode_sequence_multi.c,redis-MDEwOlJlcG9zaXRvcnkxMDgxMTA3MDY=-flat-Win32_PThread.c,20,26,6,52,58,6
210,https://htmlpreview.github.io/?https://github.com/Christina96/boilerplate-sample-matches/blob/main/C/PINRemoteImage-MDEwOlJlcG9zaXRvcnkzOTUzNzEwMw==-flat-dec_msa.c-PINRemoteImage-MDEwOlJlcG9zaXRvcnkzOTUzNzEwMw==-flat-dec_msa.c.html,17,PINRemoteImage-MDEwOlJlcG9zaXRvcnkzOTUzNzEwMw==-flat-dec_msa.c,PINRemoteImage-MDEwOlJlcG9zaXRvcnkzOTUzNzEwMw==-flat-dec_msa.c,174,176,2,197,199,2
211,https://htmlpreview.github.io/?https://github.com/Christina96/boilerplate-sample-matches/blob/main/C/redis-MDEwOlJlcG9zaXRvcnkxMDgxMTA3MDY=-flat-extent_util.c-redis-MDEwOlJlcG9zaXRvcnkxMDgxMTA3MDY=-flat-extent_util.c.html,15,redis-MDEwOlJlcG9zaXRvcnkxMDgxMTA3MDY=-flat-extent_util.c,redis-MDEwOlJlcG9zaXRvcnkxMDgxMTA3MDY=-flat-extent_util.c,86,89,3,76,78,2
212,https://htmlpreview.github.io/?https://github.com/Christina96/boilerplate-sample-matches/blob/main/C/redis-MDEwOlJlcG9zaXRvcnkxMDgxMTA3MDY=-flat-sds_35.c-redis-MDEwOlJlcG9zaXRvcnkxMDgxMTA3MDY=-flat-sds.c.html,20,redis-MDEwOlJlcG9zaXRvcnkxMDgxMTA3MDY=-flat-sds_35.c,redis-MDEwOlJlcG9zaXRvcnkxMDgxMTA3MDY=-flat-sds.c,154,156,2,143,145,2
213,https://htmlpreview.github.io/?https://github.com/Christina96/boilerplate-sample-matches/blob/main/C/libpcap-MDEwOlJlcG9zaXRvcnk5NDM1ODg3-flat-daemon.c-libpcap-MDEwOlJlcG9zaXRvcnk5NDM1ODg3-flat-daemon.c.html,24,libpcap-MDEwOlJlcG9zaXRvcnk5NDM1ODg3-flat-daemon.c,libpcap-MDEwOlJlcG9zaXRvcnk5NDM1ODg3-flat-daemon.c,313,320,7,175,181,6
214,https://htmlpreview.github.io/?https://github.com/Christina96/boilerplate-sample-matches/blob/main/C/redis-MDEwOlJlcG9zaXRvcnkxMDgxMTA3MDY=-flat-t_zset.c-redis-MDEwOlJlcG9zaXRvcnkxMDgxMTA3MDY=-flat-t_zset.c.html,171,redis-MDEwOlJlcG9zaXRvcnkxMDgxMTA3MDY=-flat-t_zset.c,redis-MDEwOlJlcG9zaXRvcnkxMDgxMTA3MDY=-flat-t_zset.c,194,215,21,432,453,21
215,https://htmlpreview.github.io/?https://github.com/Christina96/boilerplate-sample-matches/blob/main/C/android-gpuimage-plus-MDEwOlJlcG9zaXRvcnk0NjU0NzQxNw==-flat-cgeCommonDefine.h-android-gpuimage-plus-MDEwOlJlcG9zaXRvcnk0NjU0NzQxNw==-flat-cgeCommonDefine.h.html,21,android-gpuimage-plus-MDEwOlJlcG9zaXRvcnk0NjU0NzQxNw==-flat-cgeCommonDefine.h,android-gpuimage-plus-MDEwOlJlcG9zaXRvcnk0NjU0NzQxNw==-flat-cgeCommonDefine.h,78,83,5,90,95,5
216,https://htmlpreview.github.io/?https://github.com/Christina96/boilerplate-sample-matches/blob/main/C/Adafruit_nRF52_Arduino-MDEwOlJlcG9zaXRvcnk3NDM1NDcyOQ==-flat-nrf_radio.h-Adafruit_nRF52_Arduino-MDEwOlJlcG9zaXRvcnk3NDM1NDcyOQ==-flat-nrf_usbreg.h.html,21,Adafruit_nRF52_Arduino-MDEwOlJlcG9zaXRvcnk3NDM1NDcyOQ==-flat-nrf_radio.h,Adafruit_nRF52_Arduino-MDEwOlJlcG9zaXRvcnk3NDM1NDcyOQ==-flat-nrf_usbreg.h,311,313,2,24,27,3
217,https://htmlpreview.github.io/?https://github.com/Christina96/boilerplate-sample-matches/blob/main/C/Adafruit_nRF52_Arduino-MDEwOlJlcG9zaXRvcnk3NDM1NDcyOQ==-flat-nrf52811.h-Adafruit_nRF52_Arduino-MDEwOlJlcG9zaXRvcnk3NDM1NDcyOQ==-flat-nrf52805.h.html,104,Adafruit_nRF52_Arduino-MDEwOlJlcG9zaXRvcnk3NDM1NDcyOQ==-flat-nrf52811.h,Adafruit_nRF52_Arduino-MDEwOlJlcG9zaXRvcnk3NDM1NDcyOQ==-flat-nrf52805.h,113,123,10,109,119,10
218,https://htmlpreview.github.io/?https://github.com/Christina96/boilerplate-sample-matches/blob/main/C/redis-MDEwOlJlcG9zaXRvcnkxMDgxMTA3MDY=-flat-async.c-redis-MDEwOlJlcG9zaXRvcnkxMDgxMTA3MDY=-flat-adlist.c.html,15,redis-MDEwOlJlcG9zaXRvcnkxMDgxMTA3MDY=-flat-async.c,redis-MDEwOlJlcG9zaXRvcnkxMDgxMTA3MDY=-flat-adlist.c,210,212,2,141,143,2
219,https://htmlpreview.github.io/?https://github.com/Christina96/boilerplate-sample-matches/blob/main/C/PINRemoteImage-MDEwOlJlcG9zaXRvcnkzOTUzNzEwMw==-flat-gif2webp.c-PINRemoteImage-MDEwOlJlcG9zaXRvcnkzOTUzNzEwMw==-flat-cwebp.c.html,25,PINRemoteImage-MDEwOlJlcG9zaXRvcnkzOTUzNzEwMw==-flat-gif2webp.c,PINRemoteImage-MDEwOlJlcG9zaXRvcnkzOTUzNzEwMw==-flat-cwebp.c,172,175,3,782,785,3
220,https://htmlpreview.github.io/?https://github.com/Christina96/boilerplate-sample-matches/blob/main/C/PINRemoteImage-MDEwOlJlcG9zaXRvcnkzOTUzNzEwMw==-flat-mux_18.h-PINRemoteImage-MDEwOlJlcG9zaXRvcnkzOTUzNzEwMw==-flat-demux_17.h.html,42,PINRemoteImage-MDEwOlJlcG9zaXRvcnkzOTUzNzEwMw==-flat-mux_18.h,PINRemoteImage-MDEwOlJlcG9zaXRvcnkzOTUzNzEwMw==-flat-demux_17.h,96,105,9,77,87,10
221,https://htmlpreview.github.io/?https://github.com/Christina96/boilerplate-sample-matches/blob/main/C/xmrig-MDEwOlJlcG9zaXRvcnk4ODMyNzQwNg==-flat-adl_structures.h-android-gpuimage-plus-MDEwOlJlcG9zaXRvcnk0NjU0NzQxNw==-flat-avformat.h.html,15,xmrig-MDEwOlJlcG9zaXRvcnk4ODMyNzQwNg==-flat-adl_structures.h,android-gpuimage-plus-MDEwOlJlcG9zaXRvcnk0NjU0NzQxNw==-flat-avformat.h,609,614,5,343,348,5
222,https://htmlpreview.github.io/?https://github.com/Christina96/boilerplate-sample-matches/blob/main/C/Adafruit_nRF52_Arduino-MDEwOlJlcG9zaXRvcnk3NDM1NDcyOQ==-flat-nrfx_spim.h-Adafruit_nRF52_Arduino-MDEwOlJlcG9zaXRvcnk3NDM1NDcyOQ==-flat-nrfx_spi.h.html,211,Adafruit_nRF52_Arduino-MDEwOlJlcG9zaXRvcnk3NDM1NDcyOQ==-flat-nrfx_spim.h,Adafruit_nRF52_Arduino-MDEwOlJlcG9zaXRvcnk3NDM1NDcyOQ==-flat-nrfx_spi.h,92,128,36,63,99,36
223,https://htmlpreview.github.io/?https://github.com/Christina96/boilerplate-sample-matches/blob/main/C/xmrig-MDEwOlJlcG9zaXRvcnk4ODMyNzQwNg==-flat-sph_simd.c-xmrig-MDEwOlJlcG9zaXRvcnk4ODMyNzQwNg==-flat-sph_simd.c.html,455,xmrig-MDEwOlJlcG9zaXRvcnk4ODMyNzQwNg==-flat-sph_simd.c,xmrig-MDEwOlJlcG9zaXRvcnk4ODMyNzQwNg==-flat-sph_simd.c,703,748,45,988,1033,45
224,https://htmlpreview.github.io/?https://github.com/Christina96/boilerplate-sample-matches/blob/main/C/PINRemoteImage-MDEwOlJlcG9zaXRvcnkzOTUzNzEwMw==-flat-lossless_neon.c-PINRemoteImage-MDEwOlJlcG9zaXRvcnkzOTUzNzEwMw==-flat-lossless_neon.c.html,55,PINRemoteImage-MDEwOlJlcG9zaXRvcnkzOTUzNzEwMw==-flat-lossless_neon.c,PINRemoteImage-MDEwOlJlcG9zaXRvcnkzOTUzNzEwMw==-flat-lossless_neon.c,186,191,5,261,266,5
225,https://htmlpreview.github.io/?https://github.com/Christina96/boilerplate-sample-matches/blob/main/C/xmrig-MDEwOlJlcG9zaXRvcnk4ODMyNzQwNg==-flat-sph_skein.c-xmrig-MDEwOlJlcG9zaXRvcnk4ODMyNzQwNg==-flat-sph_skein.c.html,54,xmrig-MDEwOlJlcG9zaXRvcnk4ODMyNzQwNg==-flat-sph_skein.c,xmrig-MDEwOlJlcG9zaXRvcnk4ODMyNzQwNg==-flat-sph_skein.c,403,408,5,491,496,5
226,https://htmlpreview.github.io/?https://github.com/Christina96/boilerplate-sample-matches/blob/main/C/fftw3-MDEwOlJlcG9zaXRvcnk4ODQzMzg4-flat-amd64-cpuid.h-fftw3-MDEwOlJlcG9zaXRvcnk4ODQzMzg4-flat-x86-cpuid.h.html,31,fftw3-MDEwOlJlcG9zaXRvcnk4ODQzMzg4-flat-amd64-cpuid.h,fftw3-MDEwOlJlcG9zaXRvcnk4ODQzMzg4-flat-x86-cpuid.h,31,34,3,106,109,3
227,https://htmlpreview.github.io/?https://github.com/Christina96/boilerplate-sample-matches/blob/main/C/libtomcrypt-MDEwOlJlcG9zaXRvcnk3NzcwMTE=-flat-timing.c-libtomcrypt-MDEwOlJlcG9zaXRvcnk3NzcwMTE=-flat-timing.c.html,46,libtomcrypt-MDEwOlJlcG9zaXRvcnk3NzcwMTE=-flat-timing.c,libtomcrypt-MDEwOlJlcG9zaXRvcnk3NzcwMTE=-flat-timing.c,893,900,7,1013,1020,7
228,https://htmlpreview.github.io/?https://github.com/Christina96/boilerplate-sample-matches/blob/main/C/fftw3-MDEwOlJlcG9zaXRvcnk4ODQzMzg4-flat-ct_4.c-fftw3-MDEwOlJlcG9zaXRvcnk4ODQzMzg4-flat-ct-hc2c.c.html,15,fftw3-MDEwOlJlcG9zaXRvcnk4ODQzMzg4-flat-ct_4.c,fftw3-MDEwOlJlcG9zaXRvcnk4ODQzMzg4-flat-ct-hc2c.c,112,115,3,153,156,3
229,https://htmlpreview.github.io/?https://github.com/Christina96/boilerplate-sample-matches/blob/main/C/libtomcrypt-MDEwOlJlcG9zaXRvcnk3NzcwMTE=-flat-tomcrypt_pk.h-libtomcrypt-MDEwOlJlcG9zaXRvcnk3NzcwMTE=-flat-tomcrypt_pk.h.html,66,libtomcrypt-MDEwOlJlcG9zaXRvcnk3NzcwMTE=-flat-tomcrypt_pk.h,libtomcrypt-MDEwOlJlcG9zaXRvcnk3NzcwMTE=-flat-tomcrypt_pk.h,496,503,7,513,520,7
230,https://htmlpreview.github.io/?https://github.com/Christina96/boilerplate-sample-matches/blob/main/C/redis-MDEwOlJlcG9zaXRvcnkxMDgxMTA3MDY=-flat-quicklist.c-redis-MDEwOlJlcG9zaXRvcnkxMDgxMTA3MDY=-flat-quicklist.c.html,17,redis-MDEwOlJlcG9zaXRvcnkxMDgxMTA3MDY=-flat-quicklist.c,redis-MDEwOlJlcG9zaXRvcnkxMDgxMTA3MDY=-flat-quicklist.c,344,345,1,555,556,1
231,https://htmlpreview.github.io/?https://github.com/Christina96/boilerplate-sample-matches/blob/main/C/redis-MDEwOlJlcG9zaXRvcnkxMDgxMTA3MDY=-flat-atomic_c11.h-redis-MDEwOlJlcG9zaXRvcnkxMDgxMTA3MDY=-flat-atomic_c11.h.html,21,redis-MDEwOlJlcG9zaXRvcnkxMDgxMTA3MDY=-flat-atomic_c11.h,redis-MDEwOlJlcG9zaXRvcnkxMDgxMTA3MDY=-flat-atomic_c11.h,40,43,3,48,52,4
232,https://htmlpreview.github.io/?https://github.com/Christina96/boilerplate-sample-matches/blob/main/C/xmrig-MDEwOlJlcG9zaXRvcnk4ODMyNzQwNg==-flat-sse2neon.h-xmrig-MDEwOlJlcG9zaXRvcnk4ODMyNzQwNg==-flat-sse2neon.h.html,63,xmrig-MDEwOlJlcG9zaXRvcnk4ODMyNzQwNg==-flat-sse2neon.h,xmrig-MDEwOlJlcG9zaXRvcnk4ODMyNzQwNg==-flat-sse2neon.h,5812,5822,10,1057,1067,10
233,https://htmlpreview.github.io/?https://github.com/Christina96/boilerplate-sample-matches/blob/main/C/redis-MDEwOlJlcG9zaXRvcnkxMDgxMTA3MDY=-flat-stats_print.c-redis-MDEwOlJlcG9zaXRvcnkxMDgxMTA3MDY=-flat-stats_print.c.html,16,redis-MDEwOlJlcG9zaXRvcnkxMDgxMTA3MDY=-flat-stats_print.c,redis-MDEwOlJlcG9zaXRvcnkxMDgxMTA3MDY=-flat-stats_print.c,275,280,5,209,214,5
234,https://htmlpreview.github.io/?https://github.com/Christina96/boilerplate-sample-matches/blob/main/C/xmrig-MDEwOlJlcG9zaXRvcnk4ODMyNzQwNg==-flat-linux-libnuma.h-xmrig-MDEwOlJlcG9zaXRvcnk4ODMyNzQwNg==-flat-linux-libnuma.h.html,66,xmrig-MDEwOlJlcG9zaXRvcnk4ODMyNzQwNg==-flat-linux-libnuma.h,xmrig-MDEwOlJlcG9zaXRvcnk4ODMyNzQwNg==-flat-linux-libnuma.h,104,113,9,116,125,9
235,https://htmlpreview.github.io/?https://github.com/Christina96/boilerplate-sample-matches/blob/main/C/libtomcrypt-MDEwOlJlcG9zaXRvcnk3NzcwMTE=-flat-der_test.c-libtomcrypt-MDEwOlJlcG9zaXRvcnk3NzcwMTE=-flat-der_test.c.html,16,libtomcrypt-MDEwOlJlcG9zaXRvcnk3NzcwMTE=-flat-der_test.c,libtomcrypt-MDEwOlJlcG9zaXRvcnk3NzcwMTE=-flat-der_test.c,760,763,3,907,910,3
236,https://htmlpreview.github.io/?https://github.com/Christina96/boilerplate-sample-matches/blob/main/C/PINRemoteImage-MDEwOlJlcG9zaXRvcnkzOTUzNzEwMw==-flat-lossless_enc_sse2.c-PINRemoteImage-MDEwOlJlcG9zaXRvcnkzOTUzNzEwMw==-flat-lossless_enc_sse2.c.html,51,PINRemoteImage-MDEwOlJlcG9zaXRvcnkzOTUzNzEwMw==-flat-lossless_enc_sse2.c,PINRemoteImage-MDEwOlJlcG9zaXRvcnkzOTUzNzEwMw==-flat-lossless_enc_sse2.c,266,272,6,271,277,6
237,https://htmlpreview.github.io/?https://github.com/Christina96/boilerplate-sample-matches/blob/main/C/Adafruit_nRF52_Arduino-MDEwOlJlcG9zaXRvcnk3NDM1NDcyOQ==-flat-ble_gattc_4.h-Adafruit_nRF52_Arduino-MDEwOlJlcG9zaXRvcnk3NDM1NDcyOQ==-flat-ble_gattc.h.html,2025,Adafruit_nRF52_Arduino-MDEwOlJlcG9zaXRvcnk3NDM1NDcyOQ==-flat-ble_gattc_4.h,Adafruit_nRF52_Arduino-MDEwOlJlcG9zaXRvcnk3NDM1NDcyOQ==-flat-ble_gattc.h,84,248,164,84,248,164
238,https://htmlpreview.github.io/?https://github.com/Christina96/boilerplate-sample-matches/blob/main/C/fftw3-MDEwOlJlcG9zaXRvcnk4ODQzMzg4-flat-reodft11e-radix2.c-fftw3-MDEwOlJlcG9zaXRvcnk4ODQzMzg4-flat-reodft11e-radix2.c.html,571,fftw3-MDEwOlJlcG9zaXRvcnk4ODQzMzg4-flat-reodft11e-radix2.c,fftw3-MDEwOlJlcG9zaXRvcnk4ODQzMzg4-flat-reodft11e-radix2.c,70,134,64,254,318,64
239,https://htmlpreview.github.io/?https://github.com/Christina96/boilerplate-sample-matches/blob/main/C/redis-MDEwOlJlcG9zaXRvcnkxMDgxMTA3MDY=-flat-module.c-redis-MDEwOlJlcG9zaXRvcnkxMDgxMTA3MDY=-flat-module.c.html,18,redis-MDEwOlJlcG9zaXRvcnkxMDgxMTA3MDY=-flat-module.c,redis-MDEwOlJlcG9zaXRvcnkxMDgxMTA3MDY=-flat-module.c,1396,1400,4,1425,1429,4
240,https://htmlpreview.github.io/?https://github.com/Christina96/boilerplate-sample-matches/blob/main/C/redis-MDEwOlJlcG9zaXRvcnkxMDgxMTA3MDY=-flat-t_stream.c-redis-MDEwOlJlcG9zaXRvcnkxMDgxMTA3MDY=-flat-t_stream.c.html,31,redis-MDEwOlJlcG9zaXRvcnkxMDgxMTA3MDY=-flat-t_stream.c,redis-MDEwOlJlcG9zaXRvcnkxMDgxMTA3MDY=-flat-t_stream.c,677,679,2,1497,1499,2
241,https://htmlpreview.github.io/?https://github.com/Christina96/boilerplate-sample-matches/blob/main/C/xmrig-MDEwOlJlcG9zaXRvcnk4ODMyNzQwNg==-flat-sse2neon.h-xmrig-MDEwOlJlcG9zaXRvcnk4ODMyNzQwNg==-flat-sse2neon.h.html,16,xmrig-MDEwOlJlcG9zaXRvcnk4ODMyNzQwNg==-flat-sse2neon.h,xmrig-MDEwOlJlcG9zaXRvcnk4ODMyNzQwNg==-flat-sse2neon.h,4945,4947,2,2648,2650,2
242,https://htmlpreview.github.io/?https://github.com/Christina96/boilerplate-sample-matches/blob/main/C/xmrig-MDEwOlJlcG9zaXRvcnk4ODMyNzQwNg==-flat-chrono.h-xmrig-MDEwOlJlcG9zaXRvcnk4ODMyNzQwNg==-flat-chrono.h.html,16,xmrig-MDEwOlJlcG9zaXRvcnk4ODMyNzQwNg==-flat-chrono.h,xmrig-MDEwOlJlcG9zaXRvcnk4ODMyNzQwNg==-flat-chrono.h,753,754,1,131,132,1
243,https://htmlpreview.github.io/?https://github.com/Christina96/boilerplate-sample-matches/blob/main/C/Adafruit_nRF52_Arduino-MDEwOlJlcG9zaXRvcnk3NDM1NDcyOQ==-flat-nrfx_pwm.c-Adafruit_nRF52_Arduino-MDEwOlJlcG9zaXRvcnk3NDM1NDcyOQ==-flat-nrf_pdm.h.html,19,Adafruit_nRF52_Arduino-MDEwOlJlcG9zaXRvcnk3NDM1NDcyOQ==-flat-nrfx_pwm.c,Adafruit_nRF52_Arduino-MDEwOlJlcG9zaXRvcnk3NDM1NDcyOQ==-flat-nrf_pdm.h,127,132,5,242,247,5
244,https://htmlpreview.github.io/?https://github.com/Christina96/boilerplate-sample-matches/blob/main/C/small-MDEwOlJlcG9zaXRvcnkyNTY3NjMxNjk=-flat-udprelay.c-small-MDEwOlJlcG9zaXRvcnkyNTY3NjMxNjk=-flat-udprelay.c.html,27,small-MDEwOlJlcG9zaXRvcnkyNTY3NjMxNjk=-flat-udprelay.c,small-MDEwOlJlcG9zaXRvcnkyNTY3NjMxNjk=-flat-udprelay.c,505,511,6,984,990,6
245,https://htmlpreview.github.io/?https://github.com/Christina96/boilerplate-sample-matches/blob/main/C/redis-MDEwOlJlcG9zaXRvcnkxMDgxMTA3MDY=-flat-rallocx.c-redis-MDEwOlJlcG9zaXRvcnkxMDgxMTA3MDY=-flat-rallocx.c.html,16,redis-MDEwOlJlcG9zaXRvcnkxMDgxMTA3MDY=-flat-rallocx.c,redis-MDEwOlJlcG9zaXRvcnkxMDgxMTA3MDY=-flat-rallocx.c,100,102,2,168,170,2
246,https://htmlpreview.github.io/?https://github.com/Christina96/boilerplate-sample-matches/blob/main/C/xmrig-MDEwOlJlcG9zaXRvcnk4ODMyNzQwNg==-flat-sph_simd.c-xmrig-MDEwOlJlcG9zaXRvcnk4ODMyNzQwNg==-flat-sph_simd.c.html,160,xmrig-MDEwOlJlcG9zaXRvcnk4ODMyNzQwNg==-flat-sph_simd.c,xmrig-MDEwOlJlcG9zaXRvcnk4ODMyNzQwNg==-flat-sph_simd.c,1418,1434,16,1438,1454,16
247,https://htmlpreview.github.io/?https://github.com/Christina96/boilerplate-sample-matches/blob/main/C/Adafruit_nRF52_Arduino-MDEwOlJlcG9zaXRvcnk3NDM1NDcyOQ==-flat-nrf_systick.h-Adafruit_nRF52_Arduino-MDEwOlJlcG9zaXRvcnk3NDM1NDcyOQ==-flat-nrf_systick.h.html,28,Adafruit_nRF52_Arduino-MDEwOlJlcG9zaXRvcnk3NDM1NDcyOQ==-flat-nrf_systick.h,Adafruit_nRF52_Arduino-MDEwOlJlcG9zaXRvcnk3NDM1NDcyOQ==-flat-nrf_systick.h,32,40,8,40,48,8
248,https://htmlpreview.github.io/?https://github.com/Christina96/boilerplate-sample-matches/blob/main/C/libtomcrypt-MDEwOlJlcG9zaXRvcnk3NzcwMTE=-flat-tomcrypt_misc.h-libtomcrypt-MDEwOlJlcG9zaXRvcnk3NzcwMTE=-flat-tomcrypt_misc.h.html,27,libtomcrypt-MDEwOlJlcG9zaXRvcnk3NzcwMTE=-flat-tomcrypt_misc.h,libtomcrypt-MDEwOlJlcG9zaXRvcnk3NzcwMTE=-flat-tomcrypt_misc.h,77,82,5,80,85,5
249,https://htmlpreview.github.io/?https://github.com/Christina96/boilerplate-sample-matches/blob/main/C/PINRemoteImage-MDEwOlJlcG9zaXRvcnkzOTUzNzEwMw==-flat-libwebp_python_wrap.c-PINRemoteImage-MDEwOlJlcG9zaXRvcnkzOTUzNzEwMw==-flat-libwebp_python_wrap.c.html,18,PINRemoteImage-MDEwOlJlcG9zaXRvcnkzOTUzNzEwMw==-flat-libwebp_python_wrap.c,PINRemoteImage-MDEwOlJlcG9zaXRvcnkzOTUzNzEwMw==-flat-libwebp_python_wrap.c,4433,4435,2,1464,1466,2
250,https://htmlpreview.github.io/?https://github.com/Christina96/boilerplate-sample-matches/blob/main/C/PINRemoteImage-MDEwOlJlcG9zaXRvcnkzOTUzNzEwMw==-flat-vwebp.c-PINRemoteImage-MDEwOlJlcG9zaXRvcnkzOTUzNzEwMw==-flat-vwebp.c.html,16,PINRemoteImage-MDEwOlJlcG9zaXRvcnkzOTUzNzEwMw==-flat-vwebp.c,PINRemoteImage-MDEwOlJlcG9zaXRvcnkzOTUzNzEwMw==-flat-vwebp.c,58,60,2,60,62,2
251,https://htmlpreview.github.io/?https://github.com/Christina96/boilerplate-sample-matches/blob/main/C/Adafruit_nRF52_Arduino-MDEwOlJlcG9zaXRvcnk3NDM1NDcyOQ==-flat-lfs.c-Adafruit_nRF52_Arduino-MDEwOlJlcG9zaXRvcnk3NDM1NDcyOQ==-flat-lfs.c.html,20,Adafruit_nRF52_Arduino-MDEwOlJlcG9zaXRvcnk3NDM1NDcyOQ==-flat-lfs.c,Adafruit_nRF52_Arduino-MDEwOlJlcG9zaXRvcnk3NDM1NDcyOQ==-flat-lfs.c,512,514,2,529,531,2
252,https://htmlpreview.github.io/?https://github.com/Christina96/boilerplate-sample-matches/blob/main/C/redis-MDEwOlJlcG9zaXRvcnkxMDgxMTA3MDY=-flat-mallocx.c-redis-MDEwOlJlcG9zaXRvcnkxMDgxMTA3MDY=-flat-mallocx.c.html,18,redis-MDEwOlJlcG9zaXRvcnkxMDgxMTA3MDY=-flat-mallocx.c,redis-MDEwOlJlcG9zaXRvcnkxMDgxMTA3MDY=-flat-mallocx.c,125,128,3,132,135,3
253,https://htmlpreview.github.io/?https://github.com/Christina96/boilerplate-sample-matches/blob/main/C/fftw3-MDEwOlJlcG9zaXRvcnk4ODQzMzg4-flat-threads.c-small-MDEwOlJlcG9zaXRvcnkyNTY3NjMxNjk=-flat-udprelay.c.html,15,fftw3-MDEwOlJlcG9zaXRvcnk4ODQzMzg4-flat-threads.c,small-MDEwOlJlcG9zaXRvcnkyNTY3NjMxNjk=-flat-udprelay.c,307,312,5,421,426,5
254,https://htmlpreview.github.io/?https://github.com/Christina96/boilerplate-sample-matches/blob/main/C/libtomcrypt-MDEwOlJlcG9zaXRvcnk3NzcwMTE=-flat-sha3_test.c-libtomcrypt-MDEwOlJlcG9zaXRvcnk3NzcwMTE=-flat-sha3_test.c.html,16,libtomcrypt-MDEwOlJlcG9zaXRvcnk3NzcwMTE=-flat-sha3_test.c,libtomcrypt-MDEwOlJlcG9zaXRvcnk3NzcwMTE=-flat-sha3_test.c,447,451,4,330,334,4
255,https://htmlpreview.github.io/?https://github.com/Christina96/boilerplate-sample-matches/blob/main/C/fftw3-MDEwOlJlcG9zaXRvcnk4ODQzMzg4-flat-simd-avx-128-fma.h-fftw3-MDEwOlJlcG9zaXRvcnk4ODQzMzg4-flat-simd-avx2-128.h.html,28,fftw3-MDEwOlJlcG9zaXRvcnk4ODQzMzg4-flat-simd-avx-128-fma.h,fftw3-MDEwOlJlcG9zaXRvcnk4ODQzMzg4-flat-simd-avx2-128.h,194,197,3,200,203,3
256,https://htmlpreview.github.io/?https://github.com/Christina96/boilerplate-sample-matches/blob/main/C/libtomcrypt-MDEwOlJlcG9zaXRvcnk3NzcwMTE=-flat-pbes2.c-redis-MDEwOlJlcG9zaXRvcnkxMDgxMTA3MDY=-flat-quicklist.c.html,16,libtomcrypt-MDEwOlJlcG9zaXRvcnk3NzcwMTE=-flat-pbes2.c,redis-MDEwOlJlcG9zaXRvcnkxMDgxMTA3MDY=-flat-quicklist.c,119,121,2,773,775,2
257,https://htmlpreview.github.io/?https://github.com/Christina96/boilerplate-sample-matches/blob/main/C/PINRemoteImage-MDEwOlJlcG9zaXRvcnkzOTUzNzEwMw==-flat-histogram_enc.c-PINRemoteImage-MDEwOlJlcG9zaXRvcnkzOTUzNzEwMw==-flat-histogram_enc.h.html,38,PINRemoteImage-MDEwOlJlcG9zaXRvcnkzOTUzNzEwMw==-flat-histogram_enc.c,PINRemoteImage-MDEwOlJlcG9zaXRvcnkzOTUzNzEwMw==-flat-histogram_enc.h,888,895,7,50,57,7
258,https://htmlpreview.github.io/?https://github.com/Christina96/boilerplate-sample-matches/blob/main/C/xmrig-MDEwOlJlcG9zaXRvcnk4ODMyNzQwNg==-flat-OclCnRunner.h-xmrig-MDEwOlJlcG9zaXRvcnk4ODMyNzQwNg==-flat-HttpsContext.h.html,17,xmrig-MDEwOlJlcG9zaXRvcnk4ODMyNzQwNg==-flat-OclCnRunner.h,xmrig-MDEwOlJlcG9zaXRvcnk4ODMyNzQwNg==-flat-HttpsContext.h,25,31,6,23,29,6
259,https://htmlpreview.github.io/?https://github.com/Christina96/boilerplate-sample-matches/blob/main/C/android-gpuimage-plus-MDEwOlJlcG9zaXRvcnk0NjU0NzQxNw==-flat-avcodec.h-android-gpuimage-plus-MDEwOlJlcG9zaXRvcnk0NjU0NzQxNw==-flat-avcodec.h.html,16,android-gpuimage-plus-MDEwOlJlcG9zaXRvcnk0NjU0NzQxNw==-flat-avcodec.h,android-gpuimage-plus-MDEwOlJlcG9zaXRvcnk0NjU0NzQxNw==-flat-avcodec.h,328,334,6,336,342,6
260,https://htmlpreview.github.io/?https://github.com/Christina96/boilerplate-sample-matches/blob/main/C/Adafruit_nRF52_Arduino-MDEwOlJlcG9zaXRvcnk3NDM1NDcyOQ==-flat-nrf_spi.h-Adafruit_nRF52_Arduino-MDEwOlJlcG9zaXRvcnk3NDM1NDcyOQ==-flat-nrf_spim.h.html,18,Adafruit_nRF52_Arduino-MDEwOlJlcG9zaXRvcnk3NDM1NDcyOQ==-flat-nrf_spi.h,Adafruit_nRF52_Arduino-MDEwOlJlcG9zaXRvcnk3NDM1NDcyOQ==-flat-nrf_spim.h,137,140,3,330,333,3
261,https://htmlpreview.github.io/?https://github.com/Christina96/boilerplate-sample-matches/blob/main/C/redis-MDEwOlJlcG9zaXRvcnkxMDgxMTA3MDY=-flat-aof.c-redis-MDEwOlJlcG9zaXRvcnkxMDgxMTA3MDY=-flat-debug.c.html,63,redis-MDEwOlJlcG9zaXRvcnkxMDgxMTA3MDY=-flat-aof.c,redis-MDEwOlJlcG9zaXRvcnkxMDgxMTA3MDY=-flat-debug.c,711,718,7,89,96,7
262,https://htmlpreview.github.io/?https://github.com/Christina96/boilerplate-sample-matches/blob/main/C/redis-MDEwOlJlcG9zaXRvcnkxMDgxMTA3MDY=-flat-mallocx.c-redis-MDEwOlJlcG9zaXRvcnkxMDgxMTA3MDY=-flat-smallocx.c.html,44,redis-MDEwOlJlcG9zaXRvcnkxMDgxMTA3MDY=-flat-mallocx.c,redis-MDEwOlJlcG9zaXRvcnkxMDgxMTA3MDY=-flat-smallocx.c,116,121,5,135,140,5
263,https://htmlpreview.github.io/?https://github.com/Christina96/boilerplate-sample-matches/blob/main/C/Adafruit_nRF52_Arduino-MDEwOlJlcG9zaXRvcnk3NDM1NDcyOQ==-flat-nrf_vmc.h-Adafruit_nRF52_Arduino-MDEwOlJlcG9zaXRvcnk3NDM1NDcyOQ==-flat-nrf_vmc.h.html,25,Adafruit_nRF52_Arduino-MDEwOlJlcG9zaXRvcnk3NDM1NDcyOQ==-flat-nrf_vmc.h,Adafruit_nRF52_Arduino-MDEwOlJlcG9zaXRvcnk3NDM1NDcyOQ==-flat-nrf_vmc.h,81,89,8,104,112,8
264,https://htmlpreview.github.io/?https://github.com/Christina96/boilerplate-sample-matches/blob/main/C/xmrig-MDEwOlJlcG9zaXRvcnk4ODMyNzQwNg==-flat-cl_ext_intel.h-xmrig-MDEwOlJlcG9zaXRvcnk4ODMyNzQwNg==-flat-cl_gl.h.html,22,xmrig-MDEwOlJlcG9zaXRvcnk4ODMyNzQwNg==-flat-cl_ext_intel.h,xmrig-MDEwOlJlcG9zaXRvcnk4ODMyNzQwNg==-flat-cl_gl.h,100,104,4,96,100,4
265,https://htmlpreview.github.io/?https://github.com/Christina96/boilerplate-sample-matches/blob/main/C/redis-MDEwOlJlcG9zaXRvcnkxMDgxMTA3MDY=-flat-sds_35.c-redis-MDEwOlJlcG9zaXRvcnkxMDgxMTA3MDY=-flat-sds.c.html,106,redis-MDEwOlJlcG9zaXRvcnkxMDgxMTA3MDY=-flat-sds_35.c,redis-MDEwOlJlcG9zaXRvcnkxMDgxMTA3MDY=-flat-sds.c,450,460,10,421,431,10
266,https://htmlpreview.github.io/?https://github.com/Christina96/boilerplate-sample-matches/blob/main/C/PINRemoteImage-MDEwOlJlcG9zaXRvcnkzOTUzNzEwMw==-flat-dec_msa.c-PINRemoteImage-MDEwOlJlcG9zaXRvcnkzOTUzNzEwMw==-flat-dec_msa.c.html,17,PINRemoteImage-MDEwOlJlcG9zaXRvcnkzOTUzNzEwMw==-flat-dec_msa.c,PINRemoteImage-MDEwOlJlcG9zaXRvcnkzOTUzNzEwMw==-flat-dec_msa.c,592,594,2,586,588,2
267,https://htmlpreview.github.io/?https://github.com/Christina96/boilerplate-sample-matches/blob/main/C/PINRemoteImage-MDEwOlJlcG9zaXRvcnkzOTUzNzEwMw==-flat-gif2webp.c-PINRemoteImage-MDEwOlJlcG9zaXRvcnkzOTUzNzEwMw==-flat-cwebp.c.html,15,PINRemoteImage-MDEwOlJlcG9zaXRvcnkzOTUzNzEwMw==-flat-gif2webp.c,PINRemoteImage-MDEwOlJlcG9zaXRvcnkzOTUzNzEwMw==-flat-cwebp.c,222,226,4,813,817,4
268,https://htmlpreview.github.io/?https://github.com/Christina96/boilerplate-sample-matches/blob/main/C/redis-MDEwOlJlcG9zaXRvcnkxMDgxMTA3MDY=-flat-Win32_ANSI.c-redis-MDEwOlJlcG9zaXRvcnkxMDgxMTA3MDY=-flat-Win32_ANSI.c.html,22,redis-MDEwOlJlcG9zaXRvcnkxMDgxMTA3MDY=-flat-Win32_ANSI.c,redis-MDEwOlJlcG9zaXRvcnkxMDgxMTA3MDY=-flat-Win32_ANSI.c,214,217,3,219,222,3
269,https://htmlpreview.github.io/?https://github.com/Christina96/boilerplate-sample-matches/blob/main/C/small-MDEwOlJlcG9zaXRvcnkyNTY3NjMxNjk=-flat-auth.c-small-MDEwOlJlcG9zaXRvcnkyNTY3NjMxNjk=-flat-auth.c.html,15,small-MDEwOlJlcG9zaXRvcnkyNTY3NjMxNjk=-flat-auth.c,small-MDEwOlJlcG9zaXRvcnkyNTY3NjMxNjk=-flat-auth.c,457,458,1,562,563,1
270,https://htmlpreview.github.io/?https://github.com/Christina96/boilerplate-sample-matches/blob/main/C/redis-MDEwOlJlcG9zaXRvcnkxMDgxMTA3MDY=-flat-huge.c-redis-MDEwOlJlcG9zaXRvcnkxMDgxMTA3MDY=-flat-huge.c.html,24,redis-MDEwOlJlcG9zaXRvcnkxMDgxMTA3MDY=-flat-huge.c,redis-MDEwOlJlcG9zaXRvcnkxMDgxMTA3MDY=-flat-huge.c,10,12,2,21,23,2
271,https://htmlpreview.github.io/?https://github.com/Christina96/boilerplate-sample-matches/blob/main/C/android-gpuimage-plus-MDEwOlJlcG9zaXRvcnk0NjU0NzQxNw==-flat-avio.h-android-gpuimage-plus-MDEwOlJlcG9zaXRvcnk0NjU0NzQxNw==-flat-avio.h.html,16,android-gpuimage-plus-MDEwOlJlcG9zaXRvcnk0NjU0NzQxNw==-flat-avio.h,android-gpuimage-plus-MDEwOlJlcG9zaXRvcnk0NjU0NzQxNw==-flat-avio.h,21,28,7,48,55,7
272,https://htmlpreview.github.io/?https://github.com/Christina96/boilerplate-sample-matches/blob/main/C/redis-MDEwOlJlcG9zaXRvcnkxMDgxMTA3MDY=-flat-sds_35.c-redis-MDEwOlJlcG9zaXRvcnkxMDgxMTA3MDY=-flat-sds.c.html,1443,redis-MDEwOlJlcG9zaXRvcnkxMDgxMTA3MDY=-flat-sds_35.c,redis-MDEwOlJlcG9zaXRvcnkxMDgxMTA3MDY=-flat-sds.c,683,871,188,665,853,188
273,https://htmlpreview.github.io/?https://github.com/Christina96/boilerplate-sample-matches/blob/main/C/redis-MDEwOlJlcG9zaXRvcnkxMDgxMTA3MDY=-flat-prof.c-redis-MDEwOlJlcG9zaXRvcnkxMDgxMTA3MDY=-flat-prof.c.html,55,redis-MDEwOlJlcG9zaXRvcnkxMDgxMTA3MDY=-flat-prof.c,redis-MDEwOlJlcG9zaXRvcnkxMDgxMTA3MDY=-flat-prof.c,231,241,10,263,273,10
274,https://htmlpreview.github.io/?https://github.com/Christina96/boilerplate-sample-matches/blob/main/C/xmrig-MDEwOlJlcG9zaXRvcnk4ODMyNzQwNg==-flat-sph_simd.c-xmrig-MDEwOlJlcG9zaXRvcnk4ODMyNzQwNg==-flat-sph_simd.c.html,19,xmrig-MDEwOlJlcG9zaXRvcnk4ODMyNzQwNg==-flat-sph_simd.c,xmrig-MDEwOlJlcG9zaXRvcnk4ODMyNzQwNg==-flat-sph_simd.c,90,91,1,92,93,1
275,https://htmlpreview.github.io/?https://github.com/Christina96/boilerplate-sample-matches/blob/main/C/redis-MDEwOlJlcG9zaXRvcnkxMDgxMTA3MDY=-flat-aof.c-redis-MDEwOlJlcG9zaXRvcnkxMDgxMTA3MDY=-flat-hiredis.c.html,16,redis-MDEwOlJlcG9zaXRvcnkxMDgxMTA3MDY=-flat-aof.c,redis-MDEwOlJlcG9zaXRvcnkxMDgxMTA3MDY=-flat-hiredis.c,345,347,2,297,299,2
276,https://htmlpreview.github.io/?https://github.com/Christina96/boilerplate-sample-matches/blob/main/C/PINRemoteImage-MDEwOlJlcG9zaXRvcnkzOTUzNzEwMw==-flat-rescaler.c-PINRemoteImage-MDEwOlJlcG9zaXRvcnkzOTUzNzEwMw==-flat-rescaler.c.html,52,PINRemoteImage-MDEwOlJlcG9zaXRvcnkzOTUzNzEwMw==-flat-rescaler.c,PINRemoteImage-MDEwOlJlcG9zaXRvcnkzOTUzNzEwMw==-flat-rescaler.c,69,75,6,97,103,6
277,https://htmlpreview.github.io/?https://github.com/Christina96/boilerplate-sample-matches/blob/main/C/redis-MDEwOlJlcG9zaXRvcnkxMDgxMTA3MDY=-flat-mallocx.c-redis-MDEwOlJlcG9zaXRvcnkxMDgxMTA3MDY=-flat-smallocx.c.html,20,redis-MDEwOlJlcG9zaXRvcnkxMDgxMTA3MDY=-flat-mallocx.c,redis-MDEwOlJlcG9zaXRvcnkxMDgxMTA3MDY=-flat-smallocx.c,40,44,4,55,59,4
278,https://htmlpreview.github.io/?https://github.com/Christina96/boilerplate-sample-matches/blob/main/C/Adafruit_nRF52_Arduino-MDEwOlJlcG9zaXRvcnk3NDM1NDcyOQ==-flat-ble_2.h-Adafruit_nRF52_Arduino-MDEwOlJlcG9zaXRvcnk3NDM1NDcyOQ==-flat-ble.h.html,235,Adafruit_nRF52_Arduino-MDEwOlJlcG9zaXRvcnk3NDM1NDcyOQ==-flat-ble_2.h,Adafruit_nRF52_Arduino-MDEwOlJlcG9zaXRvcnk3NDM1NDcyOQ==-flat-ble.h,90,108,18,90,108,18
279,https://htmlpreview.github.io/?https://github.com/Christina96/boilerplate-sample-matches/blob/main/C/PINRemoteImage-MDEwOlJlcG9zaXRvcnkzOTUzNzEwMw==-flat-img2webp.c-PINRemoteImage-MDEwOlJlcG9zaXRvcnkzOTUzNzEwMw==-flat-img2webp.c.html,18,PINRemoteImage-MDEwOlJlcG9zaXRvcnkzOTUzNzEwMw==-flat-img2webp.c,PINRemoteImage-MDEwOlJlcG9zaXRvcnkzOTUzNzEwMw==-flat-img2webp.c,70,72,2,67,69,2
280,https://htmlpreview.github.io/?https://github.com/Christina96/boilerplate-sample-matches/blob/main/C/fftw3-MDEwOlJlcG9zaXRvcnk4ODQzMzg4-flat-verify-dft.c-fftw3-MDEwOlJlcG9zaXRvcnk4ODQzMzg4-flat-verify-rdft2.c.html,70,fftw3-MDEwOlJlcG9zaXRvcnk4ODQzMzg4-flat-verify-dft.c,fftw3-MDEwOlJlcG9zaXRvcnk4ODQzMzg4-flat-verify-rdft2.c,64,73,9,175,184,9
281,https://htmlpreview.github.io/?https://github.com/Christina96/boilerplate-sample-matches/blob/main/C/redis-MDEwOlJlcG9zaXRvcnkxMDgxMTA3MDY=-flat-hook.c-redis-MDEwOlJlcG9zaXRvcnkxMDgxMTA3MDY=-flat-hook.c.html,102,redis-MDEwOlJlcG9zaXRvcnkxMDgxMTA3MDY=-flat-hook.c,redis-MDEwOlJlcG9zaXRvcnkxMDgxMTA3MDY=-flat-hook.c,210,221,11,222,232,10
282,https://htmlpreview.github.io/?https://github.com/Christina96/boilerplate-sample-matches/blob/main/C/redis-MDEwOlJlcG9zaXRvcnkxMDgxMTA3MDY=-flat-Win32_Error.c-small-MDEwOlJlcG9zaXRvcnkyNTY3NjMxNjk=-flat-acl.c.html,26,redis-MDEwOlJlcG9zaXRvcnkxMDgxMTA3MDY=-flat-Win32_Error.c,small-MDEwOlJlcG9zaXRvcnkyNTY3NjMxNjk=-flat-acl.c,145,148,3,298,301,3
283,https://htmlpreview.github.io/?https://github.com/Christina96/boilerplate-sample-matches/blob/main/C/fftw3-MDEwOlJlcG9zaXRvcnk4ODQzMzg4-flat-mkprinter-str.c-fftw3-MDEwOlJlcG9zaXRvcnk4ODQzMzg4-flat-debug.c.html,15,fftw3-MDEwOlJlcG9zaXRvcnk4ODQzMzg4-flat-mkprinter-str.c,fftw3-MDEwOlJlcG9zaXRvcnk4ODQzMzg4-flat-debug.c,5,8,3,7,10,3
284,https://htmlpreview.github.io/?https://github.com/Christina96/boilerplate-sample-matches/blob/main/C/PINRemoteImage-MDEwOlJlcG9zaXRvcnkzOTUzNzEwMw==-flat-decode_22.h-PINRemoteImage-MDEwOlJlcG9zaXRvcnkzOTUzNzEwMw==-flat-decode_40.h.html,16,PINRemoteImage-MDEwOlJlcG9zaXRvcnkzOTUzNzEwMw==-flat-decode_22.h,PINRemoteImage-MDEwOlJlcG9zaXRvcnkzOTUzNzEwMw==-flat-decode_40.h,107,115,8,107,115,8
285,https://htmlpreview.github.io/?https://github.com/Christina96/boilerplate-sample-matches/blob/main/C/Adafruit_nRF52_Arduino-MDEwOlJlcG9zaXRvcnk3NDM1NDcyOQ==-flat-nrfx_gppi.h-Adafruit_nRF52_Arduino-MDEwOlJlcG9zaXRvcnk3NDM1NDcyOQ==-flat-nrfx_gppi.h.html,30,Adafruit_nRF52_Arduino-MDEwOlJlcG9zaXRvcnk3NDM1NDcyOQ==-flat-nrfx_gppi.h,Adafruit_nRF52_Arduino-MDEwOlJlcG9zaXRvcnk3NDM1NDcyOQ==-flat-nrfx_gppi.h,188,194,6,288,294,6
286,https://htmlpreview.github.io/?https://github.com/Christina96/boilerplate-sample-matches/blob/main/C/libtomcrypt-MDEwOlJlcG9zaXRvcnk3NzcwMTE=-flat-ocb_init.c-libtomcrypt-MDEwOlJlcG9zaXRvcnk3NzcwMTE=-flat-pmac_init.c.html,165,libtomcrypt-MDEwOlJlcG9zaXRvcnk3NzcwMTE=-flat-ocb_init.c,libtomcrypt-MDEwOlJlcG9zaXRvcnk3NzcwMTE=-flat-pmac_init.c,58,69,11,59,70,11
287,https://htmlpreview.github.io/?https://github.com/Christina96/boilerplate-sample-matches/blob/main/C/xmrig-MDEwOlJlcG9zaXRvcnk4ODMyNzQwNg==-flat-IJobResultListener.h-xmrig-MDEwOlJlcG9zaXRvcnk4ODMyNzQwNg==-flat-IWatcherListener.h.html,36,xmrig-MDEwOlJlcG9zaXRvcnk4ODMyNzQwNg==-flat-IJobResultListener.h,xmrig-MDEwOlJlcG9zaXRvcnk4ODMyNzQwNg==-flat-IWatcherListener.h,6,13,7,5,12,7
288,https://htmlpreview.github.io/?https://github.com/Christina96/boilerplate-sample-matches/blob/main/C/Adafruit_nRF52_Arduino-MDEwOlJlcG9zaXRvcnk3NDM1NDcyOQ==-flat-bignum.c-Adafruit_nRF52_Arduino-MDEwOlJlcG9zaXRvcnk3NDM1NDcyOQ==-flat-bignum.c.html,15,Adafruit_nRF52_Arduino-MDEwOlJlcG9zaXRvcnk3NDM1NDcyOQ==-flat-bignum.c,Adafruit_nRF52_Arduino-MDEwOlJlcG9zaXRvcnk3NDM1NDcyOQ==-flat-bignum.c,1225,1226,1,1198,1199,1
289,https://htmlpreview.github.io/?https://github.com/Christina96/boilerplate-sample-matches/blob/main/C/redis-MDEwOlJlcG9zaXRvcnkxMDgxMTA3MDY=-flat-sc.h-libfuse-MDEwOlJlcG9zaXRvcnk0ODI5NjE3Nw==-flat-helper.c.html,15,redis-MDEwOlJlcG9zaXRvcnkxMDgxMTA3MDY=-flat-sc.h,libfuse-MDEwOlJlcG9zaXRvcnk0ODI5NjE3Nw==-flat-helper.c,63,68,5,65,70,5
290,https://htmlpreview.github.io/?https://github.com/Christina96/boilerplate-sample-matches/blob/main/C/Adafruit_nRF52_Arduino-MDEwOlJlcG9zaXRvcnk3NDM1NDcyOQ==-flat-nrf_qspi.h-Adafruit_nRF52_Arduino-MDEwOlJlcG9zaXRvcnk3NDM1NDcyOQ==-flat-nrf_qspi.h.html,26,Adafruit_nRF52_Arduino-MDEwOlJlcG9zaXRvcnk3NDM1NDcyOQ==-flat-nrf_qspi.h,Adafruit_nRF52_Arduino-MDEwOlJlcG9zaXRvcnk3NDM1NDcyOQ==-flat-nrf_qspi.h,514,516,2,494,496,2
291,https://htmlpreview.github.io/?https://github.com/Christina96/boilerplate-sample-matches/blob/main/C/xmrig-MDEwOlJlcG9zaXRvcnk4ODMyNzQwNg==-flat-IDnsBackend.h-xmrig-MDEwOlJlcG9zaXRvcnk4ODMyNzQwNg==-flat-Rx.h.html,17,xmrig-MDEwOlJlcG9zaXRvcnk4ODMyNzQwNg==-flat-IDnsBackend.h,xmrig-MDEwOlJlcG9zaXRvcnk4ODMyNzQwNg==-flat-Rx.h,5,11,6,7,13,6
292,https://htmlpreview.github.io/?https://github.com/Christina96/boilerplate-sample-matches/blob/main/C/redis-MDEwOlJlcG9zaXRvcnkxMDgxMTA3MDY=-flat-module.c-redis-MDEwOlJlcG9zaXRvcnkxMDgxMTA3MDY=-flat-module.c.html,67,redis-MDEwOlJlcG9zaXRvcnkxMDgxMTA3MDY=-flat-module.c,redis-MDEwOlJlcG9zaXRvcnkxMDgxMTA3MDY=-flat-module.c,1125,1140,15,1179,1194,15
293,https://htmlpreview.github.io/?https://github.com/Christina96/boilerplate-sample-matches/blob/main/C/fftw3-MDEwOlJlcG9zaXRvcnk4ODQzMzg4-flat-reodft11e-radix2.c-fftw3-MDEwOlJlcG9zaXRvcnk4ODQzMzg4-flat-reodft010e-r2hc.c.html,21,fftw3-MDEwOlJlcG9zaXRvcnk4ODQzMzg4-flat-reodft11e-radix2.c,fftw3-MDEwOlJlcG9zaXRvcnk4ODQzMzg4-flat-reodft010e-r2hc.c,129,130,1,184,185,1
294,https://htmlpreview.github.io/?https://github.com/Christina96/boilerplate-sample-matches/blob/main/C/redis-MDEwOlJlcG9zaXRvcnkxMDgxMTA3MDY=-flat-lfunc.c-redis-MDEwOlJlcG9zaXRvcnkxMDgxMTA3MDY=-flat-lfunc.c.html,39,redis-MDEwOlJlcG9zaXRvcnkxMDgxMTA3MDY=-flat-lfunc.c,redis-MDEwOlJlcG9zaXRvcnkxMDgxMTA3MDY=-flat-lfunc.c,12,16,4,20,24,4
295,https://htmlpreview.github.io/?https://github.com/Christina96/boilerplate-sample-matches/blob/main/C/xmrig-MDEwOlJlcG9zaXRvcnk4ODMyNzQwNg==-flat-c_groestl.c-xmrig-MDEwOlJlcG9zaXRvcnk4ODMyNzQwNg==-flat-c_groestl.c.html,68,xmrig-MDEwOlJlcG9zaXRvcnk4ODMyNzQwNg==-flat-c_groestl.c,xmrig-MDEwOlJlcG9zaXRvcnk4ODMyNzQwNg==-flat-c_groestl.c,39,45,6,17,23,6
296,https://htmlpreview.github.io/?https://github.com/Christina96/boilerplate-sample-matches/blob/main/C/xmrig-MDEwOlJlcG9zaXRvcnk4ODMyNzQwNg==-flat-sph_hamsi_helper.c-xmrig-MDEwOlJlcG9zaXRvcnk4ODMyNzQwNg==-flat-sph_hamsi_helper.c.html,15,xmrig-MDEwOlJlcG9zaXRvcnk4ODMyNzQwNg==-flat-sph_hamsi_helper.c,xmrig-MDEwOlJlcG9zaXRvcnk4ODMyNzQwNg==-flat-sph_hamsi_helper.c,7821,7823,2,15415,15417,2
297,https://htmlpreview.github.io/?https://github.com/Christina96/boilerplate-sample-matches/blob/main/C/PINRemoteImage-MDEwOlJlcG9zaXRvcnkzOTUzNzEwMw==-flat-encode_38.h-PINRemoteImage-MDEwOlJlcG9zaXRvcnkzOTUzNzEwMw==-flat-encode_44.h.html,230,PINRemoteImage-MDEwOlJlcG9zaXRvcnkzOTUzNzEwMw==-flat-encode_38.h,PINRemoteImage-MDEwOlJlcG9zaXRvcnkzOTUzNzEwMw==-flat-encode_44.h,199,226,27,199,226,27
298,https://htmlpreview.github.io/?https://github.com/Christina96/boilerplate-sample-matches/blob/main/C/libtomcrypt-MDEwOlJlcG9zaXRvcnk3NzcwMTE=-flat-ocb_ntz.c-libtomcrypt-MDEwOlJlcG9zaXRvcnk3NzcwMTE=-flat-pmac_ntz.c.html,42,libtomcrypt-MDEwOlJlcG9zaXRvcnk3NzcwMTE=-flat-ocb_ntz.c,libtomcrypt-MDEwOlJlcG9zaXRvcnk3NzcwMTE=-flat-pmac_ntz.c,3,14,11,3,14,11
299,https://htmlpreview.github.io/?https://github.com/Christina96/boilerplate-sample-matches/blob/main/C/xmrig-MDEwOlJlcG9zaXRvcnk4ODMyNzQwNg==-flat-sse2neon.h-xmrig-MDEwOlJlcG9zaXRvcnk4ODMyNzQwNg==-flat-sse2neon.h.html,20,xmrig-MDEwOlJlcG9zaXRvcnk4ODMyNzQwNg==-flat-sse2neon.h,xmrig-MDEwOlJlcG9zaXRvcnk4ODMyNzQwNg==-flat-sse2neon.h,1087,1091,4,1106,1110,4
300,https://htmlpreview.github.io/?https://github.com/Christina96/boilerplate-sample-matches/blob/main/C/redis-MDEwOlJlcG9zaXRvcnkxMDgxMTA3MDY=-flat-sds_35.c-redis-MDEwOlJlcG9zaXRvcnkxMDgxMTA3MDY=-flat-sds.c.html,18,redis-MDEwOlJlcG9zaXRvcnkxMDgxMTA3MDY=-flat-sds_35.c,redis-MDEwOlJlcG9zaXRvcnkxMDgxMTA3MDY=-flat-sds.c,271,275,4,427,431,4
301,https://htmlpreview.github.io/?https://github.com/Christina96/boilerplate-sample-matches/blob/main/C/PINRemoteImage-MDEwOlJlcG9zaXRvcnkzOTUzNzEwMw==-flat-PINRemoteImageManager.h-PINRemoteImage-MDEwOlJlcG9zaXRvcnkzOTUzNzEwMw==-flat-PINRemoteImageManager.h.html,34,PINRemoteImage-MDEwOlJlcG9zaXRvcnkzOTUzNzEwMw==-flat-PINRemoteImageManager.h,PINRemoteImage-MDEwOlJlcG9zaXRvcnkzOTUzNzEwMw==-flat-PINRemoteImageManager.h,53,56,3,56,60,4
302,https://htmlpreview.github.io/?https://github.com/Christina96/boilerplate-sample-matches/blob/main/C/fftw3-MDEwOlJlcG9zaXRvcnk4ODQzMzg4-flat-mpi-bench.c-fftw3-MDEwOlJlcG9zaXRvcnk4ODQzMzg4-flat-mpi-bench.c.html,91,fftw3-MDEwOlJlcG9zaXRvcnk4ODQzMzg4-flat-mpi-bench.c,fftw3-MDEwOlJlcG9zaXRvcnk4ODQzMzg4-flat-mpi-bench.c,417,425,8,340,348,8
303,https://htmlpreview.github.io/?https://github.com/Christina96/boilerplate-sample-matches/blob/main/C/Adafruit_nRF52_Arduino-MDEwOlJlcG9zaXRvcnk3NDM1NDcyOQ==-flat-nrf_nfct.h-Adafruit_nRF52_Arduino-MDEwOlJlcG9zaXRvcnk3NDM1NDcyOQ==-flat-nrf_nfct.h.html,22,Adafruit_nRF52_Arduino-MDEwOlJlcG9zaXRvcnk3NDM1NDcyOQ==-flat-nrf_nfct.h,Adafruit_nRF52_Arduino-MDEwOlJlcG9zaXRvcnk3NDM1NDcyOQ==-flat-nrf_nfct.h,197,201,4,209,212,3
304,https://htmlpreview.github.io/?https://github.com/Christina96/boilerplate-sample-matches/blob/main/C/PINRemoteImage-MDEwOlJlcG9zaXRvcnkzOTUzNzEwMw==-flat-libwebp_java_wrap.c-PINRemoteImage-MDEwOlJlcG9zaXRvcnkzOTUzNzEwMw==-flat-libwebp_python_wrap.c.html,16,PINRemoteImage-MDEwOlJlcG9zaXRvcnkzOTUzNzEwMw==-flat-libwebp_java_wrap.c,PINRemoteImage-MDEwOlJlcG9zaXRvcnkzOTUzNzEwMw==-flat-libwebp_python_wrap.c,773,774,1,2774,2775,1
305,https://htmlpreview.github.io/?https://github.com/Christina96/boilerplate-sample-matches/blob/main/C/libpcap-MDEwOlJlcG9zaXRvcnk5NDM1ODg3-flat-daemon.c-libpcap-MDEwOlJlcG9zaXRvcnk5NDM1ODg3-flat-daemon.c.html,18,libpcap-MDEwOlJlcG9zaXRvcnk5NDM1ODg3-flat-daemon.c,libpcap-MDEwOlJlcG9zaXRvcnk5NDM1ODg3-flat-daemon.c,1021,1027,6,1031,1037,6
306,https://htmlpreview.github.io/?https://github.com/Christina96/boilerplate-sample-matches/blob/main/C/libtomcrypt-MDEwOlJlcG9zaXRvcnk3NzcwMTE=-flat-sosemanuk.c-libtomcrypt-MDEwOlJlcG9zaXRvcnk3NzcwMTE=-flat-sosemanuk.c.html,53,libtomcrypt-MDEwOlJlcG9zaXRvcnk3NzcwMTE=-flat-sosemanuk.c,libtomcrypt-MDEwOlJlcG9zaXRvcnk3NzcwMTE=-flat-sosemanuk.c,100,105,5,104,109,5
307,https://htmlpreview.github.io/?https://github.com/Christina96/boilerplate-sample-matches/blob/main/C/PINRemoteImage-MDEwOlJlcG9zaXRvcnkzOTUzNzEwMw==-flat-lossless_msa.c-PINRemoteImage-MDEwOlJlcG9zaXRvcnkzOTUzNzEwMw==-flat-lossless_enc_msa.c.html,125,PINRemoteImage-MDEwOlJlcG9zaXRvcnkzOTUzNzEwMw==-flat-lossless_msa.c,PINRemoteImage-MDEwOlJlcG9zaXRvcnkzOTUzNzEwMw==-flat-lossless_enc_msa.c,218,228,10,80,90,10
308,https://htmlpreview.github.io/?https://github.com/Christina96/boilerplate-sample-matches/blob/main/C/fftw3-MDEwOlJlcG9zaXRvcnk4ODQzMzg4-flat-plan-many-dft-c2r.c-fftw3-MDEwOlJlcG9zaXRvcnk4ODQzMzg4-flat-plan-many-dft-r2c.c.html,19,fftw3-MDEwOlJlcG9zaXRvcnk4ODQzMzg4-flat-plan-many-dft-c2r.c,fftw3-MDEwOlJlcG9zaXRvcnk4ODQzMzg4-flat-plan-many-dft-r2c.c,15,17,2,15,17,2
309,https://htmlpreview.github.io/?https://github.com/Christina96/boilerplate-sample-matches/blob/main/C/redis-MDEwOlJlcG9zaXRvcnkxMDgxMTA3MDY=-flat-jemalloc.c-redis-MDEwOlJlcG9zaXRvcnkxMDgxMTA3MDY=-flat-jemalloc.c.html,51,redis-MDEwOlJlcG9zaXRvcnkxMDgxMTA3MDY=-flat-jemalloc.c,redis-MDEwOlJlcG9zaXRvcnkxMDgxMTA3MDY=-flat-jemalloc.c,806,811,5,846,851,5
310,https://htmlpreview.github.io/?https://github.com/Christina96/boilerplate-sample-matches/blob/main/C/fftw3-MDEwOlJlcG9zaXRvcnk4ODQzMzg4-flat-rdft-rank-geq2-transposed.c-fftw3-MDEwOlJlcG9zaXRvcnk4ODQzMzg4-flat-rdft-rank-geq2.c.html,40,fftw3-MDEwOlJlcG9zaXRvcnk4ODQzMzg4-flat-rdft-rank-geq2-transposed.c,fftw3-MDEwOlJlcG9zaXRvcnk4ODQzMzg4-flat-rdft-rank-geq2.c,104,108,4,97,101,4
311,https://htmlpreview.github.io/?https://github.com/Christina96/boilerplate-sample-matches/blob/main/C/Adafruit_nRF52_Arduino-MDEwOlJlcG9zaXRvcnk3NDM1NDcyOQ==-flat-nrf_i2s.h-Adafruit_nRF52_Arduino-MDEwOlJlcG9zaXRvcnk3NDM1NDcyOQ==-flat-nrf_i2s.h.html,23,Adafruit_nRF52_Arduino-MDEwOlJlcG9zaXRvcnk3NDM1NDcyOQ==-flat-nrf_i2s.h,Adafruit_nRF52_Arduino-MDEwOlJlcG9zaXRvcnk3NDM1NDcyOQ==-flat-nrf_i2s.h,340,344,4,331,335,4
312,https://htmlpreview.github.io/?https://github.com/Christina96/boilerplate-sample-matches/blob/main/C/PINRemoteImage-MDEwOlJlcG9zaXRvcnkzOTUzNzEwMw==-flat-dec_sse2.c-PINRemoteImage-MDEwOlJlcG9zaXRvcnkzOTUzNzEwMw==-flat-dec_sse2.c.html,32,PINRemoteImage-MDEwOlJlcG9zaXRvcnkzOTUzNzEwMw==-flat-dec_sse2.c,PINRemoteImage-MDEwOlJlcG9zaXRvcnkzOTUzNzEwMw==-flat-dec_sse2.c,836,841,5,782,787,5
313,https://htmlpreview.github.io/?https://github.com/Christina96/boilerplate-sample-matches/blob/main/C/redis-MDEwOlJlcG9zaXRvcnkxMDgxMTA3MDY=-flat-sz.h-redis-MDEwOlJlcG9zaXRvcnkxMDgxMTA3MDY=-flat-sz.h.html,20,redis-MDEwOlJlcG9zaXRvcnkxMDgxMTA3MDY=-flat-sz.h,redis-MDEwOlJlcG9zaXRvcnkxMDgxMTA3MDY=-flat-sz.h,32,37,5,48,53,5
314,https://htmlpreview.github.io/?https://github.com/Christina96/boilerplate-sample-matches/blob/main/C/xmrig-MDEwOlJlcG9zaXRvcnk4ODMyNzQwNg==-flat-WorkerJob.h-xmrig-MDEwOlJlcG9zaXRvcnk4ODMyNzQwNg==-flat-WorkerJob.h.html,19,xmrig-MDEwOlJlcG9zaXRvcnk4ODMyNzQwNg==-flat-WorkerJob.h,xmrig-MDEwOlJlcG9zaXRvcnk4ODMyNzQwNg==-flat-WorkerJob.h,17,19,2,50,52,2
315,https://htmlpreview.github.io/?https://github.com/Christina96/boilerplate-sample-matches/blob/main/C/redis-MDEwOlJlcG9zaXRvcnkxMDgxMTA3MDY=-flat-jemalloc_protos.h-redis-MDEwOlJlcG9zaXRvcnkxMDgxMTA3MDY=-flat-jemalloc_protos_jet.h.html,178,redis-MDEwOlJlcG9zaXRvcnkxMDgxMTA3MDY=-flat-jemalloc_protos.h,redis-MDEwOlJlcG9zaXRvcnkxMDgxMTA3MDY=-flat-jemalloc_protos_jet.h,34,56,22,34,56,22
316,https://htmlpreview.github.io/?https://github.com/Christina96/boilerplate-sample-matches/blob/main/C/fftw3-MDEwOlJlcG9zaXRvcnk4ODQzMzg4-flat-x86-cpuid.h-fftw3-MDEwOlJlcG9zaXRvcnk4ODQzMzg4-flat-x86-cpuid.h.html,82,fftw3-MDEwOlJlcG9zaXRvcnk4ODQzMzg4-flat-x86-cpuid.h,fftw3-MDEwOlJlcG9zaXRvcnk4ODQzMzg4-flat-x86-cpuid.h,11,42,31,48,79,31
317,https://htmlpreview.github.io/?https://github.com/Christina96/boilerplate-sample-matches/blob/main/C/small-MDEwOlJlcG9zaXRvcnkyNTY3NjMxNjk=-flat-encrypt.c-small-MDEwOlJlcG9zaXRvcnkyNTY3NjMxNjk=-flat-encrypt.c.html,17,small-MDEwOlJlcG9zaXRvcnkyNTY3NjMxNjk=-flat-encrypt.c,small-MDEwOlJlcG9zaXRvcnkyNTY3NjMxNjk=-flat-encrypt.c,1020,1023,3,1156,1159,3
318,https://htmlpreview.github.io/?https://github.com/Christina96/boilerplate-sample-matches/blob/main/C/redis-MDEwOlJlcG9zaXRvcnkxMDgxMTA3MDY=-flat-sds.c-redis-MDEwOlJlcG9zaXRvcnkxMDgxMTA3MDY=-flat-sds.c.html,64,redis-MDEwOlJlcG9zaXRvcnkxMDgxMTA3MDY=-flat-sds.c,redis-MDEwOlJlcG9zaXRvcnkxMDgxMTA3MDY=-flat-sds.c,609,620,11,625,636,11
319,https://htmlpreview.github.io/?https://github.com/Christina96/boilerplate-sample-matches/blob/main/C/fftw3-MDEwOlJlcG9zaXRvcnk4ODQzMzg4-flat-transpose-pairwise.c-fftw3-MDEwOlJlcG9zaXRvcnk4ODQzMzg4-flat-testsched.c.html,203,fftw3-MDEwOlJlcG9zaXRvcnk4ODQzMzg4-flat-transpose-pairwise.c,fftw3-MDEwOlJlcG9zaXRvcnk4ODQzMzg4-flat-testsched.c,141,160,19,84,103,19
320,https://htmlpreview.github.io/?https://github.com/Christina96/boilerplate-sample-matches/blob/main/C/redis-MDEwOlJlcG9zaXRvcnkxMDgxMTA3MDY=-flat-atomic_c11.h-redis-MDEwOlJlcG9zaXRvcnkxMDgxMTA3MDY=-flat-atomic_c11.h.html,48,redis-MDEwOlJlcG9zaXRvcnkxMDgxMTA3MDY=-flat-atomic_c11.h,redis-MDEwOlJlcG9zaXRvcnkxMDgxMTA3MDY=-flat-atomic_c11.h,75,82,7,70,76,6
321,https://htmlpreview.github.io/?https://github.com/Christina96/boilerplate-sample-matches/blob/main/C/libtomcrypt-MDEwOlJlcG9zaXRvcnk3NzcwMTE=-flat-chacha20poly1305_memory.c-redis-MDEwOlJlcG9zaXRvcnkxMDgxMTA3MDY=-flat-ctl.c.html,15,libtomcrypt-MDEwOlJlcG9zaXRvcnk3NzcwMTE=-flat-chacha20poly1305_memory.c,redis-MDEwOlJlcG9zaXRvcnkxMDgxMTA3MDY=-flat-ctl.c,34,40,6,1461,1466,5
322,https://htmlpreview.github.io/?https://github.com/Christina96/boilerplate-sample-matches/blob/main/C/xmrig-MDEwOlJlcG9zaXRvcnk4ODMyNzQwNg==-flat-bitmap.c-libpcap-MDEwOlJlcG9zaXRvcnk5NDM1ODg3-flat-pcap-sita.c.html,17,xmrig-MDEwOlJlcG9zaXRvcnk4ODMyNzQwNg==-flat-bitmap.c,libpcap-MDEwOlJlcG9zaXRvcnk5NDM1ODg3-flat-pcap-sita.c,139,143,4,847,851,4
323,https://htmlpreview.github.io/?https://github.com/Christina96/boilerplate-sample-matches/blob/main/C/PINRemoteImage-MDEwOlJlcG9zaXRvcnkzOTUzNzEwMw==-flat-get_disto.c-PINRemoteImage-MDEwOlJlcG9zaXRvcnkzOTUzNzEwMw==-flat-dsp.h.html,18,PINRemoteImage-MDEwOlJlcG9zaXRvcnkzOTUzNzEwMw==-flat-get_disto.c,PINRemoteImage-MDEwOlJlcG9zaXRvcnkzOTUzNzEwMw==-flat-dsp.h,62,66,4,215,219,4
324,https://htmlpreview.github.io/?https://github.com/Christina96/boilerplate-sample-matches/blob/main/C/Adafruit_nRF52_Arduino-MDEwOlJlcG9zaXRvcnk3NDM1NDcyOQ==-flat-nrfx_qspi.c-Adafruit_nRF52_Arduino-MDEwOlJlcG9zaXRvcnk3NDM1NDcyOQ==-flat-nrfx_qspi.h.html,18,Adafruit_nRF52_Arduino-MDEwOlJlcG9zaXRvcnk3NDM1NDcyOQ==-flat-nrfx_qspi.c,Adafruit_nRF52_Arduino-MDEwOlJlcG9zaXRvcnk3NDM1NDcyOQ==-flat-nrfx_qspi.h,145,149,4,77,80,3
325,https://htmlpreview.github.io/?https://github.com/Christina96/boilerplate-sample-matches/blob/main/C/xmrig-MDEwOlJlcG9zaXRvcnk4ODMyNzQwNg==-flat-components.c-xmrig-MDEwOlJlcG9zaXRvcnk4ODMyNzQwNg==-flat-components.c.html,26,xmrig-MDEwOlJlcG9zaXRvcnk4ODMyNzQwNg==-flat-components.c,xmrig-MDEwOlJlcG9zaXRvcnk4ODMyNzQwNg==-flat-components.c,614,619,5,636,641,5
326,https://htmlpreview.github.io/?https://github.com/Christina96/boilerplate-sample-matches/blob/main/C/redis-MDEwOlJlcG9zaXRvcnkxMDgxMTA3MDY=-flat-Win32_RedisLog.c-redis-MDEwOlJlcG9zaXRvcnkxMDgxMTA3MDY=-flat-server.c.html,20,redis-MDEwOlJlcG9zaXRvcnkxMDgxMTA3MDY=-flat-Win32_RedisLog.c,redis-MDEwOlJlcG9zaXRvcnkxMDgxMTA3MDY=-flat-server.c,139,142,3,287,290,3
327,https://htmlpreview.github.io/?https://github.com/Christina96/boilerplate-sample-matches/blob/main/C/redis-MDEwOlJlcG9zaXRvcnkxMDgxMTA3MDY=-flat-hash.h-PINRemoteImage-MDEwOlJlcG9zaXRvcnkzOTUzNzEwMw==-flat-alpha_processing_mips_dsp_r2.c.html,18,redis-MDEwOlJlcG9zaXRvcnkxMDgxMTA3MDY=-flat-hash.h,PINRemoteImage-MDEwOlJlcG9zaXRvcnkzOTUzNzEwMw==-flat-alpha_processing_mips_dsp_r2.c,92,95,3,64,67,3
328,https://htmlpreview.github.io/?https://github.com/Christina96/boilerplate-sample-matches/blob/main/C/xmrig-MDEwOlJlcG9zaXRvcnk4ODMyNzQwNg==-flat-llhttp.c-xmrig-MDEwOlJlcG9zaXRvcnk4ODMyNzQwNg==-flat-llhttp.c.html,20,xmrig-MDEwOlJlcG9zaXRvcnk4ODMyNzQwNg==-flat-llhttp.c,xmrig-MDEwOlJlcG9zaXRvcnk4ODMyNzQwNg==-flat-llhttp.c,4478,4482,4,11387,11391,4
329,https://htmlpreview.github.io/?https://github.com/Christina96/boilerplate-sample-matches/blob/main/C/libfuse-MDEwOlJlcG9zaXRvcnk0ODI5NjE3Nw==-flat-test_syscalls.c-libfuse-MDEwOlJlcG9zaXRvcnk0ODI5NjE3Nw==-flat-test_syscalls.c.html,16,libfuse-MDEwOlJlcG9zaXRvcnk0ODI5NjE3Nw==-flat-test_syscalls.c,libfuse-MDEwOlJlcG9zaXRvcnk0ODI5NjE3Nw==-flat-test_syscalls.c,853,857,4,903,907,4
330,https://htmlpreview.github.io/?https://github.com/Christina96/boilerplate-sample-matches/blob/main/C/PINRemoteImage-MDEwOlJlcG9zaXRvcnkzOTUzNzEwMw==-flat-lossless_enc.c-PINRemoteImage-MDEwOlJlcG9zaXRvcnkzOTUzNzEwMw==-flat-lossless_enc.c.html,15,PINRemoteImage-MDEwOlJlcG9zaXRvcnkzOTUzNzEwMw==-flat-lossless_enc.c,PINRemoteImage-MDEwOlJlcG9zaXRvcnkzOTUzNzEwMw==-flat-lossless_enc.c,480,482,2,488,490,2
331,https://htmlpreview.github.io/?https://github.com/Christina96/boilerplate-sample-matches/blob/main/C/xmrig-MDEwOlJlcG9zaXRvcnk4ODMyNzQwNg==-flat-document.h-xmrig-MDEwOlJlcG9zaXRvcnk4ODMyNzQwNg==-flat-document.h.html,25,xmrig-MDEwOlJlcG9zaXRvcnk4ODMyNzQwNg==-flat-document.h,xmrig-MDEwOlJlcG9zaXRvcnk4ODMyNzQwNg==-flat-document.h,1038,1039,1,1040,1041,1
332,https://htmlpreview.github.io/?https://github.com/Christina96/boilerplate-sample-matches/blob/main/C/redis-MDEwOlJlcG9zaXRvcnkxMDgxMTA3MDY=-flat-sds_35.c-redis-MDEwOlJlcG9zaXRvcnkxMDgxMTA3MDY=-flat-sds.c.html,19,redis-MDEwOlJlcG9zaXRvcnkxMDgxMTA3MDY=-flat-sds_35.c,redis-MDEwOlJlcG9zaXRvcnkxMDgxMTA3MDY=-flat-sds.c,149,154,5,138,143,5
333,https://htmlpreview.github.io/?https://github.com/Christina96/boilerplate-sample-matches/blob/main/C/libtomcrypt-MDEwOlJlcG9zaXRvcnk3NzcwMTE=-flat-ccm_memory.c-libtomcrypt-MDEwOlJlcG9zaXRvcnk3NzcwMTE=-flat-ccm_memory.c.html,24,libtomcrypt-MDEwOlJlcG9zaXRvcnk3NzcwMTE=-flat-ccm_memory.c,libtomcrypt-MDEwOlJlcG9zaXRvcnk3NzcwMTE=-flat-ccm_memory.c,114,116,2,121,124,3
334,https://htmlpreview.github.io/?https://github.com/Christina96/boilerplate-sample-matches/blob/main/C/xmrig-MDEwOlJlcG9zaXRvcnk4ODMyNzQwNg==-flat-format-inl.h-xmrig-MDEwOlJlcG9zaXRvcnk4ODMyNzQwNg==-flat-format-inl.h.html,33,xmrig-MDEwOlJlcG9zaXRvcnk4ODMyNzQwNg==-flat-format-inl.h,xmrig-MDEwOlJlcG9zaXRvcnk4ODMyNzQwNg==-flat-format-inl.h,1714,1720,6,1738,1744,6
335,https://htmlpreview.github.io/?https://github.com/Christina96/boilerplate-sample-matches/blob/main/C/Adafruit_nRF52_Arduino-MDEwOlJlcG9zaXRvcnk3NDM1NDcyOQ==-flat-nrfx_gppi.h-Adafruit_nRF52_Arduino-MDEwOlJlcG9zaXRvcnk3NDM1NDcyOQ==-flat-nrfx_gppi.h.html,29,Adafruit_nRF52_Arduino-MDEwOlJlcG9zaXRvcnk3NDM1NDcyOQ==-flat-nrfx_gppi.h,Adafruit_nRF52_Arduino-MDEwOlJlcG9zaXRvcnk3NDM1NDcyOQ==-flat-nrfx_gppi.h,152,157,5,162,167,5
336,https://htmlpreview.github.io/?https://github.com/Christina96/boilerplate-sample-matches/blob/main/C/Adafruit_nRF52_Arduino-MDEwOlJlcG9zaXRvcnk3NDM1NDcyOQ==-flat-FreeRTOS.h-Adafruit_nRF52_Arduino-MDEwOlJlcG9zaXRvcnk3NDM1NDcyOQ==-flat-task.h.html,17,Adafruit_nRF52_Arduino-MDEwOlJlcG9zaXRvcnk3NDM1NDcyOQ==-flat-FreeRTOS.h,Adafruit_nRF52_Arduino-MDEwOlJlcG9zaXRvcnk3NDM1NDcyOQ==-flat-task.h,737,743,6,37,43,6
337,https://htmlpreview.github.io/?https://github.com/Christina96/boilerplate-sample-matches/blob/main/C/xmrig-MDEwOlJlcG9zaXRvcnk4ODMyNzQwNg==-flat-CryptoNight_x86.h-xmrig-MDEwOlJlcG9zaXRvcnk4ODMyNzQwNg==-flat-CryptoNight_x86.h.html,71,xmrig-MDEwOlJlcG9zaXRvcnk4ODMyNzQwNg==-flat-CryptoNight_x86.h,xmrig-MDEwOlJlcG9zaXRvcnk4ODMyNzQwNg==-flat-CryptoNight_x86.h,207,217,10,303,313,10
338,https://htmlpreview.github.io/?https://github.com/Christina96/boilerplate-sample-matches/blob/main/C/PINRemoteImage-MDEwOlJlcG9zaXRvcnkzOTUzNzEwMw==-flat-filters_sse2.c-PINRemoteImage-MDEwOlJlcG9zaXRvcnkzOTUzNzEwMw==-flat-rescaler_sse2.c.html,17,PINRemoteImage-MDEwOlJlcG9zaXRvcnkzOTUzNzEwMw==-flat-filters_sse2.c,PINRemoteImage-MDEwOlJlcG9zaXRvcnkzOTUzNzEwMw==-flat-rescaler_sse2.c,43,44,1,276,277,1
339,https://htmlpreview.github.io/?https://github.com/Christina96/boilerplate-sample-matches/blob/main/C/Adafruit_nRF52_Arduino-MDEwOlJlcG9zaXRvcnk3NDM1NDcyOQ==-flat-nrfx_power.c-Adafruit_nRF52_Arduino-MDEwOlJlcG9zaXRvcnk3NDM1NDcyOQ==-flat-nrfx_power.c.html,23,Adafruit_nRF52_Arduino-MDEwOlJlcG9zaXRvcnk3NDM1NDcyOQ==-flat-nrfx_power.c,Adafruit_nRF52_Arduino-MDEwOlJlcG9zaXRvcnk3NDM1NDcyOQ==-flat-nrfx_power.c,35,39,4,86,90,4
340,https://htmlpreview.github.io/?https://github.com/Christina96/boilerplate-sample-matches/blob/main/C/PINRemoteImage-MDEwOlJlcG9zaXRvcnkzOTUzNzEwMw==-flat-libwebp_java_wrap.c-PINRemoteImage-MDEwOlJlcG9zaXRvcnkzOTUzNzEwMw==-flat-libwebp_java_wrap.c.html,100,PINRemoteImage-MDEwOlJlcG9zaXRvcnkzOTUzNzEwMw==-flat-libwebp_java_wrap.c,PINRemoteImage-MDEwOlJlcG9zaXRvcnkzOTUzNzEwMw==-flat-libwebp_java_wrap.c,444,457,13,695,708,13
341,https://htmlpreview.github.io/?https://github.com/Christina96/boilerplate-sample-matches/blob/main/C/android-gpuimage-plus-MDEwOlJlcG9zaXRvcnk0NjU0NzQxNw==-flat-cgeCurveAdjust.h-android-gpuimage-plus-MDEwOlJlcG9zaXRvcnk0NjU0NzQxNw==-flat-cgeCurveAdjust.h.html,85,android-gpuimage-plus-MDEwOlJlcG9zaXRvcnk0NjU0NzQxNw==-flat-cgeCurveAdjust.h,android-gpuimage-plus-MDEwOlJlcG9zaXRvcnk0NjU0NzQxNw==-flat-cgeCurveAdjust.h,103,111,8,125,133,8
342,https://htmlpreview.github.io/?https://github.com/Christina96/boilerplate-sample-matches/blob/main/C/Adafruit_nRF52_Arduino-MDEwOlJlcG9zaXRvcnk3NDM1NDcyOQ==-flat-SEGGER_RTT.c-Adafruit_nRF52_Arduino-MDEwOlJlcG9zaXRvcnk3NDM1NDcyOQ==-flat-SEGGER_RTT.c.html,24,Adafruit_nRF52_Arduino-MDEwOlJlcG9zaXRvcnk3NDM1NDcyOQ==-flat-SEGGER_RTT.c,Adafruit_nRF52_Arduino-MDEwOlJlcG9zaXRvcnk3NDM1NDcyOQ==-flat-SEGGER_RTT.c,337,343,6,172,178,6
343,https://htmlpreview.github.io/?https://github.com/Christina96/boilerplate-sample-matches/blob/main/C/libtomcrypt-MDEwOlJlcG9zaXRvcnk3NzcwMTE=-flat-sober128.c-libtomcrypt-MDEwOlJlcG9zaXRvcnk3NzcwMTE=-flat-rc4.c.html,65,libtomcrypt-MDEwOlJlcG9zaXRvcnk3NzcwMTE=-flat-sober128.c,libtomcrypt-MDEwOlJlcG9zaXRvcnk3NzcwMTE=-flat-rc4.c,34,37,3,34,37,3
344,https://htmlpreview.github.io/?https://github.com/Christina96/boilerplate-sample-matches/blob/main/C/fftw3-MDEwOlJlcG9zaXRvcnk4ODQzMzg4-flat-dtensor.c-fftw3-MDEwOlJlcG9zaXRvcnk4ODQzMzg4-flat-tensor_0.c.html,23,fftw3-MDEwOlJlcG9zaXRvcnk4ODQzMzg4-flat-dtensor.c,fftw3-MDEwOlJlcG9zaXRvcnk4ODQzMzg4-flat-tensor_0.c,41,43,2,51,53,2
345,https://htmlpreview.github.io/?https://github.com/Christina96/boilerplate-sample-matches/blob/main/C/redis-MDEwOlJlcG9zaXRvcnkxMDgxMTA3MDY=-flat-sentinel.c-redis-MDEwOlJlcG9zaXRvcnkxMDgxMTA3MDY=-flat-sentinel.c.html,49,redis-MDEwOlJlcG9zaXRvcnkxMDgxMTA3MDY=-flat-sentinel.c,redis-MDEwOlJlcG9zaXRvcnkxMDgxMTA3MDY=-flat-sentinel.c,1483,1490,7,1503,1510,7
346,https://htmlpreview.github.io/?https://github.com/Christina96/boilerplate-sample-matches/blob/main/C/PINRemoteImage-MDEwOlJlcG9zaXRvcnkzOTUzNzEwMw==-flat-demux_47.h-PINRemoteImage-MDEwOlJlcG9zaXRvcnkzOTUzNzEwMw==-flat-demux_35.h.html,384,PINRemoteImage-MDEwOlJlcG9zaXRvcnkzOTUzNzEwMw==-flat-demux_47.h,PINRemoteImage-MDEwOlJlcG9zaXRvcnkzOTUzNzEwMw==-flat-demux_35.h,37,113,76,37,113,76
347,https://htmlpreview.github.io/?https://github.com/Christina96/boilerplate-sample-matches/blob/main/C/redis-MDEwOlJlcG9zaXRvcnkxMDgxMTA3MDY=-flat-prng.h-redis-MDEwOlJlcG9zaXRvcnkxMDgxMTA3MDY=-flat-prng.h.html,37,redis-MDEwOlJlcG9zaXRvcnkxMDgxMTA3MDY=-flat-prng.h,redis-MDEwOlJlcG9zaXRvcnkxMDgxMTA3MDY=-flat-prng.h,78,84,6,100,106,6
348,https://htmlpreview.github.io/?https://github.com/Christina96/boilerplate-sample-matches/blob/main/C/xmrig-MDEwOlJlcG9zaXRvcnk4ODMyNzQwNg==-flat-reader.h-xmrig-MDEwOlJlcG9zaXRvcnk4ODMyNzQwNg==-flat-reader.h.html,18,xmrig-MDEwOlJlcG9zaXRvcnk4ODMyNzQwNg==-flat-reader.h,xmrig-MDEwOlJlcG9zaXRvcnk4ODMyNzQwNg==-flat-reader.h,774,779,5,910,915,5
349,https://htmlpreview.github.io/?https://github.com/Christina96/boilerplate-sample-matches/blob/main/C/PINRemoteImage-MDEwOlJlcG9zaXRvcnkzOTUzNzEwMw==-flat-anim_decode.c-PINRemoteImage-MDEwOlJlcG9zaXRvcnkzOTUzNzEwMw==-flat-histogram_enc.c.html,21,PINRemoteImage-MDEwOlJlcG9zaXRvcnkzOTUzNzEwMw==-flat-anim_decode.c,PINRemoteImage-MDEwOlJlcG9zaXRvcnkzOTUzNzEwMw==-flat-histogram_enc.c,215,216,1,584,586,2
350,https://htmlpreview.github.io/?https://github.com/Christina96/boilerplate-sample-matches/blob/main/C/libtomcrypt-MDEwOlJlcG9zaXRvcnk3NzcwMTE=-flat-xcbc_memory_multi.c-libtomcrypt-MDEwOlJlcG9zaXRvcnk3NzcwMTE=-flat-f9_memory_multi.c.html,15,libtomcrypt-MDEwOlJlcG9zaXRvcnk3NzcwMTE=-flat-xcbc_memory_multi.c,libtomcrypt-MDEwOlJlcG9zaXRvcnk3NzcwMTE=-flat-f9_memory_multi.c,25,28,3,25,28,3
351,https://htmlpreview.github.io/?https://github.com/Christina96/boilerplate-sample-matches/blob/main/C/android-gpuimage-plus-MDEwOlJlcG9zaXRvcnk0NjU0NzQxNw==-flat-cgeVideoPlayer.h-xmrig-MDEwOlJlcG9zaXRvcnk4ODMyNzQwNg==-flat-format.h.html,21,android-gpuimage-plus-MDEwOlJlcG9zaXRvcnk0NjU0NzQxNw==-flat-cgeVideoPlayer.h,xmrig-MDEwOlJlcG9zaXRvcnk4ODMyNzQwNg==-flat-format.h,16,19,3,1103,1106,3
352,https://htmlpreview.github.io/?https://github.com/Christina96/boilerplate-sample-matches/blob/main/C/android-gpuimage-plus-MDEwOlJlcG9zaXRvcnk0NjU0NzQxNw==-flat-cgeSharpenBlurAdjust.h-android-gpuimage-plus-MDEwOlJlcG9zaXRvcnk0NjU0NzQxNw==-flat-cgeSharpenBlurAdjust.h.html,16,android-gpuimage-plus-MDEwOlJlcG9zaXRvcnk0NjU0NzQxNw==-flat-cgeSharpenBlurAdjust.h,android-gpuimage-plus-MDEwOlJlcG9zaXRvcnk0NjU0NzQxNw==-flat-cgeSharpenBlurAdjust.h,20,22,2,21,23,2
353,https://htmlpreview.github.io/?https://github.com/Christina96/boilerplate-sample-matches/blob/main/C/fftw3-MDEwOlJlcG9zaXRvcnk4ODQzMzg4-flat-ct-hc2c-direct.c-fftw3-MDEwOlJlcG9zaXRvcnk4ODQzMzg4-flat-hc2hc-direct.c.html,18,fftw3-MDEwOlJlcG9zaXRvcnk4ODQzMzg4-flat-ct-hc2c-direct.c,fftw3-MDEwOlJlcG9zaXRvcnk4ODQzMzg4-flat-hc2hc-direct.c,257,259,2,156,158,2
354,https://htmlpreview.github.io/?https://github.com/Christina96/boilerplate-sample-matches/blob/main/C/fftw3-MDEwOlJlcG9zaXRvcnk4ODQzMzg4-flat-threads.c-PINRemoteImage-MDEwOlJlcG9zaXRvcnkzOTUzNzEwMw==-flat-example_util.c.html,15,fftw3-MDEwOlJlcG9zaXRvcnk4ODQzMzg4-flat-threads.c,PINRemoteImage-MDEwOlJlcG9zaXRvcnkzOTUzNzEwMw==-flat-example_util.c,47,50,3,47,50,3
355,https://htmlpreview.github.io/?https://github.com/Christina96/boilerplate-sample-matches/blob/main/C/Adafruit_nRF52_Arduino-MDEwOlJlcG9zaXRvcnk3NDM1NDcyOQ==-flat-bignum.c-Adafruit_nRF52_Arduino-MDEwOlJlcG9zaXRvcnk3NDM1NDcyOQ==-flat-bignum.c.html,59,Adafruit_nRF52_Arduino-MDEwOlJlcG9zaXRvcnk3NDM1NDcyOQ==-flat-bignum.c,Adafruit_nRF52_Arduino-MDEwOlJlcG9zaXRvcnk3NDM1NDcyOQ==-flat-bignum.c,615,631,16,639,655,16
356,https://htmlpreview.github.io/?https://github.com/Christina96/boilerplate-sample-matches/blob/main/C/xmrig-MDEwOlJlcG9zaXRvcnk4ODMyNzQwNg==-flat-CryptoNight_x86.h-xmrig-MDEwOlJlcG9zaXRvcnk4ODMyNzQwNg==-flat-CryptoNight_x86.h.html,56,xmrig-MDEwOlJlcG9zaXRvcnk4ODMyNzQwNg==-flat-CryptoNight_x86.h,xmrig-MDEwOlJlcG9zaXRvcnk4ODMyNzQwNg==-flat-CryptoNight_x86.h,147,152,5,142,147,5
357,https://htmlpreview.github.io/?https://github.com/Christina96/boilerplate-sample-matches/blob/main/C/redis-MDEwOlJlcG9zaXRvcnkxMDgxMTA3MDY=-flat-ctl.c-redis-MDEwOlJlcG9zaXRvcnkxMDgxMTA3MDY=-flat-background_thread_22.c.html,15,redis-MDEwOlJlcG9zaXRvcnkxMDgxMTA3MDY=-flat-ctl.c,redis-MDEwOlJlcG9zaXRvcnkxMDgxMTA3MDY=-flat-background_thread_22.c,1173,1175,2,691,693,2
358,https://htmlpreview.github.io/?https://github.com/Christina96/boilerplate-sample-matches/blob/main/C/redis-MDEwOlJlcG9zaXRvcnkxMDgxMTA3MDY=-flat-prof_thread_name.c-redis-MDEwOlJlcG9zaXRvcnkxMDgxMTA3MDY=-flat-prof_thread_name.c.html,18,redis-MDEwOlJlcG9zaXRvcnkxMDgxMTA3MDY=-flat-prof_thread_name.c,redis-MDEwOlJlcG9zaXRvcnkxMDgxMTA3MDY=-flat-prof_thread_name.c,2,5,3,17,20,3
359,https://htmlpreview.github.io/?https://github.com/Christina96/boilerplate-sample-matches/blob/main/C/Adafruit_nRF52_Arduino-MDEwOlJlcG9zaXRvcnk3NDM1NDcyOQ==-flat-ble_gattc_4.h-Adafruit_nRF52_Arduino-MDEwOlJlcG9zaXRvcnk3NDM1NDcyOQ==-flat-ble_gattc.h.html,37,Adafruit_nRF52_Arduino-MDEwOlJlcG9zaXRvcnk3NDM1NDcyOQ==-flat-ble_gattc_4.h,Adafruit_nRF52_Arduino-MDEwOlJlcG9zaXRvcnk3NDM1NDcyOQ==-flat-ble_gattc.h,236,248,12,236,248,12
360,https://htmlpreview.github.io/?https://github.com/Christina96/boilerplate-sample-matches/blob/main/C/xmrig-MDEwOlJlcG9zaXRvcnk4ODMyNzQwNg==-flat-components.c-xmrig-MDEwOlJlcG9zaXRvcnk4ODMyNzQwNg==-flat-topology.c.html,15,xmrig-MDEwOlJlcG9zaXRvcnk4ODMyNzQwNg==-flat-components.c,xmrig-MDEwOlJlcG9zaXRvcnk4ODMyNzQwNg==-flat-topology.c,761,766,5,2835,2840,5
361,https://htmlpreview.github.io/?https://github.com/Christina96/boilerplate-sample-matches/blob/main/C/PINRemoteImage-MDEwOlJlcG9zaXRvcnkzOTUzNzEwMw==-flat-libwebp_python_wrap.c-redis-MDEwOlJlcG9zaXRvcnkxMDgxMTA3MDY=-flat-anet.c.html,16,PINRemoteImage-MDEwOlJlcG9zaXRvcnkzOTUzNzEwMw==-flat-libwebp_python_wrap.c,redis-MDEwOlJlcG9zaXRvcnkxMDgxMTA3MDY=-flat-anet.c,2145,2149,4,241,244,3
362,https://htmlpreview.github.io/?https://github.com/Christina96/boilerplate-sample-matches/blob/main/C/PINRemoteImage-MDEwOlJlcG9zaXRvcnkzOTUzNzEwMw==-flat-vp8l_dec.c-PINRemoteImage-MDEwOlJlcG9zaXRvcnkzOTUzNzEwMw==-flat-webp_enc.c.html,17,PINRemoteImage-MDEwOlJlcG9zaXRvcnkzOTUzNzEwMw==-flat-vp8l_dec.c,PINRemoteImage-MDEwOlJlcG9zaXRvcnkzOTUzNzEwMw==-flat-webp_enc.c,426,431,5,171,176,5
363,https://htmlpreview.github.io/?https://github.com/Christina96/boilerplate-sample-matches/blob/main/C/xmrig-MDEwOlJlcG9zaXRvcnk4ODMyNzQwNg==-flat-cuda.h-xmrig-MDEwOlJlcG9zaXRvcnk4ODMyNzQwNg==-flat-rsmi.h.html,26,xmrig-MDEwOlJlcG9zaXRvcnk4ODMyNzQwNg==-flat-cuda.h,xmrig-MDEwOlJlcG9zaXRvcnk4ODMyNzQwNg==-flat-rsmi.h,40,46,6,14,20,6
364,https://htmlpreview.github.io/?https://github.com/Christina96/boilerplate-sample-matches/blob/main/C/fftw3-MDEwOlJlcG9zaXRvcnk4ODQzMzg4-flat-reodft11e-radix2.c-fftw3-MDEwOlJlcG9zaXRvcnk4ODQzMzg4-flat-reodft11e-radix2.c.html,137,fftw3-MDEwOlJlcG9zaXRvcnk4ODQzMzg4-flat-reodft11e-radix2.c,fftw3-MDEwOlJlcG9zaXRvcnk4ODQzMzg4-flat-reodft11e-radix2.c,47,68,21,231,252,21
365,https://htmlpreview.github.io/?https://github.com/Christina96/boilerplate-sample-matches/blob/main/C/fftw3-MDEwOlJlcG9zaXRvcnk4ODQzMzg4-flat-dft-r2hc.c-fftw3-MDEwOlJlcG9zaXRvcnk4ODQzMzg4-flat-dft-r2hc.c.html,18,fftw3-MDEwOlJlcG9zaXRvcnk4ODQzMzg4-flat-dft-r2hc.c,fftw3-MDEwOlJlcG9zaXRvcnk4ODQzMzg4-flat-dft-r2hc.c,97,98,1,98,99,1
366,https://htmlpreview.github.io/?https://github.com/Christina96/boilerplate-sample-matches/blob/main/C/libtomcrypt-MDEwOlJlcG9zaXRvcnk3NzcwMTE=-flat-anubis.c-libtomcrypt-MDEwOlJlcG9zaXRvcnk3NzcwMTE=-flat-anubis.c.html,15,libtomcrypt-MDEwOlJlcG9zaXRvcnk3NzcwMTE=-flat-anubis.c,libtomcrypt-MDEwOlJlcG9zaXRvcnk3NzcwMTE=-flat-anubis.c,1357,1359,2,1349,1351,2
367,https://htmlpreview.github.io/?https://github.com/Christina96/boilerplate-sample-matches/blob/main/C/PINRemoteImage-MDEwOlJlcG9zaXRvcnkzOTUzNzEwMw==-flat-encode_38.h-PINRemoteImage-MDEwOlJlcG9zaXRvcnkzOTUzNzEwMw==-flat-encode.h.html,865,PINRemoteImage-MDEwOlJlcG9zaXRvcnkzOTUzNzEwMw==-flat-encode_38.h,PINRemoteImage-MDEwOlJlcG9zaXRvcnkzOTUzNzEwMw==-flat-encode.h,80,226,146,80,226,146
368,https://htmlpreview.github.io/?https://github.com/Christina96/boilerplate-sample-matches/blob/main/C/redis-MDEwOlJlcG9zaXRvcnkxMDgxMTA3MDY=-flat-redis-cli.c-redis-MDEwOlJlcG9zaXRvcnkxMDgxMTA3MDY=-flat-redis-cli.c.html,26,redis-MDEwOlJlcG9zaXRvcnkxMDgxMTA3MDY=-flat-redis-cli.c,redis-MDEwOlJlcG9zaXRvcnkxMDgxMTA3MDY=-flat-redis-cli.c,1785,1789,4,2840,2845,5
369,https://htmlpreview.github.io/?https://github.com/Christina96/boilerplate-sample-matches/blob/main/C/xmrig-MDEwOlJlcG9zaXRvcnk4ODMyNzQwNg==-flat-sph_hamsi.c-xmrig-MDEwOlJlcG9zaXRvcnk4ODMyNzQwNg==-flat-sph_hamsi.c.html,114,xmrig-MDEwOlJlcG9zaXRvcnk4ODMyNzQwNg==-flat-sph_hamsi.c,xmrig-MDEwOlJlcG9zaXRvcnk4ODMyNzQwNg==-flat-sph_hamsi.c,261,279,18,540,558,18
370,https://htmlpreview.github.io/?https://github.com/Christina96/boilerplate-sample-matches/blob/main/C/libtomcrypt-MDEwOlJlcG9zaXRvcnk3NzcwMTE=-flat-ocb3_init.c-libtomcrypt-MDEwOlJlcG9zaXRvcnk3NzcwMTE=-flat-ecb_start.c.html,17,libtomcrypt-MDEwOlJlcG9zaXRvcnk3NzcwMTE=-flat-ocb3_init.c,libtomcrypt-MDEwOlJlcG9zaXRvcnk3NzcwMTE=-flat-ecb_start.c,73,75,2,11,13,2
371,https://htmlpreview.github.io/?https://github.com/Christina96/boilerplate-sample-matches/blob/main/C/fftw3-MDEwOlJlcG9zaXRvcnk4ODQzMzg4-flat-rdft2-problem.c-fftw3-MDEwOlJlcG9zaXRvcnk4ODQzMzg4-flat-rdft2-problem.c.html,22,fftw3-MDEwOlJlcG9zaXRvcnk4ODQzMzg4-flat-rdft2-problem.c,fftw3-MDEwOlJlcG9zaXRvcnk4ODQzMzg4-flat-rdft2-problem.c,57,63,6,87,92,5
372,https://htmlpreview.github.io/?https://github.com/Christina96/boilerplate-sample-matches/blob/main/C/xmrig-MDEwOlJlcG9zaXRvcnk4ODMyNzQwNg==-flat-sph_luffa.c-xmrig-MDEwOlJlcG9zaXRvcnk4ODMyNzQwNg==-flat-sph_luffa.c.html,110,xmrig-MDEwOlJlcG9zaXRvcnk4ODMyNzQwNg==-flat-sph_luffa.c,xmrig-MDEwOlJlcG9zaXRvcnk4ODMyNzQwNg==-flat-sph_luffa.c,487,499,12,747,759,12
373,https://htmlpreview.github.io/?https://github.com/Christina96/boilerplate-sample-matches/blob/main/C/xmrig-MDEwOlJlcG9zaXRvcnk4ODMyNzQwNg==-flat-topology-synthetic.c-xmrig-MDEwOlJlcG9zaXRvcnk4ODMyNzQwNg==-flat-topology-synthetic.c.html,18,xmrig-MDEwOlJlcG9zaXRvcnk4ODMyNzQwNg==-flat-topology-synthetic.c,xmrig-MDEwOlJlcG9zaXRvcnk4ODMyNzQwNg==-flat-topology-synthetic.c,1127,1129,2,1247,1249,2
374,https://htmlpreview.github.io/?https://github.com/Christina96/boilerplate-sample-matches/blob/main/C/redis-MDEwOlJlcG9zaXRvcnkxMDgxMTA3MDY=-flat-ph.c-redis-MDEwOlJlcG9zaXRvcnkxMDgxMTA3MDY=-flat-rb.c.html,64,redis-MDEwOlJlcG9zaXRvcnkxMDgxMTA3MDY=-flat-ph.c,redis-MDEwOlJlcG9zaXRvcnkxMDgxMTA3MDY=-flat-rb.c,153,163,10,182,192,10
375,https://htmlpreview.github.io/?https://github.com/Christina96/boilerplate-sample-matches/blob/main/C/redis-MDEwOlJlcG9zaXRvcnkxMDgxMTA3MDY=-flat-WS2tcpip.h-redis-MDEwOlJlcG9zaXRvcnkxMDgxMTA3MDY=-flat-WS2tcpip.h.html,33,redis-MDEwOlJlcG9zaXRvcnkxMDgxMTA3MDY=-flat-WS2tcpip.h,redis-MDEwOlJlcG9zaXRvcnkxMDgxMTA3MDY=-flat-WS2tcpip.h,67,77,10,92,102,10
376,https://htmlpreview.github.io/?https://github.com/Christina96/boilerplate-sample-matches/blob/main/C/libtomcrypt-MDEwOlJlcG9zaXRvcnk3NzcwMTE=-flat-crypt_sizes.c-libtomcrypt-MDEwOlJlcG9zaXRvcnk3NzcwMTE=-flat-crypt_sizes.c.html,15,libtomcrypt-MDEwOlJlcG9zaXRvcnk3NzcwMTE=-flat-crypt_sizes.c,libtomcrypt-MDEwOlJlcG9zaXRvcnk3NzcwMTE=-flat-crypt_sizes.c,60,64,4,226,230,4
377,https://htmlpreview.github.io/?https://github.com/Christina96/boilerplate-sample-matches/blob/main/C/PINRemoteImage-MDEwOlJlcG9zaXRvcnkzOTUzNzEwMw==-flat-wicdec.c-xmrig-MDEwOlJlcG9zaXRvcnk4ODMyNzQwNg==-flat-OclCnRunner.h.html,17,PINRemoteImage-MDEwOlJlcG9zaXRvcnkzOTUzNzEwMw==-flat-wicdec.c,xmrig-MDEwOlJlcG9zaXRvcnk4ODMyNzQwNg==-flat-OclCnRunner.h,215,218,3,33,36,3
378,https://htmlpreview.github.io/?https://github.com/Christina96/boilerplate-sample-matches/blob/main/C/Adafruit_nRF52_Arduino-MDEwOlJlcG9zaXRvcnk3NDM1NDcyOQ==-flat-SEGGER_RTT.c-Adafruit_nRF52_Arduino-MDEwOlJlcG9zaXRvcnk3NDM1NDcyOQ==-flat-SEGGER_RTT.c.html,23,Adafruit_nRF52_Arduino-MDEwOlJlcG9zaXRvcnk3NDM1NDcyOQ==-flat-SEGGER_RTT.c,Adafruit_nRF52_Arduino-MDEwOlJlcG9zaXRvcnk3NDM1NDcyOQ==-flat-SEGGER_RTT.c,656,660,4,663,667,4
379,https://htmlpreview.github.io/?https://github.com/Christina96/boilerplate-sample-matches/blob/main/C/fftw3-MDEwOlJlcG9zaXRvcnk4ODQzMzg4-flat-dftw-directsq.c-fftw3-MDEwOlJlcG9zaXRvcnk4ODQzMzg4-flat-dftw-direct.c.html,20,fftw3-MDEwOlJlcG9zaXRvcnk4ODQzMzg4-flat-dftw-directsq.c,fftw3-MDEwOlJlcG9zaXRvcnk4ODQzMzg4-flat-dftw-direct.c,90,93,3,214,217,3
380,https://htmlpreview.github.io/?https://github.com/Christina96/boilerplate-sample-matches/blob/main/C/libtomcrypt-MDEwOlJlcG9zaXRvcnk3NzcwMTE=-flat-crypt_sizes.c-libtomcrypt-MDEwOlJlcG9zaXRvcnk3NzcwMTE=-flat-crypt_constants.c.html,15,libtomcrypt-MDEwOlJlcG9zaXRvcnk3NzcwMTE=-flat-crypt_sizes.c,libtomcrypt-MDEwOlJlcG9zaXRvcnk3NzcwMTE=-flat-crypt_constants.c,60,64,4,51,55,4
381,https://htmlpreview.github.io/?https://github.com/Christina96/boilerplate-sample-matches/blob/main/C/PINRemoteImage-MDEwOlJlcG9zaXRvcnkzOTUzNzEwMw==-flat-webpmux.c-PINRemoteImage-MDEwOlJlcG9zaXRvcnkzOTUzNzEwMw==-flat-webpmux.c.html,16,PINRemoteImage-MDEwOlJlcG9zaXRvcnkzOTUzNzEwMw==-flat-webpmux.c,PINRemoteImage-MDEwOlJlcG9zaXRvcnkzOTUzNzEwMw==-flat-webpmux.c,109,111,2,134,136,2
382,https://htmlpreview.github.io/?https://github.com/Christina96/boilerplate-sample-matches/blob/main/C/small-MDEwOlJlcG9zaXRvcnkyNTY3NjMxNjk=-flat-http_simple.c-small-MDEwOlJlcG9zaXRvcnkyNTY3NjMxNjk=-flat-http_simple.c.html,120,small-MDEwOlJlcG9zaXRvcnkyNTY3NjMxNjk=-flat-http_simple.c,small-MDEwOlJlcG9zaXRvcnkyNTY3NjMxNjk=-flat-http_simple.c,218,236,18,550,567,17
383,https://htmlpreview.github.io/?https://github.com/Christina96/boilerplate-sample-matches/blob/main/C/xmrig-MDEwOlJlcG9zaXRvcnk4ODMyNzQwNg==-flat-llhttp.c-xmrig-MDEwOlJlcG9zaXRvcnk4ODMyNzQwNg==-flat-llhttp.c.html,22,xmrig-MDEwOlJlcG9zaXRvcnk4ODMyNzQwNg==-flat-llhttp.c,xmrig-MDEwOlJlcG9zaXRvcnk4ODMyNzQwNg==-flat-llhttp.c,36,39,3,7470,7473,3
