ID,Link,Similarity,Tokens,File 1,File 2,Start 1,End 1,Detected Lines 1,Start 2,End 2,Detected Lines 2
1342,https://htmlpreview.github.io/?https://github.com/Christina96/boilerplate-sample-matches/blob/main/Cpp-beta/notepad-plus-plus-MDEwOlJlcG9zaXRvcnkzMzAxNDgxMQ==-flat-WindowsDlg.cpp-abseil-cpp-MDEwOlJlcG9zaXRvcnkxMDQyMzE1NDE=-flat-time_zone_format_test.cc.html,0.11303996770286637,10,notepad-plus-plus-MDEwOlJlcG9zaXRvcnkzMzAxNDgxMQ==-flat-WindowsDlg.cpp,abseil-cpp-MDEwOlJlcG9zaXRvcnkxMDQyMzE1NDE=-flat-time_zone_format_test.cc,306,308,2,169,176,7
31871,https://htmlpreview.github.io/?https://github.com/Christina96/boilerplate-sample-matches/blob/main/Cpp-beta/tesseract-MDEwOlJlcG9zaXRvcnkyMjg4NzA5NA==-flat-simddetect.h-glm-MDEwOlJlcG9zaXRvcnk4NDM2MzE=-flat-image2d.hpp.html,0.24203821656050956,19,tesseract-MDEwOlJlcG9zaXRvcnkyMjg4NzA5NA==-flat-simddetect.h,glm-MDEwOlJlcG9zaXRvcnk4NDM2MzE=-flat-image2d.hpp,34,46,12,16,34,18
36166,https://htmlpreview.github.io/?https://github.com/Christina96/boilerplate-sample-matches/blob/main/Cpp-beta/tesseract-MDEwOlJlcG9zaXRvcnkyMjg4NzA5NA==-flat-linlsq.cpp-nano-node-MDEwOlJlcG9zaXRvcnkxOTM0NzM0MA==-flat-system.cpp.html,0.09090909090909091,9,tesseract-MDEwOlJlcG9zaXRvcnkyMjg4NzA5NA==-flat-linlsq.cpp,nano-node-MDEwOlJlcG9zaXRvcnkxOTM0NzM0MA==-flat-system.cpp,107,109,2,15,17,2
46948,https://htmlpreview.github.io/?https://github.com/Christina96/boilerplate-sample-matches/blob/main/Cpp-beta/tesseract-MDEwOlJlcG9zaXRvcnkyMjg4NzA5NA==-flat-linefind.cpp-abseil-cpp-MDEwOlJlcG9zaXRvcnkxMDQyMzE1NDE=-flat-time_zone_format_test.cc.html,0.08587479935794542,9,tesseract-MDEwOlJlcG9zaXRvcnkyMjg4NzA5NA==-flat-linefind.cpp,abseil-cpp-MDEwOlJlcG9zaXRvcnkxMDQyMzE1NDE=-flat-time_zone_format_test.cc,424,429,5,168,175,7
56256,https://htmlpreview.github.io/?https://github.com/Christina96/boilerplate-sample-matches/blob/main/Cpp-beta/tesseract-MDEwOlJlcG9zaXRvcnkyMjg4NzA5NA==-flat-fullyconnected.h-snap-MDEwOlJlcG9zaXRvcnk0Mjg4MzU3-flat-hc.h.html,0.12322274881516587,12,tesseract-MDEwOlJlcG9zaXRvcnkyMjg4NzA5NA==-flat-fullyconnected.h,snap-MDEwOlJlcG9zaXRvcnk0Mjg4MzU3-flat-hc.h,56,63,7,88,92,4
72536,https://htmlpreview.github.io/?https://github.com/Christina96/boilerplate-sample-matches/blob/main/Cpp-beta/subconverter-MDEwOlJlcG9zaXRvcnkyMTg2ODY3NjM=-flat-upload.cpp-notepad-plus-plus-MDEwOlJlcG9zaXRvcnkzMzAxNDgxMQ==-flat-NppBigSwitch.cpp.html,0.014184397163120567,11,subconverter-MDEwOlJlcG9zaXRvcnkyMTg2ODY3NjM=-flat-upload.cpp,notepad-plus-plus-MDEwOlJlcG9zaXRvcnkzMzAxNDgxMQ==-flat-NppBigSwitch.cpp,84,95,11,1938,1947,9
101721,https://htmlpreview.github.io/?https://github.com/Christina96/boilerplate-sample-matches/blob/main/Cpp-beta/abseil-cpp-MDEwOlJlcG9zaXRvcnkxMDQyMzE1NDE=-flat-charconv_parse.h-snap-MDEwOlJlcG9zaXRvcnk0Mjg4MzU3-flat-md5.h.html,0.13333333333333333,10,abseil-cpp-MDEwOlJlcG9zaXRvcnkxMDQyMzE1NDE=-flat-charconv_parse.h,snap-MDEwOlJlcG9zaXRvcnk0Mjg4MzU3-flat-md5.h,19,25,6,4,14,10
103189,https://htmlpreview.github.io/?https://github.com/Christina96/boilerplate-sample-matches/blob/main/Cpp-beta/caffe-MDEwOlJlcG9zaXRvcnk2MTg3MDgwMw==-flat-gtest-spi.h-snap-MDEwOlJlcG9zaXRvcnk0Mjg4MzU3-flat-gviz.h.html,0.17475728155339806,9,caffe-MDEwOlJlcG9zaXRvcnk2MTg3MDgwMw==-flat-gtest-spi.h,snap-MDEwOlJlcG9zaXRvcnk0Mjg4MzU3-flat-gviz.h,19,34,15,4,7,3
116296,https://htmlpreview.github.io/?https://github.com/Christina96/boilerplate-sample-matches/blob/main/Cpp-beta/caffe-MDEwOlJlcG9zaXRvcnk2MTg3MDgwMw==-flat-batch_reindex_layer.cpp-abseil-cpp-MDEwOlJlcG9zaXRvcnkxMDQyMzE1NDE=-flat-hash_12.h.html,0.021463414634146343,11,caffe-MDEwOlJlcG9zaXRvcnk2MTg3MDgwMw==-flat-batch_reindex_layer.cpp,abseil-cpp-MDEwOlJlcG9zaXRvcnkxMDQyMzE1NDE=-flat-hash_12.h,14,20,6,413,418,5
138404,https://htmlpreview.github.io/?https://github.com/Christina96/boilerplate-sample-matches/blob/main/Cpp-beta/caffe-MDEwOlJlcG9zaXRvcnk2MTg3MDgwMw==-flat-detection_evaluate_layer.hpp-nano-node-MDEwOlJlcG9zaXRvcnkxOTM0NzM0MA==-flat-confirmation_height_unbounded.cpp.html,0.10097719869706841,12,caffe-MDEwOlJlcG9zaXRvcnk2MTg3MDgwMw==-flat-detection_evaluate_layer.hpp,nano-node-MDEwOlJlcG9zaXRvcnkxOTM0NzM0MA==-flat-confirmation_height_unbounded.cpp,14,16,2,8,8,0
141163,https://htmlpreview.github.io/?https://github.com/Christina96/boilerplate-sample-matches/blob/main/Cpp-beta/caffe-MDEwOlJlcG9zaXRvcnk2MTg3MDgwMw==-flat-test_threshold_layer.cpp-snap-MDEwOlJlcG9zaXRvcnk0Mjg4MzU3-flat-prologparser.cpp.html,0.04222648752399232,11,caffe-MDEwOlJlcG9zaXRvcnk2MTg3MDgwMw==-flat-test_threshold_layer.cpp,snap-MDEwOlJlcG9zaXRvcnk0Mjg4MzU3-flat-prologparser.cpp,34,40,6,159,165,6
150245,https://htmlpreview.github.io/?https://github.com/Christina96/boilerplate-sample-matches/blob/main/Cpp-beta/notepad-plus-plus-MDEwOlJlcG9zaXRvcnkzMzAxNDgxMQ==-flat-ReadFileChanges.h-notepad-plus-plus-MDEwOlJlcG9zaXRvcnkzMzAxNDgxMQ==-flat-DarkMode.cpp.html,0.09558823529411764,13,notepad-plus-plus-MDEwOlJlcG9zaXRvcnkzMzAxNDgxMQ==-flat-ReadFileChanges.h,notepad-plus-plus-MDEwOlJlcG9zaXRvcnkzMzAxNDgxMQ==-flat-DarkMode.cpp,12,18,6,74,80,6
159551,https://htmlpreview.github.io/?https://github.com/Christina96/boilerplate-sample-matches/blob/main/Cpp-beta/notepad-plus-plus-MDEwOlJlcG9zaXRvcnkzMzAxNDgxMQ==-flat-u32regex_token_iterator.hpp-snap-MDEwOlJlcG9zaXRvcnk0Mjg4MzU3-flat-svmbasic.cpp.html,0.029468786351298952,9,notepad-plus-plus-MDEwOlJlcG9zaXRvcnkzMzAxNDgxMQ==-flat-u32regex_token_iterator.hpp,snap-MDEwOlJlcG9zaXRvcnk0Mjg4MzU3-flat-svmbasic.cpp,117,120,3,386,390,4
174436,https://htmlpreview.github.io/?https://github.com/Christina96/boilerplate-sample-matches/blob/main/Cpp-beta/abseil-cpp-MDEwOlJlcG9zaXRvcnkxMDQyMzE1NDE=-flat-kernel_timeout_test.cc-caffe-MDEwOlJlcG9zaXRvcnk2MTg3MDgwMw==-flat-test_prior_box_layer.cpp.html,0.3553629469122427,17,abseil-cpp-MDEwOlJlcG9zaXRvcnkxMDQyMzE1NDE=-flat-kernel_timeout_test.cc,caffe-MDEwOlJlcG9zaXRvcnk2MTg3MDgwMw==-flat-test_prior_box_layer.cpp,60,75,15,313,341,28
192428,https://htmlpreview.github.io/?https://github.com/Christina96/boilerplate-sample-matches/blob/main/Cpp-beta/snap-MDEwOlJlcG9zaXRvcnk0Mjg4MzU3-flat-mxdag.cpp-snap-MDEwOlJlcG9zaXRvcnk0Mjg4MzU3-flat-agmattr.h.html,0.10392902408111533,9,snap-MDEwOlJlcG9zaXRvcnk0Mjg4MzU3-flat-mxdag.cpp,snap-MDEwOlJlcG9zaXRvcnk0Mjg4MzU3-flat-agmattr.h,35,37,2,113,115,2
194973,https://htmlpreview.github.io/?https://github.com/Christina96/boilerplate-sample-matches/blob/main/Cpp-beta/notepad-plus-plus-MDEwOlJlcG9zaXRvcnkzMzAxNDgxMQ==-flat-u32regex_token_iterator.hpp-abseil-cpp-MDEwOlJlcG9zaXRvcnkxMDQyMzE1NDE=-flat-civil_time_detail.h.html,0.11670663469224621,9,notepad-plus-plus-MDEwOlJlcG9zaXRvcnkzMzAxNDgxMQ==-flat-u32regex_token_iterator.hpp,abseil-cpp-MDEwOlJlcG9zaXRvcnkxMDQyMzE1NDE=-flat-civil_time_detail.h,201,203,2,143,145,2
195266,https://htmlpreview.github.io/?https://github.com/Christina96/boilerplate-sample-matches/blob/main/Cpp-beta/caffe-MDEwOlJlcG9zaXRvcnk2MTg3MDgwMw==-flat-test_euclidean_loss_layer.cpp-caffe-MDEwOlJlcG9zaXRvcnk2MTg3MDgwMw==-flat-common.hpp.html,0.14606741573033707,13,caffe-MDEwOlJlcG9zaXRvcnk2MTg3MDgwMw==-flat-test_euclidean_loss_layer.cpp,caffe-MDEwOlJlcG9zaXRvcnk2MTg3MDgwMw==-flat-common.hpp,48,53,5,96,101,5
197596,https://htmlpreview.github.io/?https://github.com/Christina96/boilerplate-sample-matches/blob/main/Cpp-beta/caffe-MDEwOlJlcG9zaXRvcnk2MTg3MDgwMw==-flat-test_mkl_convolution_layer.cpp-subconverter-MDEwOlJlcG9zaXRvcnkyMTg2ODY3NjM=-flat-subexport.cpp.html,0.09336609336609336,11,caffe-MDEwOlJlcG9zaXRvcnk2MTg3MDgwMw==-flat-test_mkl_convolution_layer.cpp,subconverter-MDEwOlJlcG9zaXRvcnkyMTg2ODY3NjM=-flat-subexport.cpp,531,541,10,1416,1424,8
200726,https://htmlpreview.github.io/?https://github.com/Christina96/boilerplate-sample-matches/blob/main/Cpp-beta/notepad-plus-plus-MDEwOlJlcG9zaXRvcnkzMzAxNDgxMQ==-flat-nsEUCTWProber.h-notepad-plus-plus-MDEwOlJlcG9zaXRvcnkzMzAxNDgxMQ==-flat-JpCntx.h.html,0.14285714285714285,9,notepad-plus-plus-MDEwOlJlcG9zaXRvcnkzMzAxNDgxMQ==-flat-nsEUCTWProber.h,notepad-plus-plus-MDEwOlJlcG9zaXRvcnkzMzAxNDgxMQ==-flat-JpCntx.h,15,18,3,25,28,3
210882,https://htmlpreview.github.io/?https://github.com/Christina96/boilerplate-sample-matches/blob/main/Cpp-beta/glm-MDEwOlJlcG9zaXRvcnk4NDM2MzE=-flat-type_int.hpp-caffe-MDEwOlJlcG9zaXRvcnk2MTg3MDgwMw==-flat-test_mkldnn_split_layer.cpp.html,0.21818181818181817,12,glm-MDEwOlJlcG9zaXRvcnk4NDM2MzE=-flat-type_int.hpp,caffe-MDEwOlJlcG9zaXRvcnk2MTg3MDgwMw==-flat-test_mkldnn_split_layer.cpp,8,15,7,31,35,4
219301,https://htmlpreview.github.io/?https://github.com/Christina96/boilerplate-sample-matches/blob/main/Cpp-beta/caffe-MDEwOlJlcG9zaXRvcnk2MTg3MDgwMw==-flat-spatial_dropout_layer.hpp-caffe-MDEwOlJlcG9zaXRvcnk2MTg3MDgwMw==-flat-softmax_loss_layer.hpp.html,0.8216216216216217,23,caffe-MDEwOlJlcG9zaXRvcnk2MTg3MDgwMw==-flat-spatial_dropout_layer.hpp,caffe-MDEwOlJlcG9zaXRvcnk2MTg3MDgwMw==-flat-softmax_loss_layer.hpp,9,17,8,10,18,8
222203,https://htmlpreview.github.io/?https://github.com/Christina96/boilerplate-sample-matches/blob/main/Cpp-beta/caffe-MDEwOlJlcG9zaXRvcnk2MTg3MDgwMw==-flat-test_gradient_check_util.hpp-snap-MDEwOlJlcG9zaXRvcnk0Mjg4MzU3-flat-ontolight.cpp.html,0.10143329658213891,10,caffe-MDEwOlJlcG9zaXRvcnk2MTg3MDgwMw==-flat-test_gradient_check_util.hpp,snap-MDEwOlJlcG9zaXRvcnk0Mjg4MzU3-flat-ontolight.cpp,113,117,4,48,50,2
222236,https://htmlpreview.github.io/?https://github.com/Christina96/boilerplate-sample-matches/blob/main/Cpp-beta/snap-MDEwOlJlcG9zaXRvcnk0Mjg4MzU3-flat-fl.cpp-nano-node-MDEwOlJlcG9zaXRvcnkxOTM0NzM0MA==-flat-node.cpp.html,0.024938938166859492,10,snap-MDEwOlJlcG9zaXRvcnk0Mjg4MzU3-flat-fl.cpp,nano-node-MDEwOlJlcG9zaXRvcnkxOTM0NzM0MA==-flat-node.cpp,99,104,5,53,61,8
234736,https://htmlpreview.github.io/?https://github.com/Christina96/boilerplate-sample-matches/blob/main/Cpp-beta/notepad-plus-plus-MDEwOlJlcG9zaXRvcnkzMzAxNDgxMQ==-flat-TabBar.h-caffe-MDEwOlJlcG9zaXRvcnk2MTg3MDgwMw==-flat-gtest-internal-inl.h.html,0.24078624078624078,9,notepad-plus-plus-MDEwOlJlcG9zaXRvcnkzMzAxNDgxMQ==-flat-TabBar.h,caffe-MDEwOlJlcG9zaXRvcnk2MTg3MDgwMw==-flat-gtest-internal-inl.h,62,68,6,306,314,8
236027,https://htmlpreview.github.io/?https://github.com/Christina96/boilerplate-sample-matches/blob/main/Cpp-beta/snap-MDEwOlJlcG9zaXRvcnk0Mjg4MzU3-flat-btaServer.h-tesseract-MDEwOlJlcG9zaXRvcnkyMjg4NzA5NA==-flat-oldbasel.cpp.html,0.25513513513513514,16,snap-MDEwOlJlcG9zaXRvcnk0Mjg4MzU3-flat-btaServer.h,tesseract-MDEwOlJlcG9zaXRvcnkyMjg4NzA5NA==-flat-oldbasel.cpp,50,53,3,352,367,15
249497,https://htmlpreview.github.io/?https://github.com/Christina96/boilerplate-sample-matches/blob/main/Cpp-beta/snap-MDEwOlJlcG9zaXRvcnk0Mjg4MzU3-flat-appsrv.cpp-nano-node-MDEwOlJlcG9zaXRvcnkxOTM0NzM0MA==-flat-entry_11.cpp.html,0.06968973747016706,14,snap-MDEwOlJlcG9zaXRvcnk0Mjg4MzU3-flat-appsrv.cpp,nano-node-MDEwOlJlcG9zaXRvcnkxOTM0NzM0MA==-flat-entry_11.cpp,120,126,6,51,51,0
258791,https://htmlpreview.github.io/?https://github.com/Christina96/boilerplate-sample-matches/blob/main/Cpp-beta/snap-MDEwOlJlcG9zaXRvcnk0Mjg4MzU3-flat-corrgr.cpp-snap-MDEwOlJlcG9zaXRvcnk0Mjg4MzU3-flat-nmen.cpp.html,0.18435155412647375,10,snap-MDEwOlJlcG9zaXRvcnk0Mjg4MzU3-flat-corrgr.cpp,snap-MDEwOlJlcG9zaXRvcnk0Mjg4MzU3-flat-nmen.cpp,269,272,3,481,486,5
259528,https://htmlpreview.github.io/?https://github.com/Christina96/boilerplate-sample-matches/blob/main/Cpp-beta/snap-MDEwOlJlcG9zaXRvcnk0Mjg4MzU3-flat-kronfit.cpp-nano-node-MDEwOlJlcG9zaXRvcnkxOTM0NzM0MA==-flat-voting.cpp.html,0.07867494824016563,10,snap-MDEwOlJlcG9zaXRvcnk0Mjg4MzU3-flat-kronfit.cpp,nano-node-MDEwOlJlcG9zaXRvcnkxOTM0NzM0MA==-flat-voting.cpp,49,54,5,14,20,6
271165,https://htmlpreview.github.io/?https://github.com/Christina96/boilerplate-sample-matches/blob/main/Cpp-beta/abseil-cpp-MDEwOlJlcG9zaXRvcnkxMDQyMzE1NDE=-flat-distribution_test_util.cc-snap-MDEwOlJlcG9zaXRvcnk0Mjg4MzU3-flat-google.cpp.html,0.030738720872583045,10,abseil-cpp-MDEwOlJlcG9zaXRvcnkxMDQyMzE1NDE=-flat-distribution_test_util.cc,snap-MDEwOlJlcG9zaXRvcnk0Mjg4MzU3-flat-google.cpp,287,291,4,301,305,4
281227,https://htmlpreview.github.io/?https://github.com/Christina96/boilerplate-sample-matches/blob/main/Cpp-beta/tesseract-MDEwOlJlcG9zaXRvcnkyMjg4NzA5NA==-flat-ocrblock.cpp-tesseract-MDEwOlJlcG9zaXRvcnkyMjg4NzA5NA==-flat-ratngs.cpp.html,0.08689558514365803,9,tesseract-MDEwOlJlcG9zaXRvcnkyMjg4NzA5NA==-flat-ocrblock.cpp,tesseract-MDEwOlJlcG9zaXRvcnkyMjg4NzA5NA==-flat-ratngs.cpp,36,39,3,565,570,5
295232,https://htmlpreview.github.io/?https://github.com/Christina96/boilerplate-sample-matches/blob/main/Cpp-beta/notepad-plus-plus-MDEwOlJlcG9zaXRvcnkzMzAxNDgxMQ==-flat-Editor.h-notepad-plus-plus-MDEwOlJlcG9zaXRvcnkzMzAxNDgxMQ==-flat-Parameters.cpp.html,0.01735828586927041,9,notepad-plus-plus-MDEwOlJlcG9zaXRvcnkzMzAxNDgxMQ==-flat-Editor.h,notepad-plus-plus-MDEwOlJlcG9zaXRvcnkzMzAxNDgxMQ==-flat-Parameters.cpp,98,102,4,889,895,6
320256,https://htmlpreview.github.io/?https://github.com/Christina96/boilerplate-sample-matches/blob/main/Cpp-beta/snap-MDEwOlJlcG9zaXRvcnk0Mjg4MzU3-flat-kernelmethods.h-snap-MDEwOlJlcG9zaXRvcnk0Mjg4MzU3-flat-http.cpp.html,0.027565084226646247,9,snap-MDEwOlJlcG9zaXRvcnk0Mjg4MzU3-flat-kernelmethods.h,snap-MDEwOlJlcG9zaXRvcnk0Mjg4MzU3-flat-http.cpp,1,4,3,72,77,5
324284,https://htmlpreview.github.io/?https://github.com/Christina96/boilerplate-sample-matches/blob/main/Cpp-beta/caffe-MDEwOlJlcG9zaXRvcnk2MTg3MDgwMw==-flat-batch_classification.cpp-abseil-cpp-MDEwOlJlcG9zaXRvcnkxMDQyMzE1NDE=-flat-inlined_vector_benchmark.cc.html,0.08,11,caffe-MDEwOlJlcG9zaXRvcnk2MTg3MDgwMw==-flat-batch_classification.cpp,abseil-cpp-MDEwOlJlcG9zaXRvcnkxMDQyMzE1NDE=-flat-inlined_vector_benchmark.cc,193,197,4,63,67,4
360877,https://htmlpreview.github.io/?https://github.com/Christina96/boilerplate-sample-matches/blob/main/Cpp-beta/snap-MDEwOlJlcG9zaXRvcnk0Mjg4MzU3-flat-test-TNodeNet.cpp-nano-node-MDEwOlJlcG9zaXRvcnkxOTM0NzM0MA==-flat-wallet.cpp.html,0.05306319343945972,14,snap-MDEwOlJlcG9zaXRvcnk0Mjg4MzU3-flat-test-TNodeNet.cpp,nano-node-MDEwOlJlcG9zaXRvcnkxOTM0NzM0MA==-flat-wallet.cpp,96,107,11,147,155,8
368224,https://htmlpreview.github.io/?https://github.com/Christina96/boilerplate-sample-matches/blob/main/Cpp-beta/snap-MDEwOlJlcG9zaXRvcnk0Mjg4MzU3-flat-demo-gio.cpp-snap-MDEwOlJlcG9zaXRvcnk0Mjg4MzU3-flat-googlex.cpp.html,0.028426395939086295,10,snap-MDEwOlJlcG9zaXRvcnk0Mjg4MzU3-flat-demo-gio.cpp,snap-MDEwOlJlcG9zaXRvcnk0Mjg4MzU3-flat-googlex.cpp,121,124,3,158,161,3
370319,https://htmlpreview.github.io/?https://github.com/Christina96/boilerplate-sample-matches/blob/main/Cpp-beta/caffe-MDEwOlJlcG9zaXRvcnk2MTg3MDgwMw==-flat-im2col.hpp-tesseract-MDEwOlJlcG9zaXRvcnkyMjg4NzA5NA==-flat-tesseractclass.h.html,0.34285714285714286,9,caffe-MDEwOlJlcG9zaXRvcnk2MTg3MDgwMw==-flat-im2col.hpp,tesseract-MDEwOlJlcG9zaXRvcnkyMjg4NzA5NA==-flat-tesseractclass.h,22,25,3,256,259,3
393074,https://htmlpreview.github.io/?https://github.com/Christina96/boilerplate-sample-matches/blob/main/Cpp-beta/snap-MDEwOlJlcG9zaXRvcnk0Mjg4MzU3-flat-google.cpp-snap-MDEwOlJlcG9zaXRvcnk0Mjg4MzU3-flat-lsionto.cpp.html,0.2049199904466205,9,snap-MDEwOlJlcG9zaXRvcnk0Mjg4MzU3-flat-google.cpp,snap-MDEwOlJlcG9zaXRvcnk0Mjg4MzU3-flat-lsionto.cpp,171,176,5,942,947,5
403505,https://htmlpreview.github.io/?https://github.com/Christina96/boilerplate-sample-matches/blob/main/Cpp-beta/caffe-MDEwOlJlcG9zaXRvcnk2MTg3MDgwMw==-flat-dummy_data_layer.cpp-subconverter-MDEwOlJlcG9zaXRvcnkyMTg2ODY3NjM=-flat-string.cpp.html,0.03225806451612903,10,caffe-MDEwOlJlcG9zaXRvcnk2MTg3MDgwMw==-flat-dummy_data_layer.cpp,subconverter-MDEwOlJlcG9zaXRvcnkyMTg2ODY3NjM=-flat-string.cpp,81,84,3,48,53,5
433564,https://htmlpreview.github.io/?https://github.com/Christina96/boilerplate-sample-matches/blob/main/Cpp-beta/tesseract-MDEwOlJlcG9zaXRvcnkyMjg4NzA5NA==-flat-colpartitionset.cpp-snap-MDEwOlJlcG9zaXRvcnk0Mjg4MzU3-flat-memes.cpp.html,0.08307797071842016,9,tesseract-MDEwOlJlcG9zaXRvcnkyMjg4NzA5NA==-flat-colpartitionset.cpp,snap-MDEwOlJlcG9zaXRvcnk0Mjg4MzU3-flat-memes.cpp,452,459,7,134,138,4
451966,https://htmlpreview.github.io/?https://github.com/Christina96/boilerplate-sample-matches/blob/main/Cpp-beta/nano-node-MDEwOlJlcG9zaXRvcnkxOTM0NzM0MA==-flat-confirmation_height_bounded.cpp-tesseract-MDEwOlJlcG9zaXRvcnkyMjg4NzA5NA==-flat-stringrenderer.cpp.html,0.06064356435643564,9,nano-node-MDEwOlJlcG9zaXRvcnkxOTM0NzM0MA==-flat-confirmation_height_bounded.cpp,tesseract-MDEwOlJlcG9zaXRvcnkyMjg4NzA5NA==-flat-stringrenderer.cpp,410,416,6,296,302,6
464290,https://htmlpreview.github.io/?https://github.com/Christina96/boilerplate-sample-matches/blob/main/Cpp-beta/notepad-plus-plus-MDEwOlJlcG9zaXRvcnkzMzAxNDgxMQ==-flat-preferenceDlg.h-notepad-plus-plus-MDEwOlJlcG9zaXRvcnkzMzAxNDgxMQ==-flat-ScintillaEditView.h.html,0.2694350555287301,12,notepad-plus-plus-MDEwOlJlcG9zaXRvcnkzMzAxNDgxMQ==-flat-preferenceDlg.h,notepad-plus-plus-MDEwOlJlcG9zaXRvcnkzMzAxNDgxMQ==-flat-ScintillaEditView.h,97,99,2,586,589,3
469147,https://htmlpreview.github.io/?https://github.com/Christina96/boilerplate-sample-matches/blob/main/Cpp-beta/abseil-cpp-MDEwOlJlcG9zaXRvcnkxMDQyMzE1NDE=-flat-generators_test.cc-abseil-cpp-MDEwOlJlcG9zaXRvcnkxMDQyMzE1NDE=-flat-cord.h.html,0.08548082966687617,29,abseil-cpp-MDEwOlJlcG9zaXRvcnkxMDQyMzE1NDE=-flat-generators_test.cc,abseil-cpp-MDEwOlJlcG9zaXRvcnkxMDQyMzE1NDE=-flat-cord.h,21,49,28,91,102,11
476969,https://htmlpreview.github.io/?https://github.com/Christina96/boilerplate-sample-matches/blob/main/Cpp-beta/tesseract-MDEwOlJlcG9zaXRvcnkyMjg4NzA5NA==-flat-textlineprojection.h-abseil-cpp-MDEwOlJlcG9zaXRvcnkxMDQyMzE1NDE=-flat-cord_rep_btree.h.html,0.148380355276907,11,tesseract-MDEwOlJlcG9zaXRvcnkyMjg4NzA5NA==-flat-textlineprojection.h,abseil-cpp-MDEwOlJlcG9zaXRvcnkxMDQyMzE1NDE=-flat-cord_rep_btree.h,38,46,8,69,72,3
481140,https://htmlpreview.github.io/?https://github.com/Christina96/boilerplate-sample-matches/blob/main/Cpp-beta/tesseract-MDEwOlJlcG9zaXRvcnkyMjg4NzA5NA==-flat-imagedata.cpp-tesseract-MDEwOlJlcG9zaXRvcnkyMjg4NzA5NA==-flat-shapetable.cpp.html,0.042804428044280446,9,tesseract-MDEwOlJlcG9zaXRvcnkyMjg4NzA5NA==-flat-imagedata.cpp,tesseract-MDEwOlJlcG9zaXRvcnkyMjg4NzA5NA==-flat-shapetable.cpp,72,77,5,174,179,5
492409,https://htmlpreview.github.io/?https://github.com/Christina96/boilerplate-sample-matches/blob/main/Cpp-beta/glm-MDEwOlJlcG9zaXRvcnk4NDM2MzE=-flat-_detail.hpp-snap-MDEwOlJlcG9zaXRvcnk0Mjg4MzU3-flat-graphmp-exp.h.html,0.09668508287292818,17,glm-MDEwOlJlcG9zaXRvcnk4NDM2MzE=-flat-_detail.hpp,snap-MDEwOlJlcG9zaXRvcnk0Mjg4MzU3-flat-graphmp-exp.h,203,213,10,112,114,2
537966,https://htmlpreview.github.io/?https://github.com/Christina96/boilerplate-sample-matches/blob/main/Cpp-beta/nano-node-MDEwOlJlcG9zaXRvcnkxOTM0NzM0MA==-flat-websocket.cpp-snap-MDEwOlJlcG9zaXRvcnk0Mjg4MzU3-flat-vizmapgks.cpp.html,0.21302193913658882,11,nano-node-MDEwOlJlcG9zaXRvcnkxOTM0NzM0MA==-flat-websocket.cpp,snap-MDEwOlJlcG9zaXRvcnk0Mjg4MzU3-flat-vizmapgks.cpp,833,840,7,296,300,4
543776,https://htmlpreview.github.io/?https://github.com/Christina96/boilerplate-sample-matches/blob/main/Cpp-beta/caffe-MDEwOlJlcG9zaXRvcnk2MTg3MDgwMw==-flat-reshape_layer.cpp-caffe-MDEwOlJlcG9zaXRvcnk2MTg3MDgwMw==-flat-test_annotated_data_layer.cpp.html,0.10566615620214395,21,caffe-MDEwOlJlcG9zaXRvcnk2MTg3MDgwMw==-flat-reshape_layer.cpp,caffe-MDEwOlJlcG9zaXRvcnk2MTg3MDgwMw==-flat-test_annotated_data_layer.cpp,124,137,13,314,319,5
583193,https://htmlpreview.github.io/?https://github.com/Christina96/boilerplate-sample-matches/blob/main/Cpp-beta/snap-MDEwOlJlcG9zaXRvcnk0Mjg4MzU3-flat-hldoc.cpp-snap-MDEwOlJlcG9zaXRvcnk0Mjg4MzU3-flat-postag.cpp.html,0.05275407292474787,10,snap-MDEwOlJlcG9zaXRvcnk0Mjg4MzU3-flat-hldoc.cpp,snap-MDEwOlJlcG9zaXRvcnk0Mjg4MzU3-flat-postag.cpp,47,50,3,76,78,2
591017,https://htmlpreview.github.io/?https://github.com/Christina96/boilerplate-sample-matches/blob/main/Cpp-beta/tesseract-MDEwOlJlcG9zaXRvcnkyMjg4NzA5NA==-flat-strokewidth.cpp-snap-MDEwOlJlcG9zaXRvcnk0Mjg4MzU3-flat-lsionto.cpp.html,0.15043731778425656,12,tesseract-MDEwOlJlcG9zaXRvcnkyMjg4NzA5NA==-flat-strokewidth.cpp,snap-MDEwOlJlcG9zaXRvcnk0Mjg4MzU3-flat-lsionto.cpp,99,102,3,931,935,4
600237,https://htmlpreview.github.io/?https://github.com/Christina96/boilerplate-sample-matches/blob/main/Cpp-beta/subconverter-MDEwOlJlcG9zaXRvcnkyMTg2ODY3NjM=-flat-inja.hpp-subconverter-MDEwOlJlcG9zaXRvcnkyMTg2ODY3NjM=-flat-jpcre2.hpp.html,0.07728337236533958,9,subconverter-MDEwOlJlcG9zaXRvcnkyMTg2ODY3NjM=-flat-inja.hpp,subconverter-MDEwOlJlcG9zaXRvcnkyMTg2ODY3NjM=-flat-jpcre2.hpp,556,558,2,519,521,2
609961,https://htmlpreview.github.io/?https://github.com/Christina96/boilerplate-sample-matches/blob/main/Cpp-beta/tesseract-MDEwOlJlcG9zaXRvcnkyMjg4NzA5NA==-flat-intfeaturespace.h-notepad-plus-plus-MDEwOlJlcG9zaXRvcnkzMzAxNDgxMQ==-flat-Splitter.h.html,0.1941747572815534,10,tesseract-MDEwOlJlcG9zaXRvcnkyMjg4NzA5NA==-flat-intfeaturespace.h,notepad-plus-plus-MDEwOlJlcG9zaXRvcnkzMzAxNDgxMQ==-flat-Splitter.h,4,13,9,41,47,6
616329,https://htmlpreview.github.io/?https://github.com/Christina96/boilerplate-sample-matches/blob/main/Cpp-beta/abseil-cpp-MDEwOlJlcG9zaXRvcnkxMDQyMzE1NDE=-flat-crc32c_test.cc-abseil-cpp-MDEwOlJlcG9zaXRvcnkxMDQyMzE1NDE=-flat-numbers_test.cc.html,0.08147429679922405,10,abseil-cpp-MDEwOlJlcG9zaXRvcnkxMDQyMzE1NDE=-flat-crc32c_test.cc,abseil-cpp-MDEwOlJlcG9zaXRvcnkxMDQyMzE1NDE=-flat-numbers_test.cc,119,122,3,1050,1053,3
624547,https://htmlpreview.github.io/?https://github.com/Christina96/boilerplate-sample-matches/blob/main/Cpp-beta/notepad-plus-plus-MDEwOlJlcG9zaXRvcnkzMzAxNDgxMQ==-flat-Platform.h-snap-MDEwOlJlcG9zaXRvcnk0Mjg4MzU3-flat-graph_3.h.html,0.11355413303645978,19,notepad-plus-plus-MDEwOlJlcG9zaXRvcnkzMzAxNDgxMQ==-flat-Platform.h,snap-MDEwOlJlcG9zaXRvcnk0Mjg4MzU3-flat-graph_3.h,208,216,8,284,287,3
641450,https://htmlpreview.github.io/?https://github.com/Christina96/boilerplate-sample-matches/blob/main/Cpp-beta/snap-MDEwOlJlcG9zaXRvcnk0Mjg4MzU3-flat-book.h-notepad-plus-plus-MDEwOlJlcG9zaXRvcnkzMzAxNDgxMQ==-flat-BabyGrid.cpp.html,0.07829181494661921,9,snap-MDEwOlJlcG9zaXRvcnk0Mjg4MzU3-flat-book.h,notepad-plus-plus-MDEwOlJlcG9zaXRvcnkzMzAxNDgxMQ==-flat-BabyGrid.cpp,27,31,4,818,825,7
643460,https://htmlpreview.github.io/?https://github.com/Christina96/boilerplate-sample-matches/blob/main/Cpp-beta/notepad-plus-plus-MDEwOlJlcG9zaXRvcnkzMzAxNDgxMQ==-flat-functionParser.cpp-snap-MDEwOlJlcG9zaXRvcnk0Mjg4MzU3-flat-mmnet.cpp.html,0.0841264967761744,10,notepad-plus-plus-MDEwOlJlcG9zaXRvcnkzMzAxNDgxMQ==-flat-functionParser.cpp,snap-MDEwOlJlcG9zaXRvcnk0Mjg4MzU3-flat-mmnet.cpp,105,110,5,8,12,4
647573,https://htmlpreview.github.io/?https://github.com/Christina96/boilerplate-sample-matches/blob/main/Cpp-beta/abseil-cpp-MDEwOlJlcG9zaXRvcnkxMDQyMzE1NDE=-flat-status.cc-snap-MDEwOlJlcG9zaXRvcnk0Mjg4MzU3-flat-tm.cpp.html,0.04330588594083562,14,abseil-cpp-MDEwOlJlcG9zaXRvcnkxMDQyMzE1NDE=-flat-status.cc,snap-MDEwOlJlcG9zaXRvcnk0Mjg4MzU3-flat-tm.cpp,262,270,8,862,870,8
656348,https://htmlpreview.github.io/?https://github.com/Christina96/boilerplate-sample-matches/blob/main/Cpp-beta/notepad-plus-plus-MDEwOlJlcG9zaXRvcnkzMzAxNDgxMQ==-flat-ListView.h-glm-MDEwOlJlcG9zaXRvcnk4NDM2MzE=-flat-type_mat3x3.hpp.html,0.2598870056497175,9,notepad-plus-plus-MDEwOlJlcG9zaXRvcnkzMzAxNDgxMQ==-flat-ListView.h,glm-MDEwOlJlcG9zaXRvcnk4NDM2MzE=-flat-type_mat3x3.hpp,50,54,4,62,64,2
661570,https://htmlpreview.github.io/?https://github.com/Christina96/boilerplate-sample-matches/blob/main/Cpp-beta/snap-MDEwOlJlcG9zaXRvcnk0Mjg4MzU3-flat-email.cpp-tesseract-MDEwOlJlcG9zaXRvcnkyMjg4NzA5NA==-flat-intsimdmatrixavx2.cpp.html,0.05584826132771338,17,snap-MDEwOlJlcG9zaXRvcnk0Mjg4MzU3-flat-email.cpp,tesseract-MDEwOlJlcG9zaXRvcnkyMjg4NzA5NA==-flat-intsimdmatrixavx2.cpp,101,106,5,79,84,5
667903,https://htmlpreview.github.io/?https://github.com/Christina96/boilerplate-sample-matches/blob/main/Cpp-beta/tesseract-MDEwOlJlcG9zaXRvcnkyMjg4NzA5NA==-flat-scanedg.cpp-notepad-plus-plus-MDEwOlJlcG9zaXRvcnkzMzAxNDgxMQ==-flat-Platform.h.html,0.08213944603629417,15,tesseract-MDEwOlJlcG9zaXRvcnkyMjg4NzA5NA==-flat-scanedg.cpp,notepad-plus-plus-MDEwOlJlcG9zaXRvcnkzMzAxNDgxMQ==-flat-Platform.h,22,30,8,63,77,14
672279,https://htmlpreview.github.io/?https://github.com/Christina96/boilerplate-sample-matches/blob/main/Cpp-beta/notepad-plus-plus-MDEwOlJlcG9zaXRvcnkzMzAxNDgxMQ==-flat-TreeView.h-caffe-MDEwOlJlcG9zaXRvcnk2MTg3MDgwMw==-flat-gtest-death-test.cc.html,0.04738562091503268,9,notepad-plus-plus-MDEwOlJlcG9zaXRvcnkzMzAxNDgxMQ==-flat-TreeView.h,caffe-MDEwOlJlcG9zaXRvcnk2MTg3MDgwMw==-flat-gtest-death-test.cc,67,69,2,230,239,9
688067,https://htmlpreview.github.io/?https://github.com/Christina96/boilerplate-sample-matches/blob/main/Cpp-beta/snap-MDEwOlJlcG9zaXRvcnk0Mjg4MzU3-flat-webtxtbs.cpp-tesseract-MDEwOlJlcG9zaXRvcnkyMjg4NzA5NA==-flat-blobbox.cpp.html,0.03236994219653179,10,snap-MDEwOlJlcG9zaXRvcnk0Mjg4MzU3-flat-webtxtbs.cpp,tesseract-MDEwOlJlcG9zaXRvcnkyMjg4NzA5NA==-flat-blobbox.cpp,223,227,4,18,22,4
713136,https://htmlpreview.github.io/?https://github.com/Christina96/boilerplate-sample-matches/blob/main/Cpp-beta/notepad-plus-plus-MDEwOlJlcG9zaXRvcnkzMzAxNDgxMQ==-flat-ColourPicker.cpp-snap-MDEwOlJlcG9zaXRvcnk0Mjg4MzU3-flat-attr.cpp.html,0.03015075376884422,9,notepad-plus-plus-MDEwOlJlcG9zaXRvcnkzMzAxNDgxMQ==-flat-ColourPicker.cpp,snap-MDEwOlJlcG9zaXRvcnk0Mjg4MzU3-flat-attr.cpp,64,68,4,195,198,3
720674,https://htmlpreview.github.io/?https://github.com/Christina96/boilerplate-sample-matches/blob/main/Cpp-beta/tesseract-MDEwOlJlcG9zaXRvcnkyMjg4NzA5NA==-flat-lstmtrainer_test.cc-notepad-plus-plus-MDEwOlJlcG9zaXRvcnkzMzAxNDgxMQ==-flat-ansiCharPanel.cpp.html,0.07926829268292683,13,tesseract-MDEwOlJlcG9zaXRvcnkyMjg4NzA5NA==-flat-lstmtrainer_test.cc,notepad-plus-plus-MDEwOlJlcG9zaXRvcnkzMzAxNDgxMQ==-flat-ansiCharPanel.cpp,51,57,6,26,31,5
735190,https://htmlpreview.github.io/?https://github.com/Christina96/boilerplate-sample-matches/blob/main/Cpp-beta/tesseract-MDEwOlJlcG9zaXRvcnkyMjg4NzA5NA==-flat-tessclassifier.cpp-nano-node-MDEwOlJlcG9zaXRvcnkxOTM0NzM0MA==-flat-pruned_store.cpp.html,0.15714285714285714,11,tesseract-MDEwOlJlcG9zaXRvcnkyMjg4NzA5NA==-flat-tessclassifier.cpp,nano-node-MDEwOlJlcG9zaXRvcnkxOTM0NzM0MA==-flat-pruned_store.cpp,26,32,6,47,55,8
750258,https://htmlpreview.github.io/?https://github.com/Christina96/boilerplate-sample-matches/blob/main/Cpp-beta/snap-MDEwOlJlcG9zaXRvcnk0Mjg4MzU3-flat-test-flow.cpp-snap-MDEwOlJlcG9zaXRvcnk0Mjg4MzU3-flat-rolx.cpp.html,0.0508130081300813,14,snap-MDEwOlJlcG9zaXRvcnk0Mjg4MzU3-flat-test-flow.cpp,snap-MDEwOlJlcG9zaXRvcnk0Mjg4MzU3-flat-rolx.cpp,34,38,4,267,272,5
751084,https://htmlpreview.github.io/?https://github.com/Christina96/boilerplate-sample-matches/blob/main/Cpp-beta/notepad-plus-plus-MDEwOlJlcG9zaXRvcnkzMzAxNDgxMQ==-flat-Splitter.h-nano-node-MDEwOlJlcG9zaXRvcnkxOTM0NzM0MA==-flat-websocket_42.hpp.html,0.2706766917293233,15,notepad-plus-plus-MDEwOlJlcG9zaXRvcnkzMzAxNDgxMQ==-flat-Splitter.h,nano-node-MDEwOlJlcG9zaXRvcnkxOTM0NzM0MA==-flat-websocket_42.hpp,39,48,9,117,126,9
753998,https://htmlpreview.github.io/?https://github.com/Christina96/boilerplate-sample-matches/blob/main/Cpp-beta/snap-MDEwOlJlcG9zaXRvcnk0Mjg4MzU3-flat-circles.cpp-tesseract-MDEwOlJlcG9zaXRvcnkyMjg4NzA5NA==-flat-blobs.cpp.html,0.01875,12,snap-MDEwOlJlcG9zaXRvcnk0Mjg4MzU3-flat-circles.cpp,tesseract-MDEwOlJlcG9zaXRvcnkyMjg4NzA5NA==-flat-blobs.cpp,7,14,7,31,34,3
758908,https://htmlpreview.github.io/?https://github.com/Christina96/boilerplate-sample-matches/blob/main/Cpp-beta/nano-node-MDEwOlJlcG9zaXRvcnkxOTM0NzM0MA==-flat-frontiers_confirmation.cpp-abseil-cpp-MDEwOlJlcG9zaXRvcnkxMDQyMzE1NDE=-flat-log_entry_test.cc.html,0.147239263803681,12,nano-node-MDEwOlJlcG9zaXRvcnkxOTM0NzM0MA==-flat-frontiers_confirmation.cpp,abseil-cpp-MDEwOlJlcG9zaXRvcnkxMDQyMzE1NDE=-flat-log_entry_test.cc,37,45,8,146,151,5
777272,https://htmlpreview.github.io/?https://github.com/Christina96/boilerplate-sample-matches/blob/main/Cpp-beta/caffe-MDEwOlJlcG9zaXRvcnk2MTg3MDgwMw==-flat-base_data_layer.hpp-tesseract-MDEwOlJlcG9zaXRvcnkyMjg4NzA5NA==-flat-pageres.h.html,0.20384615384615384,30,caffe-MDEwOlJlcG9zaXRvcnk2MTg3MDgwMw==-flat-base_data_layer.hpp,tesseract-MDEwOlJlcG9zaXRvcnkyMjg4NzA5NA==-flat-pageres.h,42,49,7,222,247,25
781118,https://htmlpreview.github.io/?https://github.com/Christina96/boilerplate-sample-matches/blob/main/Cpp-beta/tesseract-MDEwOlJlcG9zaXRvcnkyMjg4NzA5NA==-flat-intmatcher.h-notepad-plus-plus-MDEwOlJlcG9zaXRvcnkzMzAxNDgxMQ==-flat-w32_regex_traits.hpp.html,0.20039814200398143,9,tesseract-MDEwOlJlcG9zaXRvcnkyMjg4NzA5NA==-flat-intmatcher.h,notepad-plus-plus-MDEwOlJlcG9zaXRvcnkzMzAxNDgxMQ==-flat-w32_regex_traits.hpp,22,23,1,629,635,6
800655,https://htmlpreview.github.io/?https://github.com/Christina96/boilerplate-sample-matches/blob/main/Cpp-beta/abseil-cpp-MDEwOlJlcG9zaXRvcnkxMDQyMzE1NDE=-flat-crc_cord_state_test.cc-abseil-cpp-MDEwOlJlcG9zaXRvcnkxMDQyMzE1NDE=-flat-kernel_timeout_test.cc.html,0.030560271646859084,9,abseil-cpp-MDEwOlJlcG9zaXRvcnkxMDQyMzE1NDE=-flat-crc_cord_state_test.cc,abseil-cpp-MDEwOlJlcG9zaXRvcnkxMDQyMzE1NDE=-flat-kernel_timeout_test.cc,26,33,7,101,106,5
808751,https://htmlpreview.github.io/?https://github.com/Christina96/boilerplate-sample-matches/blob/main/Cpp-beta/abseil-cpp-MDEwOlJlcG9zaXRvcnkxMDQyMzE1NDE=-flat-pcg_engine_test.cc-snap-MDEwOlJlcG9zaXRvcnk0Mjg4MzU3-flat-sir.cpp.html,0.0317208564631245,11,abseil-cpp-MDEwOlJlcG9zaXRvcnkxMDQyMzE1NDE=-flat-pcg_engine_test.cc,snap-MDEwOlJlcG9zaXRvcnk0Mjg4MzU3-flat-sir.cpp,36,40,4,267,271,4
815503,https://htmlpreview.github.io/?https://github.com/Christina96/boilerplate-sample-matches/blob/main/Cpp-beta/caffe-MDEwOlJlcG9zaXRvcnk2MTg3MDgwMw==-flat-multi_solver.hpp-snap-MDEwOlJlcG9zaXRvcnk0Mjg4MzU3-flat-priorityqueue.h.html,0.15139442231075698,10,caffe-MDEwOlJlcG9zaXRvcnk2MTg3MDgwMw==-flat-multi_solver.hpp,snap-MDEwOlJlcG9zaXRvcnk0Mjg4MzU3-flat-priorityqueue.h,45,52,7,50,57,7
850856,https://htmlpreview.github.io/?https://github.com/Christina96/boilerplate-sample-matches/blob/main/Cpp-beta/caffe-MDEwOlJlcG9zaXRvcnk2MTg3MDgwMw==-flat-mkl_convolution_layer.cpp-tesseract-MDEwOlJlcG9zaXRvcnkyMjg4NzA5NA==-flat-paragraphs.cpp.html,0.018278301886792452,12,caffe-MDEwOlJlcG9zaXRvcnk2MTg3MDgwMw==-flat-mkl_convolution_layer.cpp,tesseract-MDEwOlJlcG9zaXRvcnkyMjg4NzA5NA==-flat-paragraphs.cpp,245,256,11,1817,1828,11
854380,https://htmlpreview.github.io/?https://github.com/Christina96/boilerplate-sample-matches/blob/main/Cpp-beta/notepad-plus-plus-MDEwOlJlcG9zaXRvcnkzMzAxNDgxMQ==-flat-localization.h-tesseract-MDEwOlJlcG9zaXRvcnkyMjg4NzA5NA==-flat-trainingsampleset.h.html,0.775,32,notepad-plus-plus-MDEwOlJlcG9zaXRvcnkzMzAxNDgxMQ==-flat-localization.h,tesseract-MDEwOlJlcG9zaXRvcnkyMjg4NzA5NA==-flat-trainingsampleset.h,18,25,7,68,80,12
869778,https://htmlpreview.github.io/?https://github.com/Christina96/boilerplate-sample-matches/blob/main/Cpp-beta/caffe-MDEwOlJlcG9zaXRvcnk2MTg3MDgwMw==-flat-db_lmdb.cpp-snap-MDEwOlJlcG9zaXRvcnk0Mjg4MzU3-flat-test-alg.cpp.html,0.016319869441044473,11,caffe-MDEwOlJlcG9zaXRvcnk2MTg3MDgwMw==-flat-db_lmdb.cpp,snap-MDEwOlJlcG9zaXRvcnk0Mjg4MzU3-flat-test-alg.cpp,22,31,9,171,179,8
877102,https://htmlpreview.github.io/?https://github.com/Christina96/boilerplate-sample-matches/blob/main/Cpp-beta/tesseract-MDEwOlJlcG9zaXRvcnkyMjg4NzA5NA==-flat-paragraphs.h-notepad-plus-plus-MDEwOlJlcG9zaXRvcnkzMzAxNDgxMQ==-flat-regbase.hpp.html,0.4745762711864407,19,tesseract-MDEwOlJlcG9zaXRvcnkyMjg4NzA5NA==-flat-paragraphs.h,notepad-plus-plus-MDEwOlJlcG9zaXRvcnkzMzAxNDgxMQ==-flat-regbase.hpp,13,31,18,9,27,18
885388,https://htmlpreview.github.io/?https://github.com/Christina96/boilerplate-sample-matches/blob/main/Cpp-beta/MMKV-MDEwOlJlcG9zaXRvcnkxNDkxMTE4MTM=-flat-ThreadLock.h-subconverter-MDEwOlJlcG9zaXRvcnkyMTg2ODY3NjM=-flat-main.cpp.html,0.11940298507462686,12,MMKV-MDEwOlJlcG9zaXRvcnkxNDkxMTE4MTM=-flat-ThreadLock.h,subconverter-MDEwOlJlcG9zaXRvcnkyMTg2ODY3NjM=-flat-main.cpp,24,34,10,143,149,6
907728,https://htmlpreview.github.io/?https://github.com/Christina96/boilerplate-sample-matches/blob/main/Cpp-beta/nano-node-MDEwOlJlcG9zaXRvcnkxOTM0NzM0MA==-flat-websocket_client.hpp-abseil-cpp-MDEwOlJlcG9zaXRvcnkxMDQyMzE1NDE=-flat-leak_check.cc.html,0.16363636363636364,9,nano-node-MDEwOlJlcG9zaXRvcnkxOTM0NzM0MA==-flat-websocket_client.hpp,abseil-cpp-MDEwOlJlcG9zaXRvcnkxMDQyMzE1NDE=-flat-leak_check.cc,39,47,8,20,22,2
930473,https://htmlpreview.github.io/?https://github.com/Christina96/boilerplate-sample-matches/blob/main/Cpp-beta/caffe-MDEwOlJlcG9zaXRvcnk2MTg3MDgwMw==-flat-filter_layer.cpp-snap-MDEwOlJlcG9zaXRvcnk0Mjg4MzU3-flat-ciawfb.cpp.html,0.025423728813559324,9,caffe-MDEwOlJlcG9zaXRvcnk2MTg3MDgwMw==-flat-filter_layer.cpp,snap-MDEwOlJlcG9zaXRvcnk0Mjg4MzU3-flat-ciawfb.cpp,19,22,3,42,43,1
939790,https://htmlpreview.github.io/?https://github.com/Christina96/boilerplate-sample-matches/blob/main/Cpp-beta/abseil-cpp-MDEwOlJlcG9zaXRvcnkxMDQyMzE1NDE=-flat-fast_uniform_bits_test.cc-abseil-cpp-MDEwOlJlcG9zaXRvcnkxMDQyMzE1NDE=-flat-span_test.cc.html,0.2068206820682068,12,abseil-cpp-MDEwOlJlcG9zaXRvcnkxMDQyMzE1NDE=-flat-fast_uniform_bits_test.cc,abseil-cpp-MDEwOlJlcG9zaXRvcnkxMDQyMzE1NDE=-flat-span_test.cc,149,163,14,220,226,6
950229,https://htmlpreview.github.io/?https://github.com/Christina96/boilerplate-sample-matches/blob/main/Cpp-beta/caffe-MDEwOlJlcG9zaXRvcnk2MTg3MDgwMw==-flat-gmock-generated-internal-utils.h-caffe-MDEwOlJlcG9zaXRvcnk2MTg3MDgwMw==-flat-gtest-type-util.h.html,0.1307175373943204,9,caffe-MDEwOlJlcG9zaXRvcnk2MTg3MDgwMw==-flat-gmock-generated-internal-utils.h,caffe-MDEwOlJlcG9zaXRvcnk2MTg3MDgwMw==-flat-gtest-type-util.h,117,121,4,81,85,4
952049,https://htmlpreview.github.io/?https://github.com/Christina96/boilerplate-sample-matches/blob/main/Cpp-beta/snap-MDEwOlJlcG9zaXRvcnk0Mjg4MzU3-flat-wordnet.cpp-snap-MDEwOlJlcG9zaXRvcnk0Mjg4MzU3-flat-google.cpp.html,0.15298507462686567,10,snap-MDEwOlJlcG9zaXRvcnk0Mjg4MzU3-flat-wordnet.cpp,snap-MDEwOlJlcG9zaXRvcnk0Mjg4MzU3-flat-google.cpp,130,133,3,308,311,3
960018,https://htmlpreview.github.io/?https://github.com/Christina96/boilerplate-sample-matches/blob/main/Cpp-beta/snap-MDEwOlJlcG9zaXRvcnk0Mjg4MzU3-flat-tagcloud.cpp-abseil-cpp-MDEwOlJlcG9zaXRvcnkxMDQyMzE1NDE=-flat-numbers.cc.html,0.04976303317535545,11,snap-MDEwOlJlcG9zaXRvcnk0Mjg4MzU3-flat-tagcloud.cpp,abseil-cpp-MDEwOlJlcG9zaXRvcnkxMDQyMzE1NDE=-flat-numbers.cc,2,6,4,481,489,8
961047,https://htmlpreview.github.io/?https://github.com/Christina96/boilerplate-sample-matches/blob/main/Cpp-beta/snap-MDEwOlJlcG9zaXRvcnk0Mjg4MzU3-flat-corrgr.cpp-abseil-cpp-MDEwOlJlcG9zaXRvcnkxMDQyMzE1NDE=-flat-crc_x86_arm_combined.cc.html,0.07878369039391846,11,snap-MDEwOlJlcG9zaXRvcnk0Mjg4MzU3-flat-corrgr.cpp,abseil-cpp-MDEwOlJlcG9zaXRvcnkxMDQyMzE1NDE=-flat-crc_x86_arm_combined.cc,64,67,3,71,74,3
967944,https://htmlpreview.github.io/?https://github.com/Christina96/boilerplate-sample-matches/blob/main/Cpp-beta/nano-node-MDEwOlJlcG9zaXRvcnkxOTM0NzM0MA==-flat-logging.hpp-notepad-plus-plus-MDEwOlJlcG9zaXRvcnkzMzAxNDgxMQ==-flat-cstdint.hpp.html,0.24203821656050956,38,nano-node-MDEwOlJlcG9zaXRvcnkxOTM0NzM0MA==-flat-logging.hpp,notepad-plus-plus-MDEwOlJlcG9zaXRvcnkzMzAxNDgxMQ==-flat-cstdint.hpp,30,61,31,31,122,91
968988,https://htmlpreview.github.io/?https://github.com/Christina96/boilerplate-sample-matches/blob/main/Cpp-beta/snap-MDEwOlJlcG9zaXRvcnk0Mjg4MzU3-flat-html.h-tesseract-MDEwOlJlcG9zaXRvcnkyMjg4NzA5NA==-flat-quspline.cpp.html,0.06321839080459771,11,snap-MDEwOlJlcG9zaXRvcnk0Mjg4MzU3-flat-html.h,tesseract-MDEwOlJlcG9zaXRvcnkyMjg4NzA5NA==-flat-quspline.cpp,9,16,7,29,35,6
978021,https://htmlpreview.github.io/?https://github.com/Christina96/boilerplate-sample-matches/blob/main/Cpp-beta/tesseract-MDEwOlJlcG9zaXRvcnkyMjg4NzA5NA==-flat-ligature_table.cpp-abseil-cpp-MDEwOlJlcG9zaXRvcnkxMDQyMzE1NDE=-flat-charconv_test.cc.html,0.043076923076923075,11,tesseract-MDEwOlJlcG9zaXRvcnkyMjg4NzA5NA==-flat-ligature_table.cpp,abseil-cpp-MDEwOlJlcG9zaXRvcnkxMDQyMzE1NDE=-flat-charconv_test.cc,90,94,4,464,469,5
989038,https://htmlpreview.github.io/?https://github.com/Christina96/boilerplate-sample-matches/blob/main/Cpp-beta/Cpp_Primer_Answers-MDEwOlJlcG9zaXRvcnk0NzE3MDI2MQ==-flat-exercise14_23.cpp-nano-node-MDEwOlJlcG9zaXRvcnkxOTM0NzM0MA==-flat-message_deserializer_65.cpp.html,0.04979253112033195,9,Cpp_Primer_Answers-MDEwOlJlcG9zaXRvcnk0NzE3MDI2MQ==-flat-exercise14_23.cpp,nano-node-MDEwOlJlcG9zaXRvcnkxOTM0NzM0MA==-flat-message_deserializer_65.cpp,107,112,5,267,272,5
999086,https://htmlpreview.github.io/?https://github.com/Christina96/boilerplate-sample-matches/blob/main/Cpp-beta/nano-node-MDEwOlJlcG9zaXRvcnkxOTM0NzM0MA==-flat-block_arrival.cpp-nano-node-MDEwOlJlcG9zaXRvcnkxOTM0NzM0MA==-flat-vote_processor.cpp.html,0.036734693877551024,9,nano-node-MDEwOlJlcG9zaXRvcnkxOTM0NzM0MA==-flat-block_arrival.cpp,nano-node-MDEwOlJlcG9zaXRvcnkxOTM0NzM0MA==-flat-vote_processor.cpp,18,22,4,24,31,7
1011210,https://htmlpreview.github.io/?https://github.com/Christina96/boilerplate-sample-matches/blob/main/Cpp-beta/notepad-plus-plus-MDEwOlJlcG9zaXRvcnkzMzAxNDgxMQ==-flat-json.hpp-snap-MDEwOlJlcG9zaXRvcnk0Mjg4MzU3-flat-memes.h.html,0.05148741418764302,10,notepad-plus-plus-MDEwOlJlcG9zaXRvcnkzMzAxNDgxMQ==-flat-json.hpp,snap-MDEwOlJlcG9zaXRvcnk0Mjg4MzU3-flat-memes.h,3112,3117,5,42,43,1
1048700,https://htmlpreview.github.io/?https://github.com/Christina96/boilerplate-sample-matches/blob/main/Cpp-beta/nano-node-MDEwOlJlcG9zaXRvcnkxOTM0NzM0MA==-flat-frontier_store_74.hpp-notepad-plus-plus-MDEwOlJlcG9zaXRvcnkzMzAxNDgxMQ==-flat-Editor.h.html,0.07092198581560284,50,nano-node-MDEwOlJlcG9zaXRvcnkxOTM0NzM0MA==-flat-frontier_store_74.hpp,notepad-plus-plus-MDEwOlJlcG9zaXRvcnkzMzAxNDgxMQ==-flat-Editor.h,12,22,10,224,246,22
1050164,https://htmlpreview.github.io/?https://github.com/Christina96/boilerplate-sample-matches/blob/main/Cpp-beta/glm-MDEwOlJlcG9zaXRvcnk4NDM2MzE=-flat-type_mat4x3.hpp-caffe-MDEwOlJlcG9zaXRvcnk2MTg3MDgwMw==-flat-mkldnn_memory.hpp.html,0.1568627450980392,12,glm-MDEwOlJlcG9zaXRvcnk4NDM2MzE=-flat-type_mat4x3.hpp,caffe-MDEwOlJlcG9zaXRvcnk2MTg3MDgwMw==-flat-mkldnn_memory.hpp,61,64,3,23,25,2
1053625,https://htmlpreview.github.io/?https://github.com/Christina96/boilerplate-sample-matches/blob/main/Cpp-beta/nano-node-MDEwOlJlcG9zaXRvcnkxOTM0NzM0MA==-flat-block_store_64.cpp-caffe-MDEwOlJlcG9zaXRvcnk2MTg3MDgwMw==-flat-test_bias_layer.cpp.html,0.09769585253456221,23,nano-node-MDEwOlJlcG9zaXRvcnkxOTM0NzM0MA==-flat-block_store_64.cpp,caffe-MDEwOlJlcG9zaXRvcnk2MTg3MDgwMw==-flat-test_bias_layer.cpp,10,19,9,44,62,18
1053683,https://htmlpreview.github.io/?https://github.com/Christina96/boilerplate-sample-matches/blob/main/Cpp-beta/tesseract-MDEwOlJlcG9zaXRvcnkyMjg4NzA5NA==-flat-baseapi.cpp-tesseract-MDEwOlJlcG9zaXRvcnkyMjg4NzA5NA==-flat-makerow.cpp.html,0.10090361445783133,9,tesseract-MDEwOlJlcG9zaXRvcnkyMjg4NzA5NA==-flat-baseapi.cpp,tesseract-MDEwOlJlcG9zaXRvcnkyMjg4NzA5NA==-flat-makerow.cpp,444,447,3,1545,1551,6
1062493,https://htmlpreview.github.io/?https://github.com/Christina96/boilerplate-sample-matches/blob/main/Cpp-beta/glm-MDEwOlJlcG9zaXRvcnk4NDM2MzE=-flat-type_vec4.hpp-tesseract-MDEwOlJlcG9zaXRvcnkyMjg4NzA5NA==-flat-tospace.cpp.html,0.061826697892271666,9,glm-MDEwOlJlcG9zaXRvcnk4NDM2MzE=-flat-type_vec4.hpp,tesseract-MDEwOlJlcG9zaXRvcnkyMjg4NzA5NA==-flat-tospace.cpp,216,224,8,1350,1356,6
1063111,https://htmlpreview.github.io/?https://github.com/Christina96/boilerplate-sample-matches/blob/main/Cpp-beta/subconverter-MDEwOlJlcG9zaXRvcnkyMTg2ODY3NjM=-flat-webget.h-tesseract-MDEwOlJlcG9zaXRvcnkyMjg4NzA5NA==-flat-stringrenderer.h.html,0.27411167512690354,27,subconverter-MDEwOlJlcG9zaXRvcnkyMTg2ODY3NjM=-flat-webget.h,tesseract-MDEwOlJlcG9zaXRvcnkyMjg4NzA5NA==-flat-stringrenderer.h,32,39,7,89,121,32
1063772,https://htmlpreview.github.io/?https://github.com/Christina96/boilerplate-sample-matches/blob/main/Cpp-beta/snap-MDEwOlJlcG9zaXRvcnk0Mjg4MzU3-flat-sir.h-tesseract-MDEwOlJlcG9zaXRvcnkyMjg4NzA5NA==-flat-applybox.cpp.html,0.03041274438812455,11,snap-MDEwOlJlcG9zaXRvcnk0Mjg4MzU3-flat-sir.h,tesseract-MDEwOlJlcG9zaXRvcnkyMjg4NzA5NA==-flat-applybox.cpp,69,72,3,383,388,5
1068870,https://htmlpreview.github.io/?https://github.com/Christina96/boilerplate-sample-matches/blob/main/Cpp-beta/nano-node-MDEwOlJlcG9zaXRvcnkxOTM0NzM0MA==-flat-difficulty.cpp-tesseract-MDEwOlJlcG9zaXRvcnkyMjg4NzA5NA==-flat-recodebeam_test.cc.html,0.026378896882494004,11,nano-node-MDEwOlJlcG9zaXRvcnkxOTM0NzM0MA==-flat-difficulty.cpp,tesseract-MDEwOlJlcG9zaXRvcnkyMjg4NzA5NA==-flat-recodebeam_test.cc,50,56,6,149,154,5
1080107,https://htmlpreview.github.io/?https://github.com/Christina96/boilerplate-sample-matches/blob/main/Cpp-beta/Cpp_Primer_Answers-MDEwOlJlcG9zaXRvcnk0NzE3MDI2MQ==-flat-exercise7_26_0.h-snap-MDEwOlJlcG9zaXRvcnk0Mjg4MzU3-flat-gkswf.h.html,0.15037593984962405,10,Cpp_Primer_Answers-MDEwOlJlcG9zaXRvcnk0NzE3MDI2MQ==-flat-exercise7_26_0.h,snap-MDEwOlJlcG9zaXRvcnk0Mjg4MzU3-flat-gkswf.h,7,8,1,7,16,9
1094758,https://htmlpreview.github.io/?https://github.com/Christina96/boilerplate-sample-matches/blob/main/Cpp-beta/nano-node-MDEwOlJlcG9zaXRvcnkxOTM0NzM0MA==-flat-vote_processor.cpp-snap-MDEwOlJlcG9zaXRvcnk0Mjg4MzU3-flat-euproj.cpp.html,0.05124716553287982,18,nano-node-MDEwOlJlcG9zaXRvcnkxOTM0NzM0MA==-flat-vote_processor.cpp,snap-MDEwOlJlcG9zaXRvcnk0Mjg4MzU3-flat-euproj.cpp,148,158,10,317,326,9
1100627,https://htmlpreview.github.io/?https://github.com/Christina96/boilerplate-sample-matches/blob/main/Cpp-beta/notepad-plus-plus-MDEwOlJlcG9zaXRvcnkzMzAxNDgxMQ==-flat-PropSetSimple.h-nano-node-MDEwOlJlcG9zaXRvcnkxOTM0NzM0MA==-flat-ed25519-donna_0.h.html,0.3333333333333333,13,notepad-plus-plus-MDEwOlJlcG9zaXRvcnkzMzAxNDgxMQ==-flat-PropSetSimple.h,nano-node-MDEwOlJlcG9zaXRvcnkxOTM0NzM0MA==-flat-ed25519-donna_0.h,13,15,2,4,9,5
1123411,https://htmlpreview.github.io/?https://github.com/Christina96/boilerplate-sample-matches/blob/main/Cpp-beta/snap-MDEwOlJlcG9zaXRvcnk0Mjg4MzU3-flat-wbmp.h-abseil-cpp-MDEwOlJlcG9zaXRvcnkxMDQyMzE1NDE=-flat-status.h.html,0.07984031936127745,11,snap-MDEwOlJlcG9zaXRvcnk0Mjg4MzU3-flat-wbmp.h,abseil-cpp-MDEwOlJlcG9zaXRvcnkxMDQyMzE1NDE=-flat-status.h,7,13,6,74,80,6
1129266,https://htmlpreview.github.io/?https://github.com/Christina96/boilerplate-sample-matches/blob/main/Cpp-beta/notepad-plus-plus-MDEwOlJlcG9zaXRvcnkzMzAxNDgxMQ==-flat-CharacterCategory.h-snap-MDEwOlJlcG9zaXRvcnk0Mjg4MzU3-flat-tnt.cpp.html,0.032441200324412,10,notepad-plus-plus-MDEwOlJlcG9zaXRvcnkzMzAxNDgxMQ==-flat-CharacterCategory.h,snap-MDEwOlJlcG9zaXRvcnk0Mjg4MzU3-flat-tnt.cpp,7,9,2,439,443,4
1129654,https://htmlpreview.github.io/?https://github.com/Christina96/boilerplate-sample-matches/blob/main/Cpp-beta/snap-MDEwOlJlcG9zaXRvcnk0Mjg4MzU3-flat-test-multimodal.cpp-notepad-plus-plus-MDEwOlJlcG9zaXRvcnkzMzAxNDgxMQ==-flat-ScintillaEditView.cpp.html,0.06056183874498358,12,snap-MDEwOlJlcG9zaXRvcnk0Mjg4MzU3-flat-test-multimodal.cpp,notepad-plus-plus-MDEwOlJlcG9zaXRvcnkzMzAxNDgxMQ==-flat-ScintillaEditView.cpp,1006,1009,3,1489,1492,3
1141526,https://htmlpreview.github.io/?https://github.com/Christina96/boilerplate-sample-matches/blob/main/Cpp-beta/nano-node-MDEwOlJlcG9zaXRvcnkxOTM0NzM0MA==-flat-daemonconfig.hpp-tesseract-MDEwOlJlcG9zaXRvcnkyMjg4NzA5NA==-flat-tesseractclass.h.html,0.04146730462519936,13,nano-node-MDEwOlJlcG9zaXRvcnkxOTM0NzM0MA==-flat-daemonconfig.hpp,tesseract-MDEwOlJlcG9zaXRvcnkyMjg4NzA5NA==-flat-tesseractclass.h,13,17,4,47,70,23
1155198,https://htmlpreview.github.io/?https://github.com/Christina96/boilerplate-sample-matches/blob/main/Cpp-beta/snap-MDEwOlJlcG9zaXRvcnk0Mjg4MzU3-flat-test-ggen.cpp-notepad-plus-plus-MDEwOlJlcG9zaXRvcnkzMzAxNDgxMQ==-flat-basic_regex_creator.hpp.html,0.014477766287487074,12,snap-MDEwOlJlcG9zaXRvcnk0Mjg4MzU3-flat-test-ggen.cpp,notepad-plus-plus-MDEwOlJlcG9zaXRvcnkzMzAxNDgxMQ==-flat-basic_regex_creator.hpp,314,319,5,898,905,7
1189266,https://htmlpreview.github.io/?https://github.com/Christina96/boilerplate-sample-matches/blob/main/Cpp-beta/nano-node-MDEwOlJlcG9zaXRvcnkxOTM0NzM0MA==-flat-messages.hpp-snap-MDEwOlJlcG9zaXRvcnk0Mjg4MzU3-flat-mmgraph-exp.h.html,0.011782032400589101,16,nano-node-MDEwOlJlcG9zaXRvcnkxOTM0NzM0MA==-flat-messages.hpp,snap-MDEwOlJlcG9zaXRvcnk0Mjg4MzU3-flat-mmgraph-exp.h,21,37,16,594,602,8
1203578,https://htmlpreview.github.io/?https://github.com/Christina96/boilerplate-sample-matches/blob/main/Cpp-beta/snap-MDEwOlJlcG9zaXRvcnk0Mjg4MzU3-flat-googlex.cpp-snap-MDEwOlJlcG9zaXRvcnk0Mjg4MzU3-flat-kronecker.cpp.html,0.1551897883775613,10,snap-MDEwOlJlcG9zaXRvcnk0Mjg4MzU3-flat-googlex.cpp,snap-MDEwOlJlcG9zaXRvcnk0Mjg4MzU3-flat-kronecker.cpp,582,585,3,884,887,3
1207899,https://htmlpreview.github.io/?https://github.com/Christina96/boilerplate-sample-matches/blob/main/Cpp-beta/notepad-plus-plus-MDEwOlJlcG9zaXRvcnkzMzAxNDgxMQ==-flat-Lexilla.h-tesseract-MDEwOlJlcG9zaXRvcnkyMjg4NzA5NA==-flat-validate_indic.h.html,0.6666666666666666,13,notepad-plus-plus-MDEwOlJlcG9zaXRvcnkzMzAxNDgxMQ==-flat-Lexilla.h,tesseract-MDEwOlJlcG9zaXRvcnkyMjg4NzA5NA==-flat-validate_indic.h,31,66,35,10,17,7
1218407,https://htmlpreview.github.io/?https://github.com/Christina96/boilerplate-sample-matches/blob/main/Cpp-beta/snap-MDEwOlJlcG9zaXRvcnk0Mjg4MzU3-flat-imdbnet.h-notepad-plus-plus-MDEwOlJlcG9zaXRvcnkzMzAxNDgxMQ==-flat-regex_token_iterator.hpp.html,0.17573221757322174,15,snap-MDEwOlJlcG9zaXRvcnk0Mjg4MzU3-flat-imdbnet.h,notepad-plus-plus-MDEwOlJlcG9zaXRvcnkzMzAxNDgxMQ==-flat-regex_token_iterator.hpp,52,58,6,103,112,9
1241899,https://htmlpreview.github.io/?https://github.com/Christina96/boilerplate-sample-matches/blob/main/Cpp-beta/caffe-MDEwOlJlcG9zaXRvcnk2MTg3MDgwMw==-flat-test_engine_selection.cpp-abseil-cpp-MDEwOlJlcG9zaXRvcnkxMDQyMzE1NDE=-flat-poisson_distribution_test.cc.html,0.08486017357762778,11,caffe-MDEwOlJlcG9zaXRvcnk2MTg3MDgwMw==-flat-test_engine_selection.cpp,abseil-cpp-MDEwOlJlcG9zaXRvcnkxMDQyMzE1NDE=-flat-poisson_distribution_test.cc,150,157,7,38,54,16
1243688,https://htmlpreview.github.io/?https://github.com/Christina96/boilerplate-sample-matches/blob/main/Cpp-beta/nano-node-MDEwOlJlcG9zaXRvcnkxOTM0NzM0MA==-flat-telemetry_41.hpp-nano-node-MDEwOlJlcG9zaXRvcnkxOTM0NzM0MA==-flat-tomlconfig.hpp.html,0.4105263157894737,25,nano-node-MDEwOlJlcG9zaXRvcnkxOTM0NzM0MA==-flat-telemetry_41.hpp,nano-node-MDEwOlJlcG9zaXRvcnkxOTM0NzM0MA==-flat-tomlconfig.hpp,70,79,9,34,41,7
1246569,https://htmlpreview.github.io/?https://github.com/Christina96/boilerplate-sample-matches/blob/main/Cpp-beta/MMKV-MDEwOlJlcG9zaXRvcnkxNDkxMTE4MTM=-flat-AESCrypt.h-abseil-cpp-MDEwOlJlcG9zaXRvcnkxMDQyMzE1NDE=-flat-conformance_profile.h.html,0.19402985074626866,30,MMKV-MDEwOlJlcG9zaXRvcnkxNDkxMTE4MTM=-flat-AESCrypt.h,abseil-cpp-MDEwOlJlcG9zaXRvcnkxMDQyMzE1NDE=-flat-conformance_profile.h,36,41,5,429,439,10
1271614,https://htmlpreview.github.io/?https://github.com/Christina96/boilerplate-sample-matches/blob/main/Cpp-beta/caffe-MDEwOlJlcG9zaXRvcnk2MTg3MDgwMw==-flat-test_deconvolution3d_layer.cpp-caffe-MDEwOlJlcG9zaXRvcnk2MTg3MDgwMw==-flat-test_bbox_util.cpp.html,0.13547724940130004,19,caffe-MDEwOlJlcG9zaXRvcnk2MTg3MDgwMw==-flat-test_deconvolution3d_layer.cpp,caffe-MDEwOlJlcG9zaXRvcnk2MTg3MDgwMw==-flat-test_bbox_util.cpp,274,283,9,1102,1127,25
1285127,https://htmlpreview.github.io/?https://github.com/Christina96/boilerplate-sample-matches/blob/main/Cpp-beta/snap-MDEwOlJlcG9zaXRvcnk0Mjg4MzU3-flat-cascdynetinf.h-snap-MDEwOlJlcG9zaXRvcnk0Mjg4MzU3-flat-yahoodm.cpp.html,0.030283080974325215,12,snap-MDEwOlJlcG9zaXRvcnk0Mjg4MzU3-flat-cascdynetinf.h,snap-MDEwOlJlcG9zaXRvcnk0Mjg4MzU3-flat-yahoodm.cpp,175,175,0,106,112,6
1292440,https://htmlpreview.github.io/?https://github.com/Christina96/boilerplate-sample-matches/blob/main/Cpp-beta/snap-MDEwOlJlcG9zaXRvcnk0Mjg4MzU3-flat-timenet.h-tesseract-MDEwOlJlcG9zaXRvcnkyMjg4NzA5NA==-flat-blobbox.cpp.html,0.07397444519166106,10,snap-MDEwOlJlcG9zaXRvcnk0Mjg4MzU3-flat-timenet.h,tesseract-MDEwOlJlcG9zaXRvcnkyMjg4NzA5NA==-flat-blobbox.cpp,41,42,1,401,410,9
1295616,https://htmlpreview.github.io/?https://github.com/Christina96/boilerplate-sample-matches/blob/main/Cpp-beta/tesseract-MDEwOlJlcG9zaXRvcnkyMjg4NzA5NA==-flat-mfoutline.cpp-tesseract-MDEwOlJlcG9zaXRvcnkyMjg4NzA5NA==-flat-linefind.cpp.html,0.033216783216783216,10,tesseract-MDEwOlJlcG9zaXRvcnkyMjg4NzA5NA==-flat-mfoutline.cpp,tesseract-MDEwOlJlcG9zaXRvcnkyMjg4NzA5NA==-flat-linefind.cpp,98,104,6,71,77,6
1302853,https://htmlpreview.github.io/?https://github.com/Christina96/boilerplate-sample-matches/blob/main/Cpp-beta/nano-node-MDEwOlJlcG9zaXRvcnkxOTM0NzM0MA==-flat-peer_container.cpp-caffe-MDEwOlJlcG9zaXRvcnk2MTg3MDgwMw==-flat-test_io.cpp.html,0.2400793650793651,10,nano-node-MDEwOlJlcG9zaXRvcnkxOTM0NzM0MA==-flat-peer_container.cpp,caffe-MDEwOlJlcG9zaXRvcnk2MTg3MDgwMw==-flat-test_io.cpp,38,40,2,233,236,3
1306145,https://htmlpreview.github.io/?https://github.com/Christina96/boilerplate-sample-matches/blob/main/Cpp-beta/tesseract-MDEwOlJlcG9zaXRvcnkyMjg4NzA5NA==-flat-hocrrenderer.cpp-tesseract-MDEwOlJlcG9zaXRvcnkyMjg4NzA5NA==-flat-cjkpitch.cpp.html,0.021364985163204748,9,tesseract-MDEwOlJlcG9zaXRvcnkyMjg4NzA5NA==-flat-hocrrenderer.cpp,tesseract-MDEwOlJlcG9zaXRvcnkyMjg4NzA5NA==-flat-cjkpitch.cpp,61,66,5,279,283,4
1318105,https://htmlpreview.github.io/?https://github.com/Christina96/boilerplate-sample-matches/blob/main/Cpp-beta/nano-node-MDEwOlJlcG9zaXRvcnkxOTM0NzM0MA==-flat-peer_container.cpp-abseil-cpp-MDEwOlJlcG9zaXRvcnkxMDQyMzE1NDE=-flat-cord_buffer_test.cc.html,0.40380047505938244,10,nano-node-MDEwOlJlcG9zaXRvcnkxOTM0NzM0MA==-flat-peer_container.cpp,abseil-cpp-MDEwOlJlcG9zaXRvcnkxMDQyMzE1NDE=-flat-cord_buffer_test.cc,116,120,4,207,210,3
1322833,https://htmlpreview.github.io/?https://github.com/Christina96/boilerplate-sample-matches/blob/main/Cpp-beta/tesseract-MDEwOlJlcG9zaXRvcnkyMjg4NzA5NA==-flat-fpchop.cpp-tesseract-MDEwOlJlcG9zaXRvcnkyMjg4NzA5NA==-flat-adaptmatch.cpp.html,0.10574018126888217,11,tesseract-MDEwOlJlcG9zaXRvcnkyMjg4NzA5NA==-flat-fpchop.cpp,tesseract-MDEwOlJlcG9zaXRvcnkyMjg4NzA5NA==-flat-adaptmatch.cpp,66,73,7,242,251,9
1328636,https://htmlpreview.github.io/?https://github.com/Christina96/boilerplate-sample-matches/blob/main/Cpp-beta/abseil-cpp-MDEwOlJlcG9zaXRvcnkxMDQyMzE1NDE=-flat-str_split_test.cc-snap-MDEwOlJlcG9zaXRvcnk0Mjg4MzU3-flat-gsearch.cpp.html,0.17451084082496035,10,abseil-cpp-MDEwOlJlcG9zaXRvcnkxMDQyMzE1NDE=-flat-str_split_test.cc,snap-MDEwOlJlcG9zaXRvcnk0Mjg4MzU3-flat-gsearch.cpp,540,547,7,983,987,4
1333021,https://htmlpreview.github.io/?https://github.com/Christina96/boilerplate-sample-matches/blob/main/Cpp-beta/caffe-MDEwOlJlcG9zaXRvcnk2MTg3MDgwMw==-flat-batch_norm_layer.cpp-snap-MDEwOlJlcG9zaXRvcnk0Mjg4MzU3-flat-memes.cpp.html,0.0851063829787234,9,caffe-MDEwOlJlcG9zaXRvcnk2MTg3MDgwMw==-flat-batch_norm_layer.cpp,snap-MDEwOlJlcG9zaXRvcnk0Mjg4MzU3-flat-memes.cpp,76,88,12,136,138,2
1334647,https://htmlpreview.github.io/?https://github.com/Christina96/boilerplate-sample-matches/blob/main/Cpp-beta/nano-node-MDEwOlJlcG9zaXRvcnkxOTM0NzM0MA==-flat-message_deserializer.hpp-tesseract-MDEwOlJlcG9zaXRvcnkyMjg4NzA5NA==-flat-capi.h.html,0.5919439579684763,18,nano-node-MDEwOlJlcG9zaXRvcnkxOTM0NzM0MA==-flat-message_deserializer.hpp,tesseract-MDEwOlJlcG9zaXRvcnkyMjg4NzA5NA==-flat-capi.h,15,32,17,221,234,13
1344583,https://htmlpreview.github.io/?https://github.com/Christina96/boilerplate-sample-matches/blob/main/Cpp-beta/tesseract-MDEwOlJlcG9zaXRvcnkyMjg4NzA5NA==-flat-equationdetect_test.cc-snap-MDEwOlJlcG9zaXRvcnk0Mjg4MzU3-flat-networkmp.h.html,0.07204610951008646,19,tesseract-MDEwOlJlcG9zaXRvcnkyMjg4NzA5NA==-flat-equationdetect_test.cc,snap-MDEwOlJlcG9zaXRvcnk0Mjg4MzU3-flat-networkmp.h,350,365,15,214,222,8
1349948,https://htmlpreview.github.io/?https://github.com/Christina96/boilerplate-sample-matches/blob/main/Cpp-beta/caffe-MDEwOlJlcG9zaXRvcnk2MTg3MDgwMw==-flat-data_transformer.hpp-tesseract-MDEwOlJlcG9zaXRvcnkyMjg4NzA5NA==-flat-recodebeam.cpp.html,0.09195402298850575,10,caffe-MDEwOlJlcG9zaXRvcnk2MTg3MDgwMw==-flat-data_transformer.hpp,tesseract-MDEwOlJlcG9zaXRvcnkyMjg4NzA5NA==-flat-recodebeam.cpp,91,93,2,988,994,6
1362702,https://htmlpreview.github.io/?https://github.com/Christina96/boilerplate-sample-matches/blob/main/Cpp-beta/caffe-MDEwOlJlcG9zaXRvcnk2MTg3MDgwMw==-flat-pooling_layer.cpp-notepad-plus-plus-MDEwOlJlcG9zaXRvcnkzMzAxNDgxMQ==-flat-NppCommands.cpp.html,0.06888499708114419,9,caffe-MDEwOlJlcG9zaXRvcnk2MTg3MDgwMw==-flat-pooling_layer.cpp,notepad-plus-plus-MDEwOlJlcG9zaXRvcnkzMzAxNDgxMQ==-flat-NppCommands.cpp,353,356,3,1821,1824,3
1369888,https://htmlpreview.github.io/?https://github.com/Christina96/boilerplate-sample-matches/blob/main/Cpp-beta/nano-node-MDEwOlJlcG9zaXRvcnkxOTM0NzM0MA==-flat-toml.cpp-tesseract-MDEwOlJlcG9zaXRvcnkyMjg4NzA5NA==-flat-strokewidth.cpp.html,0.03947832217130772,9,nano-node-MDEwOlJlcG9zaXRvcnkxOTM0NzM0MA==-flat-toml.cpp,tesseract-MDEwOlJlcG9zaXRvcnkyMjg4NzA5NA==-flat-strokewidth.cpp,760,769,9,1211,1215,4
1377950,https://htmlpreview.github.io/?https://github.com/Christina96/boilerplate-sample-matches/blob/main/Cpp-beta/snap-MDEwOlJlcG9zaXRvcnk0Mjg4MzU3-flat-ff.cpp-snap-MDEwOlJlcG9zaXRvcnk0Mjg4MzU3-flat-mmgraph-exp.h.html,0.0895800933125972,9,snap-MDEwOlJlcG9zaXRvcnk0Mjg4MzU3-flat-ff.cpp,snap-MDEwOlJlcG9zaXRvcnk0Mjg4MzU3-flat-mmgraph-exp.h,98,101,3,1109,1111,2
1381059,https://htmlpreview.github.io/?https://github.com/Christina96/boilerplate-sample-matches/blob/main/Cpp-beta/nano-node-MDEwOlJlcG9zaXRvcnkxOTM0NzM0MA==-flat-node_6.cpp-tesseract-MDEwOlJlcG9zaXRvcnkyMjg4NzA5NA==-flat-colpartition.cpp.html,0.1089125655335701,11,nano-node-MDEwOlJlcG9zaXRvcnkxOTM0NzM0MA==-flat-node_6.cpp,tesseract-MDEwOlJlcG9zaXRvcnkyMjg4NzA5NA==-flat-colpartition.cpp,475,481,6,346,351,5
1397410,https://htmlpreview.github.io/?https://github.com/Christina96/boilerplate-sample-matches/blob/main/Cpp-beta/nano-node-MDEwOlJlcG9zaXRvcnkxOTM0NzM0MA==-flat-bootstrap_bulk_push.hpp-snap-MDEwOlJlcG9zaXRvcnk0Mjg4MzU3-flat-email.cpp.html,0.022909507445589918,10,nano-node-MDEwOlJlcG9zaXRvcnkxOTM0NzM0MA==-flat-bootstrap_bulk_push.hpp,snap-MDEwOlJlcG9zaXRvcnk0Mjg4MzU3-flat-email.cpp,15,19,4,200,207,7
1410746,https://htmlpreview.github.io/?https://github.com/Christina96/boilerplate-sample-matches/blob/main/Cpp-beta/tesseract-MDEwOlJlcG9zaXRvcnkyMjg4NzA5NA==-flat-paragraphs.cpp-snap-MDEwOlJlcG9zaXRvcnk0Mjg4MzU3-flat-vizmap.cpp.html,0.1551668286362164,10,tesseract-MDEwOlJlcG9zaXRvcnkyMjg4NzA5NA==-flat-paragraphs.cpp,snap-MDEwOlJlcG9zaXRvcnk0Mjg4MzU3-flat-vizmap.cpp,1852,1855,3,448,451,3
1426413,https://htmlpreview.github.io/?https://github.com/Christina96/boilerplate-sample-matches/blob/main/Cpp-beta/notepad-plus-plus-MDEwOlJlcG9zaXRvcnkzMzAxNDgxMQ==-flat-ShortcutMapper.cpp-snap-MDEwOlJlcG9zaXRvcnk0Mjg4MzU3-flat-gsearch.cpp.html,0.131538962448448,11,notepad-plus-plus-MDEwOlJlcG9zaXRvcnkzMzAxNDgxMQ==-flat-ShortcutMapper.cpp,snap-MDEwOlJlcG9zaXRvcnk0Mjg4MzU3-flat-gsearch.cpp,81,88,7,1129,1135,6
1426598,https://htmlpreview.github.io/?https://github.com/Christina96/boilerplate-sample-matches/blob/main/Cpp-beta/nano-node-MDEwOlJlcG9zaXRvcnkxOTM0NzM0MA==-flat-cl_egl.h-notepad-plus-plus-MDEwOlJlcG9zaXRvcnkzMzAxNDgxMQ==-flat-Splitter.h.html,0.5148514851485149,9,nano-node-MDEwOlJlcG9zaXRvcnkxOTM0NzM0MA==-flat-cl_egl.h,notepad-plus-plus-MDEwOlJlcG9zaXRvcnkzMzAxNDgxMQ==-flat-Splitter.h,61,70,9,56,58,2
1465674,https://htmlpreview.github.io/?https://github.com/Christina96/boilerplate-sample-matches/blob/main/Cpp-beta/abseil-cpp-MDEwOlJlcG9zaXRvcnkxMDQyMzE1NDE=-flat-examples_test.cc-tesseract-MDEwOlJlcG9zaXRvcnkyMjg4NzA5NA==-flat-mastertrainer_test.cc.html,0.1404494382022472,9,abseil-cpp-MDEwOlJlcG9zaXRvcnkxMDQyMzE1NDE=-flat-examples_test.cc,tesseract-MDEwOlJlcG9zaXRvcnkyMjg4NzA5NA==-flat-mastertrainer_test.cc,31,37,6,132,135,3
1466237,https://htmlpreview.github.io/?https://github.com/Christina96/boilerplate-sample-matches/blob/main/Cpp-beta/notepad-plus-plus-MDEwOlJlcG9zaXRvcnkzMzAxNDgxMQ==-flat-Style.h-tesseract-MDEwOlJlcG9zaXRvcnkyMjg4NzA5NA==-flat-colpartitionset.h.html,0.14925373134328357,15,notepad-plus-plus-MDEwOlJlcG9zaXRvcnkzMzAxNDgxMQ==-flat-Style.h,tesseract-MDEwOlJlcG9zaXRvcnkyMjg4NzA5NA==-flat-colpartitionset.h,35,42,7,26,29,3
1497308,https://htmlpreview.github.io/?https://github.com/Christina96/boilerplate-sample-matches/blob/main/Cpp-beta/subconverter-MDEwOlJlcG9zaXRvcnkyMTg2ODY3NjM=-flat-quickjspp.hpp-caffe-MDEwOlJlcG9zaXRvcnk2MTg3MDgwMw==-flat-mkl_layers.hpp.html,0.012730744748567792,10,subconverter-MDEwOlJlcG9zaXRvcnkyMTg2ODY3NjM=-flat-quickjspp.hpp,caffe-MDEwOlJlcG9zaXRvcnk2MTg3MDgwMw==-flat-mkl_layers.hpp,26,27,1,24,26,2
1500649,https://htmlpreview.github.io/?https://github.com/Christina96/boilerplate-sample-matches/blob/main/Cpp-beta/snap-MDEwOlJlcG9zaXRvcnk0Mjg4MzU3-flat-svmPrLoqo.cpp-caffe-MDEwOlJlcG9zaXRvcnk2MTg3MDgwMw==-flat-sgd_solver.cpp.html,0.08343265792610251,9,snap-MDEwOlJlcG9zaXRvcnk0Mjg4MzU3-flat-svmPrLoqo.cpp,caffe-MDEwOlJlcG9zaXRvcnk2MTg3MDgwMw==-flat-sgd_solver.cpp,23,26,3,222,228,6
1514990,https://htmlpreview.github.io/?https://github.com/Christina96/boilerplate-sample-matches/blob/main/Cpp-beta/glm-MDEwOlJlcG9zaXRvcnk4NDM2MzE=-flat-type.hpp-caffe-MDEwOlJlcG9zaXRvcnk2MTg3MDgwMw==-flat-lstm_layer.hpp.html,0.7487179487179487,45,glm-MDEwOlJlcG9zaXRvcnk4NDM2MzE=-flat-type.hpp,caffe-MDEwOlJlcG9zaXRvcnk2MTg3MDgwMw==-flat-lstm_layer.hpp,23,70,47,41,50,9
1531333,https://htmlpreview.github.io/?https://github.com/Christina96/boilerplate-sample-matches/blob/main/Cpp-beta/subconverter-MDEwOlJlcG9zaXRvcnkyMTg2ODY3NjM=-flat-upload.cpp-abseil-cpp-MDEwOlJlcG9zaXRvcnkxMDQyMzE1NDE=-flat-civil_time_detail.h.html,0.07739307535641547,13,subconverter-MDEwOlJlcG9zaXRvcnkyMTg2ODY3NjM=-flat-upload.cpp,abseil-cpp-MDEwOlJlcG9zaXRvcnkxMDQyMzE1NDE=-flat-civil_time_detail.h,25,32,7,67,71,4
1568528,https://htmlpreview.github.io/?https://github.com/Christina96/boilerplate-sample-matches/blob/main/Cpp-beta/caffe-MDEwOlJlcG9zaXRvcnk2MTg3MDgwMw==-flat-lstm_layer.cpp-abseil-cpp-MDEwOlJlcG9zaXRvcnkxMDQyMzE1NDE=-flat-str_split_test.cc.html,0.20220588235294118,10,caffe-MDEwOlJlcG9zaXRvcnk2MTg3MDgwMw==-flat-lstm_layer.cpp,abseil-cpp-MDEwOlJlcG9zaXRvcnkxMDQyMzE1NDE=-flat-str_split_test.cc,96,103,7,290,300,10
1584757,https://htmlpreview.github.io/?https://github.com/Christina96/boilerplate-sample-matches/blob/main/Cpp-beta/snap-MDEwOlJlcG9zaXRvcnk0Mjg4MzU3-flat-conjgrad.h-caffe-MDEwOlJlcG9zaXRvcnk2MTg3MDgwMw==-flat-mlsl.hpp.html,0.1280120481927711,9,snap-MDEwOlJlcG9zaXRvcnk0Mjg4MzU3-flat-conjgrad.h,caffe-MDEwOlJlcG9zaXRvcnk2MTg3MDgwMw==-flat-mlsl.hpp,27,28,1,128,129,1
1612304,https://htmlpreview.github.io/?https://github.com/Christina96/boilerplate-sample-matches/blob/main/Cpp-beta/snap-MDEwOlJlcG9zaXRvcnk0Mjg4MzU3-flat-ggen.h-snap-MDEwOlJlcG9zaXRvcnk0Mjg4MzU3-flat-test-TDirNet.cpp.html,0.02629757785467128,9,snap-MDEwOlJlcG9zaXRvcnk0Mjg4MzU3-flat-ggen.h,snap-MDEwOlJlcG9zaXRvcnk0Mjg4MzU3-flat-test-TDirNet.cpp,150,153,3,254,260,6
1636062,https://htmlpreview.github.io/?https://github.com/Christina96/boilerplate-sample-matches/blob/main/Cpp-beta/nano-node-MDEwOlJlcG9zaXRvcnkxOTM0NzM0MA==-flat-ledger_walker.cpp-abseil-cpp-MDEwOlJlcG9zaXRvcnkxMDQyMzE1NDE=-flat-substitute_test.cc.html,0.03522504892367906,9,nano-node-MDEwOlJlcG9zaXRvcnkxOTM0NzM0MA==-flat-ledger_walker.cpp,abseil-cpp-MDEwOlJlcG9zaXRvcnkxMDQyMzE1NDE=-flat-substitute_test.cc,74,79,5,33,37,4
1662226,https://htmlpreview.github.io/?https://github.com/Christina96/boilerplate-sample-matches/blob/main/Cpp-beta/nano-node-MDEwOlJlcG9zaXRvcnkxOTM0NzM0MA==-flat-rpc_connection.hpp-caffe-MDEwOlJlcG9zaXRvcnk2MTg3MDgwMw==-flat-test_mkldnn_pooling_layer.cpp.html,0.03713527851458886,14,nano-node-MDEwOlJlcG9zaXRvcnkxOTM0NzM0MA==-flat-rpc_connection.hpp,caffe-MDEwOlJlcG9zaXRvcnk2MTg3MDgwMw==-flat-test_mkldnn_pooling_layer.cpp,22,26,4,28,37,9
1665529,https://htmlpreview.github.io/?https://github.com/Christina96/boilerplate-sample-matches/blob/main/Cpp-beta/nano-node-MDEwOlJlcG9zaXRvcnkxOTM0NzM0MA==-flat-ed25519-donna-portable-identify.h-tesseract-MDEwOlJlcG9zaXRvcnkyMjg4NzA5NA==-flat-linefind.h.html,0.9142857142857143,16,nano-node-MDEwOlJlcG9zaXRvcnkxOTM0NzM0MA==-flat-ed25519-donna-portable-identify.h,tesseract-MDEwOlJlcG9zaXRvcnkyMjg4NzA5NA==-flat-linefind.h,77,84,7,7,9,2
1671676,https://htmlpreview.github.io/?https://github.com/Christina96/boilerplate-sample-matches/blob/main/Cpp-beta/nano-node-MDEwOlJlcG9zaXRvcnkxOTM0NzM0MA==-flat-cli_53.cpp-notepad-plus-plus-MDEwOlJlcG9zaXRvcnkzMzAxNDgxMQ==-flat-concepts.hpp.html,0.07964033397559409,10,nano-node-MDEwOlJlcG9zaXRvcnkxOTM0NzM0MA==-flat-cli_53.cpp,notepad-plus-plus-MDEwOlJlcG9zaXRvcnkzMzAxNDgxMQ==-flat-concepts.hpp,35,37,2,415,430,15
1681902,https://htmlpreview.github.io/?https://github.com/Christina96/boilerplate-sample-matches/blob/main/Cpp-beta/caffe-MDEwOlJlcG9zaXRvcnk2MTg3MDgwMw==-flat-test_net_2.cpp-snap-MDEwOlJlcG9zaXRvcnk0Mjg4MzU3-flat-cmty.cpp.html,0.1787109375,9,caffe-MDEwOlJlcG9zaXRvcnk2MTg3MDgwMw==-flat-test_net_2.cpp,snap-MDEwOlJlcG9zaXRvcnk0Mjg4MzU3-flat-cmty.cpp,2719,2720,1,742,743,1
1697546,https://htmlpreview.github.io/?https://github.com/Christina96/boilerplate-sample-matches/blob/main/Cpp-beta/abseil-cpp-MDEwOlJlcG9zaXRvcnkxMDQyMzE1NDE=-flat-compressed_tuple_test.cc-caffe-MDEwOlJlcG9zaXRvcnk2MTg3MDgwMw==-flat-test_pooling_layer.cpp.html,0.11707317073170732,11,abseil-cpp-MDEwOlJlcG9zaXRvcnkxMDQyMzE1NDE=-flat-compressed_tuple_test.cc,caffe-MDEwOlJlcG9zaXRvcnk2MTg3MDgwMw==-flat-test_pooling_layer.cpp,57,64,7,819,826,7
1719428,https://htmlpreview.github.io/?https://github.com/Christina96/boilerplate-sample-matches/blob/main/Cpp-beta/tesseract-MDEwOlJlcG9zaXRvcnkyMjg4NzA5NA==-flat-validator.h-caffe-MDEwOlJlcG9zaXRvcnk2MTg3MDgwMw==-flat-gmock-internal-utils.h.html,0.23058823529411765,10,tesseract-MDEwOlJlcG9zaXRvcnkyMjg4NzA5NA==-flat-validator.h,caffe-MDEwOlJlcG9zaXRvcnk2MTg3MDgwMw==-flat-gmock-internal-utils.h,102,108,6,143,149,6
1723054,https://htmlpreview.github.io/?https://github.com/Christina96/boilerplate-sample-matches/blob/main/Cpp-beta/caffe-MDEwOlJlcG9zaXRvcnk2MTg3MDgwMw==-flat-test_convolution_layer.cpp-snap-MDEwOlJlcG9zaXRvcnk0Mjg4MzU3-flat-kronecker.cpp.html,0.16172965611167858,16,caffe-MDEwOlJlcG9zaXRvcnk2MTg3MDgwMw==-flat-test_convolution_layer.cpp,snap-MDEwOlJlcG9zaXRvcnk0Mjg4MzU3-flat-kronecker.cpp,533,547,14,1725,1731,6
1736020,https://htmlpreview.github.io/?https://github.com/Christina96/boilerplate-sample-matches/blob/main/Cpp-beta/abseil-cpp-MDEwOlJlcG9zaXRvcnkxMDQyMzE1NDE=-flat-chi_square.cc-tesseract-MDEwOlJlcG9zaXRvcnkyMjg4NzA5NA==-flat-kdtree.cpp.html,0.0578386605783866,9,abseil-cpp-MDEwOlJlcG9zaXRvcnkxMDQyMzE1NDE=-flat-chi_square.cc,tesseract-MDEwOlJlcG9zaXRvcnkyMjg4NzA5NA==-flat-kdtree.cpp,82,86,4,142,146,4
1742991,https://htmlpreview.github.io/?https://github.com/Christina96/boilerplate-sample-matches/blob/main/Cpp-beta/notepad-plus-plus-MDEwOlJlcG9zaXRvcnkzMzAxNDgxMQ==-flat-StyleContext.h-tesseract-MDEwOlJlcG9zaXRvcnkyMjg4NzA5NA==-flat-baseapi_test.cc.html,0.025412960609911054,10,notepad-plus-plus-MDEwOlJlcG9zaXRvcnkzMzAxNDgxMQ==-flat-StyleContext.h,tesseract-MDEwOlJlcG9zaXRvcnkyMjg4NzA5NA==-flat-baseapi_test.cc,72,77,5,270,274,4
1754305,https://htmlpreview.github.io/?https://github.com/Christina96/boilerplate-sample-matches/blob/main/Cpp-beta/notepad-plus-plus-MDEwOlJlcG9zaXRvcnkzMzAxNDgxMQ==-flat-PlatQt.h-caffe-MDEwOlJlcG9zaXRvcnk2MTg3MDgwMw==-flat-_caffe.cpp.html,0.028634361233480177,13,notepad-plus-plus-MDEwOlJlcG9zaXRvcnkzMzAxNDgxMQ==-flat-PlatQt.h,caffe-MDEwOlJlcG9zaXRvcnk2MTg3MDgwMw==-flat-_caffe.cpp,56,62,6,313,325,12
1758667,https://htmlpreview.github.io/?https://github.com/Christina96/boilerplate-sample-matches/blob/main/Cpp-beta/caffe-MDEwOlJlcG9zaXRvcnk2MTg3MDgwMw==-flat-mn_activation_layer.hpp-snap-MDEwOlJlcG9zaXRvcnk0Mjg4MzU3-flat-agmdirected.h.html,0.21254355400696864,67,caffe-MDEwOlJlcG9zaXRvcnk2MTg3MDgwMw==-flat-mn_activation_layer.hpp,snap-MDEwOlJlcG9zaXRvcnk0Mjg4MzU3-flat-agmdirected.h,22,34,12,59,64,5
1777299,https://htmlpreview.github.io/?https://github.com/Christina96/boilerplate-sample-matches/blob/main/Cpp-beta/nano-node-MDEwOlJlcG9zaXRvcnkxOTM0NzM0MA==-flat-active_transactions.hpp-snap-MDEwOlJlcG9zaXRvcnk0Mjg4MzU3-flat-ghash.h.html,0.32577665827036106,22,nano-node-MDEwOlJlcG9zaXRvcnkxOTM0NzM0MA==-flat-active_transactions.hpp,snap-MDEwOlJlcG9zaXRvcnk0Mjg4MzU3-flat-ghash.h,36,45,9,363,368,5
1780314,https://htmlpreview.github.io/?https://github.com/Christina96/boilerplate-sample-matches/blob/main/Cpp-beta/snap-MDEwOlJlcG9zaXRvcnk0Mjg4MzU3-flat-randwalk.h-snap-MDEwOlJlcG9zaXRvcnk0Mjg4MzU3-flat-semspace.cpp.html,0.07054337464251668,11,snap-MDEwOlJlcG9zaXRvcnk0Mjg4MzU3-flat-randwalk.h,snap-MDEwOlJlcG9zaXRvcnk0Mjg4MzU3-flat-semspace.cpp,28,30,2,18,20,2
1781017,https://htmlpreview.github.io/?https://github.com/Christina96/boilerplate-sample-matches/blob/main/Cpp-beta/abseil-cpp-MDEwOlJlcG9zaXRvcnkxMDQyMzE1NDE=-flat-mocking_bit_gen_test.cc-nano-node-MDEwOlJlcG9zaXRvcnkxOTM0NzM0MA==-flat-block_store.cpp.html,0.20771349862258953,10,abseil-cpp-MDEwOlJlcG9zaXRvcnkxMDQyMzE1NDE=-flat-mocking_bit_gen_test.cc,nano-node-MDEwOlJlcG9zaXRvcnkxOTM0NzM0MA==-flat-block_store.cpp,171,176,5,1188,1194,6
1783641,https://htmlpreview.github.io/?https://github.com/Christina96/boilerplate-sample-matches/blob/main/Cpp-beta/tesseract-MDEwOlJlcG9zaXRvcnkyMjg4NzA5NA==-flat-gap_map.h-nano-node-MDEwOlJlcG9zaXRvcnkxOTM0NzM0MA==-flat-hinted.hpp.html,0.3582089552238806,12,tesseract-MDEwOlJlcG9zaXRvcnkyMjg4NzA5NA==-flat-gap_map.h,nano-node-MDEwOlJlcG9zaXRvcnkxOTM0NzM0MA==-flat-hinted.hpp,12,22,10,26,26,0
1786467,https://htmlpreview.github.io/?https://github.com/Christina96/boilerplate-sample-matches/blob/main/Cpp-beta/abseil-cpp-MDEwOlJlcG9zaXRvcnkxMDQyMzE1NDE=-flat-nonsecure_base.h-abseil-cpp-MDEwOlJlcG9zaXRvcnkxMDQyMzE1NDE=-flat-hash.h.html,0.16974169741697417,10,abseil-cpp-MDEwOlJlcG9zaXRvcnkxMDQyMzE1NDE=-flat-nonsecure_base.h,abseil-cpp-MDEwOlJlcG9zaXRvcnkxMDQyMzE1NDE=-flat-hash.h,29,34,5,36,41,5
1788355,https://htmlpreview.github.io/?https://github.com/Christina96/boilerplate-sample-matches/blob/main/Cpp-beta/notepad-plus-plus-MDEwOlJlcG9zaXRvcnkzMzAxNDgxMQ==-flat-ScintillaCall.h-snap-MDEwOlJlcG9zaXRvcnk0Mjg4MzU3-flat-fl.h.html,0.32004089979550104,11,notepad-plus-plus-MDEwOlJlcG9zaXRvcnkzMzAxNDgxMQ==-flat-ScintillaCall.h,snap-MDEwOlJlcG9zaXRvcnk0Mjg4MzU3-flat-fl.h,286,301,15,310,317,7
1792768,https://htmlpreview.github.io/?https://github.com/Christina96/boilerplate-sample-matches/blob/main/Cpp-beta/nano-node-MDEwOlJlcG9zaXRvcnkxOTM0NzM0MA==-flat-backlog_population.cpp-snap-MDEwOlJlcG9zaXRvcnk0Mjg4MzU3-flat-yahooex.cpp.html,0.017110266159695818,9,nano-node-MDEwOlJlcG9zaXRvcnkxOTM0NzM0MA==-flat-backlog_population.cpp,snap-MDEwOlJlcG9zaXRvcnk0Mjg4MzU3-flat-yahooex.cpp,80,85,5,532,535,3
1795445,https://htmlpreview.github.io/?https://github.com/Christina96/boilerplate-sample-matches/blob/main/Cpp-beta/snap-MDEwOlJlcG9zaXRvcnk0Mjg4MzU3-flat-sir.cpp-snap-MDEwOlJlcG9zaXRvcnk0Mjg4MzU3-flat-ncp.cpp.html,0.16178067318132464,11,snap-MDEwOlJlcG9zaXRvcnk0Mjg4MzU3-flat-sir.cpp,snap-MDEwOlJlcG9zaXRvcnk0Mjg4MzU3-flat-ncp.cpp,149,155,6,989,991,2
1803067,https://htmlpreview.github.io/?https://github.com/Christina96/boilerplate-sample-matches/blob/main/Cpp-beta/subconverter-MDEwOlJlcG9zaXRvcnkyMTg2ODY3NjM=-flat-webget.cpp-notepad-plus-plus-MDEwOlJlcG9zaXRvcnkzMzAxNDgxMQ==-flat-FindReplaceDlg.h.html,0.016433853738701727,10,subconverter-MDEwOlJlcG9zaXRvcnkyMTg2ODY3NjM=-flat-webget.cpp,notepad-plus-plus-MDEwOlJlcG9zaXRvcnkzMzAxNDgxMQ==-flat-FindReplaceDlg.h,25,32,7,361,368,7
1816147,https://htmlpreview.github.io/?https://github.com/Christina96/boilerplate-sample-matches/blob/main/Cpp-beta/abseil-cpp-MDEwOlJlcG9zaXRvcnkxMDQyMzE1NDE=-flat-usage_config_test.cc-MMKV-MDEwOlJlcG9zaXRvcnkxNDkxMTE4MTM=-flat-libmmkv_python.cpp.html,0.1182108626198083,9,abseil-cpp-MDEwOlJlcG9zaXRvcnkxMDQyMzE1NDE=-flat-usage_config_test.cc,MMKV-MDEwOlJlcG9zaXRvcnkxNDkxMTE4MTM=-flat-libmmkv_python.cpp,59,68,9,224,241,17
1822587,https://htmlpreview.github.io/?https://github.com/Christina96/boilerplate-sample-matches/blob/main/Cpp-beta/caffe-MDEwOlJlcG9zaXRvcnk2MTg3MDgwMw==-flat-absval_layer.cpp-nano-node-MDEwOlJlcG9zaXRvcnkxOTM0NzM0MA==-flat-rep_weights.cpp.html,0.23841059602649006,9,caffe-MDEwOlJlcG9zaXRvcnk2MTg3MDgwMw==-flat-absval_layer.cpp,nano-node-MDEwOlJlcG9zaXRvcnkxOTM0NzM0MA==-flat-rep_weights.cpp,20,23,3,74,81,7
1824803,https://htmlpreview.github.io/?https://github.com/Christina96/boilerplate-sample-matches/blob/main/Cpp-beta/caffe-MDEwOlJlcG9zaXRvcnk2MTg3MDgwMw==-flat-test_detection.cpp-nano-node-MDEwOlJlcG9zaXRvcnkxOTM0NzM0MA==-flat-wallet.hpp.html,0.04721030042918455,13,caffe-MDEwOlJlcG9zaXRvcnk2MTg3MDgwMw==-flat-test_detection.cpp,nano-node-MDEwOlJlcG9zaXRvcnkxOTM0NzM0MA==-flat-wallet.hpp,170,180,10,99,108,9
1825918,https://htmlpreview.github.io/?https://github.com/Christina96/boilerplate-sample-matches/blob/main/Cpp-beta/notepad-plus-plus-MDEwOlJlcG9zaXRvcnkzMzAxNDgxMQ==-flat-CellBuffer.h-MMKV-MDEwOlJlcG9zaXRvcnkxNDkxMTE4MTM=-flat-native-bridge.cpp.html,0.0249609984399376,9,notepad-plus-plus-MDEwOlJlcG9zaXRvcnkzMzAxNDgxMQ==-flat-CellBuffer.h,MMKV-MDEwOlJlcG9zaXRvcnkxNDkxMTE4MTM=-flat-native-bridge.cpp,108,112,4,839,844,5
1839974,https://htmlpreview.github.io/?https://github.com/Christina96/boilerplate-sample-matches/blob/main/Cpp-beta/subconverter-MDEwOlJlcG9zaXRvcnkyMTg2ODY3NjM=-flat-subexport.h-caffe-MDEwOlJlcG9zaXRvcnk2MTg3MDgwMw==-flat-layer.hpp.html,0.2745762711864407,11,subconverter-MDEwOlJlcG9zaXRvcnkyMTg2ODY3NjM=-flat-subexport.h,caffe-MDEwOlJlcG9zaXRvcnk2MTg3MDgwMw==-flat-layer.hpp,31,34,3,253,256,3
1843545,https://htmlpreview.github.io/?https://github.com/Christina96/boilerplate-sample-matches/blob/main/Cpp-beta/tesseract-MDEwOlJlcG9zaXRvcnkyMjg4NzA5NA==-flat-pango_font_info.cpp-nano-node-MDEwOlJlcG9zaXRvcnkxOTM0NzM0MA==-flat-node_6.cpp.html,0.07239819004524888,10,tesseract-MDEwOlJlcG9zaXRvcnkyMjg4NzA5NA==-flat-pango_font_info.cpp,nano-node-MDEwOlJlcG9zaXRvcnkxOTM0NzM0MA==-flat-node_6.cpp,496,500,4,1436,1441,5
1856885,https://htmlpreview.github.io/?https://github.com/Christina96/boilerplate-sample-matches/blob/main/Cpp-beta/notepad-plus-plus-MDEwOlJlcG9zaXRvcnkzMzAxNDgxMQ==-flat-PlatWin.h-caffe-MDEwOlJlcG9zaXRvcnk2MTg3MDgwMw==-flat-im2col_layer.hpp.html,0.11173184357541899,10,notepad-plus-plus-MDEwOlJlcG9zaXRvcnkzMzAxNDgxMQ==-flat-PlatWin.h,caffe-MDEwOlJlcG9zaXRvcnk2MTg3MDgwMw==-flat-im2col_layer.hpp,25,32,7,12,14,2
1857913,https://htmlpreview.github.io/?https://github.com/Christina96/boilerplate-sample-matches/blob/main/Cpp-beta/snap-MDEwOlJlcG9zaXRvcnk0Mjg4MzU3-flat-mkcca.h-tesseract-MDEwOlJlcG9zaXRvcnkyMjg4NzA5NA==-flat-resultiterator.cpp.html,0.017905102954341987,10,snap-MDEwOlJlcG9zaXRvcnk0Mjg4MzU3-flat-mkcca.h,tesseract-MDEwOlJlcG9zaXRvcnkyMjg4NzA5NA==-flat-resultiterator.cpp,36,39,3,176,182,6
1862412,https://htmlpreview.github.io/?https://github.com/Christina96/boilerplate-sample-matches/blob/main/Cpp-beta/subconverter-MDEwOlJlcG9zaXRvcnkyMTg2ODY3NjM=-flat-webserver.cpp-caffe-MDEwOlJlcG9zaXRvcnk2MTg3MDgwMw==-flat-compareToolUtilities.h.html,0.023612750885478158,10,subconverter-MDEwOlJlcG9zaXRvcnkyMTg2ODY3NjM=-flat-webserver.cpp,caffe-MDEwOlJlcG9zaXRvcnk2MTg3MDgwMw==-flat-compareToolUtilities.h,63,72,9,100,107,7
1887765,https://htmlpreview.github.io/?https://github.com/Christina96/boilerplate-sample-matches/blob/main/Cpp-beta/tesseract-MDEwOlJlcG9zaXRvcnkyMjg4NzA5NA==-flat-validate_grapheme.cpp-snap-MDEwOlJlcG9zaXRvcnk0Mjg4MzU3-flat-mmgraph-exp.h.html,0.015691868758915834,13,tesseract-MDEwOlJlcG9zaXRvcnkyMjg4NzA5NA==-flat-validate_grapheme.cpp,snap-MDEwOlJlcG9zaXRvcnk0Mjg4MzU3-flat-mmgraph-exp.h,99,107,8,295,299,4
1900344,https://htmlpreview.github.io/?https://github.com/Christina96/boilerplate-sample-matches/blob/main/Cpp-beta/nano-node-MDEwOlJlcG9zaXRvcnkxOTM0NzM0MA==-flat-config.hpp-nano-node-MDEwOlJlcG9zaXRvcnkxOTM0NzM0MA==-flat-numbers.cpp.html,0.06526806526806526,9,nano-node-MDEwOlJlcG9zaXRvcnkxOTM0NzM0MA==-flat-config.hpp,nano-node-MDEwOlJlcG9zaXRvcnkxOTM0NzM0MA==-flat-numbers.cpp,123,125,2,633,636,3
1905903,https://htmlpreview.github.io/?https://github.com/Christina96/boilerplate-sample-matches/blob/main/Cpp-beta/caffe-MDEwOlJlcG9zaXRvcnk2MTg3MDgwMw==-flat-test_stochastic_pooling.cpp-abseil-cpp-MDEwOlJlcG9zaXRvcnkxMDQyMzE1NDE=-flat-cord_rep_btree_navigator_test.cc.html,0.1276595744680851,9,caffe-MDEwOlJlcG9zaXRvcnk2MTg3MDgwMw==-flat-test_stochastic_pooling.cpp,abseil-cpp-MDEwOlJlcG9zaXRvcnkxMDQyMzE1NDE=-flat-cord_rep_btree_navigator_test.cc,84,86,2,151,153,2
1939882,https://htmlpreview.github.io/?https://github.com/Christina96/boilerplate-sample-matches/blob/main/Cpp-beta/caffe-MDEwOlJlcG9zaXRvcnk2MTg3MDgwMw==-flat-test_deconvolution3d_layer.cpp-snap-MDEwOlJlcG9zaXRvcnk0Mjg4MzU3-flat-test-TUndirNet.cpp.html,0.09146681539319576,10,caffe-MDEwOlJlcG9zaXRvcnk2MTg3MDgwMw==-flat-test_deconvolution3d_layer.cpp,snap-MDEwOlJlcG9zaXRvcnk0Mjg4MzU3-flat-test-TUndirNet.cpp,207,215,8,100,109,9
1965762,https://htmlpreview.github.io/?https://github.com/Christina96/boilerplate-sample-matches/blob/main/Cpp-beta/abseil-cpp-MDEwOlJlcG9zaXRvcnkxMDQyMzE1NDE=-flat-randen_hwaes.cc-snap-MDEwOlJlcG9zaXRvcnk0Mjg4MzU3-flat-networkmp.h.html,0.05523101433882103,10,abseil-cpp-MDEwOlJlcG9zaXRvcnkxMDQyMzE1NDE=-flat-randen_hwaes.cc,snap-MDEwOlJlcG9zaXRvcnk0Mjg4MzU3-flat-networkmp.h,113,116,3,247,249,2
1978387,https://htmlpreview.github.io/?https://github.com/Christina96/boilerplate-sample-matches/blob/main/Cpp-beta/caffe-MDEwOlJlcG9zaXRvcnk2MTg3MDgwMw==-flat-xbyak_util.h-nano-node-MDEwOlJlcG9zaXRvcnkxOTM0NzM0MA==-flat-cl_gl.h.html,0.41304347826086957,19,caffe-MDEwOlJlcG9zaXRvcnk2MTg3MDgwMw==-flat-xbyak_util.h,nano-node-MDEwOlJlcG9zaXRvcnkxOTM0NzM0MA==-flat-cl_gl.h,9,19,10,11,42,31
1989411,https://htmlpreview.github.io/?https://github.com/Christina96/boilerplate-sample-matches/blob/main/Cpp-beta/notepad-plus-plus-MDEwOlJlcG9zaXRvcnkzMzAxNDgxMQ==-flat-AutoComplete.h-snap-MDEwOlJlcG9zaXRvcnk0Mjg4MzU3-flat-ds.h.html,0.18043478260869567,19,notepad-plus-plus-MDEwOlJlcG9zaXRvcnkzMzAxNDgxMQ==-flat-AutoComplete.h,snap-MDEwOlJlcG9zaXRvcnk0Mjg4MzU3-flat-ds.h,42,50,8,144,162,18
2018006,https://htmlpreview.github.io/?https://github.com/Christina96/boilerplate-sample-matches/blob/main/Cpp-beta/tesseract-MDEwOlJlcG9zaXRvcnkyMjg4NzA5NA==-flat-bitvector.cpp-snap-MDEwOlJlcG9zaXRvcnk0Mjg4MzU3-flat-gsearch.cpp.html,0.040012702445220705,12,tesseract-MDEwOlJlcG9zaXRvcnkyMjg4NzA5NA==-flat-bitvector.cpp,snap-MDEwOlJlcG9zaXRvcnk0Mjg4MzU3-flat-gsearch.cpp,134,137,3,186,192,6
2028294,https://htmlpreview.github.io/?https://github.com/Christina96/boilerplate-sample-matches/blob/main/Cpp-beta/notepad-plus-plus-MDEwOlJlcG9zaXRvcnkzMzAxNDgxMQ==-flat-ScintillaEditView.cpp-snap-MDEwOlJlcG9zaXRvcnk0Mjg4MzU3-flat-table.cpp.html,0.09490533842528642,9,notepad-plus-plus-MDEwOlJlcG9zaXRvcnkzMzAxNDgxMQ==-flat-ScintillaEditView.cpp,snap-MDEwOlJlcG9zaXRvcnk0Mjg4MzU3-flat-table.cpp,605,608,3,465,468,3
2038949,https://htmlpreview.github.io/?https://github.com/Christina96/boilerplate-sample-matches/blob/main/Cpp-beta/caffe-MDEwOlJlcG9zaXRvcnk2MTg3MDgwMw==-flat-test_mkldnn_convolution_layer.cpp-snap-MDEwOlJlcG9zaXRvcnk0Mjg4MzU3-flat-sch.cpp.html,0.11961879723956621,9,caffe-MDEwOlJlcG9zaXRvcnk2MTg3MDgwMw==-flat-test_mkldnn_convolution_layer.cpp,snap-MDEwOlJlcG9zaXRvcnk0Mjg4MzU3-flat-sch.cpp,713,715,2,447,449,2
2044238,https://htmlpreview.github.io/?https://github.com/Christina96/boilerplate-sample-matches/blob/main/Cpp-beta/snap-MDEwOlJlcG9zaXRvcnk0Mjg4MzU3-flat-util.h-tesseract-MDEwOlJlcG9zaXRvcnkyMjg4NzA5NA==-flat-pithsync.cpp.html,0.1963302752293578,10,snap-MDEwOlJlcG9zaXRvcnk0Mjg4MzU3-flat-util.h,tesseract-MDEwOlJlcG9zaXRvcnkyMjg4NzA5NA==-flat-pithsync.cpp,27,28,1,254,263,9
2053033,https://htmlpreview.github.io/?https://github.com/Christina96/boilerplate-sample-matches/blob/main/Cpp-beta/Cpp_Primer_Answers-MDEwOlJlcG9zaXRvcnk0NzE3MDI2MQ==-flat-exercise13_53.h-caffe-MDEwOlJlcG9zaXRvcnk2MTg3MDgwMw==-flat-eval_detection_layer.hpp.html,0.23376623376623376,9,Cpp_Primer_Answers-MDEwOlJlcG9zaXRvcnk0NzE3MDI2MQ==-flat-exercise13_53.h,caffe-MDEwOlJlcG9zaXRvcnk2MTg3MDgwMw==-flat-eval_detection_layer.hpp,9,15,6,13,14,1
2063075,https://htmlpreview.github.io/?https://github.com/Christina96/boilerplate-sample-matches/blob/main/Cpp-beta/tesseract-MDEwOlJlcG9zaXRvcnkyMjg4NzA5NA==-flat-outlines.cpp-notepad-plus-plus-MDEwOlJlcG9zaXRvcnkzMzAxNDgxMQ==-flat-DockingCont.h.html,0.08135593220338982,12,tesseract-MDEwOlJlcG9zaXRvcnkyMjg4NzA5NA==-flat-outlines.cpp,notepad-plus-plus-MDEwOlJlcG9zaXRvcnkzMzAxNDgxMQ==-flat-DockingCont.h,4,11,7,113,119,6
2082120,https://htmlpreview.github.io/?https://github.com/Christina96/boilerplate-sample-matches/blob/main/Cpp-beta/abseil-cpp-MDEwOlJlcG9zaXRvcnkxMDQyMzE1NDE=-flat-pcg_engine_test.cc-snap-MDEwOlJlcG9zaXRvcnk0Mjg4MzU3-flat-hysgen.cpp.html,0.03153745072273324,9,abseil-cpp-MDEwOlJlcG9zaXRvcnkxMDQyMzE1NDE=-flat-pcg_engine_test.cc,snap-MDEwOlJlcG9zaXRvcnk0Mjg4MzU3-flat-hysgen.cpp,83,91,8,925,927,2
2095017,https://htmlpreview.github.io/?https://github.com/Christina96/boilerplate-sample-matches/blob/main/Cpp-beta/caffe-MDEwOlJlcG9zaXRvcnk2MTg3MDgwMw==-flat-test_math_functions.cpp-nano-node-MDEwOlJlcG9zaXRvcnkxOTM0NzM0MA==-flat-bootstrap.cpp.html,0.025460636515912898,9,caffe-MDEwOlJlcG9zaXRvcnk2MTg3MDgwMw==-flat-test_math_functions.cpp,nano-node-MDEwOlJlcG9zaXRvcnkxOTM0NzM0MA==-flat-bootstrap.cpp,80,83,3,177,181,4
2123128,https://htmlpreview.github.io/?https://github.com/Christina96/boilerplate-sample-matches/blob/main/Cpp-beta/glm-MDEwOlJlcG9zaXRvcnk4NDM2MzE=-flat-type_mat2x2.hpp-snap-MDEwOlJlcG9zaXRvcnk0Mjg4MzU3-flat-memenet.h.html,0.13411078717201166,12,glm-MDEwOlJlcG9zaXRvcnk4NDM2MzE=-flat-type_mat2x2.hpp,snap-MDEwOlJlcG9zaXRvcnk0Mjg4MzU3-flat-memenet.h,63,74,11,33,36,3
2126862,https://htmlpreview.github.io/?https://github.com/Christina96/boilerplate-sample-matches/blob/main/Cpp-beta/snap-MDEwOlJlcG9zaXRvcnk0Mjg4MzU3-flat-test-TAttr.cpp-snap-MDEwOlJlcG9zaXRvcnk0Mjg4MzU3-flat-test-TDirNet.cpp.html,0.6419753086419753,11,snap-MDEwOlJlcG9zaXRvcnk0Mjg4MzU3-flat-test-TAttr.cpp,snap-MDEwOlJlcG9zaXRvcnk0Mjg4MzU3-flat-test-TDirNet.cpp,532,542,10,737,747,10
2156800,https://htmlpreview.github.io/?https://github.com/Christina96/boilerplate-sample-matches/blob/main/Cpp-beta/tesseract-MDEwOlJlcG9zaXRvcnkyMjg4NzA5NA==-flat-validate_khmer_test.cc-caffe-MDEwOlJlcG9zaXRvcnk2MTg3MDgwMw==-flat-mkldnn_lrn_layer.cpp.html,0.03837953091684435,9,tesseract-MDEwOlJlcG9zaXRvcnkyMjg4NzA5NA==-flat-validate_khmer_test.cc,caffe-MDEwOlJlcG9zaXRvcnk2MTg3MDgwMw==-flat-mkldnn_lrn_layer.cpp,17,25,8,36,38,2
2186288,https://htmlpreview.github.io/?https://github.com/Christina96/boilerplate-sample-matches/blob/main/Cpp-beta/caffe-MDEwOlJlcG9zaXRvcnk2MTg3MDgwMw==-flat-lstm_unit_layer.cpp-caffe-MDEwOlJlcG9zaXRvcnk2MTg3MDgwMw==-flat-test_eltwise_layer.cpp.html,0.2532188841201717,19,caffe-MDEwOlJlcG9zaXRvcnk2MTg3MDgwMw==-flat-lstm_unit_layer.cpp,caffe-MDEwOlJlcG9zaXRvcnk2MTg3MDgwMw==-flat-test_eltwise_layer.cpp,40,45,5,85,90,5
2186649,https://htmlpreview.github.io/?https://github.com/Christina96/boilerplate-sample-matches/blob/main/Cpp-beta/tesseract-MDEwOlJlcG9zaXRvcnkyMjg4NzA5NA==-flat-tablefind.cpp-snap-MDEwOlJlcG9zaXRvcnk0Mjg4MzU3-flat-mmnet.cpp.html,0.1276595744680851,10,tesseract-MDEwOlJlcG9zaXRvcnkyMjg4NzA5NA==-flat-tablefind.cpp,snap-MDEwOlJlcG9zaXRvcnk0Mjg4MzU3-flat-mmnet.cpp,610,615,5,598,603,5
2202411,https://htmlpreview.github.io/?https://github.com/Christina96/boilerplate-sample-matches/blob/main/Cpp-beta/caffe-MDEwOlJlcG9zaXRvcnk2MTg3MDgwMw==-flat-classification.cpp-snap-MDEwOlJlcG9zaXRvcnk0Mjg4MzU3-flat-lsionto.cpp.html,0.0912751677852349,9,caffe-MDEwOlJlcG9zaXRvcnk2MTg3MDgwMw==-flat-classification.cpp,snap-MDEwOlJlcG9zaXRvcnk0Mjg4MzU3-flat-lsionto.cpp,38,48,10,396,399,3
2213154,https://htmlpreview.github.io/?https://github.com/Christina96/boilerplate-sample-matches/blob/main/Cpp-beta/caffe-MDEwOlJlcG9zaXRvcnk2MTg3MDgwMw==-flat-gtest-filepath.h-nano-node-MDEwOlJlcG9zaXRvcnkxOTM0NzM0MA==-flat-confirmation_height_unbounded.cpp.html,0.030303030303030304,9,caffe-MDEwOlJlcG9zaXRvcnk2MTg3MDgwMw==-flat-gtest-filepath.h,nano-node-MDEwOlJlcG9zaXRvcnkxOTM0NzM0MA==-flat-confirmation_height_unbounded.cpp,23,31,8,8,8,0
2214777,https://htmlpreview.github.io/?https://github.com/Christina96/boilerplate-sample-matches/blob/main/Cpp-beta/nano-node-MDEwOlJlcG9zaXRvcnkxOTM0NzM0MA==-flat-frontier_store.hpp-caffe-MDEwOlJlcG9zaXRvcnk2MTg3MDgwMw==-flat-memory_data_layer.hpp.html,0.7874015748031497,20,nano-node-MDEwOlJlcG9zaXRvcnkxOTM0NzM0MA==-flat-frontier_store.hpp,caffe-MDEwOlJlcG9zaXRvcnk2MTg3MDgwMw==-flat-memory_data_layer.hpp,16,21,5,31,41,10
2242628,https://htmlpreview.github.io/?https://github.com/Christina96/boilerplate-sample-matches/blob/main/Cpp-beta/caffe-MDEwOlJlcG9zaXRvcnk2MTg3MDgwMw==-flat-test_lrn_layer.cpp-snap-MDEwOlJlcG9zaXRvcnk0Mjg4MzU3-flat-kronecker.cpp.html,0.11974623314829501,9,caffe-MDEwOlJlcG9zaXRvcnk2MTg3MDgwMw==-flat-test_lrn_layer.cpp,snap-MDEwOlJlcG9zaXRvcnk0Mjg4MzU3-flat-kronecker.cpp,271,273,2,147,149,2
2242702,https://htmlpreview.github.io/?https://github.com/Christina96/boilerplate-sample-matches/blob/main/Cpp-beta/nano-node-MDEwOlJlcG9zaXRvcnkxOTM0NzM0MA==-flat-network.cpp-tesseract-MDEwOlJlcG9zaXRvcnkyMjg4NzA5NA==-flat-colpartitiongrid.cpp.html,0.09964216900633086,10,nano-node-MDEwOlJlcG9zaXRvcnkxOTM0NzM0MA==-flat-network.cpp,tesseract-MDEwOlJlcG9zaXRvcnkyMjg4NzA5NA==-flat-colpartitiongrid.cpp,1030,1037,7,1256,1258,2
2246996,https://htmlpreview.github.io/?https://github.com/Christina96/boilerplate-sample-matches/blob/main/Cpp-beta/notepad-plus-plus-MDEwOlJlcG9zaXRvcnkzMzAxNDgxMQ==-flat-SplitterContainer.h-snap-MDEwOlJlcG9zaXRvcnk0Mjg4MzU3-flat-bfs-hybrid.h.html,0.2140845070422535,15,notepad-plus-plus-MDEwOlJlcG9zaXRvcnkzMzAxNDgxMQ==-flat-SplitterContainer.h,snap-MDEwOlJlcG9zaXRvcnk0Mjg4MzU3-flat-bfs-hybrid.h,45,47,2,10,14,4
2254311,https://htmlpreview.github.io/?https://github.com/Christina96/boilerplate-sample-matches/blob/main/Cpp-beta/tesseract-MDEwOlJlcG9zaXRvcnkyMjg4NzA5NA==-flat-dict.cpp-MMKV-MDEwOlJlcG9zaXRvcnkxNDkxMTE4MTM=-flat-MMKV.cpp.html,0.033209081667231445,10,tesseract-MDEwOlJlcG9zaXRvcnkyMjg4NzA5NA==-flat-dict.cpp,MMKV-MDEwOlJlcG9zaXRvcnkxNDkxMTE4MTM=-flat-MMKV.cpp,589,593,4,1185,1190,5
2256733,https://htmlpreview.github.io/?https://github.com/Christina96/boilerplate-sample-matches/blob/main/Cpp-beta/abseil-cpp-MDEwOlJlcG9zaXRvcnkxMDQyMzE1NDE=-flat-tzfile.h-tesseract-MDEwOlJlcG9zaXRvcnkyMjg4NzA5NA==-flat-equationdetect.h.html,0.65625,42,abseil-cpp-MDEwOlJlcG9zaXRvcnkxMDQyMzE1NDE=-flat-tzfile.h,tesseract-MDEwOlJlcG9zaXRvcnkyMjg4NzA5NA==-flat-equationdetect.h,14,22,8,24,58,34
2274493,https://htmlpreview.github.io/?https://github.com/Christina96/boilerplate-sample-matches/blob/main/Cpp-beta/nano-node-MDEwOlJlcG9zaXRvcnkxOTM0NzM0MA==-flat-blockprocessor.hpp-tesseract-MDEwOlJlcG9zaXRvcnkyMjg4NzA5NA==-flat-recodebeam.cpp.html,0.08793686583990981,12,nano-node-MDEwOlJlcG9zaXRvcnkxOTM0NzM0MA==-flat-blockprocessor.hpp,tesseract-MDEwOlJlcG9zaXRvcnkyMjg4NzA5NA==-flat-recodebeam.cpp,36,40,4,1009,1012,3
2277539,https://htmlpreview.github.io/?https://github.com/Christina96/boilerplate-sample-matches/blob/main/Cpp-beta/tesseract-MDEwOlJlcG9zaXRvcnkyMjg4NzA5NA==-flat-superscript.cpp-abseil-cpp-MDEwOlJlcG9zaXRvcnkxMDQyMzE1NDE=-flat-time_zone_format.cc.html,0.09872434830837493,13,tesseract-MDEwOlJlcG9zaXRvcnkyMjg4NzA5NA==-flat-superscript.cpp,abseil-cpp-MDEwOlJlcG9zaXRvcnkxMDQyMzE1NDE=-flat-time_zone_format.cc,35,40,5,551,558,7
2298239,https://htmlpreview.github.io/?https://github.com/Christina96/boilerplate-sample-matches/blob/main/Cpp-beta/nano-node-MDEwOlJlcG9zaXRvcnkxOTM0NzM0MA==-flat-block_store_86.cpp-notepad-plus-plus-MDEwOlJlcG9zaXRvcnkzMzAxNDgxMQ==-flat-Buffer.cpp.html,0.047769265434880574,10,nano-node-MDEwOlJlcG9zaXRvcnkxOTM0NzM0MA==-flat-block_store_86.cpp,notepad-plus-plus-MDEwOlJlcG9zaXRvcnkzMzAxNDgxMQ==-flat-Buffer.cpp,82,90,8,108,115,7
2298963,https://htmlpreview.github.io/?https://github.com/Christina96/boilerplate-sample-matches/blob/main/Cpp-beta/caffe-MDEwOlJlcG9zaXRvcnk2MTg3MDgwMw==-flat-test_tile_layer.cpp-abseil-cpp-MDEwOlJlcG9zaXRvcnkxMDQyMzE1NDE=-flat-cord_rep_btree_navigator_test.cc.html,0.22792022792022792,10,caffe-MDEwOlJlcG9zaXRvcnk2MTg3MDgwMw==-flat-test_tile_layer.cpp,abseil-cpp-MDEwOlJlcG9zaXRvcnkxMDQyMzE1NDE=-flat-cord_rep_btree_navigator_test.cc,71,75,4,156,161,5
2310875,https://htmlpreview.github.io/?https://github.com/Christina96/boilerplate-sample-matches/blob/main/Cpp-beta/tesseract-MDEwOlJlcG9zaXRvcnkyMjg4NzA5NA==-flat-blobs.cpp-notepad-plus-plus-MDEwOlJlcG9zaXRvcnkzMzAxNDgxMQ==-flat-basic_regex_parser.hpp.html,0.02371721778791334,9,tesseract-MDEwOlJlcG9zaXRvcnkyMjg4NzA5NA==-flat-blobs.cpp,notepad-plus-plus-MDEwOlJlcG9zaXRvcnkzMzAxNDgxMQ==-flat-basic_regex_parser.hpp,458,462,4,30,31,1
2312446,https://htmlpreview.github.io/?https://github.com/Christina96/boilerplate-sample-matches/blob/main/Cpp-beta/nano-node-MDEwOlJlcG9zaXRvcnkxOTM0NzM0MA==-flat-common_40.cpp-caffe-MDEwOlJlcG9zaXRvcnk2MTg3MDgwMw==-flat-xbyak.h.html,0.018685121107266434,9,nano-node-MDEwOlJlcG9zaXRvcnkxOTM0NzM0MA==-flat-common_40.cpp,caffe-MDEwOlJlcG9zaXRvcnk2MTg3MDgwMw==-flat-xbyak.h,46,51,5,326,330,4
2320481,https://htmlpreview.github.io/?https://github.com/Christina96/boilerplate-sample-matches/blob/main/Cpp-beta/caffe-MDEwOlJlcG9zaXRvcnk2MTg3MDgwMw==-flat-lrn_layer.hpp-subconverter-MDEwOlJlcG9zaXRvcnkyMTg2ODY3NjM=-flat-subexport.cpp.html,0.07336050389032975,11,caffe-MDEwOlJlcG9zaXRvcnk2MTg3MDgwMw==-flat-lrn_layer.hpp,subconverter-MDEwOlJlcG9zaXRvcnkyMTg2ODY3NjM=-flat-subexport.cpp,32,34,2,28,30,2
2325732,https://htmlpreview.github.io/?https://github.com/Christina96/boilerplate-sample-matches/blob/main/Cpp-beta/nano-node-MDEwOlJlcG9zaXRvcnkxOTM0NzM0MA==-flat-walletconfig.hpp-snap-MDEwOlJlcG9zaXRvcnk0Mjg4MzU3-flat-gsvd.h.html,0.19402985074626866,13,nano-node-MDEwOlJlcG9zaXRvcnkxOTM0NzM0MA==-flat-walletconfig.hpp,snap-MDEwOlJlcG9zaXRvcnk0Mjg4MzU3-flat-gsvd.h,12,16,4,11,13,2
2338836,https://htmlpreview.github.io/?https://github.com/Christina96/boilerplate-sample-matches/blob/main/Cpp-beta/nano-node-MDEwOlJlcG9zaXRvcnkxOTM0NzM0MA==-flat-bootstrap_attempt.cpp-caffe-MDEwOlJlcG9zaXRvcnk2MTg3MDgwMw==-flat-common.cpp.html,0.05701754385964912,13,nano-node-MDEwOlJlcG9zaXRvcnkxOTM0NzM0MA==-flat-bootstrap_attempt.cpp,caffe-MDEwOlJlcG9zaXRvcnk2MTg3MDgwMw==-flat-common.cpp,95,106,11,224,239,15
2365651,https://htmlpreview.github.io/?https://github.com/Christina96/boilerplate-sample-matches/blob/main/Cpp-beta/abseil-cpp-MDEwOlJlcG9zaXRvcnkxMDQyMzE1NDE=-flat-log_entry_test.cc-notepad-plus-plus-MDEwOlJlcG9zaXRvcnkzMzAxNDgxMQ==-flat-ProjectPanel.cpp.html,0.07650273224043716,9,abseil-cpp-MDEwOlJlcG9zaXRvcnkxMDQyMzE1NDE=-flat-log_entry_test.cc,notepad-plus-plus-MDEwOlJlcG9zaXRvcnkzMzAxNDgxMQ==-flat-ProjectPanel.cpp,265,276,11,235,242,7
2369388,https://htmlpreview.github.io/?https://github.com/Christina96/boilerplate-sample-matches/blob/main/Cpp-beta/notepad-plus-plus-MDEwOlJlcG9zaXRvcnkzMzAxNDgxMQ==-flat-FindCharsInRange.h-caffe-MDEwOlJlcG9zaXRvcnk2MTg3MDgwMw==-flat-test_lrn_layer.cpp.html,0.08469945355191257,21,notepad-plus-plus-MDEwOlJlcG9zaXRvcnkzMzAxNDgxMQ==-flat-FindCharsInRange.h,caffe-MDEwOlJlcG9zaXRvcnk2MTg3MDgwMw==-flat-test_lrn_layer.cpp,26,29,3,35,42,7
2371502,https://htmlpreview.github.io/?https://github.com/Christina96/boilerplate-sample-matches/blob/main/Cpp-beta/abseil-cpp-MDEwOlJlcG9zaXRvcnkxMDQyMzE1NDE=-flat-compressed_tuple_test.cc-nano-node-MDEwOlJlcG9zaXRvcnkxOTM0NzM0MA==-flat-node.cpp.html,0.08217446270543616,9,abseil-cpp-MDEwOlJlcG9zaXRvcnkxMDQyMzE1NDE=-flat-compressed_tuple_test.cc,nano-node-MDEwOlJlcG9zaXRvcnkxOTM0NzM0MA==-flat-node.cpp,241,247,6,484,489,5
2381868,https://htmlpreview.github.io/?https://github.com/Christina96/boilerplate-sample-matches/blob/main/Cpp-beta/abseil-cpp-MDEwOlJlcG9zaXRvcnkxMDQyMzE1NDE=-flat-str_cat_test.cc-tesseract-MDEwOlJlcG9zaXRvcnkyMjg4NzA5NA==-flat-control.cpp.html,0.033401499659168374,10,abseil-cpp-MDEwOlJlcG9zaXRvcnkxMDQyMzE1NDE=-flat-str_cat_test.cc,tesseract-MDEwOlJlcG9zaXRvcnkyMjg4NzA5NA==-flat-control.cpp,342,354,12,743,749,6
2387255,https://htmlpreview.github.io/?https://github.com/Christina96/boilerplate-sample-matches/blob/main/Cpp-beta/caffe-MDEwOlJlcG9zaXRvcnk2MTg3MDgwMw==-flat-test_engine_selection.cpp-nano-node-MDEwOlJlcG9zaXRvcnkxOTM0NzM0MA==-flat-nodeconfig.cpp.html,0.08905380333951762,9,caffe-MDEwOlJlcG9zaXRvcnk2MTg3MDgwMw==-flat-test_engine_selection.cpp,nano-node-MDEwOlJlcG9zaXRvcnkxOTM0NzM0MA==-flat-nodeconfig.cpp,184,187,3,15,17,2
2389885,https://htmlpreview.github.io/?https://github.com/Christina96/boilerplate-sample-matches/blob/main/Cpp-beta/abseil-cpp-MDEwOlJlcG9zaXRvcnkxMDQyMzE1NDE=-flat-ostringstream_benchmark.cc-tesseract-MDEwOlJlcG9zaXRvcnkyMjg4NzA5NA==-flat-openclwrapper.cpp.html,0.01652892561983471,10,abseil-cpp-MDEwOlJlcG9zaXRvcnkxMDQyMzE1NDE=-flat-ostringstream_benchmark.cc,tesseract-MDEwOlJlcG9zaXRvcnkyMjg4NzA5NA==-flat-openclwrapper.cpp,33,39,6,83,92,9
2392475,https://htmlpreview.github.io/?https://github.com/Christina96/boilerplate-sample-matches/blob/main/Cpp-beta/caffe-MDEwOlJlcG9zaXRvcnk2MTg3MDgwMw==-flat-test_softmax_layer.cpp-abseil-cpp-MDEwOlJlcG9zaXRvcnkxMDQyMzE1NDE=-flat-charconv_bigint_test.cc.html,0.04576659038901602,10,caffe-MDEwOlJlcG9zaXRvcnk2MTg3MDgwMw==-flat-test_softmax_layer.cpp,abseil-cpp-MDEwOlJlcG9zaXRvcnkxMDQyMzE1NDE=-flat-charconv_bigint_test.cc,62,69,7,126,138,12
2399406,https://htmlpreview.github.io/?https://github.com/Christina96/boilerplate-sample-matches/blob/main/Cpp-beta/snap-MDEwOlJlcG9zaXRvcnk0Mjg4MzU3-flat-ssqldm.cpp-snap-MDEwOlJlcG9zaXRvcnk0Mjg4MzU3-flat-table.h.html,0.042647466075879256,9,snap-MDEwOlJlcG9zaXRvcnk0Mjg4MzU3-flat-ssqldm.cpp,snap-MDEwOlJlcG9zaXRvcnk0Mjg4MzU3-flat-table.h,336,341,5,427,430,3
2407545,https://htmlpreview.github.io/?https://github.com/Christina96/boilerplate-sample-matches/blob/main/Cpp-beta/nano-node-MDEwOlJlcG9zaXRvcnkxOTM0NzM0MA==-flat-asio.hpp-snap-MDEwOlJlcG9zaXRvcnk0Mjg4MzU3-flat-cascnetinf.cpp.html,0.04290091930541369,12,nano-node-MDEwOlJlcG9zaXRvcnkxOTM0NzM0MA==-flat-asio.hpp,snap-MDEwOlJlcG9zaXRvcnk0Mjg4MzU3-flat-cascnetinf.cpp,8,13,5,96,100,4
2415249,https://htmlpreview.github.io/?https://github.com/Christina96/boilerplate-sample-matches/blob/main/Cpp-beta/abseil-cpp-MDEwOlJlcG9zaXRvcnkxMDQyMzE1NDE=-flat-compressed_tuple_test.cc-nano-node-MDEwOlJlcG9zaXRvcnkxOTM0NzM0MA==-flat-active_transactions.cpp.html,0.18360655737704917,13,abseil-cpp-MDEwOlJlcG9zaXRvcnkxMDQyMzE1NDE=-flat-compressed_tuple_test.cc,nano-node-MDEwOlJlcG9zaXRvcnkxOTM0NzM0MA==-flat-active_transactions.cpp,56,64,8,490,504,14
2416147,https://htmlpreview.github.io/?https://github.com/Christina96/boilerplate-sample-matches/blob/main/Cpp-beta/tesseract-MDEwOlJlcG9zaXRvcnkyMjg4NzA5NA==-flat-weightmatrix.cpp-snap-MDEwOlJlcG9zaXRvcnk0Mjg4MzU3-flat-soap.cpp.html,0.09985022466300549,10,tesseract-MDEwOlJlcG9zaXRvcnkyMjg4NzA5NA==-flat-weightmatrix.cpp,snap-MDEwOlJlcG9zaXRvcnk0Mjg4MzU3-flat-soap.cpp,308,311,3,362,366,4
2423386,https://htmlpreview.github.io/?https://github.com/Christina96/boilerplate-sample-matches/blob/main/Cpp-beta/nano-node-MDEwOlJlcG9zaXRvcnkxOTM0NzM0MA==-flat-fake.cpp-abseil-cpp-MDEwOlJlcG9zaXRvcnkxMDQyMzE1NDE=-flat-substitute.h.html,0.033112582781456956,10,nano-node-MDEwOlJlcG9zaXRvcnkxOTM0NzM0MA==-flat-fake.cpp,abseil-cpp-MDEwOlJlcG9zaXRvcnkxMDQyMzE1NDE=-flat-substitute.h,10,13,3,155,161,6
2427740,https://htmlpreview.github.io/?https://github.com/Christina96/boilerplate-sample-matches/blob/main/Cpp-beta/abseil-cpp-MDEwOlJlcG9zaXRvcnkxMDQyMzE1NDE=-flat-ascii_test.cc-nano-node-MDEwOlJlcG9zaXRvcnkxOTM0NzM0MA==-flat-curve25519-donna-32bit.h.html,0.05,9,abseil-cpp-MDEwOlJlcG9zaXRvcnkxMDQyMzE1NDE=-flat-ascii_test.cc,nano-node-MDEwOlJlcG9zaXRvcnkxOTM0NzM0MA==-flat-curve25519-donna-32bit.h,118,121,3,166,166,0
2428834,https://htmlpreview.github.io/?https://github.com/Christina96/boilerplate-sample-matches/blob/main/Cpp-beta/notepad-plus-plus-MDEwOlJlcG9zaXRvcnkzMzAxNDgxMQ==-flat-StatusBar.h-nano-node-MDEwOlJlcG9zaXRvcnkxOTM0NzM0MA==-flat-thread_roles.hpp.html,0.7441860465116279,32,notepad-plus-plus-MDEwOlJlcG9zaXRvcnkzMzAxNDgxMQ==-flat-StatusBar.h,nano-node-MDEwOlJlcG9zaXRvcnkxOTM0NzM0MA==-flat-thread_roles.hpp,13,22,9,7,38,31
2429736,https://htmlpreview.github.io/?https://github.com/Christina96/boilerplate-sample-matches/blob/main/Cpp-beta/caffe-MDEwOlJlcG9zaXRvcnk2MTg3MDgwMw==-flat-test_mkl_convolution_layer.cpp-abseil-cpp-MDEwOlJlcG9zaXRvcnkxMDQyMzE1NDE=-flat-str_format_test.cc.html,0.16626311541565778,10,caffe-MDEwOlJlcG9zaXRvcnk2MTg3MDgwMw==-flat-test_mkl_convolution_layer.cpp,abseil-cpp-MDEwOlJlcG9zaXRvcnkxMDQyMzE1NDE=-flat-str_format_test.cc,192,201,9,289,294,5
2437841,https://htmlpreview.github.io/?https://github.com/Christina96/boilerplate-sample-matches/blob/main/Cpp-beta/abseil-cpp-MDEwOlJlcG9zaXRvcnkxMDQyMzE1NDE=-flat-log_modifier_methods_test.cc-snap-MDEwOlJlcG9zaXRvcnk0Mjg4MzU3-flat-sir.cpp.html,0.14786729857819905,10,abseil-cpp-MDEwOlJlcG9zaXRvcnkxMDQyMzE1NDE=-flat-log_modifier_methods_test.cc,snap-MDEwOlJlcG9zaXRvcnk0Mjg4MzU3-flat-sir.cpp,80,85,5,106,112,6
2443624,https://htmlpreview.github.io/?https://github.com/Christina96/boilerplate-sample-matches/blob/main/Cpp-beta/nano-node-MDEwOlJlcG9zaXRvcnkxOTM0NzM0MA==-flat-peer_container.cpp-snap-MDEwOlJlcG9zaXRvcnk0Mjg4MzU3-flat-wmine.cpp.html,0.09563409563409564,16,nano-node-MDEwOlJlcG9zaXRvcnkxOTM0NzM0MA==-flat-peer_container.cpp,snap-MDEwOlJlcG9zaXRvcnk0Mjg4MzU3-flat-wmine.cpp,158,166,8,121,129,8
2453414,https://htmlpreview.github.io/?https://github.com/Christina96/boilerplate-sample-matches/blob/main/Cpp-beta/caffe-MDEwOlJlcG9zaXRvcnk2MTg3MDgwMw==-flat-multibox_loss_layer.hpp-snap-MDEwOlJlcG9zaXRvcnk0Mjg4MzU3-flat-webtrv.h.html,0.15864022662889518,16,caffe-MDEwOlJlcG9zaXRvcnk2MTg3MDgwMw==-flat-multibox_loss_layer.hpp,snap-MDEwOlJlcG9zaXRvcnk0Mjg4MzU3-flat-webtrv.h,17,21,4,97,106,9
2458381,https://htmlpreview.github.io/?https://github.com/Christina96/boilerplate-sample-matches/blob/main/Cpp-beta/snap-MDEwOlJlcG9zaXRvcnk0Mjg4MzU3-flat-test-alg.cpp-snap-MDEwOlJlcG9zaXRvcnk0Mjg4MzU3-flat-ultra.cpp.html,0.19997147339894453,11,snap-MDEwOlJlcG9zaXRvcnk0Mjg4MzU3-flat-test-alg.cpp,snap-MDEwOlJlcG9zaXRvcnk0Mjg4MzU3-flat-ultra.cpp,858,868,10,734,746,12
2476095,https://htmlpreview.github.io/?https://github.com/Christina96/boilerplate-sample-matches/blob/main/Cpp-beta/snap-MDEwOlJlcG9zaXRvcnk0Mjg4MzU3-flat-conv.cpp-notepad-plus-plus-MDEwOlJlcG9zaXRvcnkzMzAxNDgxMQ==-flat-Common.cpp.html,0.010133578995854445,11,snap-MDEwOlJlcG9zaXRvcnk0Mjg4MzU3-flat-conv.cpp,notepad-plus-plus-MDEwOlJlcG9zaXRvcnkzMzAxNDgxMQ==-flat-Common.cpp,7,11,4,1197,1201,4
2495136,https://htmlpreview.github.io/?https://github.com/Christina96/boilerplate-sample-matches/blob/main/Cpp-beta/tesseract-MDEwOlJlcG9zaXRvcnkyMjg4NzA5NA==-flat-shapetable.h-tesseract-MDEwOlJlcG9zaXRvcnkyMjg4NzA5NA==-flat-ambigs.cpp.html,0.06365159128978225,10,tesseract-MDEwOlJlcG9zaXRvcnkyMjg4NzA5NA==-flat-shapetable.h,tesseract-MDEwOlJlcG9zaXRvcnkyMjg4NzA5NA==-flat-ambigs.cpp,20,25,5,168,172,4
2501994,https://htmlpreview.github.io/?https://github.com/Christina96/boilerplate-sample-matches/blob/main/Cpp-beta/caffe-MDEwOlJlcG9zaXRvcnk2MTg3MDgwMw==-flat-test_softmax_with_loss_layer.cpp-caffe-MDEwOlJlcG9zaXRvcnk2MTg3MDgwMw==-flat-test_mkldnn_batch_norm_layer.cpp.html,0.11583011583011583,15,caffe-MDEwOlJlcG9zaXRvcnk2MTg3MDgwMw==-flat-test_softmax_with_loss_layer.cpp,caffe-MDEwOlJlcG9zaXRvcnk2MTg3MDgwMw==-flat-test_mkldnn_batch_norm_layer.cpp,29,41,12,29,36,7
2516663,https://htmlpreview.github.io/?https://github.com/Christina96/boilerplate-sample-matches/blob/main/Cpp-beta/nano-node-MDEwOlJlcG9zaXRvcnkxOTM0NzM0MA==-flat-rocksdbconfig.hpp-notepad-plus-plus-MDEwOlJlcG9zaXRvcnkzMzAxNDgxMQ==-flat-Notepad_plus.h.html,0.02217741935483871,11,nano-node-MDEwOlJlcG9zaXRvcnkxOTM0NzM0MA==-flat-rocksdbconfig.hpp,notepad-plus-plus-MDEwOlJlcG9zaXRvcnkzMzAxNDgxMQ==-flat-Notepad_plus.h,15,19,4,115,116,1
2517866,https://htmlpreview.github.io/?https://github.com/Christina96/boilerplate-sample-matches/blob/main/Cpp-beta/snap-MDEwOlJlcG9zaXRvcnk0Mjg4MzU3-flat-rolx.cpp-abseil-cpp-MDEwOlJlcG9zaXRvcnkxMDQyMzE1NDE=-flat-flag_test.cc.html,0.04743465634075508,12,snap-MDEwOlJlcG9zaXRvcnk0Mjg4MzU3-flat-rolx.cpp,abseil-cpp-MDEwOlJlcG9zaXRvcnkxMDQyMzE1NDE=-flat-flag_test.cc,268,272,4,77,84,7
2519478,https://htmlpreview.github.io/?https://github.com/Christina96/boilerplate-sample-matches/blob/main/Cpp-beta/abseil-cpp-MDEwOlJlcG9zaXRvcnkxMDQyMzE1NDE=-flat-inlined_vector_exception_safety_test.cc-tesseract-MDEwOlJlcG9zaXRvcnkyMjg4NzA5NA==-flat-blobbox.cpp.html,0.036748329621380846,14,abseil-cpp-MDEwOlJlcG9zaXRvcnkxMDQyMzE1NDE=-flat-inlined_vector_exception_safety_test.cc,tesseract-MDEwOlJlcG9zaXRvcnkyMjg4NzA5NA==-flat-blobbox.cpp,95,97,2,208,214,6
2520415,https://htmlpreview.github.io/?https://github.com/Christina96/boilerplate-sample-matches/blob/main/Cpp-beta/abseil-cpp-MDEwOlJlcG9zaXRvcnkxMDQyMzE1NDE=-flat-log_format.h-tesseract-MDEwOlJlcG9zaXRvcnkyMjg4NzA5NA==-flat-coutln.h.html,0.11406844106463879,15,abseil-cpp-MDEwOlJlcG9zaXRvcnkxMDQyMzE1NDE=-flat-log_format.h,tesseract-MDEwOlJlcG9zaXRvcnkyMjg4NzA5NA==-flat-coutln.h,19,26,7,34,40,6
2534867,https://htmlpreview.github.io/?https://github.com/Christina96/boilerplate-sample-matches/blob/main/Cpp-beta/nano-node-MDEwOlJlcG9zaXRvcnkxOTM0NzM0MA==-flat-blocks.cpp-subconverter-MDEwOlJlcG9zaXRvcnkyMTg2ODY3NjM=-flat-jpcre2.hpp.html,0.13967391304347826,10,nano-node-MDEwOlJlcG9zaXRvcnkxOTM0NzM0MA==-flat-blocks.cpp,subconverter-MDEwOlJlcG9zaXRvcnkyMTg2ODY3NjM=-flat-jpcre2.hpp,868,880,12,877,887,10
2540657,https://htmlpreview.github.io/?https://github.com/Christina96/boilerplate-sample-matches/blob/main/Cpp-beta/tesseract-MDEwOlJlcG9zaXRvcnkyMjg4NzA5NA==-flat-lang_model_helpers.cpp-tesseract-MDEwOlJlcG9zaXRvcnkyMjg4NzA5NA==-flat-drawtord.cpp.html,0.10876132930513595,15,tesseract-MDEwOlJlcG9zaXRvcnkyMjg4NzA5NA==-flat-lang_model_helpers.cpp,tesseract-MDEwOlJlcG9zaXRvcnkyMjg4NzA5NA==-flat-drawtord.cpp,130,137,7,211,224,13
2552370,https://htmlpreview.github.io/?https://github.com/Christina96/boilerplate-sample-matches/blob/main/Cpp-beta/notepad-plus-plus-MDEwOlJlcG9zaXRvcnkzMzAxNDgxMQ==-flat-TreeView.cpp-notepad-plus-plus-MDEwOlJlcG9zaXRvcnkzMzAxNDgxMQ==-flat-DockingCont.cpp.html,0.06511627906976744,9,notepad-plus-plus-MDEwOlJlcG9zaXRvcnkzMzAxNDgxMQ==-flat-TreeView.cpp,notepad-plus-plus-MDEwOlJlcG9zaXRvcnkzMzAxNDgxMQ==-flat-DockingCont.cpp,472,476,4,1285,1288,3
2553421,https://htmlpreview.github.io/?https://github.com/Christina96/boilerplate-sample-matches/blob/main/Cpp-beta/caffe-MDEwOlJlcG9zaXRvcnk2MTg3MDgwMw==-flat-io.cpp-snap-MDEwOlJlcG9zaXRvcnk0Mjg4MzU3-flat-vizmapgks.cpp.html,0.20622422197225346,11,caffe-MDEwOlJlcG9zaXRvcnk2MTg3MDgwMw==-flat-io.cpp,snap-MDEwOlJlcG9zaXRvcnk0Mjg4MzU3-flat-vizmapgks.cpp,350,369,19,30,35,5
2555458,https://htmlpreview.github.io/?https://github.com/Christina96/boilerplate-sample-matches/blob/main/Cpp-beta/nano-node-MDEwOlJlcG9zaXRvcnkxOTM0NzM0MA==-flat-ed25519-donna-impl-base.h-notepad-plus-plus-MDEwOlJlcG9zaXRvcnkzMzAxNDgxMQ==-flat-perl_matcher.hpp.html,0.04467005076142132,10,nano-node-MDEwOlJlcG9zaXRvcnkxOTM0NzM0MA==-flat-ed25519-donna-impl-base.h,notepad-plus-plus-MDEwOlJlcG9zaXRvcnkzMzAxNDgxMQ==-flat-perl_matcher.hpp,203,208,5,250,259,9
2559716,https://htmlpreview.github.io/?https://github.com/Christina96/boilerplate-sample-matches/blob/main/Cpp-beta/abseil-cpp-MDEwOlJlcG9zaXRvcnkxMDQyMzE1NDE=-flat-proto.cc-tesseract-MDEwOlJlcG9zaXRvcnkyMjg4NzA5NA==-flat-osdetect.cpp.html,0.07774538386783285,11,abseil-cpp-MDEwOlJlcG9zaXRvcnkxMDQyMzE1NDE=-flat-proto.cc,tesseract-MDEwOlJlcG9zaXRvcnkyMjg4NzA5NA==-flat-osdetect.cpp,22,27,5,111,118,7
2580611,https://htmlpreview.github.io/?https://github.com/Christina96/boilerplate-sample-matches/blob/main/Cpp-beta/nano-node-MDEwOlJlcG9zaXRvcnkxOTM0NzM0MA==-flat-bootstrap_8.cpp-notepad-plus-plus-MDEwOlJlcG9zaXRvcnkzMzAxNDgxMQ==-flat-nsEscSM.cpp.html,0.05221932114882506,10,nano-node-MDEwOlJlcG9zaXRvcnkxOTM0NzM0MA==-flat-bootstrap_8.cpp,notepad-plus-plus-MDEwOlJlcG9zaXRvcnkzMzAxNDgxMQ==-flat-nsEscSM.cpp,125,134,9,3,12,9
2581552,https://htmlpreview.github.io/?https://github.com/Christina96/boilerplate-sample-matches/blob/main/Cpp-beta/abseil-cpp-MDEwOlJlcG9zaXRvcnkxMDQyMzE1NDE=-flat-cpu_detect.h-nano-node-MDEwOlJlcG9zaXRvcnkxOTM0NzM0MA==-flat-confirmation_height_store_76.cpp.html,0.1896551724137931,11,abseil-cpp-MDEwOlJlcG9zaXRvcnkxMDQyMzE1NDE=-flat-cpu_detect.h,nano-node-MDEwOlJlcG9zaXRvcnkxOTM0NzM0MA==-flat-confirmation_height_store_76.cpp,8,18,10,64,68,4
2583416,https://htmlpreview.github.io/?https://github.com/Christina96/boilerplate-sample-matches/blob/main/Cpp-beta/nano-node-MDEwOlJlcG9zaXRvcnkxOTM0NzM0MA==-flat-gap_cache_47.cpp-caffe-MDEwOlJlcG9zaXRvcnk2MTg3MDgwMw==-flat-mlsl.hpp.html,0.023783783783783784,11,nano-node-MDEwOlJlcG9zaXRvcnkxOTM0NzM0MA==-flat-gap_cache_47.cpp,caffe-MDEwOlJlcG9zaXRvcnk2MTg3MDgwMw==-flat-mlsl.hpp,117,122,5,67,71,4
2620113,https://htmlpreview.github.io/?https://github.com/Christina96/boilerplate-sample-matches/blob/main/Cpp-beta/tesseract-MDEwOlJlcG9zaXRvcnkyMjg4NzA5NA==-flat-scrollview.cpp-snap-MDEwOlJlcG9zaXRvcnk0Mjg4MzU3-flat-ggen.cpp.html,0.040370976541189305,9,tesseract-MDEwOlJlcG9zaXRvcnkyMjg4NzA5NA==-flat-scrollview.cpp,snap-MDEwOlJlcG9zaXRvcnk0Mjg4MzU3-flat-ggen.cpp,179,181,2,382,384,2
2635286,https://htmlpreview.github.io/?https://github.com/Christina96/boilerplate-sample-matches/blob/main/Cpp-beta/nano-node-MDEwOlJlcG9zaXRvcnkxOTM0NzM0MA==-flat-account_store.hpp-tesseract-MDEwOlJlcG9zaXRvcnkyMjg4NzA5NA==-flat-alignedblob.h.html,0.6811594202898551,37,nano-node-MDEwOlJlcG9zaXRvcnkxOTM0NzM0MA==-flat-account_store.hpp,tesseract-MDEwOlJlcG9zaXRvcnkyMjg4NzA5NA==-flat-alignedblob.h,11,19,8,11,26,15
2646403,https://htmlpreview.github.io/?https://github.com/Christina96/boilerplate-sample-matches/blob/main/Cpp-beta/caffe-MDEwOlJlcG9zaXRvcnk2MTg3MDgwMw==-flat-test_im2col_layer.cpp-caffe-MDEwOlJlcG9zaXRvcnk2MTg3MDgwMw==-flat-test_multibox_loss_layer.cpp.html,0.20277777777777778,10,caffe-MDEwOlJlcG9zaXRvcnk2MTg3MDgwMw==-flat-test_im2col_layer.cpp,caffe-MDEwOlJlcG9zaXRvcnk2MTg3MDgwMw==-flat-test_multibox_loss_layer.cpp,120,128,8,351,359,8
2653761,https://htmlpreview.github.io/?https://github.com/Christina96/boilerplate-sample-matches/blob/main/Cpp-beta/tesseract-MDEwOlJlcG9zaXRvcnkyMjg4NzA5NA==-flat-lm_pain_points.cpp-snap-MDEwOlJlcG9zaXRvcnk0Mjg4MzU3-flat-nlpwinlf.cpp.html,0.04441154700222058,9,tesseract-MDEwOlJlcG9zaXRvcnkyMjg4NzA5NA==-flat-lm_pain_points.cpp,snap-MDEwOlJlcG9zaXRvcnk0Mjg4MzU3-flat-nlpwinlf.cpp,47,50,3,130,133,3
2666499,https://htmlpreview.github.io/?https://github.com/Christina96/boilerplate-sample-matches/blob/main/Cpp-beta/tesseract-MDEwOlJlcG9zaXRvcnkyMjg4NzA5NA==-flat-intsimdmatrixavx2.cpp-notepad-plus-plus-MDEwOlJlcG9zaXRvcnkzMzAxNDgxMQ==-flat-NppDarkMode.cpp.html,0.08066429418742586,11,tesseract-MDEwOlJlcG9zaXRvcnkyMjg4NzA5NA==-flat-intsimdmatrixavx2.cpp,notepad-plus-plus-MDEwOlJlcG9zaXRvcnkzMzAxNDgxMQ==-flat-NppDarkMode.cpp,165,167,2,985,989,4
2670745,https://htmlpreview.github.io/?https://github.com/Christina96/boilerplate-sample-matches/blob/main/Cpp-beta/caffe-MDEwOlJlcG9zaXRvcnk2MTg3MDgwMw==-flat-benchmark.hpp-abseil-cpp-MDEwOlJlcG9zaXRvcnkxMDQyMzE1NDE=-flat-conformance_archetype.h.html,0.057001239157372985,12,caffe-MDEwOlJlcG9zaXRvcnk2MTg3MDgwMw==-flat-benchmark.hpp,abseil-cpp-MDEwOlJlcG9zaXRvcnkxMDQyMzE1NDE=-flat-conformance_archetype.h,20,34,14,410,417,7
2678684,https://htmlpreview.github.io/?https://github.com/Christina96/boilerplate-sample-matches/blob/main/Cpp-beta/snap-MDEwOlJlcG9zaXRvcnk0Mjg4MzU3-flat-flx.h-snap-MDEwOlJlcG9zaXRvcnk0Mjg4MzU3-flat-gstat.h.html,0.2280130293159609,12,snap-MDEwOlJlcG9zaXRvcnk0Mjg4MzU3-flat-flx.h,snap-MDEwOlJlcG9zaXRvcnk0Mjg4MzU3-flat-gstat.h,339,343,4,66,70,4
2702694,https://htmlpreview.github.io/?https://github.com/Christina96/boilerplate-sample-matches/blob/main/Cpp-beta/snap-MDEwOlJlcG9zaXRvcnk0Mjg4MzU3-flat-sock.cpp-nano-node-MDEwOlJlcG9zaXRvcnkxOTM0NzM0MA==-flat-ledger.cpp.html,0.02945273631840796,9,snap-MDEwOlJlcG9zaXRvcnk0Mjg4MzU3-flat-sock.cpp,nano-node-MDEwOlJlcG9zaXRvcnkxOTM0NzM0MA==-flat-ledger.cpp,109,112,3,648,655,7
2708627,https://htmlpreview.github.io/?https://github.com/Christina96/boilerplate-sample-matches/blob/main/Cpp-beta/snap-MDEwOlJlcG9zaXRvcnk0Mjg4MzU3-flat-webpgfetch.h-tesseract-MDEwOlJlcG9zaXRvcnkyMjg4NzA5NA==-flat-ocrpara.h.html,0.225,9,snap-MDEwOlJlcG9zaXRvcnk0Mjg4MzU3-flat-webpgfetch.h,tesseract-MDEwOlJlcG9zaXRvcnkyMjg4NzA5NA==-flat-ocrpara.h,3,11,8,43,45,2
2712464,https://htmlpreview.github.io/?https://github.com/Christina96/boilerplate-sample-matches/blob/main/Cpp-beta/nano-node-MDEwOlJlcG9zaXRvcnkxOTM0NzM0MA==-flat-config.hpp-abseil-cpp-MDEwOlJlcG9zaXRvcnkxMDQyMzE1NDE=-flat-bind_front_test.cc.html,0.03680981595092025,12,nano-node-MDEwOlJlcG9zaXRvcnkxOTM0NzM0MA==-flat-config.hpp,abseil-cpp-MDEwOlJlcG9zaXRvcnkxMDQyMzE1NDE=-flat-bind_front_test.cc,27,46,19,24,27,3
2739548,https://htmlpreview.github.io/?https://github.com/Christina96/boilerplate-sample-matches/blob/main/Cpp-beta/abseil-cpp-MDEwOlJlcG9zaXRvcnkxMDQyMzE1NDE=-flat-futex.h-snap-MDEwOlJlcG9zaXRvcnk0Mjg4MzU3-flat-vizmap.cpp.html,0.020551967116852612,11,abseil-cpp-MDEwOlJlcG9zaXRvcnkxMDQyMzE1NDE=-flat-futex.h,snap-MDEwOlJlcG9zaXRvcnk0Mjg4MzU3-flat-vizmap.cpp,85,89,4,610,615,5
2743999,https://htmlpreview.github.io/?https://github.com/Christina96/boilerplate-sample-matches/blob/main/Cpp-beta/caffe-MDEwOlJlcG9zaXRvcnk2MTg3MDgwMw==-flat-test_mkldnn_split_layer.cpp-tesseract-MDEwOlJlcG9zaXRvcnkyMjg4NzA5NA==-flat-lstmtrainer_test.cc.html,0.09523809523809523,9,caffe-MDEwOlJlcG9zaXRvcnk2MTg3MDgwMw==-flat-test_mkldnn_split_layer.cpp,tesseract-MDEwOlJlcG9zaXRvcnkyMjg4NzA5NA==-flat-lstmtrainer_test.cc,41,48,7,64,69,5
2749804,https://htmlpreview.github.io/?https://github.com/Christina96/boilerplate-sample-matches/blob/main/Cpp-beta/snap-MDEwOlJlcG9zaXRvcnk0Mjg4MzU3-flat-wikinet.cpp-notepad-plus-plus-MDEwOlJlcG9zaXRvcnkzMzAxNDgxMQ==-flat-NppDarkMode.cpp.html,0.052469768395162944,10,snap-MDEwOlJlcG9zaXRvcnk0Mjg4MzU3-flat-wikinet.cpp,notepad-plus-plus-MDEwOlJlcG9zaXRvcnkzMzAxNDgxMQ==-flat-NppDarkMode.cpp,438,439,1,167,176,9
2759431,https://htmlpreview.github.io/?https://github.com/Christina96/boilerplate-sample-matches/blob/main/Cpp-beta/snap-MDEwOlJlcG9zaXRvcnk0Mjg4MzU3-flat-shash.h-snap-MDEwOlJlcG9zaXRvcnk0Mjg4MzU3-flat-table.cpp.html,0.08011268597587816,11,snap-MDEwOlJlcG9zaXRvcnk0Mjg4MzU3-flat-shash.h,snap-MDEwOlJlcG9zaXRvcnk0Mjg4MzU3-flat-table.cpp,545,547,2,1099,1104,5
2766584,https://htmlpreview.github.io/?https://github.com/Christina96/boilerplate-sample-matches/blob/main/Cpp-beta/nano-node-MDEwOlJlcG9zaXRvcnkxOTM0NzM0MA==-flat-cl_egl.h-snap-MDEwOlJlcG9zaXRvcnk0Mjg4MzU3-flat-vizmapgks.cpp.html,0.05989430416911333,12,nano-node-MDEwOlJlcG9zaXRvcnkxOTM0NzM0MA==-flat-cl_egl.h,snap-MDEwOlJlcG9zaXRvcnk0Mjg4MzU3-flat-vizmapgks.cpp,45,56,11,702,703,1
2774030,https://htmlpreview.github.io/?https://github.com/Christina96/boilerplate-sample-matches/blob/main/Cpp-beta/subconverter-MDEwOlJlcG9zaXRvcnkyMTg2ODY3NjM=-flat-string.h-abseil-cpp-MDEwOlJlcG9zaXRvcnkxMDQyMzE1NDE=-flat-str_format.h.html,0.09456264775413711,20,subconverter-MDEwOlJlcG9zaXRvcnkyMTg2ODY3NjM=-flat-string.h,abseil-cpp-MDEwOlJlcG9zaXRvcnkxMDQyMzE1NDE=-flat-str_format.h,23,29,6,118,122,4
2775769,https://htmlpreview.github.io/?https://github.com/Christina96/boilerplate-sample-matches/blob/main/Cpp-beta/snap-MDEwOlJlcG9zaXRvcnk0Mjg4MzU3-flat-wgtnet.h-tesseract-MDEwOlJlcG9zaXRvcnkyMjg4NzA5NA==-flat-trainingsampleset.cpp.html,0.015126050420168067,9,snap-MDEwOlJlcG9zaXRvcnk0Mjg4MzU3-flat-wgtnet.h,tesseract-MDEwOlJlcG9zaXRvcnkyMjg4NzA5NA==-flat-trainingsampleset.cpp,45,48,3,330,336,6
2806270,https://htmlpreview.github.io/?https://github.com/Christina96/boilerplate-sample-matches/blob/main/Cpp-beta/notepad-plus-plus-MDEwOlJlcG9zaXRvcnkzMzAxNDgxMQ==-flat-RunMacroDlg.h-MMKV-MDEwOlJlcG9zaXRvcnkxNDkxMTE4MTM=-flat-MMKVPredef.h.html,0.16981132075471697,9,notepad-plus-plus-MDEwOlJlcG9zaXRvcnkzMzAxNDgxMQ==-flat-RunMacroDlg.h,MMKV-MDEwOlJlcG9zaXRvcnkxNDkxMTE4MTM=-flat-MMKVPredef.h,21,23,2,99,102,3
2808799,https://htmlpreview.github.io/?https://github.com/Christina96/boilerplate-sample-matches/blob/main/Cpp-beta/abseil-cpp-MDEwOlJlcG9zaXRvcnkxMDQyMzE1NDE=-flat-civil_time_test_17.cc-snap-MDEwOlJlcG9zaXRvcnk0Mjg4MzU3-flat-agmfast.cpp.html,0.05339641770868537,18,abseil-cpp-MDEwOlJlcG9zaXRvcnkxMDQyMzE1NDE=-flat-civil_time_test_17.cc,snap-MDEwOlJlcG9zaXRvcnk0Mjg4MzU3-flat-agmfast.cpp,722,731,9,17,32,15
2818449,https://htmlpreview.github.io/?https://github.com/Christina96/boilerplate-sample-matches/blob/main/Cpp-beta/snap-MDEwOlJlcG9zaXRvcnk0Mjg4MzU3-flat-webmb.cpp-snap-MDEwOlJlcG9zaXRvcnk0Mjg4MzU3-flat-ftrgen.cpp.html,0.07640878701050621,9,snap-MDEwOlJlcG9zaXRvcnk0Mjg4MzU3-flat-webmb.cpp,snap-MDEwOlJlcG9zaXRvcnk0Mjg4MzU3-flat-ftrgen.cpp,27,30,3,50,53,3
2842213,https://htmlpreview.github.io/?https://github.com/Christina96/boilerplate-sample-matches/blob/main/Cpp-beta/subconverter-MDEwOlJlcG9zaXRvcnkyMTg2ODY3NjM=-flat-script_quickjs.h-tesseract-MDEwOlJlcG9zaXRvcnkyMjg4NzA5NA==-flat-stringrenderer.cpp.html,0.09647779479326186,13,subconverter-MDEwOlJlcG9zaXRvcnkyMTg2ODY3NjM=-flat-script_quickjs.h,tesseract-MDEwOlJlcG9zaXRvcnkyMjg4NzA5NA==-flat-stringrenderer.cpp,26,32,6,511,517,6
2851726,https://htmlpreview.github.io/?https://github.com/Christina96/boilerplate-sample-matches/blob/main/Cpp-beta/tesseract-MDEwOlJlcG9zaXRvcnkyMjg4NzA5NA==-flat-colpartitionset.h-snap-MDEwOlJlcG9zaXRvcnk0Mjg4MzU3-flat-lsionto.cpp.html,0.06442272891784293,10,tesseract-MDEwOlJlcG9zaXRvcnkyMjg4NzA5NA==-flat-colpartitionset.h,snap-MDEwOlJlcG9zaXRvcnk0Mjg4MzU3-flat-lsionto.cpp,35,39,4,758,760,2
2852405,https://htmlpreview.github.io/?https://github.com/Christina96/boilerplate-sample-matches/blob/main/Cpp-beta/caffe-MDEwOlJlcG9zaXRvcnk2MTg3MDgwMw==-flat-test_filter_layer.cpp-tesseract-MDEwOlJlcG9zaXRvcnkyMjg4NzA5NA==-flat-intmatcher.h.html,0.11221122112211221,17,caffe-MDEwOlJlcG9zaXRvcnk2MTg3MDgwMw==-flat-test_filter_layer.cpp,tesseract-MDEwOlJlcG9zaXRvcnkyMjg4NzA5NA==-flat-intmatcher.h,46,53,7,57,67,10
2898021,https://htmlpreview.github.io/?https://github.com/Christina96/boilerplate-sample-matches/blob/main/Cpp-beta/snap-MDEwOlJlcG9zaXRvcnk0Mjg4MzU3-flat-yahooex.cpp-nano-node-MDEwOlJlcG9zaXRvcnkxOTM0NzM0MA==-flat-block_store.cpp.html,0.16243654822335024,13,snap-MDEwOlJlcG9zaXRvcnk0Mjg4MzU3-flat-yahooex.cpp,nano-node-MDEwOlJlcG9zaXRvcnkxOTM0NzM0MA==-flat-block_store.cpp,859,865,6,221,229,8
2907490,https://htmlpreview.github.io/?https://github.com/Christina96/boilerplate-sample-matches/blob/main/Cpp-beta/caffe-MDEwOlJlcG9zaXRvcnk2MTg3MDgwMw==-flat-mkldnn_memory.cpp-nano-node-MDEwOlJlcG9zaXRvcnkxOTM0NzM0MA==-flat-socket.cpp.html,0.051417270929466054,9,caffe-MDEwOlJlcG9zaXRvcnk2MTg3MDgwMw==-flat-mkldnn_memory.cpp,nano-node-MDEwOlJlcG9zaXRvcnkxOTM0NzM0MA==-flat-socket.cpp,43,48,5,306,308,2
2924053,https://htmlpreview.github.io/?https://github.com/Christina96/boilerplate-sample-matches/blob/main/Cpp-beta/caffe-MDEwOlJlcG9zaXRvcnk2MTg3MDgwMw==-flat-gtest-internal.h-tesseract-MDEwOlJlcG9zaXRvcnkyMjg4NzA5NA==-flat-language_model.h.html,0.1504950495049505,9,caffe-MDEwOlJlcG9zaXRvcnk2MTg3MDgwMw==-flat-gtest-internal.h,tesseract-MDEwOlJlcG9zaXRvcnkyMjg4NzA5NA==-flat-language_model.h,35,54,19,110,112,2
2926962,https://htmlpreview.github.io/?https://github.com/Christina96/boilerplate-sample-matches/blob/main/Cpp-beta/tesseract-MDEwOlJlcG9zaXRvcnkyMjg4NzA5NA==-flat-unicharset_training_utils.cpp-tesseract-MDEwOlJlcG9zaXRvcnkyMjg4NzA5NA==-flat-pgedit.cpp.html,0.03554724041159962,10,tesseract-MDEwOlJlcG9zaXRvcnkyMjg4NzA5NA==-flat-unicharset_training_utils.cpp,tesseract-MDEwOlJlcG9zaXRvcnkyMjg4NzA5NA==-flat-pgedit.cpp,25,29,4,77,81,4
2932345,https://htmlpreview.github.io/?https://github.com/Christina96/boilerplate-sample-matches/blob/main/Cpp-beta/abseil-cpp-MDEwOlJlcG9zaXRvcnkxMDQyMzE1NDE=-flat-symbolize_test.cc-snap-MDEwOlJlcG9zaXRvcnk0Mjg4MzU3-flat-hashgenericmp.h.html,0.020654044750430294,9,abseil-cpp-MDEwOlJlcG9zaXRvcnkxMDQyMzE1NDE=-flat-symbolize_test.cc,snap-MDEwOlJlcG9zaXRvcnk0Mjg4MzU3-flat-hashgenericmp.h,257,262,5,215,217,2
2935541,https://htmlpreview.github.io/?https://github.com/Christina96/boilerplate-sample-matches/blob/main/Cpp-beta/nano-node-MDEwOlJlcG9zaXRvcnkxOTM0NzM0MA==-flat-messages.hpp-snap-MDEwOlJlcG9zaXRvcnk0Mjg4MzU3-flat-ds.h.html,0.072480181200453,16,nano-node-MDEwOlJlcG9zaXRvcnkxOTM0NzM0MA==-flat-messages.hpp,snap-MDEwOlJlcG9zaXRvcnk0Mjg4MzU3-flat-ds.h,21,37,16,62,77,15
2940331,https://htmlpreview.github.io/?https://github.com/Christina96/boilerplate-sample-matches/blob/main/Cpp-beta/nano-node-MDEwOlJlcG9zaXRvcnkxOTM0NzM0MA==-flat-frontier_store.cpp-abseil-cpp-MDEwOlJlcG9zaXRvcnkxMDQyMzE1NDE=-flat-mutex_test.cc.html,0.03345925526173772,12,nano-node-MDEwOlJlcG9zaXRvcnkxOTM0NzM0MA==-flat-frontier_store.cpp,abseil-cpp-MDEwOlJlcG9zaXRvcnkxMDQyMzE1NDE=-flat-mutex_test.cc,41,45,4,297,302,5
2944702,https://htmlpreview.github.io/?https://github.com/Christina96/boilerplate-sample-matches/blob/main/Cpp-beta/tesseract-MDEwOlJlcG9zaXRvcnkyMjg4NzA5NA==-flat-pitsync1.h-caffe-MDEwOlJlcG9zaXRvcnk2MTg3MDgwMw==-flat-scale_layer.hpp.html,0.7590361445783133,22,tesseract-MDEwOlJlcG9zaXRvcnkyMjg4NzA5NA==-flat-pitsync1.h,caffe-MDEwOlJlcG9zaXRvcnk2MTg3MDgwMw==-flat-scale_layer.hpp,56,86,30,23,27,4
2953794,https://htmlpreview.github.io/?https://github.com/Christina96/boilerplate-sample-matches/blob/main/Cpp-beta/abseil-cpp-MDEwOlJlcG9zaXRvcnkxMDQyMzE1NDE=-flat-civil_time_test.cc-nano-node-MDEwOlJlcG9zaXRvcnkxOTM0NzM0MA==-flat-rpc.cpp.html,0.1122036874451273,16,abseil-cpp-MDEwOlJlcG9zaXRvcnkxMDQyMzE1NDE=-flat-civil_time_test.cc,nano-node-MDEwOlJlcG9zaXRvcnkxOTM0NzM0MA==-flat-rpc.cpp,558,571,13,3604,3619,15
2956439,https://htmlpreview.github.io/?https://github.com/Christina96/boilerplate-sample-matches/blob/main/Cpp-beta/notepad-plus-plus-MDEwOlJlcG9zaXRvcnkzMzAxNDgxMQ==-flat-winmain.cpp-abseil-cpp-MDEwOlJlcG9zaXRvcnkxMDQyMzE1NDE=-flat-conformance_profile.h.html,0.16200578592092574,9,notepad-plus-plus-MDEwOlJlcG9zaXRvcnkzMzAxNDgxMQ==-flat-winmain.cpp,abseil-cpp-MDEwOlJlcG9zaXRvcnkxMDQyMzE1NDE=-flat-conformance_profile.h,298,302,4,117,122,5
2979088,https://htmlpreview.github.io/?https://github.com/Christina96/boilerplate-sample-matches/blob/main/Cpp-beta/snap-MDEwOlJlcG9zaXRvcnk0Mjg4MzU3-flat-gviz.h-notepad-plus-plus-MDEwOlJlcG9zaXRvcnkzMzAxNDgxMQ==-flat-cstdint.hpp.html,0.07171314741035857,9,snap-MDEwOlJlcG9zaXRvcnk0Mjg4MzU3-flat-gviz.h,notepad-plus-plus-MDEwOlJlcG9zaXRvcnkzMzAxNDgxMQ==-flat-cstdint.hpp,4,7,3,31,39,8
2979730,https://htmlpreview.github.io/?https://github.com/Christina96/boilerplate-sample-matches/blob/main/Cpp-beta/snap-MDEwOlJlcG9zaXRvcnk0Mjg4MzU3-flat-alternativetable.h-abseil-cpp-MDEwOlJlcG9zaXRvcnkxMDQyMzE1NDE=-flat-btree_test.cc.html,0.01771418838358031,16,snap-MDEwOlJlcG9zaXRvcnk0Mjg4MzU3-flat-alternativetable.h,abseil-cpp-MDEwOlJlcG9zaXRvcnkxMDQyMzE1NDE=-flat-btree_test.cc,158,161,3,90,93,3
2989445,https://htmlpreview.github.io/?https://github.com/Christina96/boilerplate-sample-matches/blob/main/Cpp-beta/caffe-MDEwOlJlcG9zaXRvcnk2MTg3MDgwMw==-flat-input_layer.hpp-snap-MDEwOlJlcG9zaXRvcnk0Mjg4MzU3-flat-graphmp.h.html,0.03418803418803419,10,caffe-MDEwOlJlcG9zaXRvcnk2MTg3MDgwMw==-flat-input_layer.hpp,snap-MDEwOlJlcG9zaXRvcnk0Mjg4MzU3-flat-graphmp.h,12,14,2,102,104,2
3002936,https://htmlpreview.github.io/?https://github.com/Christina96/boilerplate-sample-matches/blob/main/Cpp-beta/caffe-MDEwOlJlcG9zaXRvcnk2MTg3MDgwMw==-flat-batch_reindex_layer.cpp-caffe-MDEwOlJlcG9zaXRvcnk2MTg3MDgwMw==-flat-test_convolution_layer.cpp.html,0.03117206982543641,16,caffe-MDEwOlJlcG9zaXRvcnk2MTg3MDgwMw==-flat-batch_reindex_layer.cpp,caffe-MDEwOlJlcG9zaXRvcnk2MTg3MDgwMw==-flat-test_convolution_layer.cpp,35,39,4,321,325,4
3016442,https://htmlpreview.github.io/?https://github.com/Christina96/boilerplate-sample-matches/blob/main/Cpp-beta/subconverter-MDEwOlJlcG9zaXRvcnkyMTg2ODY3NjM=-flat-webget.h-notepad-plus-plus-MDEwOlJlcG9zaXRvcnkzMzAxNDgxMQ==-flat-Indicator.h.html,0.20634920634920634,13,subconverter-MDEwOlJlcG9zaXRvcnkyMTg2ODY3NjM=-flat-webget.h,notepad-plus-plus-MDEwOlJlcG9zaXRvcnkzMzAxNDgxMQ==-flat-Indicator.h,32,36,4,30,30,0
3019931,https://htmlpreview.github.io/?https://github.com/Christina96/boilerplate-sample-matches/blob/main/Cpp-beta/abseil-cpp-MDEwOlJlcG9zaXRvcnkxMDQyMzE1NDE=-flat-cordz_sample_token.h-notepad-plus-plus-MDEwOlJlcG9zaXRvcnkzMzAxNDgxMQ==-flat-EditModel.h.html,0.35294117647058826,21,abseil-cpp-MDEwOlJlcG9zaXRvcnkxMDQyMzE1NDE=-flat-cordz_sample_token.h,notepad-plus-plus-MDEwOlJlcG9zaXRvcnkzMzAxNDgxMQ==-flat-EditModel.h,19,29,10,17,35,18
3026919,https://htmlpreview.github.io/?https://github.com/Christina96/boilerplate-sample-matches/blob/main/Cpp-beta/abseil-cpp-MDEwOlJlcG9zaXRvcnkxMDQyMzE1NDE=-flat-bits_test.cc-caffe-MDEwOlJlcG9zaXRvcnk2MTg3MDgwMw==-flat-test_net_2.cpp.html,0.04597701149425287,9,abseil-cpp-MDEwOlJlcG9zaXRvcnkxMDQyMzE1NDE=-flat-bits_test.cc,caffe-MDEwOlJlcG9zaXRvcnk2MTg3MDgwMw==-flat-test_net_2.cpp,280,285,5,1139,1147,8
3034560,https://htmlpreview.github.io/?https://github.com/Christina96/boilerplate-sample-matches/blob/main/Cpp-beta/caffe-MDEwOlJlcG9zaXRvcnk2MTg3MDgwMw==-flat-relu_layer.hpp-snap-MDEwOlJlcG9zaXRvcnk0Mjg4MzU3-flat-subgraphenum.h.html,0.18271604938271604,20,caffe-MDEwOlJlcG9zaXRvcnk2MTg3MDgwMw==-flat-relu_layer.hpp,snap-MDEwOlJlcG9zaXRvcnk0Mjg4MzU3-flat-subgraphenum.h,16,20,4,51,57,6
3041345,https://htmlpreview.github.io/?https://github.com/Christina96/boilerplate-sample-matches/blob/main/Cpp-beta/snap-MDEwOlJlcG9zaXRvcnk0Mjg4MzU3-flat-sir.cpp-tesseract-MDEwOlJlcG9zaXRvcnkyMjg4NzA5NA==-flat-baselinedetect.cpp.html,0.09691629955947137,9,snap-MDEwOlJlcG9zaXRvcnk0Mjg4MzU3-flat-sir.cpp,tesseract-MDEwOlJlcG9zaXRvcnkyMjg4NzA5NA==-flat-baselinedetect.cpp,148,150,2,487,489,2
3062471,https://htmlpreview.github.io/?https://github.com/Christina96/boilerplate-sample-matches/blob/main/Cpp-beta/abseil-cpp-MDEwOlJlcG9zaXRvcnkxMDQyMzE1NDE=-flat-fixed_array_test.cc-abseil-cpp-MDEwOlJlcG9zaXRvcnkxMDQyMzE1NDE=-flat-time_zone_format.cc.html,0.04234234234234234,9,abseil-cpp-MDEwOlJlcG9zaXRvcnkxMDQyMzE1NDE=-flat-fixed_array_test.cc,abseil-cpp-MDEwOlJlcG9zaXRvcnkxMDQyMzE1NDE=-flat-time_zone_format.cc,550,556,6,560,564,4
3081690,https://htmlpreview.github.io/?https://github.com/Christina96/boilerplate-sample-matches/blob/main/Cpp-beta/caffe-MDEwOlJlcG9zaXRvcnk2MTg3MDgwMw==-flat-layer.cpp-snap-MDEwOlJlcG9zaXRvcnk0Mjg4MzU3-flat-vizmapgks.cpp.html,0.022701475595913734,9,caffe-MDEwOlJlcG9zaXRvcnk2MTg3MDgwMw==-flat-layer.cpp,snap-MDEwOlJlcG9zaXRvcnk0Mjg4MzU3-flat-vizmapgks.cpp,44,46,2,505,508,3
3098912,https://htmlpreview.github.io/?https://github.com/Christina96/boilerplate-sample-matches/blob/main/Cpp-beta/tesseract-MDEwOlJlcG9zaXRvcnkyMjg4NzA5NA==-flat-adaptive.h-notepad-plus-plus-MDEwOlJlcG9zaXRvcnkzMzAxNDgxMQ==-flat-object_cache.hpp.html,0.14772727272727273,13,tesseract-MDEwOlJlcG9zaXRvcnkyMjg4NzA5NA==-flat-adaptive.h,notepad-plus-plus-MDEwOlJlcG9zaXRvcnkzMzAxNDgxMQ==-flat-object_cache.hpp,59,65,6,17,23,6
3114255,https://htmlpreview.github.io/?https://github.com/Christina96/boilerplate-sample-matches/blob/main/Cpp-beta/tesseract-MDEwOlJlcG9zaXRvcnkyMjg4NzA5NA==-flat-render.h-caffe-MDEwOlJlcG9zaXRvcnk2MTg3MDgwMw==-flat-test_mkldnn_neuron_layers.cpp.html,0.23809523809523808,10,tesseract-MDEwOlJlcG9zaXRvcnkyMjg4NzA5NA==-flat-render.h,caffe-MDEwOlJlcG9zaXRvcnk2MTg3MDgwMw==-flat-test_mkldnn_neuron_layers.cpp,9,16,7,28,31,3
3122367,https://htmlpreview.github.io/?https://github.com/Christina96/boilerplate-sample-matches/blob/main/Cpp-beta/tesseract-MDEwOlJlcG9zaXRvcnkyMjg4NzA5NA==-flat-reject.h-notepad-plus-plus-MDEwOlJlcG9zaXRvcnkzMzAxNDgxMQ==-flat-preferenceDlg.h.html,0.043668122270742356,10,tesseract-MDEwOlJlcG9zaXRvcnkyMjg4NzA5NA==-flat-reject.h,notepad-plus-plus-MDEwOlJlcG9zaXRvcnkzMzAxNDgxMQ==-flat-preferenceDlg.h,6,13,7,18,20,2
3131087,https://htmlpreview.github.io/?https://github.com/Christina96/boilerplate-sample-matches/blob/main/Cpp-beta/tesseract-MDEwOlJlcG9zaXRvcnkyMjg4NzA5NA==-flat-lstmtrainer_test.cc-caffe-MDEwOlJlcG9zaXRvcnk2MTg3MDgwMw==-flat-batch_norm_layer.cpp.html,0.03896103896103896,9,tesseract-MDEwOlJlcG9zaXRvcnkyMjg4NzA5NA==-flat-lstmtrainer_test.cc,caffe-MDEwOlJlcG9zaXRvcnk2MTg3MDgwMw==-flat-batch_norm_layer.cpp,51,56,5,177,185,8
3131560,https://htmlpreview.github.io/?https://github.com/Christina96/boilerplate-sample-matches/blob/main/Cpp-beta/notepad-plus-plus-MDEwOlJlcG9zaXRvcnkzMzAxNDgxMQ==-flat-u32regex_token_iterator.hpp-snap-MDEwOlJlcG9zaXRvcnk0Mjg4MzU3-flat-linalg.cpp.html,0.031874662344678555,10,notepad-plus-plus-MDEwOlJlcG9zaXRvcnkzMzAxNDgxMQ==-flat-u32regex_token_iterator.hpp,snap-MDEwOlJlcG9zaXRvcnk0Mjg4MzU3-flat-linalg.cpp,116,120,4,558,561,3
3132815,https://htmlpreview.github.io/?https://github.com/Christina96/boilerplate-sample-matches/blob/main/Cpp-beta/abseil-cpp-MDEwOlJlcG9zaXRvcnkxMDQyMzE1NDE=-flat-symbolize_test.cc-abseil-cpp-MDEwOlJlcG9zaXRvcnkxMDQyMzE1NDE=-flat-crc_x86_arm_combined.cc.html,0.050314465408805034,9,abseil-cpp-MDEwOlJlcG9zaXRvcnkxMDQyMzE1NDE=-flat-symbolize_test.cc,abseil-cpp-MDEwOlJlcG9zaXRvcnkxMDQyMzE1NDE=-flat-crc_x86_arm_combined.cc,393,397,4,315,321,6
3135908,https://htmlpreview.github.io/?https://github.com/Christina96/boilerplate-sample-matches/blob/main/Cpp-beta/snap-MDEwOlJlcG9zaXRvcnk0Mjg4MzU3-flat-memes.cpp-snap-MDEwOlJlcG9zaXRvcnk0Mjg4MzU3-flat-network.cpp.html,0.12576328439651813,11,snap-MDEwOlJlcG9zaXRvcnk0Mjg4MzU3-flat-memes.cpp,snap-MDEwOlJlcG9zaXRvcnk0Mjg4MzU3-flat-network.cpp,464,467,3,1633,1636,3
3136970,https://htmlpreview.github.io/?https://github.com/Christina96/boilerplate-sample-matches/blob/main/Cpp-beta/tesseract-MDEwOlJlcG9zaXRvcnkyMjg4NzA5NA==-flat-pdblock.h-tesseract-MDEwOlJlcG9zaXRvcnkyMjg4NzA5NA==-flat-scrollview.h.html,0.24624624624624625,14,tesseract-MDEwOlJlcG9zaXRvcnkyMjg4NzA5NA==-flat-pdblock.h,tesseract-MDEwOlJlcG9zaXRvcnkyMjg4NzA5NA==-flat-scrollview.h,17,22,5,113,118,5
3146774,https://htmlpreview.github.io/?https://github.com/Christina96/boilerplate-sample-matches/blob/main/Cpp-beta/abseil-cpp-MDEwOlJlcG9zaXRvcnkxMDQyMzE1NDE=-flat-symbolize_13.h-caffe-MDEwOlJlcG9zaXRvcnk2MTg3MDgwMw==-flat-annotated_data_layer.hpp.html,0.5633802816901409,9,abseil-cpp-MDEwOlJlcG9zaXRvcnkxMDQyMzE1NDE=-flat-symbolize_13.h,caffe-MDEwOlJlcG9zaXRvcnk2MTg3MDgwMw==-flat-annotated_data_layer.hpp,20,24,4,26,30,4
3148507,https://htmlpreview.github.io/?https://github.com/Christina96/boilerplate-sample-matches/blob/main/Cpp-beta/nano-node-MDEwOlJlcG9zaXRvcnkxOTM0NzM0MA==-flat-pruned_store.hpp-subconverter-MDEwOlJlcG9zaXRvcnkyMTg2ODY3NjM=-flat-quickjspp.hpp.html,0.038535645472061654,10,nano-node-MDEwOlJlcG9zaXRvcnkxOTM0NzM0MA==-flat-pruned_store.hpp,subconverter-MDEwOlJlcG9zaXRvcnkyMTg2ODY3NjM=-flat-quickjspp.hpp,11,15,4,26,27,1
3154057,https://htmlpreview.github.io/?https://github.com/Christina96/boilerplate-sample-matches/blob/main/Cpp-beta/snap-MDEwOlJlcG9zaXRvcnk0Mjg4MzU3-flat-hc.h-snap-MDEwOlJlcG9zaXRvcnk0Mjg4MzU3-flat-sock.cpp.html,0.1146417445482866,12,snap-MDEwOlJlcG9zaXRvcnk0Mjg4MzU3-flat-hc.h,snap-MDEwOlJlcG9zaXRvcnk0Mjg4MzU3-flat-sock.cpp,58,60,2,102,105,3
3159680,https://htmlpreview.github.io/?https://github.com/Christina96/boilerplate-sample-matches/blob/main/Cpp-beta/snap-MDEwOlJlcG9zaXRvcnk0Mjg4MzU3-flat-SimJoinTest.cpp-caffe-MDEwOlJlcG9zaXRvcnk2MTg3MDgwMw==-flat-test_data_transformer.cpp.html,0.03481624758220503,9,snap-MDEwOlJlcG9zaXRvcnk0Mjg4MzU3-flat-SimJoinTest.cpp,caffe-MDEwOlJlcG9zaXRvcnk2MTg3MDgwMw==-flat-test_data_transformer.cpp,24,32,8,75,81,6
3170746,https://htmlpreview.github.io/?https://github.com/Christina96/boilerplate-sample-matches/blob/main/Cpp-beta/tesseract-MDEwOlJlcG9zaXRvcnkyMjg4NzA5NA==-flat-ocrblock.h-tesseract-MDEwOlJlcG9zaXRvcnkyMjg4NzA5NA==-flat-intfx.cpp.html,0.032948929159802305,10,tesseract-MDEwOlJlcG9zaXRvcnkyMjg4NzA5NA==-flat-ocrblock.h,tesseract-MDEwOlJlcG9zaXRvcnkyMjg4NzA5NA==-flat-intfx.cpp,109,120,11,149,152,3
3172065,https://htmlpreview.github.io/?https://github.com/Christina96/boilerplate-sample-matches/blob/main/Cpp-beta/abseil-cpp-MDEwOlJlcG9zaXRvcnkxMDQyMzE1NDE=-flat-node_hash_set_test.cc-snap-MDEwOlJlcG9zaXRvcnk0Mjg4MzU3-flat-ultra.cpp.html,0.027835479850436228,22,abseil-cpp-MDEwOlJlcG9zaXRvcnkxMDQyMzE1NDE=-flat-node_hash_set_test.cc,snap-MDEwOlJlcG9zaXRvcnk0Mjg4MzU3-flat-ultra.cpp,41,50,9,508,517,9
3178256,https://htmlpreview.github.io/?https://github.com/Christina96/boilerplate-sample-matches/blob/main/Cpp-beta/nano-node-MDEwOlJlcG9zaXRvcnkxOTM0NzM0MA==-flat-rpc_connection_secure.hpp-notepad-plus-plus-MDEwOlJlcG9zaXRvcnkzMzAxNDgxMQ==-flat-ProjectPanel.h.html,0.21238938053097345,24,nano-node-MDEwOlJlcG9zaXRvcnkxOTM0NzM0MA==-flat-rpc_connection_secure.hpp,notepad-plus-plus-MDEwOlJlcG9zaXRvcnkzMzAxNDgxMQ==-flat-ProjectPanel.h,9,16,7,100,107,7
3179381,https://htmlpreview.github.io/?https://github.com/Christina96/boilerplate-sample-matches/blob/main/Cpp-beta/caffe-MDEwOlJlcG9zaXRvcnk2MTg3MDgwMw==-flat-hdf5.hpp-snap-MDEwOlJlcG9zaXRvcnk0Mjg4MzU3-flat-lsh.h.html,0.24539877300613497,9,caffe-MDEwOlJlcG9zaXRvcnk2MTg3MDgwMw==-flat-hdf5.hpp,snap-MDEwOlJlcG9zaXRvcnk0Mjg4MzU3-flat-lsh.h,18,21,3,17,21,4
3179733,https://htmlpreview.github.io/?https://github.com/Christina96/boilerplate-sample-matches/blob/main/Cpp-beta/tesseract-MDEwOlJlcG9zaXRvcnkyMjg4NzA5NA==-flat-pitsync1.cpp-snap-MDEwOlJlcG9zaXRvcnk0Mjg4MzU3-flat-yahoodm.cpp.html,0.046898638426626324,10,tesseract-MDEwOlJlcG9zaXRvcnkyMjg4NzA5NA==-flat-pitsync1.cpp,snap-MDEwOlJlcG9zaXRvcnk0Mjg4MzU3-flat-yahoodm.cpp,82,92,10,18,23,5
3184668,https://htmlpreview.github.io/?https://github.com/Christina96/boilerplate-sample-matches/blob/main/Cpp-beta/caffe-MDEwOlJlcG9zaXRvcnk2MTg3MDgwMw==-flat-im2col.hpp-tesseract-MDEwOlJlcG9zaXRvcnkyMjg4NzA5NA==-flat-openclwrapper.h.html,0.7682926829268293,9,caffe-MDEwOlJlcG9zaXRvcnk2MTg3MDgwMw==-flat-im2col.hpp,tesseract-MDEwOlJlcG9zaXRvcnkyMjg4NzA5NA==-flat-openclwrapper.h,22,25,3,104,104,0
3194903,https://htmlpreview.github.io/?https://github.com/Christina96/boilerplate-sample-matches/blob/main/Cpp-beta/Cpp_Primer_Answers-MDEwOlJlcG9zaXRvcnk0NzE3MDI2MQ==-flat-exercise13_39.h-caffe-MDEwOlJlcG9zaXRvcnk2MTg3MDgwMw==-flat-test_mkl_convolution_layer.cpp.html,0.039473684210526314,9,Cpp_Primer_Answers-MDEwOlJlcG9zaXRvcnk0NzE3MDI2MQ==-flat-exercise13_39.h,caffe-MDEwOlJlcG9zaXRvcnk2MTg3MDgwMw==-flat-test_mkl_convolution_layer.cpp,8,13,5,143,151,8
3201010,https://htmlpreview.github.io/?https://github.com/Christina96/boilerplate-sample-matches/blob/main/Cpp-beta/snap-MDEwOlJlcG9zaXRvcnk0Mjg4MzU3-flat-wixexp.cpp-tesseract-MDEwOlJlcG9zaXRvcnkyMjg4NzA5NA==-flat-stepblob.cpp.html,0.024581005586592177,11,snap-MDEwOlJlcG9zaXRvcnk0Mjg4MzU3-flat-wixexp.cpp,tesseract-MDEwOlJlcG9zaXRvcnkyMjg4NzA5NA==-flat-stepblob.cpp,120,124,4,170,178,8
3207256,https://htmlpreview.github.io/?https://github.com/Christina96/boilerplate-sample-matches/blob/main/Cpp-beta/tesseract-MDEwOlJlcG9zaXRvcnkyMjg4NzA5NA==-flat-scanedg.cpp-abseil-cpp-MDEwOlJlcG9zaXRvcnkxMDQyMzE1NDE=-flat-low_level_alloc.cc.html,0.08695652173913043,19,tesseract-MDEwOlJlcG9zaXRvcnkyMjg4NzA5NA==-flat-scanedg.cpp,abseil-cpp-MDEwOlJlcG9zaXRvcnkxMDQyMzE1NDE=-flat-low_level_alloc.cc,16,22,6,108,116,8
3228813,https://htmlpreview.github.io/?https://github.com/Christina96/boilerplate-sample-matches/blob/main/Cpp-beta/nano-node-MDEwOlJlcG9zaXRvcnkxOTM0NzM0MA==-flat-blockbuilders.hpp-abseil-cpp-MDEwOlJlcG9zaXRvcnkxMDQyMzE1NDE=-flat-conformance_profile.h.html,0.20422535211267606,15,nano-node-MDEwOlJlcG9zaXRvcnkxOTM0NzM0MA==-flat-blockbuilders.hpp,abseil-cpp-MDEwOlJlcG9zaXRvcnkxMDQyMzE1NDE=-flat-conformance_profile.h,36,40,4,530,537,7
3231062,https://htmlpreview.github.io/?https://github.com/Christina96/boilerplate-sample-matches/blob/main/Cpp-beta/abseil-cpp-MDEwOlJlcG9zaXRvcnkxMDQyMzE1NDE=-flat-cord_rep_btree.h-snap-MDEwOlJlcG9zaXRvcnk0Mjg4MzU3-flat-svmmodels.h.html,0.2840108401084011,16,abseil-cpp-MDEwOlJlcG9zaXRvcnkxMDQyMzE1NDE=-flat-cord_rep_btree.h,snap-MDEwOlJlcG9zaXRvcnk0Mjg4MzU3-flat-svmmodels.h,133,137,4,156,157,1
3236268,https://htmlpreview.github.io/?https://github.com/Christina96/boilerplate-sample-matches/blob/main/Cpp-beta/nano-node-MDEwOlJlcG9zaXRvcnkxOTM0NzM0MA==-flat-ed25519-donna-32bit-sse2.h-notepad-plus-plus-MDEwOlJlcG9zaXRvcnkzMzAxNDgxMQ==-flat-fileBrowser.h.html,0.060240963855421686,10,nano-node-MDEwOlJlcG9zaXRvcnkxOTM0NzM0MA==-flat-ed25519-donna-32bit-sse2.h,notepad-plus-plus-MDEwOlJlcG9zaXRvcnkzMzAxNDgxMQ==-flat-fileBrowser.h,4,6,2,110,116,6
3237752,https://htmlpreview.github.io/?https://github.com/Christina96/boilerplate-sample-matches/blob/main/Cpp-beta/notepad-plus-plus-MDEwOlJlcG9zaXRvcnkzMzAxNDgxMQ==-flat-functionListPanel.cpp-notepad-plus-plus-MDEwOlJlcG9zaXRvcnkzMzAxNDgxMQ==-flat-columnEditor.cpp.html,0.06728538283062645,9,notepad-plus-plus-MDEwOlJlcG9zaXRvcnkzMzAxNDgxMQ==-flat-functionListPanel.cpp,notepad-plus-plus-MDEwOlJlcG9zaXRvcnkzMzAxNDgxMQ==-flat-columnEditor.cpp,188,190,2,69,70,1
3259950,https://htmlpreview.github.io/?https://github.com/Christina96/boilerplate-sample-matches/blob/main/Cpp-beta/caffe-MDEwOlJlcG9zaXRvcnk2MTg3MDgwMw==-flat-test_inner_product_layer.cpp-abseil-cpp-MDEwOlJlcG9zaXRvcnkxMDQyMzE1NDE=-flat-cord_rep_ring.cc.html,0.07911802853437094,10,caffe-MDEwOlJlcG9zaXRvcnk2MTg3MDgwMw==-flat-test_inner_product_layer.cpp,abseil-cpp-MDEwOlJlcG9zaXRvcnkxMDQyMzE1NDE=-flat-cord_rep_ring.cc,339,342,3,238,241,3
3265265,https://htmlpreview.github.io/?https://github.com/Christina96/boilerplate-sample-matches/blob/main/Cpp-beta/glm-MDEwOlJlcG9zaXRvcnk4NDM2MzE=-flat-intrinsic_matrix.hpp-abseil-cpp-MDEwOlJlcG9zaXRvcnkxMDQyMzE1NDE=-flat-fast_uniform_bits_test.cc.html,0.12637362637362637,12,glm-MDEwOlJlcG9zaXRvcnk4NDM2MzE=-flat-intrinsic_matrix.hpp,abseil-cpp-MDEwOlJlcG9zaXRvcnkxMDQyMzE1NDE=-flat-fast_uniform_bits_test.cc,11,15,4,185,196,11
3265861,https://htmlpreview.github.io/?https://github.com/Christina96/boilerplate-sample-matches/blob/main/Cpp-beta/abseil-cpp-MDEwOlJlcG9zaXRvcnkxMDQyMzE1NDE=-flat-low_level_alloc_test.cc-tesseract-MDEwOlJlcG9zaXRvcnkyMjg4NzA5NA==-flat-blamer.h.html,0.043478260869565216,9,abseil-cpp-MDEwOlJlcG9zaXRvcnkxMDQyMzE1NDE=-flat-low_level_alloc_test.cc,tesseract-MDEwOlJlcG9zaXRvcnkyMjg4NzA5NA==-flat-blamer.h,38,44,6,27,35,8
3272027,https://htmlpreview.github.io/?https://github.com/Christina96/boilerplate-sample-matches/blob/main/Cpp-beta/tesseract-MDEwOlJlcG9zaXRvcnkyMjg4NzA5NA==-flat-ligature_table_test.cc-abseil-cpp-MDEwOlJlcG9zaXRvcnkxMDQyMzE1NDE=-flat-parse_test.cc.html,0.060362173038229376,10,tesseract-MDEwOlJlcG9zaXRvcnkyMjg4NzA5NA==-flat-ligature_table_test.cc,abseil-cpp-MDEwOlJlcG9zaXRvcnkxMDQyMzE1NDE=-flat-parse_test.cc,54,61,7,222,230,8
3320654,https://htmlpreview.github.io/?https://github.com/Christina96/boilerplate-sample-matches/blob/main/Cpp-beta/snap-MDEwOlJlcG9zaXRvcnk0Mjg4MzU3-flat-centr-exp.cpp-snap-MDEwOlJlcG9zaXRvcnk0Mjg4MzU3-flat-graph_2.cpp.html,0.038338658146964855,10,snap-MDEwOlJlcG9zaXRvcnk0Mjg4MzU3-flat-centr-exp.cpp,snap-MDEwOlJlcG9zaXRvcnk0Mjg4MzU3-flat-graph_2.cpp,76,78,2,431,433,2
3332640,https://htmlpreview.github.io/?https://github.com/Christina96/boilerplate-sample-matches/blob/main/Cpp-beta/nano-node-MDEwOlJlcG9zaXRvcnkxOTM0NzM0MA==-flat-bootstrap_bulk_push.hpp-caffe-MDEwOlJlcG9zaXRvcnk2MTg3MDgwMw==-flat-xbyak_bin2hex.h.html,0.2591362126245847,21,nano-node-MDEwOlJlcG9zaXRvcnkxOTM0NzM0MA==-flat-bootstrap_bulk_push.hpp,caffe-MDEwOlJlcG9zaXRvcnk2MTg3MDgwMw==-flat-xbyak_bin2hex.h,15,24,9,2,22,20
3332750,https://htmlpreview.github.io/?https://github.com/Christina96/boilerplate-sample-matches/blob/main/Cpp-beta/caffe-MDEwOlJlcG9zaXRvcnk2MTg3MDgwMw==-flat-benchmark.hpp-snap-MDEwOlJlcG9zaXRvcnk0Mjg4MzU3-flat-cascdynetinf.cpp.html,0.010073260073260074,11,caffe-MDEwOlJlcG9zaXRvcnk2MTg3MDgwMw==-flat-benchmark.hpp,snap-MDEwOlJlcG9zaXRvcnk0Mjg4MzU3-flat-cascdynetinf.cpp,22,34,12,651,652,1
3344302,https://htmlpreview.github.io/?https://github.com/Christina96/boilerplate-sample-matches/blob/main/Cpp-beta/snap-MDEwOlJlcG9zaXRvcnk0Mjg4MzU3-flat-agm.h-snap-MDEwOlJlcG9zaXRvcnk0Mjg4MzU3-flat-flx.h.html,0.21067415730337077,33,snap-MDEwOlJlcG9zaXRvcnk0Mjg4MzU3-flat-agm.h,snap-MDEwOlJlcG9zaXRvcnk0Mjg4MzU3-flat-flx.h,13,17,4,293,308,15
3361040,https://htmlpreview.github.io/?https://github.com/Christina96/boilerplate-sample-matches/blob/main/Cpp-beta/abseil-cpp-MDEwOlJlcG9zaXRvcnkxMDQyMzE1NDE=-flat-mocking_bit_gen_test.cc-snap-MDEwOlJlcG9zaXRvcnk0Mjg4MzU3-flat-kronecker.cpp.html,0.12098765432098765,12,abseil-cpp-MDEwOlJlcG9zaXRvcnkxMDQyMzE1NDE=-flat-mocking_bit_gen_test.cc,snap-MDEwOlJlcG9zaXRvcnk0Mjg4MzU3-flat-kronecker.cpp,233,243,10,1505,1510,5
3363275,https://htmlpreview.github.io/?https://github.com/Christina96/boilerplate-sample-matches/blob/main/Cpp-beta/subconverter-MDEwOlJlcG9zaXRvcnkyMTg2ODY3NjM=-flat-network.cpp-nano-node-MDEwOlJlcG9zaXRvcnkxOTM0NzM0MA==-flat-nodeconfig.hpp.html,0.04591836734693878,9,subconverter-MDEwOlJlcG9zaXRvcnkyMTg2ODY3NjM=-flat-network.cpp,nano-node-MDEwOlJlcG9zaXRvcnkxOTM0NzM0MA==-flat-nodeconfig.hpp,93,99,6,31,37,6
3394065,https://htmlpreview.github.io/?https://github.com/Christina96/boilerplate-sample-matches/blob/main/Cpp-beta/Cpp_Primer_Answers-MDEwOlJlcG9zaXRvcnk0NzE3MDI2MQ==-flat-exercise7_27.h-nano-node-MDEwOlJlcG9zaXRvcnkxOTM0NzM0MA==-flat-stats.hpp.html,0.11691022964509394,17,Cpp_Primer_Answers-MDEwOlJlcG9zaXRvcnk0NzE3MDI2MQ==-flat-exercise7_27.h,nano-node-MDEwOlJlcG9zaXRvcnkxOTM0NzM0MA==-flat-stats.hpp,14,17,3,154,156,2
3395871,https://htmlpreview.github.io/?https://github.com/Christina96/boilerplate-sample-matches/blob/main/Cpp-beta/caffe-MDEwOlJlcG9zaXRvcnk2MTg3MDgwMw==-flat-smooth_L1_loss_layer.cpp-tesseract-MDEwOlJlcG9zaXRvcnkyMjg4NzA5NA==-flat-rect.h.html,0.11134020618556702,15,caffe-MDEwOlJlcG9zaXRvcnk2MTg3MDgwMw==-flat-smooth_L1_loss_layer.cpp,tesseract-MDEwOlJlcG9zaXRvcnkyMjg4NzA5NA==-flat-rect.h,30,35,5,127,129,2
3400018,https://htmlpreview.github.io/?https://github.com/Christina96/boilerplate-sample-matches/blob/main/Cpp-beta/notepad-plus-plus-MDEwOlJlcG9zaXRvcnkzMzAxNDgxMQ==-flat-basic_regex_creator.hpp-tesseract-MDEwOlJlcG9zaXRvcnkyMjg4NzA5NA==-flat-colpartition.cpp.html,0.021479229989868287,10,notepad-plus-plus-MDEwOlJlcG9zaXRvcnkzMzAxNDgxMQ==-flat-basic_regex_creator.hpp,tesseract-MDEwOlJlcG9zaXRvcnkyMjg4NzA5NA==-flat-colpartition.cpp,444,447,3,907,909,2
3445033,https://htmlpreview.github.io/?https://github.com/Christina96/boilerplate-sample-matches/blob/main/Cpp-beta/tesseract-MDEwOlJlcG9zaXRvcnkyMjg4NzA5NA==-flat-textlineprojection.cpp-snap-MDEwOlJlcG9zaXRvcnk0Mjg4MzU3-flat-linalg.cpp.html,0.12108362779740872,14,tesseract-MDEwOlJlcG9zaXRvcnkyMjg4NzA5NA==-flat-textlineprojection.cpp,snap-MDEwOlJlcG9zaXRvcnk0Mjg4MzU3-flat-linalg.cpp,256,260,4,1122,1128,6
3450469,https://htmlpreview.github.io/?https://github.com/Christina96/boilerplate-sample-matches/blob/main/Cpp-beta/snap-MDEwOlJlcG9zaXRvcnk0Mjg4MzU3-flat-agmdirected.h-snap-MDEwOlJlcG9zaXRvcnk0Mjg4MzU3-flat-network.h.html,0.07616996279616213,9,snap-MDEwOlJlcG9zaXRvcnk0Mjg4MzU3-flat-agmdirected.h,snap-MDEwOlJlcG9zaXRvcnk0Mjg4MzU3-flat-network.h,168,170,2,290,292,2
3498089,https://htmlpreview.github.io/?https://github.com/Christina96/boilerplate-sample-matches/blob/main/Cpp-beta/tesseract-MDEwOlJlcG9zaXRvcnkyMjg4NzA5NA==-flat-baseapi_test.cc-snap-MDEwOlJlcG9zaXRvcnk0Mjg4MzU3-flat-networkmp.cpp.html,0.06428248076052512,9,tesseract-MDEwOlJlcG9zaXRvcnkyMjg4NzA5NA==-flat-baseapi_test.cc,snap-MDEwOlJlcG9zaXRvcnk0Mjg4MzU3-flat-networkmp.cpp,66,71,5,51,53,2
3500153,https://htmlpreview.github.io/?https://github.com/Christina96/boilerplate-sample-matches/blob/main/Cpp-beta/snap-MDEwOlJlcG9zaXRvcnk0Mjg4MzU3-flat-webmb.h-notepad-plus-plus-MDEwOlJlcG9zaXRvcnkzMzAxNDgxMQ==-flat-Parameters.h.html,0.05409106470386854,18,snap-MDEwOlJlcG9zaXRvcnk0Mjg4MzU3-flat-webmb.h,notepad-plus-plus-MDEwOlJlcG9zaXRvcnkzMzAxNDgxMQ==-flat-Parameters.h,6,16,10,1201,1206,5
3500904,https://htmlpreview.github.io/?https://github.com/Christina96/boilerplate-sample-matches/blob/main/Cpp-beta/snap-MDEwOlJlcG9zaXRvcnk0Mjg4MzU3-flat-skygrid.cpp-abseil-cpp-MDEwOlJlcG9zaXRvcnkxMDQyMzE1NDE=-flat-any_invocable_test.cc.html,0.05221932114882506,9,snap-MDEwOlJlcG9zaXRvcnk0Mjg4MzU3-flat-skygrid.cpp,abseil-cpp-MDEwOlJlcG9zaXRvcnkxMDQyMzE1NDE=-flat-any_invocable_test.cc,202,207,5,725,734,9
3502358,https://htmlpreview.github.io/?https://github.com/Christina96/boilerplate-sample-matches/blob/main/Cpp-beta/glm-MDEwOlJlcG9zaXRvcnk4NDM2MzE=-flat-type_mat3x3.hpp-abseil-cpp-MDEwOlJlcG9zaXRvcnkxMDQyMzE1NDE=-flat-cord_rep_btree_navigator.h.html,0.18072289156626506,12,glm-MDEwOlJlcG9zaXRvcnk4NDM2MzE=-flat-type_mat3x3.hpp,abseil-cpp-MDEwOlJlcG9zaXRvcnkxMDQyMzE1NDE=-flat-cord_rep_btree_navigator.h,71,82,11,20,25,5
3510354,https://htmlpreview.github.io/?https://github.com/Christina96/boilerplate-sample-matches/blob/main/Cpp-beta/tesseract-MDEwOlJlcG9zaXRvcnkyMjg4NzA5NA==-flat-reject.cpp-tesseract-MDEwOlJlcG9zaXRvcnkyMjg4NzA5NA==-flat-strokewidth.cpp.html,0.0863905325443787,11,tesseract-MDEwOlJlcG9zaXRvcnkyMjg4NzA5NA==-flat-reject.cpp,tesseract-MDEwOlJlcG9zaXRvcnkyMjg4NzA5NA==-flat-strokewidth.cpp,356,358,2,409,411,2
3514098,https://htmlpreview.github.io/?https://github.com/Christina96/boilerplate-sample-matches/blob/main/Cpp-beta/tesseract-MDEwOlJlcG9zaXRvcnkyMjg4NzA5NA==-flat-tabvector_test.cc-caffe-MDEwOlJlcG9zaXRvcnk2MTg3MDgwMw==-flat-test_upgrade_proto.cpp.html,0.1111111111111111,18,tesseract-MDEwOlJlcG9zaXRvcnkyMjg4NzA5NA==-flat-tabvector_test.cc,caffe-MDEwOlJlcG9zaXRvcnk2MTg3MDgwMw==-flat-test_upgrade_proto.cpp,64,75,11,111,376,265
3519136,https://htmlpreview.github.io/?https://github.com/Christina96/boilerplate-sample-matches/blob/main/Cpp-beta/tesseract-MDEwOlJlcG9zaXRvcnkyMjg4NzA5NA==-flat-bbgrid.cpp-snap-MDEwOlJlcG9zaXRvcnk0Mjg4MzU3-flat-test-shmio.cpp.html,0.04661487236403995,12,tesseract-MDEwOlJlcG9zaXRvcnkyMjg4NzA5NA==-flat-bbgrid.cpp,snap-MDEwOlJlcG9zaXRvcnk0Mjg4MzU3-flat-test-shmio.cpp,124,125,1,181,186,5
3527199,https://htmlpreview.github.io/?https://github.com/Christina96/boilerplate-sample-matches/blob/main/Cpp-beta/caffe-MDEwOlJlcG9zaXRvcnk2MTg3MDgwMw==-flat-test_im2col_layer.cpp-snap-MDEwOlJlcG9zaXRvcnk0Mjg4MzU3-flat-sch.cpp.html,0.042105263157894736,9,caffe-MDEwOlJlcG9zaXRvcnk2MTg3MDgwMw==-flat-test_im2col_layer.cpp,snap-MDEwOlJlcG9zaXRvcnk0Mjg4MzU3-flat-sch.cpp,46,52,6,61,67,6
3540870,https://htmlpreview.github.io/?https://github.com/Christina96/boilerplate-sample-matches/blob/main/Cpp-beta/abseil-cpp-MDEwOlJlcG9zaXRvcnkxMDQyMzE1NDE=-flat-escaping_0.h-abseil-cpp-MDEwOlJlcG9zaXRvcnkxMDQyMzE1NDE=-flat-die_if_null_test.cc.html,0.17647058823529413,12,abseil-cpp-MDEwOlJlcG9zaXRvcnkxMDQyMzE1NDE=-flat-escaping_0.h,abseil-cpp-MDEwOlJlcG9zaXRvcnkxMDQyMzE1NDE=-flat-die_if_null_test.cc,15,20,5,15,20,5
3547455,https://htmlpreview.github.io/?https://github.com/Christina96/boilerplate-sample-matches/blob/main/Cpp-beta/notepad-plus-plus-MDEwOlJlcG9zaXRvcnkzMzAxNDgxMQ==-flat-ProjectPanel.cpp-abseil-cpp-MDEwOlJlcG9zaXRvcnkxMDQyMzE1NDE=-flat-btree_test.cc.html,0.07303202633941934,12,notepad-plus-plus-MDEwOlJlcG9zaXRvcnkzMzAxNDgxMQ==-flat-ProjectPanel.cpp,abseil-cpp-MDEwOlJlcG9zaXRvcnkxMDQyMzE1NDE=-flat-btree_test.cc,409,414,5,2066,2070,4
3554600,https://htmlpreview.github.io/?https://github.com/Christina96/boilerplate-sample-matches/blob/main/Cpp-beta/snap-MDEwOlJlcG9zaXRvcnk0Mjg4MzU3-flat-hashgenericmp.h-tesseract-MDEwOlJlcG9zaXRvcnkyMjg4NzA5NA==-flat-tospace.cpp.html,0.06099935107073329,16,snap-MDEwOlJlcG9zaXRvcnk0Mjg4MzU3-flat-hashgenericmp.h,tesseract-MDEwOlJlcG9zaXRvcnkyMjg4NzA5NA==-flat-tospace.cpp,17,26,9,926,934,8
3555356,https://htmlpreview.github.io/?https://github.com/Christina96/boilerplate-sample-matches/blob/main/Cpp-beta/glm-MDEwOlJlcG9zaXRvcnk4NDM2MzE=-flat-image2d.hpp-notepad-plus-plus-MDEwOlJlcG9zaXRvcnkzMzAxNDgxMQ==-flat-ScintillaTypes.h.html,0.2286348501664817,15,glm-MDEwOlJlcG9zaXRvcnk4NDM2MzE=-flat-image2d.hpp,notepad-plus-plus-MDEwOlJlcG9zaXRvcnkzMzAxNDgxMQ==-flat-ScintillaTypes.h,106,119,13,141,155,14
3563552,https://htmlpreview.github.io/?https://github.com/Christina96/boilerplate-sample-matches/blob/main/Cpp-beta/notepad-plus-plus-MDEwOlJlcG9zaXRvcnkzMzAxNDgxMQ==-flat-ScintillaQt.h-snap-MDEwOlJlcG9zaXRvcnk0Mjg4MzU3-flat-centr.h.html,0.15138888888888888,9,notepad-plus-plus-MDEwOlJlcG9zaXRvcnkzMzAxNDgxMQ==-flat-ScintillaQt.h,snap-MDEwOlJlcG9zaXRvcnk0Mjg4MzU3-flat-centr.h,107,111,4,22,23,1
3581753,https://htmlpreview.github.io/?https://github.com/Christina96/boilerplate-sample-matches/blob/main/Cpp-beta/notepad-plus-plus-MDEwOlJlcG9zaXRvcnkzMzAxNDgxMQ==-flat-ScintillaView.h-abseil-cpp-MDEwOlJlcG9zaXRvcnkxMDQyMzE1NDE=-flat-arg.cc.html,0.04354136429608128,15,notepad-plus-plus-MDEwOlJlcG9zaXRvcnkzMzAxNDgxMQ==-flat-ScintillaView.h,abseil-cpp-MDEwOlJlcG9zaXRvcnkxMDQyMzE1NDE=-flat-arg.cc,9,25,16,261,274,13
3589749,https://htmlpreview.github.io/?https://github.com/Christina96/boilerplate-sample-matches/blob/main/Cpp-beta/tesseract-MDEwOlJlcG9zaXRvcnkyMjg4NzA5NA==-flat-tablefind.cpp-nano-node-MDEwOlJlcG9zaXRvcnkxOTM0NzM0MA==-flat-node_6.cpp.html,0.10810810810810811,10,tesseract-MDEwOlJlcG9zaXRvcnkyMjg4NzA5NA==-flat-tablefind.cpp,nano-node-MDEwOlJlcG9zaXRvcnkxOTM0NzM0MA==-flat-node_6.cpp,912,915,3,1930,1934,4
3604251,https://htmlpreview.github.io/?https://github.com/Christina96/boilerplate-sample-matches/blob/main/Cpp-beta/snap-MDEwOlJlcG9zaXRvcnk0Mjg4MzU3-flat-memenet.cpp-snap-MDEwOlJlcG9zaXRvcnk0Mjg4MzU3-flat-network.h.html,0.022024226649314246,10,snap-MDEwOlJlcG9zaXRvcnk0Mjg4MzU3-flat-memenet.cpp,snap-MDEwOlJlcG9zaXRvcnk0Mjg4MzU3-flat-network.h,193,196,3,1137,1139,2
3613058,https://htmlpreview.github.io/?https://github.com/Christina96/boilerplate-sample-matches/blob/main/Cpp-beta/nano-node-MDEwOlJlcG9zaXRvcnkxOTM0NzM0MA==-flat-socket.hpp-caffe-MDEwOlJlcG9zaXRvcnk2MTg3MDgwMw==-flat-test_gradient_check_util.hpp.html,0.22427035330261136,11,nano-node-MDEwOlJlcG9zaXRvcnkxOTM0NzM0MA==-flat-socket.hpp,caffe-MDEwOlJlcG9zaXRvcnk2MTg3MDgwMw==-flat-test_gradient_check_util.hpp,56,63,7,31,32,1
3618473,https://htmlpreview.github.io/?https://github.com/Christina96/boilerplate-sample-matches/blob/main/Cpp-beta/caffe-MDEwOlJlcG9zaXRvcnk2MTg3MDgwMw==-flat-detection_evaluate_layer.hpp-notepad-plus-plus-MDEwOlJlcG9zaXRvcnkzMzAxNDgxMQ==-flat-tinystr.h.html,0.2079207920792079,12,caffe-MDEwOlJlcG9zaXRvcnk2MTg3MDgwMw==-flat-detection_evaluate_layer.hpp,notepad-plus-plus-MDEwOlJlcG9zaXRvcnkzMzAxNDgxMQ==-flat-tinystr.h,20,24,4,49,54,5
3621420,https://htmlpreview.github.io/?https://github.com/Christina96/boilerplate-sample-matches/blob/main/Cpp-beta/snap-MDEwOlJlcG9zaXRvcnk0Mjg4MzU3-flat-tbhc.cpp-snap-MDEwOlJlcG9zaXRvcnk0Mjg4MzU3-flat-bfsdfs.h.html,0.03177405119152692,9,snap-MDEwOlJlcG9zaXRvcnk0Mjg4MzU3-flat-tbhc.cpp,snap-MDEwOlJlcG9zaXRvcnk0Mjg4MzU3-flat-bfsdfs.h,28,30,2,233,235,2
3623956,https://htmlpreview.github.io/?https://github.com/Christina96/boilerplate-sample-matches/blob/main/Cpp-beta/snap-MDEwOlJlcG9zaXRvcnk0Mjg4MzU3-flat-skygrid.cpp-abseil-cpp-MDEwOlJlcG9zaXRvcnkxMDQyMzE1NDE=-flat-cord_rep_ring.cc.html,0.12396694214876033,10,snap-MDEwOlJlcG9zaXRvcnk0Mjg4MzU3-flat-skygrid.cpp,abseil-cpp-MDEwOlJlcG9zaXRvcnkxMDQyMzE1NDE=-flat-cord_rep_ring.cc,74,77,3,306,309,3
3626943,https://htmlpreview.github.io/?https://github.com/Christina96/boilerplate-sample-matches/blob/main/Cpp-beta/caffe-MDEwOlJlcG9zaXRvcnk2MTg3MDgwMw==-flat-absval_layer.hpp-tesseract-MDEwOlJlcG9zaXRvcnkyMjg4NzA5NA==-flat-pageres.cpp.html,0.011416709911779968,11,caffe-MDEwOlJlcG9zaXRvcnk2MTg3MDgwMw==-flat-absval_layer.hpp,tesseract-MDEwOlJlcG9zaXRvcnkyMjg4NzA5NA==-flat-pageres.cpp,20,22,2,199,205,6
3645233,https://htmlpreview.github.io/?https://github.com/Christina96/boilerplate-sample-matches/blob/main/Cpp-beta/abseil-cpp-MDEwOlJlcG9zaXRvcnkxMDQyMzE1NDE=-flat-civil_time_detail.h-snap-MDEwOlJlcG9zaXRvcnk0Mjg4MzU3-flat-nlpwinlf.cpp.html,0.06518518518518518,9,abseil-cpp-MDEwOlJlcG9zaXRvcnkxMDQyMzE1NDE=-flat-civil_time_detail.h,snap-MDEwOlJlcG9zaXRvcnk0Mjg4MzU3-flat-nlpwinlf.cpp,419,421,2,5,10,5
3666341,https://htmlpreview.github.io/?https://github.com/Christina96/boilerplate-sample-matches/blob/main/Cpp-beta/abseil-cpp-MDEwOlJlcG9zaXRvcnkxMDQyMzE1NDE=-flat-charconv_test.cc-abseil-cpp-MDEwOlJlcG9zaXRvcnkxMDQyMzE1NDE=-flat-hash_test.cc.html,0.14440734557595994,9,abseil-cpp-MDEwOlJlcG9zaXRvcnkxMDQyMzE1NDE=-flat-charconv_test.cc,abseil-cpp-MDEwOlJlcG9zaXRvcnkxMDQyMzE1NDE=-flat-hash_test.cc,195,199,4,364,371,7
3680258,https://htmlpreview.github.io/?https://github.com/Christina96/boilerplate-sample-matches/blob/main/Cpp-beta/caffe-MDEwOlJlcG9zaXRvcnk2MTg3MDgwMw==-flat-hdf5.cpp-snap-MDEwOlJlcG9zaXRvcnk0Mjg4MzU3-flat-kronecker.cpp.html,0.05597094637897885,11,caffe-MDEwOlJlcG9zaXRvcnk2MTg3MDgwMw==-flat-hdf5.cpp,snap-MDEwOlJlcG9zaXRvcnk0Mjg4MzU3-flat-kronecker.cpp,69,76,7,1506,1511,5
3691157,https://htmlpreview.github.io/?https://github.com/Christina96/boilerplate-sample-matches/blob/main/Cpp-beta/caffe-MDEwOlJlcG9zaXRvcnk2MTg3MDgwMw==-flat-async_param_server.cpp-abseil-cpp-MDEwOlJlcG9zaXRvcnkxMDQyMzE1NDE=-flat-time_zone_format_test.cc.html,0.09335362760020294,9,caffe-MDEwOlJlcG9zaXRvcnk2MTg3MDgwMw==-flat-async_param_server.cpp,abseil-cpp-MDEwOlJlcG9zaXRvcnkxMDQyMzE1NDE=-flat-time_zone_format_test.cc,84,88,4,1325,1329,4
3694259,https://htmlpreview.github.io/?https://github.com/Christina96/boilerplate-sample-matches/blob/main/Cpp-beta/tesseract-MDEwOlJlcG9zaXRvcnkyMjg4NzA5NA==-flat-bitvector_test.cc-snap-MDEwOlJlcG9zaXRvcnk0Mjg4MzU3-flat-bowclust.cpp.html,0.038910505836575876,10,tesseract-MDEwOlJlcG9zaXRvcnkyMjg4NzA5NA==-flat-bitvector_test.cc,snap-MDEwOlJlcG9zaXRvcnk0Mjg4MzU3-flat-bowclust.cpp,44,47,3,144,147,3
3704150,https://htmlpreview.github.io/?https://github.com/Christina96/boilerplate-sample-matches/blob/main/Cpp-beta/glm-MDEwOlJlcG9zaXRvcnk4NDM2MzE=-flat-intrinsic_matrix.hpp-notepad-plus-plus-MDEwOlJlcG9zaXRvcnkzMzAxNDgxMQ==-flat-AboutDlg.h.html,0.3050847457627119,9,glm-MDEwOlJlcG9zaXRvcnk4NDM2MzE=-flat-intrinsic_matrix.hpp,notepad-plus-plus-MDEwOlJlcG9zaXRvcnkzMzAxNDgxMQ==-flat-AboutDlg.h,11,14,3,27,29,2
3704614,https://htmlpreview.github.io/?https://github.com/Christina96/boilerplate-sample-matches/blob/main/Cpp-beta/nano-node-MDEwOlJlcG9zaXRvcnkxOTM0NzM0MA==-flat-voting.hpp-abseil-cpp-MDEwOlJlcG9zaXRvcnkxMDQyMzE1NDE=-flat-arg.cc.html,0.0748074807480748,34,nano-node-MDEwOlJlcG9zaXRvcnkxOTM0NzM0MA==-flat-voting.hpp,abseil-cpp-MDEwOlJlcG9zaXRvcnkxMDQyMzE1NDE=-flat-arg.cc,75,86,11,260,291,31
3714876,https://htmlpreview.github.io/?https://github.com/Christina96/boilerplate-sample-matches/blob/main/Cpp-beta/caffe-MDEwOlJlcG9zaXRvcnk2MTg3MDgwMw==-flat-mkldnn_memory.hpp-notepad-plus-plus-MDEwOlJlcG9zaXRvcnkzMzAxNDgxMQ==-flat-Buffer.h.html,0.4036144578313253,13,caffe-MDEwOlJlcG9zaXRvcnk2MTg3MDgwMw==-flat-mkldnn_memory.hpp,notepad-plus-plus-MDEwOlJlcG9zaXRvcnkzMzAxNDgxMQ==-flat-Buffer.h,41,49,8,113,117,4
3724302,https://htmlpreview.github.io/?https://github.com/Christina96/boilerplate-sample-matches/blob/main/Cpp-beta/snap-MDEwOlJlcG9zaXRvcnk0Mjg4MzU3-flat-os.cpp-notepad-plus-plus-MDEwOlJlcG9zaXRvcnkzMzAxNDgxMQ==-flat-pluginsAdmin.cpp.html,0.08909630886720407,13,snap-MDEwOlJlcG9zaXRvcnk0Mjg4MzU3-flat-os.cpp,notepad-plus-plus-MDEwOlJlcG9zaXRvcnkzMzAxNDgxMQ==-flat-pluginsAdmin.cpp,544,552,8,266,272,6
3761389,https://htmlpreview.github.io/?https://github.com/Christina96/boilerplate-sample-matches/blob/main/Cpp-beta/abseil-cpp-MDEwOlJlcG9zaXRvcnkxMDQyMzE1NDE=-flat-gaussian_distribution_test.cc-snap-MDEwOlJlcG9zaXRvcnk0Mjg4MzU3-flat-test-gio.cpp.html,0.06255144032921811,9,abseil-cpp-MDEwOlJlcG9zaXRvcnkxMDQyMzE1NDE=-flat-gaussian_distribution_test.cc,snap-MDEwOlJlcG9zaXRvcnk0Mjg4MzU3-flat-test-gio.cpp,70,73,3,57,60,3
3785519,https://htmlpreview.github.io/?https://github.com/Christina96/boilerplate-sample-matches/blob/main/Cpp-beta/glm-MDEwOlJlcG9zaXRvcnk4NDM2MzE=-flat-type.hpp-tesseract-MDEwOlJlcG9zaXRvcnkyMjg4NzA5NA==-flat-coutln.cpp.html,0.06869009584664537,9,glm-MDEwOlJlcG9zaXRvcnk4NDM2MzE=-flat-type.hpp,tesseract-MDEwOlJlcG9zaXRvcnkyMjg4NzA5NA==-flat-coutln.cpp,59,68,9,483,484,1
3812958,https://htmlpreview.github.io/?https://github.com/Christina96/boilerplate-sample-matches/blob/main/Cpp-beta/nano-node-MDEwOlJlcG9zaXRvcnkxOTM0NzM0MA==-flat-election_scheduler.cpp-notepad-plus-plus-MDEwOlJlcG9zaXRvcnkzMzAxNDgxMQ==-flat-NppBigSwitch.cpp.html,0.024200518582541054,9,nano-node-MDEwOlJlcG9zaXRvcnkxOTM0NzM0MA==-flat-election_scheduler.cpp,notepad-plus-plus-MDEwOlJlcG9zaXRvcnkzMzAxNDgxMQ==-flat-NppBigSwitch.cpp,15,16,1,325,330,5
3829229,https://htmlpreview.github.io/?https://github.com/Christina96/boilerplate-sample-matches/blob/main/Cpp-beta/caffe-MDEwOlJlcG9zaXRvcnk2MTg3MDgwMw==-flat-hdf5_output_layer.hpp-snap-MDEwOlJlcG9zaXRvcnk0Mjg4MzU3-flat-lsionto.cpp.html,0.03820720058780309,9,caffe-MDEwOlJlcG9zaXRvcnk2MTg3MDgwMw==-flat-hdf5_output_layer.hpp,snap-MDEwOlJlcG9zaXRvcnk0Mjg4MzU3-flat-lsionto.cpp,18,19,1,153,156,3
3839930,https://htmlpreview.github.io/?https://github.com/Christina96/boilerplate-sample-matches/blob/main/Cpp-beta/snap-MDEwOlJlcG9zaXRvcnk0Mjg4MzU3-flat-ut.cpp-snap-MDEwOlJlcG9zaXRvcnk0Mjg4MzU3-flat-bowbs.cpp.html,0.025039123630672927,10,snap-MDEwOlJlcG9zaXRvcnk0Mjg4MzU3-flat-ut.cpp,snap-MDEwOlJlcG9zaXRvcnk0Mjg4MzU3-flat-bowbs.cpp,32,36,4,294,297,3
3843227,https://htmlpreview.github.io/?https://github.com/Christina96/boilerplate-sample-matches/blob/main/Cpp-beta/nano-node-MDEwOlJlcG9zaXRvcnkxOTM0NzM0MA==-flat-work.hpp-notepad-plus-plus-MDEwOlJlcG9zaXRvcnkzMzAxNDgxMQ==-flat-ShortcutMapper.h.html,0.4088888888888889,32,nano-node-MDEwOlJlcG9zaXRvcnkxOTM0NzM0MA==-flat-work.hpp,notepad-plus-plus-MDEwOlJlcG9zaXRvcnkzMzAxNDgxMQ==-flat-ShortcutMapper.h,33,38,5,30,42,12
3860469,https://htmlpreview.github.io/?https://github.com/Christina96/boilerplate-sample-matches/blob/main/Cpp-beta/snap-MDEwOlJlcG9zaXRvcnk0Mjg4MzU3-flat-gksvml.h-caffe-MDEwOlJlcG9zaXRvcnk2MTg3MDgwMw==-flat-upgrade_proto.cpp.html,0.04043545878693624,10,snap-MDEwOlJlcG9zaXRvcnk0Mjg4MzU3-flat-gksvml.h,caffe-MDEwOlJlcG9zaXRvcnk2MTg3MDgwMw==-flat-upgrade_proto.cpp,104,108,4,93,99,6
3861477,https://htmlpreview.github.io/?https://github.com/Christina96/boilerplate-sample-matches/blob/main/Cpp-beta/caffe-MDEwOlJlcG9zaXRvcnk2MTg3MDgwMw==-flat-gtest-port.h-snap-MDEwOlJlcG9zaXRvcnk0Mjg4MzU3-flat-tbhc.h.html,0.06792452830188679,9,caffe-MDEwOlJlcG9zaXRvcnk2MTg3MDgwMw==-flat-gtest-port.h,snap-MDEwOlJlcG9zaXRvcnk0Mjg4MzU3-flat-tbhc.h,351,354,3,16,19,3
3864017,https://htmlpreview.github.io/?https://github.com/Christina96/boilerplate-sample-matches/blob/main/Cpp-beta/caffe-MDEwOlJlcG9zaXRvcnk2MTg3MDgwMw==-flat-permute_layer.cpp-snap-MDEwOlJlcG9zaXRvcnk0Mjg4MzU3-flat-agmfit.cpp.html,0.02606310013717421,9,caffe-MDEwOlJlcG9zaXRvcnk2MTg3MDgwMw==-flat-permute_layer.cpp,snap-MDEwOlJlcG9zaXRvcnk0Mjg4MzU3-flat-agmfit.cpp,6,8,2,35,36,1
3870237,https://htmlpreview.github.io/?https://github.com/Christina96/boilerplate-sample-matches/blob/main/Cpp-beta/snap-MDEwOlJlcG9zaXRvcnk0Mjg4MzU3-flat-kronfit.cpp-nano-node-MDEwOlJlcG9zaXRvcnkxOTM0NzM0MA==-flat-wallet.cpp.html,0.06362058993637941,10,snap-MDEwOlJlcG9zaXRvcnk0Mjg4MzU3-flat-kronfit.cpp,nano-node-MDEwOlJlcG9zaXRvcnkxOTM0NzM0MA==-flat-wallet.cpp,17,20,3,1106,1109,3
3879427,https://htmlpreview.github.io/?https://github.com/Christina96/boilerplate-sample-matches/blob/main/Cpp-beta/caffe-MDEwOlJlcG9zaXRvcnk2MTg3MDgwMw==-flat-test_mkldnn_batch_norm_layer.cpp-abseil-cpp-MDEwOlJlcG9zaXRvcnkxMDQyMzE1NDE=-flat-mutex_test.cc.html,0.05159958720330237,12,caffe-MDEwOlJlcG9zaXRvcnk2MTg3MDgwMw==-flat-test_mkldnn_batch_norm_layer.cpp,abseil-cpp-MDEwOlJlcG9zaXRvcnkxMDQyMzE1NDE=-flat-mutex_test.cc,47,50,3,997,1000,3
3918899,https://htmlpreview.github.io/?https://github.com/Christina96/boilerplate-sample-matches/blob/main/Cpp-beta/caffe-MDEwOlJlcG9zaXRvcnk2MTg3MDgwMw==-flat-sgd_solver.cpp-notepad-plus-plus-MDEwOlJlcG9zaXRvcnkzMzAxNDgxMQ==-flat-Buffer.cpp.html,0.07837338262476895,10,caffe-MDEwOlJlcG9zaXRvcnk2MTg3MDgwMw==-flat-sgd_solver.cpp,notepad-plus-plus-MDEwOlJlcG9zaXRvcnkzMzAxNDgxMQ==-flat-Buffer.cpp,556,563,7,957,962,5
3922464,https://htmlpreview.github.io/?https://github.com/Christina96/boilerplate-sample-matches/blob/main/Cpp-beta/snap-MDEwOlJlcG9zaXRvcnk0Mjg4MzU3-flat-test-TNodeNet.cpp-nano-node-MDEwOlJlcG9zaXRvcnkxOTM0NzM0MA==-flat-wallet_55.cpp.html,0.0513950073421439,9,snap-MDEwOlJlcG9zaXRvcnk0Mjg4MzU3-flat-test-TNodeNet.cpp,nano-node-MDEwOlJlcG9zaXRvcnkxOTM0NzM0MA==-flat-wallet_55.cpp,196,204,8,218,226,8
3926860,https://htmlpreview.github.io/?https://github.com/Christina96/boilerplate-sample-matches/blob/main/Cpp-beta/tesseract-MDEwOlJlcG9zaXRvcnkyMjg4NzA5NA==-flat-ocrclass.h-tesseract-MDEwOlJlcG9zaXRvcnkyMjg4NzA5NA==-flat-dawg.h.html,0.19528619528619529,13,tesseract-MDEwOlJlcG9zaXRvcnkyMjg4NzA5NA==-flat-ocrclass.h,tesseract-MDEwOlJlcG9zaXRvcnkyMjg4NzA5NA==-flat-dawg.h,17,21,4,163,172,9
3927955,https://htmlpreview.github.io/?https://github.com/Christina96/boilerplate-sample-matches/blob/main/Cpp-beta/nano-node-MDEwOlJlcG9zaXRvcnkxOTM0NzM0MA==-flat-ledger.hpp-snap-MDEwOlJlcG9zaXRvcnk0Mjg4MzU3-flat-cascdynetinf.h.html,0.47264260768335276,16,nano-node-MDEwOlJlcG9zaXRvcnkxOTM0NzM0MA==-flat-ledger.hpp,snap-MDEwOlJlcG9zaXRvcnk0Mjg4MzU3-flat-cascdynetinf.h,48,51,3,186,189,3
3929509,https://htmlpreview.github.io/?https://github.com/Christina96/boilerplate-sample-matches/blob/main/Cpp-beta/nano-node-MDEwOlJlcG9zaXRvcnkxOTM0NzM0MA==-flat-portmapping.cpp-snap-MDEwOlJlcG9zaXRvcnk0Mjg4MzU3-flat-rids.h.html,0.018471010774756286,9,nano-node-MDEwOlJlcG9zaXRvcnkxOTM0NzM0MA==-flat-portmapping.cpp,snap-MDEwOlJlcG9zaXRvcnk0Mjg4MzU3-flat-rids.h,95,95,0,993,996,3
3939568,https://htmlpreview.github.io/?https://github.com/Christina96/boilerplate-sample-matches/blob/main/Cpp-beta/caffe-MDEwOlJlcG9zaXRvcnk2MTg3MDgwMw==-flat-test_normalize_layer.cpp-tesseract-MDEwOlJlcG9zaXRvcnkyMjg4NzA5NA==-flat-strokewidth.cpp.html,0.07835190813914218,12,caffe-MDEwOlJlcG9zaXRvcnk2MTg3MDgwMw==-flat-test_normalize_layer.cpp,tesseract-MDEwOlJlcG9zaXRvcnkyMjg4NzA5NA==-flat-strokewidth.cpp,65,70,5,99,102,3
3966915,https://htmlpreview.github.io/?https://github.com/Christina96/boilerplate-sample-matches/blob/main/Cpp-beta/abseil-cpp-MDEwOlJlcG9zaXRvcnkxMDQyMzE1NDE=-flat-test_matchers.h-tesseract-MDEwOlJlcG9zaXRvcnkyMjg4NzA5NA==-flat-boxchar.h.html,0.19631901840490798,16,abseil-cpp-MDEwOlJlcG9zaXRvcnkxMDQyMzE1NDE=-flat-test_matchers.h,tesseract-MDEwOlJlcG9zaXRvcnkyMjg4NzA5NA==-flat-boxchar.h,18,51,33,49,52,3
3980425,https://htmlpreview.github.io/?https://github.com/Christina96/boilerplate-sample-matches/blob/main/Cpp-beta/nano-node-MDEwOlJlcG9zaXRvcnkxOTM0NzM0MA==-flat-utility_21.hpp-caffe-MDEwOlJlcG9zaXRvcnk2MTg3MDgwMw==-flat-batch_classification.cpp.html,0.11217948717948718,10,nano-node-MDEwOlJlcG9zaXRvcnkxOTM0NzM0MA==-flat-utility_21.hpp,caffe-MDEwOlJlcG9zaXRvcnk2MTg3MDgwMw==-flat-batch_classification.cpp,88,98,10,48,52,4
3988664,https://htmlpreview.github.io/?https://github.com/Christina96/boilerplate-sample-matches/blob/main/Cpp-beta/notepad-plus-plus-MDEwOlJlcG9zaXRvcnkzMzAxNDgxMQ==-flat-BabyGrid.cpp-tesseract-MDEwOlJlcG9zaXRvcnkyMjg4NzA5NA==-flat-tabfind.cpp.html,0.05876393110435663,11,notepad-plus-plus-MDEwOlJlcG9zaXRvcnkzMzAxNDgxMQ==-flat-BabyGrid.cpp,tesseract-MDEwOlJlcG9zaXRvcnkyMjg4NzA5NA==-flat-tabfind.cpp,255,262,7,290,294,4
3993397,https://htmlpreview.github.io/?https://github.com/Christina96/boilerplate-sample-matches/blob/main/Cpp-beta/abseil-cpp-MDEwOlJlcG9zaXRvcnkxMDQyMzE1NDE=-flat-log_uniform_int_distribution_test.cc-snap-MDEwOlJlcG9zaXRvcnk0Mjg4MzU3-flat-networkmp.cpp.html,0.048265460030165915,12,abseil-cpp-MDEwOlJlcG9zaXRvcnkxMDQyMzE1NDE=-flat-log_uniform_int_distribution_test.cc,snap-MDEwOlJlcG9zaXRvcnk0Mjg4MzU3-flat-networkmp.cpp,34,42,8,295,299,4
4040312,https://htmlpreview.github.io/?https://github.com/Christina96/boilerplate-sample-matches/blob/main/Cpp-beta/caffe-MDEwOlJlcG9zaXRvcnk2MTg3MDgwMw==-flat-gmock-generated-actions.h-tesseract-MDEwOlJlcG9zaXRvcnkyMjg4NzA5NA==-flat-fixspace.cpp.html,0.08042488619119878,11,caffe-MDEwOlJlcG9zaXRvcnk2MTg3MDgwMw==-flat-gmock-generated-actions.h,tesseract-MDEwOlJlcG9zaXRvcnkyMjg4NzA5NA==-flat-fixspace.cpp,264,265,1,433,440,7
4049283,https://htmlpreview.github.io/?https://github.com/Christina96/boilerplate-sample-matches/blob/main/Cpp-beta/snap-MDEwOlJlcG9zaXRvcnk0Mjg4MzU3-flat-agmfit.h-snap-MDEwOlJlcG9zaXRvcnk0Mjg4MzU3-flat-conv.h.html,0.023983620941795847,9,snap-MDEwOlJlcG9zaXRvcnk0Mjg4MzU3-flat-agmfit.h,snap-MDEwOlJlcG9zaXRvcnk0Mjg4MzU3-flat-conv.h,10,15,5,1695,1699,4
4083103,https://htmlpreview.github.io/?https://github.com/Christina96/boilerplate-sample-matches/blob/main/Cpp-beta/abseil-cpp-MDEwOlJlcG9zaXRvcnkxMDQyMzE1NDE=-flat-any_test.cc-snap-MDEwOlJlcG9zaXRvcnk0Mjg4MzU3-flat-table.cpp.html,0.027692978630614914,9,abseil-cpp-MDEwOlJlcG9zaXRvcnkxMDQyMzE1NDE=-flat-any_test.cc,snap-MDEwOlJlcG9zaXRvcnk0Mjg4MzU3-flat-table.cpp,86,90,4,315,323,8
4100140,https://htmlpreview.github.io/?https://github.com/Christina96/boilerplate-sample-matches/blob/main/Cpp-beta/notepad-plus-plus-MDEwOlJlcG9zaXRvcnkzMzAxNDgxMQ==-flat-regExtDlg.cpp-snap-MDEwOlJlcG9zaXRvcnk0Mjg4MzU3-flat-network.cpp.html,0.02780472033624313,12,notepad-plus-plus-MDEwOlJlcG9zaXRvcnkzMzAxNDgxMQ==-flat-regExtDlg.cpp,snap-MDEwOlJlcG9zaXRvcnk0Mjg4MzU3-flat-network.cpp,19,22,3,5,16,11
