ID,Link,Similarity,Tokens,File 1,File 2,Start 1,End 1,Detected Lines 1,Start 2,End 2,Detected Lines 2
991,https://htmlpreview.github.io/?https://github.com/Christina96/boilerplate-sample-matches/blob/main/Cpp/caffe-MDEwOlJlcG9zaXRvcnk2MTg3MDgwMw==-flat-test_mkldnn_pooling_layer.cpp-notepad-plus-plus-MDEwOlJlcG9zaXRvcnkzMzAxNDgxMQ==-flat-VerticalFileSwitcherListView.cpp.html,0.06572769953051644,9,caffe-MDEwOlJlcG9zaXRvcnk2MTg3MDgwMw==-flat-test_mkldnn_pooling_layer.cpp,notepad-plus-plus-MDEwOlJlcG9zaXRvcnkzMzAxNDgxMQ==-flat-VerticalFileSwitcherListView.cpp,215,219,4,207,212,5
1696,https://htmlpreview.github.io/?https://github.com/Christina96/boilerplate-sample-matches/blob/main/Cpp/snap-MDEwOlJlcG9zaXRvcnk0Mjg4MzU3-flat-wixexp.cpp-caffe-MDEwOlJlcG9zaXRvcnk2MTg3MDgwMw==-flat-gmock-spec-builders.cc.html,0.10750279955207166,9,snap-MDEwOlJlcG9zaXRvcnk0Mjg4MzU3-flat-wixexp.cpp,caffe-MDEwOlJlcG9zaXRvcnk2MTg3MDgwMw==-flat-gmock-spec-builders.cc,120,129,9,203,209,6
11611,https://htmlpreview.github.io/?https://github.com/Christina96/boilerplate-sample-matches/blob/main/Cpp/caffe-MDEwOlJlcG9zaXRvcnk2MTg3MDgwMw==-flat-lstm_unit_layer.cpp-snap-MDEwOlJlcG9zaXRvcnk0Mjg4MzU3-flat-dt.cpp.html,0.031800391389432484,10,caffe-MDEwOlJlcG9zaXRvcnk2MTg3MDgwMw==-flat-lstm_unit_layer.cpp,snap-MDEwOlJlcG9zaXRvcnk0Mjg4MzU3-flat-dt.cpp,81,82,1,1335,1337,2
12493,https://htmlpreview.github.io/?https://github.com/Christina96/boilerplate-sample-matches/blob/main/Cpp/glm-MDEwOlJlcG9zaXRvcnk4NDM2MzE=-flat-core_func_integer.cpp-abseil-cpp-MDEwOlJlcG9zaXRvcnkxMDQyMzE1NDE=-flat-marshalling_test.cc.html,0.21305841924398625,15,glm-MDEwOlJlcG9zaXRvcnk4NDM2MzE=-flat-core_func_integer.cpp,abseil-cpp-MDEwOlJlcG9zaXRvcnkxMDQyMzE1NDE=-flat-marshalling_test.cc,34,41,7,582,595,13
19186,https://htmlpreview.github.io/?https://github.com/Christina96/boilerplate-sample-matches/blob/main/Cpp/snap-MDEwOlJlcG9zaXRvcnk0Mjg4MzU3-flat-svmmodels.cpp-snap-MDEwOlJlcG9zaXRvcnk0Mjg4MzU3-flat-dt.h.html,0.03420467185761958,9,snap-MDEwOlJlcG9zaXRvcnk0Mjg4MzU3-flat-svmmodels.cpp,snap-MDEwOlJlcG9zaXRvcnk0Mjg4MzU3-flat-dt.h,100,104,4,671,672,1
21763,https://htmlpreview.github.io/?https://github.com/Christina96/boilerplate-sample-matches/blob/main/Cpp/abseil-cpp-MDEwOlJlcG9zaXRvcnkxMDQyMzE1NDE=-flat-substitute.h-tesseract-MDEwOlJlcG9zaXRvcnkyMjg4NzA5NA==-flat-colpartition.h.html,0.057843996494303246,14,abseil-cpp-MDEwOlJlcG9zaXRvcnkxMDQyMzE1NDE=-flat-substitute.h,tesseract-MDEwOlJlcG9zaXRvcnkyMjg4NzA5NA==-flat-colpartition.h,242,266,24,368,379,11
32377,https://htmlpreview.github.io/?https://github.com/Christina96/boilerplate-sample-matches/blob/main/Cpp/abseil-cpp-MDEwOlJlcG9zaXRvcnkxMDQyMzE1NDE=-flat-atomic_hook.h-nano-node-MDEwOlJlcG9zaXRvcnkxOTM0NzM0MA==-flat-service.cpp.html,0.03522504892367906,9,abseil-cpp-MDEwOlJlcG9zaXRvcnkxMDQyMzE1NDE=-flat-atomic_hook.h,nano-node-MDEwOlJlcG9zaXRvcnkxOTM0NzM0MA==-flat-service.cpp,33,46,13,12,16,4
39897,https://htmlpreview.github.io/?https://github.com/Christina96/boilerplate-sample-matches/blob/main/Cpp/snap-MDEwOlJlcG9zaXRvcnk0Mjg4MzU3-flat-numpy.cpp-tesseract-MDEwOlJlcG9zaXRvcnkyMjg4NzA5NA==-flat-imagedata.cpp.html,0.027739251040221916,10,snap-MDEwOlJlcG9zaXRvcnk0Mjg4MzU3-flat-numpy.cpp,tesseract-MDEwOlJlcG9zaXRvcnkyMjg4NzA5NA==-flat-imagedata.cpp,2,4,2,579,581,2
44987,https://htmlpreview.github.io/?https://github.com/Christina96/boilerplate-sample-matches/blob/main/Cpp/snap-MDEwOlJlcG9zaXRvcnk0Mjg4MzU3-flat-circles.h-tesseract-MDEwOlJlcG9zaXRvcnkyMjg4NzA5NA==-flat-lstm.cpp.html,0.14130434782608695,11,snap-MDEwOlJlcG9zaXRvcnk0Mjg4MzU3-flat-circles.h,tesseract-MDEwOlJlcG9zaXRvcnkyMjg4NzA5NA==-flat-lstm.cpp,279,284,5,126,131,5
46739,https://htmlpreview.github.io/?https://github.com/Christina96/boilerplate-sample-matches/blob/main/Cpp/abseil-cpp-MDEwOlJlcG9zaXRvcnkxMDQyMzE1NDE=-flat-statusor_test.cc-snap-MDEwOlJlcG9zaXRvcnk0Mjg4MzU3-flat-svmmodels.cpp.html,0.011241970021413276,11,abseil-cpp-MDEwOlJlcG9zaXRvcnkxMDQyMzE1NDE=-flat-statusor_test.cc,snap-MDEwOlJlcG9zaXRvcnk0Mjg4MzU3-flat-svmmodels.cpp,1217,1226,9,27,35,8
47805,https://htmlpreview.github.io/?https://github.com/Christina96/boilerplate-sample-matches/blob/main/Cpp/notepad-plus-plus-MDEwOlJlcG9zaXRvcnkzMzAxNDgxMQ==-flat-SparseVector.h-snap-MDEwOlJlcG9zaXRvcnk0Mjg4MzU3-flat-gnuplot.h.html,0.010746268656716417,9,notepad-plus-plus-MDEwOlJlcG9zaXRvcnkzMzAxNDgxMQ==-flat-SparseVector.h,snap-MDEwOlJlcG9zaXRvcnk0Mjg4MzU3-flat-gnuplot.h,63,67,4,233,237,4
48606,https://htmlpreview.github.io/?https://github.com/Christina96/boilerplate-sample-matches/blob/main/Cpp/snap-MDEwOlJlcG9zaXRvcnk0Mjg4MzU3-flat-yahoodm.h-snap-MDEwOlJlcG9zaXRvcnk0Mjg4MzU3-flat-hashmp.h.html,0.09031318281136198,12,snap-MDEwOlJlcG9zaXRvcnk0Mjg4MzU3-flat-yahoodm.h,snap-MDEwOlJlcG9zaXRvcnk0Mjg4MzU3-flat-hashmp.h,50,53,3,141,144,3
53120,https://htmlpreview.github.io/?https://github.com/Christina96/boilerplate-sample-matches/blob/main/Cpp/snap-MDEwOlJlcG9zaXRvcnk0Mjg4MzU3-flat-demo-hashvec-benchmark.cpp-snap-MDEwOlJlcG9zaXRvcnk0Mjg4MzU3-flat-linalg.cpp.html,0.03311025008805918,11,snap-MDEwOlJlcG9zaXRvcnk0Mjg4MzU3-flat-demo-hashvec-benchmark.cpp,snap-MDEwOlJlcG9zaXRvcnk0Mjg4MzU3-flat-linalg.cpp,81,92,11,641,647,6
54476,https://htmlpreview.github.io/?https://github.com/Christina96/boilerplate-sample-matches/blob/main/Cpp/nano-node-MDEwOlJlcG9zaXRvcnkxOTM0NzM0MA==-flat-qt.cpp-snap-MDEwOlJlcG9zaXRvcnk0Mjg4MzU3-flat-svmmodels.cpp.html,0.012623985572587917,9,nano-node-MDEwOlJlcG9zaXRvcnkxOTM0NzM0MA==-flat-qt.cpp,snap-MDEwOlJlcG9zaXRvcnk0Mjg4MzU3-flat-svmmodels.cpp,1371,1382,11,739,750,11
55403,https://htmlpreview.github.io/?https://github.com/Christina96/boilerplate-sample-matches/blob/main/Cpp/abseil-cpp-MDEwOlJlcG9zaXRvcnkxMDQyMzE1NDE=-flat-conformance_testing_helpers.h-abseil-cpp-MDEwOlJlcG9zaXRvcnkxMDQyMzE1NDE=-flat-conformance_testing.h.html,0.04252199413489736,9,abseil-cpp-MDEwOlJlcG9zaXRvcnkxMDQyMzE1NDE=-flat-conformance_testing_helpers.h,abseil-cpp-MDEwOlJlcG9zaXRvcnkxMDQyMzE1NDE=-flat-conformance_testing.h,170,173,3,784,787,3
65554,https://htmlpreview.github.io/?https://github.com/Christina96/boilerplate-sample-matches/blob/main/Cpp/caffe-MDEwOlJlcG9zaXRvcnk2MTg3MDgwMw==-flat-pooling_layer.cpp-snap-MDEwOlJlcG9zaXRvcnk0Mjg4MzU3-flat-yahooex.cpp.html,0.0886141164348274,10,caffe-MDEwOlJlcG9zaXRvcnk2MTg3MDgwMw==-flat-pooling_layer.cpp,snap-MDEwOlJlcG9zaXRvcnk0Mjg4MzU3-flat-yahooex.cpp,380,386,6,161,165,4
69624,https://htmlpreview.github.io/?https://github.com/Christina96/boilerplate-sample-matches/blob/main/Cpp/abseil-cpp-MDEwOlJlcG9zaXRvcnkxMDQyMzE1NDE=-flat-civil_time_benchmark.cc-notepad-plus-plus-MDEwOlJlcG9zaXRvcnkzMzAxNDgxMQ==-flat-shortcut.cpp.html,0.022819885900570498,14,abseil-cpp-MDEwOlJlcG9zaXRvcnkxMDQyMzE1NDE=-flat-civil_time_benchmark.cc,notepad-plus-plus-MDEwOlJlcG9zaXRvcnkzMzAxNDgxMQ==-flat-shortcut.cpp,61,86,25,100,107,7
70341,https://htmlpreview.github.io/?https://github.com/Christina96/boilerplate-sample-matches/blob/main/Cpp/tesseract-MDEwOlJlcG9zaXRvcnkyMjg4NzA5NA==-flat-weightmatrix.cpp-snap-MDEwOlJlcG9zaXRvcnk0Mjg4MzU3-flat-test-ggen.cpp.html,0.17082785808147175,11,tesseract-MDEwOlJlcG9zaXRvcnkyMjg4NzA5NA==-flat-weightmatrix.cpp,snap-MDEwOlJlcG9zaXRvcnk0Mjg4MzU3-flat-test-ggen.cpp,101,105,4,272,278,6
71254,https://htmlpreview.github.io/?https://github.com/Christina96/boilerplate-sample-matches/blob/main/Cpp/tesseract-MDEwOlJlcG9zaXRvcnkyMjg4NzA5NA==-flat-colpartition.cpp-notepad-plus-plus-MDEwOlJlcG9zaXRvcnkzMzAxNDgxMQ==-flat-json.hpp.html,0.031496062992125984,11,tesseract-MDEwOlJlcG9zaXRvcnkyMjg4NzA5NA==-flat-colpartition.cpp,notepad-plus-plus-MDEwOlJlcG9zaXRvcnkzMzAxNDgxMQ==-flat-json.hpp,819,828,9,8891,8901,10
73457,https://htmlpreview.github.io/?https://github.com/Christina96/boilerplate-sample-matches/blob/main/Cpp/snap-MDEwOlJlcG9zaXRvcnk0Mjg4MzU3-flat-nntp.h-snap-MDEwOlJlcG9zaXRvcnk0Mjg4MzU3-flat-wixexp.h.html,0.06451612903225806,11,snap-MDEwOlJlcG9zaXRvcnk0Mjg4MzU3-flat-nntp.h,snap-MDEwOlJlcG9zaXRvcnk0Mjg4MzU3-flat-wixexp.h,23,26,3,67,70,3
75498,https://htmlpreview.github.io/?https://github.com/Christina96/boilerplate-sample-matches/blob/main/Cpp/tesseract-MDEwOlJlcG9zaXRvcnkyMjg4NzA5NA==-flat-linefind.cpp-caffe-MDEwOlJlcG9zaXRvcnk2MTg3MDgwMw==-flat-bbox_util.cpp.html,0.05715718225119078,10,tesseract-MDEwOlJlcG9zaXRvcnkyMjg4NzA5NA==-flat-linefind.cpp,caffe-MDEwOlJlcG9zaXRvcnk2MTg3MDgwMw==-flat-bbox_util.cpp,128,135,7,88,94,6
77732,https://htmlpreview.github.io/?https://github.com/Christina96/boilerplate-sample-matches/blob/main/Cpp/tesseract-MDEwOlJlcG9zaXRvcnkyMjg4NzA5NA==-flat-networkbuilder.cpp-tesseract-MDEwOlJlcG9zaXRvcnkyMjg4NzA5NA==-flat-paragraphs.cpp.html,0.037048866176940275,10,tesseract-MDEwOlJlcG9zaXRvcnkyMjg4NzA5NA==-flat-networkbuilder.cpp,tesseract-MDEwOlJlcG9zaXRvcnkyMjg4NzA5NA==-flat-paragraphs.cpp,293,298,5,1064,1070,6
82537,https://htmlpreview.github.io/?https://github.com/Christina96/boilerplate-sample-matches/blob/main/Cpp/snap-MDEwOlJlcG9zaXRvcnk0Mjg4MzU3-flat-tnt.cpp-snap-MDEwOlJlcG9zaXRvcnk0Mjg4MzU3-flat-bowclust.cpp.html,0.2717247463608293,11,snap-MDEwOlJlcG9zaXRvcnk0Mjg4MzU3-flat-tnt.cpp,snap-MDEwOlJlcG9zaXRvcnk0Mjg4MzU3-flat-bowclust.cpp,338,345,7,141,147,6
86878,https://htmlpreview.github.io/?https://github.com/Christina96/boilerplate-sample-matches/blob/main/Cpp/tesseract-MDEwOlJlcG9zaXRvcnkyMjg4NzA5NA==-flat-tablerecog.cpp-snap-MDEwOlJlcG9zaXRvcnk0Mjg4MzU3-flat-bowlearn.cpp.html,0.027083333333333334,12,tesseract-MDEwOlJlcG9zaXRvcnkyMjg4NzA5NA==-flat-tablerecog.cpp,snap-MDEwOlJlcG9zaXRvcnk0Mjg4MzU3-flat-bowlearn.cpp,609,617,8,691,693,2
91057,https://htmlpreview.github.io/?https://github.com/Christina96/boilerplate-sample-matches/blob/main/Cpp/snap-MDEwOlJlcG9zaXRvcnk0Mjg4MzU3-flat-book.h-notepad-plus-plus-MDEwOlJlcG9zaXRvcnkzMzAxNDgxMQ==-flat-concepts.hpp.html,0.04487179487179487,9,snap-MDEwOlJlcG9zaXRvcnk0Mjg4MzU3-flat-book.h,notepad-plus-plus-MDEwOlJlcG9zaXRvcnkzMzAxNDgxMQ==-flat-concepts.hpp,19,20,1,111,112,1
93234,https://htmlpreview.github.io/?https://github.com/Christina96/boilerplate-sample-matches/blob/main/Cpp/snap-MDEwOlJlcG9zaXRvcnk0Mjg4MzU3-flat-ontolight.cpp-snap-MDEwOlJlcG9zaXRvcnk0Mjg4MzU3-flat-bowbs.cpp.html,0.21921037124337064,12,snap-MDEwOlJlcG9zaXRvcnk0Mjg4MzU3-flat-ontolight.cpp,snap-MDEwOlJlcG9zaXRvcnk0Mjg4MzU3-flat-bowbs.cpp,237,243,6,1222,1227,5
96921,https://htmlpreview.github.io/?https://github.com/Christina96/boilerplate-sample-matches/blob/main/Cpp/nano-node-MDEwOlJlcG9zaXRvcnkxOTM0NzM0MA==-flat-websocket_59.cpp-tesseract-MDEwOlJlcG9zaXRvcnkyMjg4NzA5NA==-flat-intmatcher.cpp.html,0.010995052226498075,10,nano-node-MDEwOlJlcG9zaXRvcnkxOTM0NzM0MA==-flat-websocket_59.cpp,tesseract-MDEwOlJlcG9zaXRvcnkyMjg4NzA5NA==-flat-intmatcher.cpp,567,576,9,207,214,7
97279,https://htmlpreview.github.io/?https://github.com/Christina96/boilerplate-sample-matches/blob/main/Cpp/tesseract-MDEwOlJlcG9zaXRvcnkyMjg4NzA5NA==-flat-blobbox.cpp-caffe-MDEwOlJlcG9zaXRvcnk2MTg3MDgwMw==-flat-upgrade_proto.cpp.html,0.08117706747843734,16,tesseract-MDEwOlJlcG9zaXRvcnkyMjg4NzA5NA==-flat-blobbox.cpp,caffe-MDEwOlJlcG9zaXRvcnk2MTg3MDgwMw==-flat-upgrade_proto.cpp,341,352,11,588,591,3
100823,https://htmlpreview.github.io/?https://github.com/Christina96/boilerplate-sample-matches/blob/main/Cpp/snap-MDEwOlJlcG9zaXRvcnk0Mjg4MzU3-flat-agmattr.cpp-snap-MDEwOlJlcG9zaXRvcnk0Mjg4MzU3-flat-kronecker.cpp.html,0.21407501053518752,12,snap-MDEwOlJlcG9zaXRvcnk0Mjg4MzU3-flat-agmattr.cpp,snap-MDEwOlJlcG9zaXRvcnk0Mjg4MzU3-flat-kronecker.cpp,44,49,5,395,397,2
103919,https://htmlpreview.github.io/?https://github.com/Christina96/boilerplate-sample-matches/blob/main/Cpp/caffe-MDEwOlJlcG9zaXRvcnk2MTg3MDgwMw==-flat-gtest-test-part.h-snap-MDEwOlJlcG9zaXRvcnk0Mjg4MzU3-flat-tm.h.html,0.04107142857142857,9,caffe-MDEwOlJlcG9zaXRvcnk2MTg3MDgwMw==-flat-gtest-test-part.h,snap-MDEwOlJlcG9zaXRvcnk0Mjg4MzU3-flat-tm.h,25,27,2,330,331,1
106467,https://htmlpreview.github.io/?https://github.com/Christina96/boilerplate-sample-matches/blob/main/Cpp/nano-node-MDEwOlJlcG9zaXRvcnkxOTM0NzM0MA==-flat-confirmation_height_bounded.cpp-notepad-plus-plus-MDEwOlJlcG9zaXRvcnkzMzAxNDgxMQ==-flat-fileBrowser.cpp.html,0.030167597765363128,9,nano-node-MDEwOlJlcG9zaXRvcnkxOTM0NzM0MA==-flat-confirmation_height_bounded.cpp,notepad-plus-plus-MDEwOlJlcG9zaXRvcnkzMzAxNDgxMQ==-flat-fileBrowser.cpp,372,379,7,448,455,7
110468,https://htmlpreview.github.io/?https://github.com/Christina96/boilerplate-sample-matches/blob/main/Cpp/tesseract-MDEwOlJlcG9zaXRvcnkyMjg4NzA5NA==-flat-osdetect.cpp-snap-MDEwOlJlcG9zaXRvcnk0Mjg4MzU3-flat-svmmodels.cpp.html,0.0683477106834771,10,tesseract-MDEwOlJlcG9zaXRvcnkyMjg4NzA5NA==-flat-osdetect.cpp,snap-MDEwOlJlcG9zaXRvcnk0Mjg4MzU3-flat-svmmodels.cpp,314,319,5,14,20,6
113798,https://htmlpreview.github.io/?https://github.com/Christina96/boilerplate-sample-matches/blob/main/Cpp/tesseract-MDEwOlJlcG9zaXRvcnkyMjg4NzA5NA==-flat-stringrenderer.cpp-tesseract-MDEwOlJlcG9zaXRvcnkyMjg4NzA5NA==-flat-colfind.cpp.html,0.08442211055276382,12,tesseract-MDEwOlJlcG9zaXRvcnkyMjg4NzA5NA==-flat-stringrenderer.cpp,tesseract-MDEwOlJlcG9zaXRvcnkyMjg4NzA5NA==-flat-colfind.cpp,492,504,12,1200,1218,18
116063,https://htmlpreview.github.io/?https://github.com/Christina96/boilerplate-sample-matches/blob/main/Cpp/snap-MDEwOlJlcG9zaXRvcnk0Mjg4MzU3-flat-wixexp.h-abseil-cpp-MDEwOlJlcG9zaXRvcnkxMDQyMzE1NDE=-flat-beta_distribution_test.cc.html,0.033846153846153845,11,snap-MDEwOlJlcG9zaXRvcnk0Mjg4MzU3-flat-wixexp.h,abseil-cpp-MDEwOlJlcG9zaXRvcnkxMDQyMzE1NDE=-flat-beta_distribution_test.cc,70,72,2,193,205,12
118899,https://htmlpreview.github.io/?https://github.com/Christina96/boilerplate-sample-matches/blob/main/Cpp/tesseract-MDEwOlJlcG9zaXRvcnkyMjg4NzA5NA==-flat-scanedg.cpp-snap-MDEwOlJlcG9zaXRvcnk0Mjg4MzU3-flat-svmmodels.cpp.html,0.03781818181818182,10,tesseract-MDEwOlJlcG9zaXRvcnkyMjg4NzA5NA==-flat-scanedg.cpp,snap-MDEwOlJlcG9zaXRvcnk0Mjg4MzU3-flat-svmmodels.cpp,119,122,3,1064,1068,4
119652,https://htmlpreview.github.io/?https://github.com/Christina96/boilerplate-sample-matches/blob/main/Cpp/caffe-MDEwOlJlcG9zaXRvcnk2MTg3MDgwMw==-flat-bbox_util.cpp-snap-MDEwOlJlcG9zaXRvcnk0Mjg4MzU3-flat-unicode.h.html,0.05743927125506073,9,caffe-MDEwOlJlcG9zaXRvcnk2MTg3MDgwMw==-flat-bbox_util.cpp,snap-MDEwOlJlcG9zaXRvcnk0Mjg4MzU3-flat-unicode.h,1673,1675,2,382,384,2
121783,https://htmlpreview.github.io/?https://github.com/Christina96/boilerplate-sample-matches/blob/main/Cpp/tesseract-MDEwOlJlcG9zaXRvcnkyMjg4NzA5NA==-flat-scanutils.cpp-tesseract-MDEwOlJlcG9zaXRvcnkyMjg4NzA5NA==-flat-mastertrainer.cpp.html,0.021778584392014518,9,tesseract-MDEwOlJlcG9zaXRvcnkyMjg4NzA5NA==-flat-scanutils.cpp,tesseract-MDEwOlJlcG9zaXRvcnkyMjg4NzA5NA==-flat-mastertrainer.cpp,237,241,4,163,167,4
122672,https://htmlpreview.github.io/?https://github.com/Christina96/boilerplate-sample-matches/blob/main/Cpp/notepad-plus-plus-MDEwOlJlcG9zaXRvcnkzMzAxNDgxMQ==-flat-states.hpp-abseil-cpp-MDEwOlJlcG9zaXRvcnkxMDQyMzE1NDE=-flat-time_test.cc.html,0.07856341189674523,35,notepad-plus-plus-MDEwOlJlcG9zaXRvcnkzMzAxNDgxMQ==-flat-states.hpp,abseil-cpp-MDEwOlJlcG9zaXRvcnkxMDQyMzE1NDE=-flat-time_test.cc,22,56,34,660,704,44
128924,https://htmlpreview.github.io/?https://github.com/Christina96/boilerplate-sample-matches/blob/main/Cpp/caffe-MDEwOlJlcG9zaXRvcnk2MTg3MDgwMw==-flat-mkl_eltwise_layer.cpp-nano-node-MDEwOlJlcG9zaXRvcnkxOTM0NzM0MA==-flat-entry.cpp.html,0.02616279069767442,9,caffe-MDEwOlJlcG9zaXRvcnk2MTg3MDgwMw==-flat-mkl_eltwise_layer.cpp,nano-node-MDEwOlJlcG9zaXRvcnkxOTM0NzM0MA==-flat-entry.cpp,141,145,4,530,538,8
129533,https://htmlpreview.github.io/?https://github.com/Christina96/boilerplate-sample-matches/blob/main/Cpp/tesseract-MDEwOlJlcG9zaXRvcnkyMjg4NzA5NA==-flat-svpaint.cpp-caffe-MDEwOlJlcG9zaXRvcnk2MTg3MDgwMw==-flat-sgd_solver.cpp.html,0.01933404940923738,9,tesseract-MDEwOlJlcG9zaXRvcnkyMjg4NzA5NA==-flat-svpaint.cpp,caffe-MDEwOlJlcG9zaXRvcnk2MTg3MDgwMw==-flat-sgd_solver.cpp,98,103,5,454,468,14
131531,https://htmlpreview.github.io/?https://github.com/Christina96/boilerplate-sample-matches/blob/main/Cpp/snap-MDEwOlJlcG9zaXRvcnk0Mjg4MzU3-flat-lshtest.cpp-snap-MDEwOlJlcG9zaXRvcnk0Mjg4MzU3-flat-circles.h.html,0.03454231433506045,10,snap-MDEwOlJlcG9zaXRvcnk0Mjg4MzU3-flat-lshtest.cpp,snap-MDEwOlJlcG9zaXRvcnk0Mjg4MzU3-flat-circles.h,19,21,2,23,24,1
135026,https://htmlpreview.github.io/?https://github.com/Christina96/boilerplate-sample-matches/blob/main/Cpp/snap-MDEwOlJlcG9zaXRvcnk0Mjg4MzU3-flat-cyc.cpp-snap-MDEwOlJlcG9zaXRvcnk0Mjg4MzU3-flat-lsionto.cpp.html,0.11568872243029546,10,snap-MDEwOlJlcG9zaXRvcnk0Mjg4MzU3-flat-cyc.cpp,snap-MDEwOlJlcG9zaXRvcnk0Mjg4MzU3-flat-lsionto.cpp,391,400,9,909,913,4
145871,https://htmlpreview.github.io/?https://github.com/Christina96/boilerplate-sample-matches/blob/main/Cpp/tesseract-MDEwOlJlcG9zaXRvcnkyMjg4NzA5NA==-flat-bbgrid.cpp-snap-MDEwOlJlcG9zaXRvcnk0Mjg4MzU3-flat-centr-exp.h.html,0.15859030837004406,10,tesseract-MDEwOlJlcG9zaXRvcnkyMjg4NzA5NA==-flat-bbgrid.cpp,snap-MDEwOlJlcG9zaXRvcnk0Mjg4MzU3-flat-centr-exp.h,76,77,1,36,37,1
148109,https://htmlpreview.github.io/?https://github.com/Christina96/boilerplate-sample-matches/blob/main/Cpp/abseil-cpp-MDEwOlJlcG9zaXRvcnkxMDQyMzE1NDE=-flat-private_handle_accessor.cc-snap-MDEwOlJlcG9zaXRvcnk0Mjg4MzU3-flat-websrv.h.html,0.08928571428571429,10,abseil-cpp-MDEwOlJlcG9zaXRvcnkxMDQyMzE1NDE=-flat-private_handle_accessor.cc,snap-MDEwOlJlcG9zaXRvcnk0Mjg4MzU3-flat-websrv.h,17,27,10,37,40,3
153343,https://htmlpreview.github.io/?https://github.com/Christina96/boilerplate-sample-matches/blob/main/Cpp/nano-node-MDEwOlJlcG9zaXRvcnkxOTM0NzM0MA==-flat-peer_exclusion.cpp-abseil-cpp-MDEwOlJlcG9zaXRvcnkxMDQyMzE1NDE=-flat-charconv.cc.html,0.023778071334214,9,nano-node-MDEwOlJlcG9zaXRvcnkxOTM0NzM0MA==-flat-peer_exclusion.cpp,abseil-cpp-MDEwOlJlcG9zaXRvcnkxMDQyMzE1NDE=-flat-charconv.cc,27,34,7,269,273,4
154214,https://htmlpreview.github.io/?https://github.com/Christina96/boilerplate-sample-matches/blob/main/Cpp/caffe-MDEwOlJlcG9zaXRvcnk2MTg3MDgwMw==-flat-mkl_alternate.hpp-snap-MDEwOlJlcG9zaXRvcnk0Mjg4MzU3-flat-agm.cpp.html,0.03939592908732764,10,caffe-MDEwOlJlcG9zaXRvcnk2MTg3MDgwMw==-flat-mkl_alternate.hpp,snap-MDEwOlJlcG9zaXRvcnk0Mjg4MzU3-flat-agm.cpp,57,58,1,75,75,0
157903,https://htmlpreview.github.io/?https://github.com/Christina96/boilerplate-sample-matches/blob/main/Cpp/notepad-plus-plus-MDEwOlJlcG9zaXRvcnkzMzAxNDgxMQ==-flat-Parameters.h-abseil-cpp-MDEwOlJlcG9zaXRvcnkxMDQyMzE1NDE=-flat-btree.h.html,0.11035054967848994,9,notepad-plus-plus-MDEwOlJlcG9zaXRvcnkzMzAxNDgxMQ==-flat-Parameters.h,abseil-cpp-MDEwOlJlcG9zaXRvcnkxMDQyMzE1NDE=-flat-btree.h,381,382,1,1055,1061,6
161064,https://htmlpreview.github.io/?https://github.com/Christina96/boilerplate-sample-matches/blob/main/Cpp/snap-MDEwOlJlcG9zaXRvcnk0Mjg4MzU3-flat-nyta.h-abseil-cpp-MDEwOlJlcG9zaXRvcnkxMDQyMzE1NDE=-flat-zipf_distribution_test.cc.html,0.026706231454005934,9,snap-MDEwOlJlcG9zaXRvcnk0Mjg4MzU3-flat-nyta.h,abseil-cpp-MDEwOlJlcG9zaXRvcnkxMDQyMzE1NDE=-flat-zipf_distribution_test.cc,46,48,2,78,80,2
166424,https://htmlpreview.github.io/?https://github.com/Christina96/boilerplate-sample-matches/blob/main/Cpp/caffe-MDEwOlJlcG9zaXRvcnk2MTg3MDgwMw==-flat-mkl_pooling_layer.cpp-notepad-plus-plus-MDEwOlJlcG9zaXRvcnkzMzAxNDgxMQ==-flat-WindowsDlg.cpp.html,0.07449392712550608,11,caffe-MDEwOlJlcG9zaXRvcnk2MTg3MDgwMw==-flat-mkl_pooling_layer.cpp,notepad-plus-plus-MDEwOlJlcG9zaXRvcnkzMzAxNDgxMQ==-flat-WindowsDlg.cpp,51,57,6,343,355,12
168313,https://htmlpreview.github.io/?https://github.com/Christina96/boilerplate-sample-matches/blob/main/Cpp/tesseract-MDEwOlJlcG9zaXRvcnkyMjg4NzA5NA==-flat-ligature_table.cpp-snap-MDEwOlJlcG9zaXRvcnk0Mjg4MzU3-flat-fa.cpp.html,0.07860262008733625,9,tesseract-MDEwOlJlcG9zaXRvcnkyMjg4NzA5NA==-flat-ligature_table.cpp,snap-MDEwOlJlcG9zaXRvcnk0Mjg4MzU3-flat-fa.cpp,39,45,6,276,282,6
169062,https://htmlpreview.github.io/?https://github.com/Christina96/boilerplate-sample-matches/blob/main/Cpp/notepad-plus-plus-MDEwOlJlcG9zaXRvcnkzMzAxNDgxMQ==-flat-localization.cpp-snap-MDEwOlJlcG9zaXRvcnk0Mjg4MzU3-flat-timenet.cpp.html,0.07829181494661921,10,notepad-plus-plus-MDEwOlJlcG9zaXRvcnkzMzAxNDgxMQ==-flat-localization.cpp,snap-MDEwOlJlcG9zaXRvcnk0Mjg4MzU3-flat-timenet.cpp,695,707,12,700,704,4
169133,https://htmlpreview.github.io/?https://github.com/Christina96/boilerplate-sample-matches/blob/main/Cpp/snap-MDEwOlJlcG9zaXRvcnk0Mjg4MzU3-flat-linalg.h-snap-MDEwOlJlcG9zaXRvcnk0Mjg4MzU3-flat-bignet.h.html,0.06394316163410302,10,snap-MDEwOlJlcG9zaXRvcnk0Mjg4MzU3-flat-linalg.h,snap-MDEwOlJlcG9zaXRvcnk0Mjg4MzU3-flat-bignet.h,66,67,1,36,37,1
172532,https://htmlpreview.github.io/?https://github.com/Christina96/boilerplate-sample-matches/blob/main/Cpp/snap-MDEwOlJlcG9zaXRvcnk0Mjg4MzU3-flat-agmattr.cpp-snap-MDEwOlJlcG9zaXRvcnk0Mjg4MzU3-flat-hysgen.cpp.html,0.40058479532163743,29,snap-MDEwOlJlcG9zaXRvcnk0Mjg4MzU3-flat-agmattr.cpp,snap-MDEwOlJlcG9zaXRvcnk0Mjg4MzU3-flat-hysgen.cpp,52,69,17,280,298,18
175623,https://htmlpreview.github.io/?https://github.com/Christina96/boilerplate-sample-matches/blob/main/Cpp/tesseract-MDEwOlJlcG9zaXRvcnkyMjg4NzA5NA==-flat-colpartition.h-snap-MDEwOlJlcG9zaXRvcnk0Mjg4MzU3-flat-xmath.h.html,0.12435233160621761,10,tesseract-MDEwOlJlcG9zaXRvcnkyMjg4NzA5NA==-flat-colpartition.h,snap-MDEwOlJlcG9zaXRvcnk0Mjg4MzU3-flat-xmath.h,100,106,6,193,195,2
175956,https://htmlpreview.github.io/?https://github.com/Christina96/boilerplate-sample-matches/blob/main/Cpp/snap-MDEwOlJlcG9zaXRvcnk0Mjg4MzU3-flat-agmattr.cpp-snap-MDEwOlJlcG9zaXRvcnk0Mjg4MzU3-flat-bowclust.cpp.html,0.3315276273022752,9,snap-MDEwOlJlcG9zaXRvcnk0Mjg4MzU3-flat-agmattr.cpp,snap-MDEwOlJlcG9zaXRvcnk0Mjg4MzU3-flat-bowclust.cpp,426,431,5,520,524,4
180590,https://htmlpreview.github.io/?https://github.com/Christina96/boilerplate-sample-matches/blob/main/Cpp/notepad-plus-plus-MDEwOlJlcG9zaXRvcnkzMzAxNDgxMQ==-flat-nsHebrewProber.cpp-abseil-cpp-MDEwOlJlcG9zaXRvcnkxMDQyMzE1NDE=-flat-flag_test.cc.html,0.032667876588021776,9,notepad-plus-plus-MDEwOlJlcG9zaXRvcnkzMzAxNDgxMQ==-flat-nsHebrewProber.cpp,abseil-cpp-MDEwOlJlcG9zaXRvcnkxMDQyMzE1NDE=-flat-flag_test.cc,61,69,8,562,568,6
182044,https://htmlpreview.github.io/?https://github.com/Christina96/boilerplate-sample-matches/blob/main/Cpp/snap-MDEwOlJlcG9zaXRvcnk0Mjg4MzU3-flat-corrgr.cpp-snap-MDEwOlJlcG9zaXRvcnk0Mjg4MzU3-flat-agmfast.cpp.html,0.19304618578100674,11,snap-MDEwOlJlcG9zaXRvcnk0Mjg4MzU3-flat-corrgr.cpp,snap-MDEwOlJlcG9zaXRvcnk0Mjg4MzU3-flat-agmfast.cpp,170,172,2,709,712,3
187152,https://htmlpreview.github.io/?https://github.com/Christina96/boilerplate-sample-matches/blob/main/Cpp/tesseract-MDEwOlJlcG9zaXRvcnkyMjg4NzA5NA==-flat-polyaprx.cpp-abseil-cpp-MDEwOlJlcG9zaXRvcnkxMDQyMzE1NDE=-flat-cord_rep_btree_test.cc.html,0.01184990125082291,9,tesseract-MDEwOlJlcG9zaXRvcnkyMjg4NzA5NA==-flat-polyaprx.cpp,abseil-cpp-MDEwOlJlcG9zaXRvcnkxMDQyMzE1NDE=-flat-cord_rep_btree_test.cc,134,142,8,930,943,13
189739,https://htmlpreview.github.io/?https://github.com/Christina96/boilerplate-sample-matches/blob/main/Cpp/snap-MDEwOlJlcG9zaXRvcnk0Mjg4MzU3-flat-flx.cpp-notepad-plus-plus-MDEwOlJlcG9zaXRvcnkzMzAxNDgxMQ==-flat-Parameters.cpp.html,0.03409850679741475,9,snap-MDEwOlJlcG9zaXRvcnk0Mjg4MzU3-flat-flx.cpp,notepad-plus-plus-MDEwOlJlcG9zaXRvcnkzMzAxNDgxMQ==-flat-Parameters.cpp,395,397,2,705,714,9
190654,https://htmlpreview.github.io/?https://github.com/Christina96/boilerplate-sample-matches/blob/main/Cpp/tesseract-MDEwOlJlcG9zaXRvcnkyMjg4NzA5NA==-flat-output.cpp-tesseract-MDEwOlJlcG9zaXRvcnkyMjg4NzA5NA==-flat-resultiterator_test.cc.html,0.09911054637865312,9,tesseract-MDEwOlJlcG9zaXRvcnkyMjg4NzA5NA==-flat-output.cpp,tesseract-MDEwOlJlcG9zaXRvcnkyMjg4NzA5NA==-flat-resultiterator_test.cc,110,115,5,54,64,10
190808,https://htmlpreview.github.io/?https://github.com/Christina96/boilerplate-sample-matches/blob/main/Cpp/caffe-MDEwOlJlcG9zaXRvcnk2MTg3MDgwMw==-flat-elu_layer.cpp-caffe-MDEwOlJlcG9zaXRvcnk2MTg3MDgwMw==-flat-test_contrastive_loss_layer.cpp.html,0.09473684210526316,9,caffe-MDEwOlJlcG9zaXRvcnk2MTg3MDgwMw==-flat-elu_layer.cpp,caffe-MDEwOlJlcG9zaXRvcnk2MTg3MDgwMw==-flat-test_contrastive_loss_layer.cpp,11,19,8,27,34,7
198981,https://htmlpreview.github.io/?https://github.com/Christina96/boilerplate-sample-matches/blob/main/Cpp/snap-MDEwOlJlcG9zaXRvcnk0Mjg4MzU3-flat-svmbasic.h-snap-MDEwOlJlcG9zaXRvcnk0Mjg4MzU3-flat-ultra.cpp.html,0.027718040621266427,10,snap-MDEwOlJlcG9zaXRvcnk0Mjg4MzU3-flat-svmbasic.h,snap-MDEwOlJlcG9zaXRvcnk0Mjg4MzU3-flat-ultra.cpp,131,135,4,396,399,3
207185,https://htmlpreview.github.io/?https://github.com/Christina96/boilerplate-sample-matches/blob/main/Cpp/notepad-plus-plus-MDEwOlJlcG9zaXRvcnkzMzAxNDgxMQ==-flat-DockingManager.cpp-snap-MDEwOlJlcG9zaXRvcnk0Mjg4MzU3-flat-sock.cpp.html,0.031496062992125984,9,notepad-plus-plus-MDEwOlJlcG9zaXRvcnkzMzAxNDgxMQ==-flat-DockingManager.cpp,snap-MDEwOlJlcG9zaXRvcnk0Mjg4MzU3-flat-sock.cpp,717,726,9,523,529,6
211254,https://htmlpreview.github.io/?https://github.com/Christina96/boilerplate-sample-matches/blob/main/Cpp/caffe-MDEwOlJlcG9zaXRvcnk2MTg3MDgwMw==-flat-psroi_pooling_layer.cpp-caffe-MDEwOlJlcG9zaXRvcnk2MTg3MDgwMw==-flat-net.cpp.html,0.058365758754863814,11,caffe-MDEwOlJlcG9zaXRvcnk2MTg3MDgwMw==-flat-psroi_pooling_layer.cpp,caffe-MDEwOlJlcG9zaXRvcnk2MTg3MDgwMw==-flat-net.cpp,178,185,7,1135,1147,12
212215,https://htmlpreview.github.io/?https://github.com/Christina96/boilerplate-sample-matches/blob/main/Cpp/snap-MDEwOlJlcG9zaXRvcnk0Mjg4MzU3-flat-coda.cpp-tesseract-MDEwOlJlcG9zaXRvcnkyMjg4NzA5NA==-flat-baseapi.cpp.html,0.03262347077480743,10,snap-MDEwOlJlcG9zaXRvcnk0Mjg4MzU3-flat-coda.cpp,tesseract-MDEwOlJlcG9zaXRvcnkyMjg4NzA5NA==-flat-baseapi.cpp,23,35,12,1565,1572,7
212385,https://htmlpreview.github.io/?https://github.com/Christina96/boilerplate-sample-matches/blob/main/Cpp/caffe-MDEwOlJlcG9zaXRvcnk2MTg3MDgwMw==-flat-reshape_layer.cpp-snap-MDEwOlJlcG9zaXRvcnk0Mjg4MzU3-flat-vizmapgks.cpp.html,0.16746739876458477,14,caffe-MDEwOlJlcG9zaXRvcnk2MTg3MDgwMw==-flat-reshape_layer.cpp,snap-MDEwOlJlcG9zaXRvcnk0Mjg4MzU3-flat-vizmapgks.cpp,157,162,5,362,368,6
215505,https://htmlpreview.github.io/?https://github.com/Christina96/boilerplate-sample-matches/blob/main/Cpp/caffe-MDEwOlJlcG9zaXRvcnk2MTg3MDgwMw==-flat-eval_detection_layer.cpp-snap-MDEwOlJlcG9zaXRvcnk0Mjg4MzU3-flat-agmdirected.cpp.html,0.15706806282722513,9,caffe-MDEwOlJlcG9zaXRvcnk2MTg3MDgwMw==-flat-eval_detection_layer.cpp,snap-MDEwOlJlcG9zaXRvcnk0Mjg4MzU3-flat-agmdirected.cpp,184,187,3,216,219,3
216805,https://htmlpreview.github.io/?https://github.com/Christina96/boilerplate-sample-matches/blob/main/Cpp/snap-MDEwOlJlcG9zaXRvcnk0Mjg4MzU3-flat-yahoodm.cpp-snap-MDEwOlJlcG9zaXRvcnk0Mjg4MzU3-flat-agmattr.h.html,0.08809648662821185,10,snap-MDEwOlJlcG9zaXRvcnk0Mjg4MzU3-flat-yahoodm.cpp,snap-MDEwOlJlcG9zaXRvcnk0Mjg4MzU3-flat-agmattr.h,151,153,2,448,450,2
222061,https://htmlpreview.github.io/?https://github.com/Christina96/boilerplate-sample-matches/blob/main/Cpp/caffe-MDEwOlJlcG9zaXRvcnk2MTg3MDgwMw==-flat-layer.hpp-snap-MDEwOlJlcG9zaXRvcnk0Mjg4MzU3-flat-crawler.h.html,0.01721170395869191,10,caffe-MDEwOlJlcG9zaXRvcnk2MTg3MDgwMw==-flat-layer.hpp,snap-MDEwOlJlcG9zaXRvcnk0Mjg4MzU3-flat-crawler.h,106,111,5,205,209,4
240767,https://htmlpreview.github.io/?https://github.com/Christina96/boilerplate-sample-matches/blob/main/Cpp/snap-MDEwOlJlcG9zaXRvcnk0Mjg4MzU3-flat-mmgraph-exp.h-snap-MDEwOlJlcG9zaXRvcnk0Mjg4MzU3-flat-mag.cpp.html,0.2023470839260313,11,snap-MDEwOlJlcG9zaXRvcnk0Mjg4MzU3-flat-mmgraph-exp.h,snap-MDEwOlJlcG9zaXRvcnk0Mjg4MzU3-flat-mag.cpp,262,267,5,1203,1209,6
243757,https://htmlpreview.github.io/?https://github.com/Christina96/boilerplate-sample-matches/blob/main/Cpp/tesseract-MDEwOlJlcG9zaXRvcnkyMjg4NzA5NA==-flat-lstmtrainer.cpp-tesseract-MDEwOlJlcG9zaXRvcnkyMjg4NzA5NA==-flat-paragraphs.cpp.html,0.11524911927528939,10,tesseract-MDEwOlJlcG9zaXRvcnkyMjg4NzA5NA==-flat-lstmtrainer.cpp,tesseract-MDEwOlJlcG9zaXRvcnkyMjg4NzA5NA==-flat-paragraphs.cpp,824,829,5,1296,1304,8
249951,https://htmlpreview.github.io/?https://github.com/Christina96/boilerplate-sample-matches/blob/main/Cpp/snap-MDEwOlJlcG9zaXRvcnk0Mjg4MzU3-flat-lx.cpp-snap-MDEwOlJlcG9zaXRvcnk0Mjg4MzU3-flat-graph_2.cpp.html,0.06475037821482602,10,snap-MDEwOlJlcG9zaXRvcnk0Mjg4MzU3-flat-lx.cpp,snap-MDEwOlJlcG9zaXRvcnk0Mjg4MzU3-flat-graph_2.cpp,676,682,6,4,10,6
260708,https://htmlpreview.github.io/?https://github.com/Christina96/boilerplate-sample-matches/blob/main/Cpp/snap-MDEwOlJlcG9zaXRvcnk0Mjg4MzU3-flat-rinetmatch.h-snap-MDEwOlJlcG9zaXRvcnk0Mjg4MzU3-flat-flx.h.html,0.04566596194503171,9,snap-MDEwOlJlcG9zaXRvcnk0Mjg4MzU3-flat-rinetmatch.h,snap-MDEwOlJlcG9zaXRvcnk0Mjg4MzU3-flat-flx.h,84,85,1,56,58,2
267842,https://htmlpreview.github.io/?https://github.com/Christina96/boilerplate-sample-matches/blob/main/Cpp/tesseract-MDEwOlJlcG9zaXRvcnkyMjg4NzA5NA==-flat-imagedata_test.cc-caffe-MDEwOlJlcG9zaXRvcnk2MTg3MDgwMw==-flat-hinge_loss_layer.cpp.html,0.19095477386934673,9,tesseract-MDEwOlJlcG9zaXRvcnkyMjg4NzA5NA==-flat-imagedata_test.cc,caffe-MDEwOlJlcG9zaXRvcnk2MTg3MDgwMw==-flat-hinge_loss_layer.cpp,67,74,7,10,14,4
271628,https://htmlpreview.github.io/?https://github.com/Christina96/boilerplate-sample-matches/blob/main/Cpp/snap-MDEwOlJlcG9zaXRvcnk0Mjg4MzU3-flat-dm.h-snap-MDEwOlJlcG9zaXRvcnk0Mjg4MzU3-flat-linalg.h.html,0.060218978102189784,11,snap-MDEwOlJlcG9zaXRvcnk0Mjg4MzU3-flat-dm.h,snap-MDEwOlJlcG9zaXRvcnk0Mjg4MzU3-flat-linalg.h,128,131,3,87,89,2
277401,https://htmlpreview.github.io/?https://github.com/Christina96/boilerplate-sample-matches/blob/main/Cpp/abseil-cpp-MDEwOlJlcG9zaXRvcnkxMDQyMzE1NDE=-flat-fast_type_id_test.cc-snap-MDEwOlJlcG9zaXRvcnk0Mjg4MzU3-flat-agmdirected.cpp.html,0.026578073089700997,10,abseil-cpp-MDEwOlJlcG9zaXRvcnkxMDQyMzE1NDE=-flat-fast_type_id_test.cc,snap-MDEwOlJlcG9zaXRvcnk0Mjg4MzU3-flat-agmdirected.cpp,69,71,2,173,174,1
289351,https://htmlpreview.github.io/?https://github.com/Christina96/boilerplate-sample-matches/blob/main/Cpp/snap-MDEwOlJlcG9zaXRvcnk0Mjg4MzU3-flat-amazon.cpp-snap-MDEwOlJlcG9zaXRvcnk0Mjg4MzU3-flat-webbsfetch.cpp.html,0.09717314487632508,13,snap-MDEwOlJlcG9zaXRvcnk0Mjg4MzU3-flat-amazon.cpp,snap-MDEwOlJlcG9zaXRvcnk0Mjg4MzU3-flat-webbsfetch.cpp,147,153,6,456,465,9
292502,https://htmlpreview.github.io/?https://github.com/Christina96/boilerplate-sample-matches/blob/main/Cpp/tesseract-MDEwOlJlcG9zaXRvcnkyMjg4NzA5NA==-flat-validator.cpp-subconverter-MDEwOlJlcG9zaXRvcnkyMTg2ODY3NjM=-flat-main.cpp.html,0.061971830985915494,11,tesseract-MDEwOlJlcG9zaXRvcnkyMjg4NzA5NA==-flat-validator.cpp,subconverter-MDEwOlJlcG9zaXRvcnkyMTg2ODY3NjM=-flat-main.cpp,29,34,5,114,125,11
293520,https://htmlpreview.github.io/?https://github.com/Christina96/boilerplate-sample-matches/blob/main/Cpp/snap-MDEwOlJlcG9zaXRvcnk0Mjg4MzU3-flat-ssqldm.cpp-snap-MDEwOlJlcG9zaXRvcnk0Mjg4MzU3-flat-util.cpp.html,0.022085889570552148,9,snap-MDEwOlJlcG9zaXRvcnk0Mjg4MzU3-flat-ssqldm.cpp,snap-MDEwOlJlcG9zaXRvcnk0Mjg4MzU3-flat-util.cpp,312,313,1,139,142,3
294140,https://htmlpreview.github.io/?https://github.com/Christina96/boilerplate-sample-matches/blob/main/Cpp/snap-MDEwOlJlcG9zaXRvcnk0Mjg4MzU3-flat-book.cpp-snap-MDEwOlJlcG9zaXRvcnk0Mjg4MzU3-flat-webtxtbs.cpp.html,0.037037037037037035,9,snap-MDEwOlJlcG9zaXRvcnk0Mjg4MzU3-flat-book.cpp,snap-MDEwOlJlcG9zaXRvcnk0Mjg4MzU3-flat-webtxtbs.cpp,48,53,5,215,222,7
294427,https://htmlpreview.github.io/?https://github.com/Christina96/boilerplate-sample-matches/blob/main/Cpp/snap-MDEwOlJlcG9zaXRvcnk0Mjg4MzU3-flat-sskj.h-snap-MDEwOlJlcG9zaXRvcnk0Mjg4MzU3-flat-lsionto.h.html,0.05104408352668213,10,snap-MDEwOlJlcG9zaXRvcnk0Mjg4MzU3-flat-sskj.h,snap-MDEwOlJlcG9zaXRvcnk0Mjg4MzU3-flat-lsionto.h,18,19,1,155,156,1
296833,https://htmlpreview.github.io/?https://github.com/Christina96/boilerplate-sample-matches/blob/main/Cpp/snap-MDEwOlJlcG9zaXRvcnk0Mjg4MzU3-flat-rolx.cpp-snap-MDEwOlJlcG9zaXRvcnk0Mjg4MzU3-flat-mag.cpp.html,0.15665399239543726,10,snap-MDEwOlJlcG9zaXRvcnk0Mjg4MzU3-flat-rolx.cpp,snap-MDEwOlJlcG9zaXRvcnk0Mjg4MzU3-flat-mag.cpp,172,174,2,1060,1063,3
300979,https://htmlpreview.github.io/?https://github.com/Christina96/boilerplate-sample-matches/blob/main/Cpp/abseil-cpp-MDEwOlJlcG9zaXRvcnkxMDQyMzE1NDE=-flat-cord_ring_test.cc-notepad-plus-plus-MDEwOlJlcG9zaXRvcnkzMzAxNDgxMQ==-flat-UserDefineDialog.cpp.html,0.013724742661075104,9,abseil-cpp-MDEwOlJlcG9zaXRvcnkxMDQyMzE1NDE=-flat-cord_ring_test.cc,notepad-plus-plus-MDEwOlJlcG9zaXRvcnkzMzAxNDgxMQ==-flat-UserDefineDialog.cpp,586,590,4,24,31,7
302217,https://htmlpreview.github.io/?https://github.com/Christina96/boilerplate-sample-matches/blob/main/Cpp/abseil-cpp-MDEwOlJlcG9zaXRvcnkxMDQyMzE1NDE=-flat-escaping_1.cc-notepad-plus-plus-MDEwOlJlcG9zaXRvcnkzMzAxNDgxMQ==-flat-NppCommands.cpp.html,0.024532352039251762,9,abseil-cpp-MDEwOlJlcG9zaXRvcnkxMDQyMzE1NDE=-flat-escaping_1.cc,notepad-plus-plus-MDEwOlJlcG9zaXRvcnkzMzAxNDgxMQ==-flat-NppCommands.cpp,76,83,7,1934,1944,10
304536,https://htmlpreview.github.io/?https://github.com/Christina96/boilerplate-sample-matches/blob/main/Cpp/snap-MDEwOlJlcG9zaXRvcnk0Mjg4MzU3-flat-hashgenericmp.h-snap-MDEwOlJlcG9zaXRvcnk0Mjg4MzU3-flat-flx.cpp.html,0.07266855066612839,9,snap-MDEwOlJlcG9zaXRvcnk0Mjg4MzU3-flat-hashgenericmp.h,snap-MDEwOlJlcG9zaXRvcnk0Mjg4MzU3-flat-flx.cpp,326,328,2,152,157,5
313825,https://htmlpreview.github.io/?https://github.com/Christina96/boilerplate-sample-matches/blob/main/Cpp/abseil-cpp-MDEwOlJlcG9zaXRvcnkxMDQyMzE1NDE=-flat-marshalling_test.cc-abseil-cpp-MDEwOlJlcG9zaXRvcnkxMDQyMzE1NDE=-flat-btree.h.html,0.01412928293889085,11,abseil-cpp-MDEwOlJlcG9zaXRvcnkxMDQyMzE1NDE=-flat-marshalling_test.cc,abseil-cpp-MDEwOlJlcG9zaXRvcnkxMDQyMzE1NDE=-flat-btree.h,335,365,30,295,306,11
315210,https://htmlpreview.github.io/?https://github.com/Christina96/boilerplate-sample-matches/blob/main/Cpp/notepad-plus-plus-MDEwOlJlcG9zaXRvcnkzMzAxNDgxMQ==-flat-Buffer.cpp-snap-MDEwOlJlcG9zaXRvcnk0Mjg4MzU3-flat-btaserver.cpp.html,0.015931721194879088,9,notepad-plus-plus-MDEwOlJlcG9zaXRvcnkzMzAxNDgxMQ==-flat-Buffer.cpp,snap-MDEwOlJlcG9zaXRvcnk0Mjg4MzU3-flat-btaserver.cpp,123,133,10,437,446,9
315504,https://htmlpreview.github.io/?https://github.com/Christina96/boilerplate-sample-matches/blob/main/Cpp/notepad-plus-plus-MDEwOlJlcG9zaXRvcnkzMzAxNDgxMQ==-flat-SparseVector.h-MMKV-MDEwOlJlcG9zaXRvcnkxNDkxMTE4MTM=-flat-golang-bridge.cpp.html,0.05025125628140704,10,notepad-plus-plus-MDEwOlJlcG9zaXRvcnkzMzAxNDgxMQ==-flat-SparseVector.h,MMKV-MDEwOlJlcG9zaXRvcnkxNDkxMTE4MTM=-flat-golang-bridge.cpp,28,34,6,223,230,7
322909,https://htmlpreview.github.io/?https://github.com/Christina96/boilerplate-sample-matches/blob/main/Cpp/snap-MDEwOlJlcG9zaXRvcnk0Mjg4MzU3-flat-nmobj.cpp-snap-MDEwOlJlcG9zaXRvcnk0Mjg4MzU3-flat-mag.cpp.html,0.20476683937823834,10,snap-MDEwOlJlcG9zaXRvcnk0Mjg4MzU3-flat-nmobj.cpp,snap-MDEwOlJlcG9zaXRvcnk0Mjg4MzU3-flat-mag.cpp,207,210,3,166,170,4
324273,https://htmlpreview.github.io/?https://github.com/Christina96/boilerplate-sample-matches/blob/main/Cpp/tesseract-MDEwOlJlcG9zaXRvcnkyMjg4NzA5NA==-flat-superscript.cpp-tesseract-MDEwOlJlcG9zaXRvcnkyMjg4NzA5NA==-flat-networkio.cpp.html,0.0849740932642487,9,tesseract-MDEwOlJlcG9zaXRvcnkyMjg4NzA5NA==-flat-superscript.cpp,tesseract-MDEwOlJlcG9zaXRvcnkyMjg4NzA5NA==-flat-networkio.cpp,368,374,6,378,384,6
327589,https://htmlpreview.github.io/?https://github.com/Christina96/boilerplate-sample-matches/blob/main/Cpp/snap-MDEwOlJlcG9zaXRvcnk0Mjg4MzU3-flat-sortSource.cpp-snap-MDEwOlJlcG9zaXRvcnk0Mjg4MzU3-flat-btaserver.cpp.html,0.019913419913419914,14,snap-MDEwOlJlcG9zaXRvcnk0Mjg4MzU3-flat-sortSource.cpp,snap-MDEwOlJlcG9zaXRvcnk0Mjg4MzU3-flat-btaserver.cpp,21,28,7,7,14,7
331606,https://htmlpreview.github.io/?https://github.com/Christina96/boilerplate-sample-matches/blob/main/Cpp/snap-MDEwOlJlcG9zaXRvcnk0Mjg4MzU3-flat-fa.cpp-snap-MDEwOlJlcG9zaXRvcnk0Mjg4MzU3-flat-kronecker.cpp.html,0.07940813810110973,13,snap-MDEwOlJlcG9zaXRvcnk0Mjg4MzU3-flat-fa.cpp,snap-MDEwOlJlcG9zaXRvcnk0Mjg4MzU3-flat-kronecker.cpp,80,88,8,549,556,7
334238,https://htmlpreview.github.io/?https://github.com/Christina96/boilerplate-sample-matches/blob/main/Cpp/snap-MDEwOlJlcG9zaXRvcnk0Mjg4MzU3-flat-sortSource.cpp-notepad-plus-plus-MDEwOlJlcG9zaXRvcnkzMzAxNDgxMQ==-flat-VerticalFileSwitcher.cpp.html,0.034055727554179564,11,snap-MDEwOlJlcG9zaXRvcnk0Mjg4MzU3-flat-sortSource.cpp,notepad-plus-plus-MDEwOlJlcG9zaXRvcnkzMzAxNDgxMQ==-flat-VerticalFileSwitcher.cpp,56,59,3,529,541,12
334971,https://htmlpreview.github.io/?https://github.com/Christina96/boilerplate-sample-matches/blob/main/Cpp/snap-MDEwOlJlcG9zaXRvcnk0Mjg4MzU3-flat-cyc.cpp-abseil-cpp-MDEwOlJlcG9zaXRvcnkxMDQyMzE1NDE=-flat-hash_12.h.html,0.013605442176870748,11,snap-MDEwOlJlcG9zaXRvcnk0Mjg4MzU3-flat-cyc.cpp,abseil-cpp-MDEwOlJlcG9zaXRvcnkxMDQyMzE1NDE=-flat-hash_12.h,386,395,9,642,646,4
339244,https://htmlpreview.github.io/?https://github.com/Christina96/boilerplate-sample-matches/blob/main/Cpp/snap-MDEwOlJlcG9zaXRvcnk0Mjg4MzU3-flat-anf.cpp-caffe-MDEwOlJlcG9zaXRvcnk2MTg3MDgwMw==-flat-solver.cpp.html,0.022277227722772276,9,snap-MDEwOlJlcG9zaXRvcnk0Mjg4MzU3-flat-anf.cpp,caffe-MDEwOlJlcG9zaXRvcnk2MTg3MDgwMw==-flat-solver.cpp,33,37,4,402,405,3
346639,https://htmlpreview.github.io/?https://github.com/Christina96/boilerplate-sample-matches/blob/main/Cpp/snap-MDEwOlJlcG9zaXRvcnk0Mjg4MzU3-flat-wbmp.h-snap-MDEwOlJlcG9zaXRvcnk0Mjg4MzU3-flat-ciawfb.h.html,0.1510791366906475,12,snap-MDEwOlJlcG9zaXRvcnk0Mjg4MzU3-flat-wbmp.h,snap-MDEwOlJlcG9zaXRvcnk0Mjg4MzU3-flat-ciawfb.h,29,31,2,19,21,2
347354,https://htmlpreview.github.io/?https://github.com/Christina96/boilerplate-sample-matches/blob/main/Cpp/caffe-MDEwOlJlcG9zaXRvcnk2MTg3MDgwMw==-flat-db_lmdb.hpp-notepad-plus-plus-MDEwOlJlcG9zaXRvcnkzMzAxNDgxMQ==-flat-functionListPanel.cpp.html,0.02252252252252252,10,caffe-MDEwOlJlcG9zaXRvcnk2MTg3MDgwMw==-flat-db_lmdb.hpp,notepad-plus-plus-MDEwOlJlcG9zaXRvcnkzMzAxNDgxMQ==-flat-functionListPanel.cpp,38,45,7,71,80,9
347900,https://htmlpreview.github.io/?https://github.com/Christina96/boilerplate-sample-matches/blob/main/Cpp/tesseract-MDEwOlJlcG9zaXRvcnkyMjg4NzA5NA==-flat-cluster.cpp-snap-MDEwOlJlcG9zaXRvcnk0Mjg4MzU3-flat-gsearch.cpp.html,0.08461131676361713,9,tesseract-MDEwOlJlcG9zaXRvcnkyMjg4NzA5NA==-flat-cluster.cpp,snap-MDEwOlJlcG9zaXRvcnk0Mjg4MzU3-flat-gsearch.cpp,1945,1950,5,1283,1286,3
348949,https://htmlpreview.github.io/?https://github.com/Christina96/boilerplate-sample-matches/blob/main/Cpp/caffe-MDEwOlJlcG9zaXRvcnk2MTg3MDgwMw==-flat-gtest-internal-inl.h-abseil-cpp-MDEwOlJlcG9zaXRvcnkxMDQyMzE1NDE=-flat-cord_rep_ring.cc.html,0.030395136778115502,11,caffe-MDEwOlJlcG9zaXRvcnk2MTg3MDgwMw==-flat-gtest-internal-inl.h,abseil-cpp-MDEwOlJlcG9zaXRvcnkxMDQyMzE1NDE=-flat-cord_rep_ring.cc,88,98,10,388,399,11
350060,https://htmlpreview.github.io/?https://github.com/Christina96/boilerplate-sample-matches/blob/main/Cpp/snap-MDEwOlJlcG9zaXRvcnk0Mjg4MzU3-flat-dnet.h-notepad-plus-plus-MDEwOlJlcG9zaXRvcnkzMzAxNDgxMQ==-flat-FindReplaceDlg.h.html,0.07110091743119266,12,snap-MDEwOlJlcG9zaXRvcnk0Mjg4MzU3-flat-dnet.h,notepad-plus-plus-MDEwOlJlcG9zaXRvcnkzMzAxNDgxMQ==-flat-FindReplaceDlg.h,131,133,2,223,230,7
353060,https://htmlpreview.github.io/?https://github.com/Christina96/boilerplate-sample-matches/blob/main/Cpp/snap-MDEwOlJlcG9zaXRvcnk0Mjg4MzU3-flat-adox.h-snap-MDEwOlJlcG9zaXRvcnk0Mjg4MzU3-flat-gstat.h.html,0.1401015228426396,13,snap-MDEwOlJlcG9zaXRvcnk0Mjg4MzU3-flat-adox.h,snap-MDEwOlJlcG9zaXRvcnk0Mjg4MzU3-flat-gstat.h,95,99,4,157,159,2
354409,https://htmlpreview.github.io/?https://github.com/Christina96/boilerplate-sample-matches/blob/main/Cpp/snap-MDEwOlJlcG9zaXRvcnk0Mjg4MzU3-flat-gstat.h-nano-node-MDEwOlJlcG9zaXRvcnkxOTM0NzM0MA==-flat-cl.hpp.html,0.012147640554430773,10,snap-MDEwOlJlcG9zaXRvcnk0Mjg4MzU3-flat-gstat.h,nano-node-MDEwOlJlcG9zaXRvcnkxOTM0NzM0MA==-flat-cl.hpp,75,77,2,4515,4527,12
356309,https://htmlpreview.github.io/?https://github.com/Christina96/boilerplate-sample-matches/blob/main/Cpp/tesseract-MDEwOlJlcG9zaXRvcnkyMjg4NzA5NA==-flat-lstmrecognizer.cpp-snap-MDEwOlJlcG9zaXRvcnk0Mjg4MzU3-flat-btalarms.cpp.html,0.06691962745774405,9,tesseract-MDEwOlJlcG9zaXRvcnkyMjg4NzA5NA==-flat-lstmrecognizer.cpp,snap-MDEwOlJlcG9zaXRvcnk0Mjg4MzU3-flat-btalarms.cpp,243,246,3,892,894,2
358933,https://htmlpreview.github.io/?https://github.com/Christina96/boilerplate-sample-matches/blob/main/Cpp/tesseract-MDEwOlJlcG9zaXRvcnkyMjg4NzA5NA==-flat-resultiterator.cpp-snap-MDEwOlJlcG9zaXRvcnk0Mjg4MzU3-flat-mmgraph-exp.h.html,0.07361197754210855,11,tesseract-MDEwOlJlcG9zaXRvcnkyMjg4NzA5NA==-flat-resultiterator.cpp,snap-MDEwOlJlcG9zaXRvcnk0Mjg4MzU3-flat-mmgraph-exp.h,110,116,6,962,970,8
362741,https://htmlpreview.github.io/?https://github.com/Christina96/boilerplate-sample-matches/blob/main/Cpp/tesseract-MDEwOlJlcG9zaXRvcnkyMjg4NzA5NA==-flat-networkbuilder.cpp-snap-MDEwOlJlcG9zaXRvcnk0Mjg4MzU3-flat-gstat.cpp.html,0.06706408345752608,17,tesseract-MDEwOlJlcG9zaXRvcnkyMjg4NzA5NA==-flat-networkbuilder.cpp,snap-MDEwOlJlcG9zaXRvcnk0Mjg4MzU3-flat-gstat.cpp,194,209,15,306,314,8
363703,https://htmlpreview.github.io/?https://github.com/Christina96/boilerplate-sample-matches/blob/main/Cpp/caffe-MDEwOlJlcG9zaXRvcnk2MTg3MDgwMw==-flat-spatial_dropout_layer.cpp-snap-MDEwOlJlcG9zaXRvcnk0Mjg4MzU3-flat-ds.h.html,0.010159397442634437,10,caffe-MDEwOlJlcG9zaXRvcnk2MTg3MDgwMw==-flat-spatial_dropout_layer.cpp,snap-MDEwOlJlcG9zaXRvcnk0Mjg4MzU3-flat-ds.h,73,77,4,2036,2040,4
369151,https://htmlpreview.github.io/?https://github.com/Christina96/boilerplate-sample-matches/blob/main/Cpp/snap-MDEwOlJlcG9zaXRvcnk0Mjg4MzU3-flat-rolx.cpp-notepad-plus-plus-MDEwOlJlcG9zaXRvcnkzMzAxNDgxMQ==-flat-ProjectPanel.cpp.html,0.02099125364431487,9,snap-MDEwOlJlcG9zaXRvcnk0Mjg4MzU3-flat-rolx.cpp,notepad-plus-plus-MDEwOlJlcG9zaXRvcnkzMzAxNDgxMQ==-flat-ProjectPanel.cpp,376,381,5,408,413,5
373622,https://htmlpreview.github.io/?https://github.com/Christina96/boilerplate-sample-matches/blob/main/Cpp/snap-MDEwOlJlcG9zaXRvcnk0Mjg4MzU3-flat-yahoodm.cpp-snap-MDEwOlJlcG9zaXRvcnk0Mjg4MzU3-flat-wikinet.cpp.html,0.06841628959276018,11,snap-MDEwOlJlcG9zaXRvcnk0Mjg4MzU3-flat-yahoodm.cpp,snap-MDEwOlJlcG9zaXRvcnk0Mjg4MzU3-flat-wikinet.cpp,430,433,3,2094,2097,3
375910,https://htmlpreview.github.io/?https://github.com/Christina96/boilerplate-sample-matches/blob/main/Cpp/nano-node-MDEwOlJlcG9zaXRvcnkxOTM0NzM0MA==-flat-account_store.cpp-MMKV-MDEwOlJlcG9zaXRvcnkxNDkxMTE4MTM=-flat-MemoryFile.h.html,0.12093023255813953,13,nano-node-MDEwOlJlcG9zaXRvcnkxOTM0NzM0MA==-flat-account_store.cpp,MMKV-MDEwOlJlcG9zaXRvcnkxNDkxMTE4MTM=-flat-MemoryFile.h,43,54,11,45,50,5
380616,https://htmlpreview.github.io/?https://github.com/Christina96/boilerplate-sample-matches/blob/main/Cpp/snap-MDEwOlJlcG9zaXRvcnk0Mjg4MzU3-flat-graphmp-exp.h-snap-MDEwOlJlcG9zaXRvcnk0Mjg4MzU3-flat-yahoobs.h.html,0.1767870868562644,14,snap-MDEwOlJlcG9zaXRvcnk0Mjg4MzU3-flat-graphmp-exp.h,snap-MDEwOlJlcG9zaXRvcnk0Mjg4MzU3-flat-yahoobs.h,19,21,2,105,108,3
381902,https://htmlpreview.github.io/?https://github.com/Christina96/boilerplate-sample-matches/blob/main/Cpp/tesseract-MDEwOlJlcG9zaXRvcnkyMjg4NzA5NA==-flat-rect.cpp-snap-MDEwOlJlcG9zaXRvcnk0Mjg4MzU3-flat-gsearch.h.html,0.02595529920692141,9,tesseract-MDEwOlJlcG9zaXRvcnkyMjg4NzA5NA==-flat-rect.cpp,snap-MDEwOlJlcG9zaXRvcnk0Mjg4MzU3-flat-gsearch.h,180,183,3,365,366,1
383104,https://htmlpreview.github.io/?https://github.com/Christina96/boilerplate-sample-matches/blob/main/Cpp/caffe-MDEwOlJlcG9zaXRvcnk2MTg3MDgwMw==-flat-caffe.cpp-snap-MDEwOlJlcG9zaXRvcnk0Mjg4MzU3-flat-ghash.cpp.html,0.13490725126475547,9,caffe-MDEwOlJlcG9zaXRvcnk2MTg3MDgwMw==-flat-caffe.cpp,snap-MDEwOlJlcG9zaXRvcnk0Mjg4MzU3-flat-ghash.cpp,506,513,7,362,369,7
386274,https://htmlpreview.github.io/?https://github.com/Christina96/boilerplate-sample-matches/blob/main/Cpp/snap-MDEwOlJlcG9zaXRvcnk0Mjg4MzU3-flat-bd.h-caffe-MDEwOlJlcG9zaXRvcnk2MTg3MDgwMw==-flat-bbox_util.cpp.html,0.022639691714836225,10,snap-MDEwOlJlcG9zaXRvcnk0Mjg4MzU3-flat-bd.h,caffe-MDEwOlJlcG9zaXRvcnk2MTg3MDgwMw==-flat-bbox_util.cpp,314,317,3,401,407,6
387281,https://htmlpreview.github.io/?https://github.com/Christina96/boilerplate-sample-matches/blob/main/Cpp/tesseract-MDEwOlJlcG9zaXRvcnkyMjg4NzA5NA==-flat-stopper.cpp-abseil-cpp-MDEwOlJlcG9zaXRvcnkxMDQyMzE1NDE=-flat-escaping_test.cc.html,0.013588634959851761,11,tesseract-MDEwOlJlcG9zaXRvcnkyMjg4NzA5NA==-flat-stopper.cpp,abseil-cpp-MDEwOlJlcG9zaXRvcnkxMDQyMzE1NDE=-flat-escaping_test.cc,33,42,9,36,45,9
409729,https://htmlpreview.github.io/?https://github.com/Christina96/boilerplate-sample-matches/blob/main/Cpp/tesseract-MDEwOlJlcG9zaXRvcnkyMjg4NzA5NA==-flat-apiexample_test.cc-snap-MDEwOlJlcG9zaXRvcnk0Mjg4MzU3-flat-agm.cpp.html,0.013192612137203167,10,tesseract-MDEwOlJlcG9zaXRvcnkyMjg4NzA5NA==-flat-apiexample_test.cc,snap-MDEwOlJlcG9zaXRvcnk0Mjg4MzU3-flat-agm.cpp,26,30,4,73,75,2
411177,https://htmlpreview.github.io/?https://github.com/Christina96/boilerplate-sample-matches/blob/main/Cpp/tesseract-MDEwOlJlcG9zaXRvcnkyMjg4NzA5NA==-flat-dppoint.h-snap-MDEwOlJlcG9zaXRvcnk0Mjg4MzU3-flat-odbc.h.html,0.08,10,tesseract-MDEwOlJlcG9zaXRvcnkyMjg4NzA5NA==-flat-dppoint.h,snap-MDEwOlJlcG9zaXRvcnk0Mjg4MzU3-flat-odbc.h,19,25,6,76,78,2
412471,https://htmlpreview.github.io/?https://github.com/Christina96/boilerplate-sample-matches/blob/main/Cpp/caffe-MDEwOlJlcG9zaXRvcnk2MTg3MDgwMw==-flat-test_mkl_deconvolution_layer.cpp-caffe-MDEwOlJlcG9zaXRvcnk2MTg3MDgwMw==-flat-upgrade_proto.cpp.html,0.035578144853875476,19,caffe-MDEwOlJlcG9zaXRvcnk2MTg3MDgwMw==-flat-test_mkl_deconvolution_layer.cpp,caffe-MDEwOlJlcG9zaXRvcnk2MTg3MDgwMw==-flat-upgrade_proto.cpp,292,307,15,190,199,9
416590,https://htmlpreview.github.io/?https://github.com/Christina96/boilerplate-sample-matches/blob/main/Cpp/snap-MDEwOlJlcG9zaXRvcnk0Mjg4MzU3-flat-google.h-snap-MDEwOlJlcG9zaXRvcnk0Mjg4MzU3-flat-bignet.h.html,0.03476245654692932,10,snap-MDEwOlJlcG9zaXRvcnk0Mjg4MzU3-flat-google.h,snap-MDEwOlJlcG9zaXRvcnk0Mjg4MzU3-flat-bignet.h,123,124,1,111,114,3
419072,https://htmlpreview.github.io/?https://github.com/Christina96/boilerplate-sample-matches/blob/main/Cpp/caffe-MDEwOlJlcG9zaXRvcnk2MTg3MDgwMw==-flat-gmock-matchers.h-snap-MDEwOlJlcG9zaXRvcnk0Mjg4MzU3-flat-table.cpp.html,0.05032169117647059,9,caffe-MDEwOlJlcG9zaXRvcnk2MTg3MDgwMw==-flat-gmock-matchers.h,snap-MDEwOlJlcG9zaXRvcnk0Mjg4MzU3-flat-table.cpp,1717,1726,9,1795,1802,7
420963,https://htmlpreview.github.io/?https://github.com/Christina96/boilerplate-sample-matches/blob/main/Cpp/tesseract-MDEwOlJlcG9zaXRvcnkyMjg4NzA5NA==-flat-sampleiterator.cpp-snap-MDEwOlJlcG9zaXRvcnk0Mjg4MzU3-flat-dt.h.html,0.012318696602424002,11,tesseract-MDEwOlJlcG9zaXRvcnkyMjg4NzA5NA==-flat-sampleiterator.cpp,snap-MDEwOlJlcG9zaXRvcnk0Mjg4MzU3-flat-dt.h,90,96,6,632,634,2
422052,https://htmlpreview.github.io/?https://github.com/Christina96/boilerplate-sample-matches/blob/main/Cpp/tesseract-MDEwOlJlcG9zaXRvcnkyMjg4NzA5NA==-flat-sorthelper.h-notepad-plus-plus-MDEwOlJlcG9zaXRvcnkzMzAxNDgxMQ==-flat-VerticalFileSwitcher.cpp.html,0.03215434083601286,10,tesseract-MDEwOlJlcG9zaXRvcnkyMjg4NzA5NA==-flat-sorthelper.h,notepad-plus-plus-MDEwOlJlcG9zaXRvcnkzMzAxNDgxMQ==-flat-VerticalFileSwitcher.cpp,22,29,7,515,524,9
422109,https://htmlpreview.github.io/?https://github.com/Christina96/boilerplate-sample-matches/blob/main/Cpp/tesseract-MDEwOlJlcG9zaXRvcnkyMjg4NzA5NA==-flat-resultiterator_test.cc-abseil-cpp-MDEwOlJlcG9zaXRvcnkxMDQyMzE1NDE=-flat-cordz_info_statistics_test.cc.html,0.022123893805309734,10,tesseract-MDEwOlJlcG9zaXRvcnkyMjg4NzA5NA==-flat-resultiterator_test.cc,abseil-cpp-MDEwOlJlcG9zaXRvcnkxMDQyMzE1NDE=-flat-cordz_info_statistics_test.cc,91,97,6,404,409,5
423459,https://htmlpreview.github.io/?https://github.com/Christina96/boilerplate-sample-matches/blob/main/Cpp/abseil-cpp-MDEwOlJlcG9zaXRvcnkxMDQyMzE1NDE=-flat-elf_mem_image.cc-notepad-plus-plus-MDEwOlJlcG9zaXRvcnkzMzAxNDgxMQ==-flat-Sorters.h.html,0.03805496828752643,9,abseil-cpp-MDEwOlJlcG9zaXRvcnkxMDQyMzE1NDE=-flat-elf_mem_image.cc,notepad-plus-plus-MDEwOlJlcG9zaXRvcnkzMzAxNDgxMQ==-flat-Sorters.h,15,16,1,492,497,5
427966,https://htmlpreview.github.io/?https://github.com/Christina96/boilerplate-sample-matches/blob/main/Cpp/subconverter-MDEwOlJlcG9zaXRvcnkyMTg2ODY3NjM=-flat-settings.cpp-abseil-cpp-MDEwOlJlcG9zaXRvcnkxMDQyMzE1NDE=-flat-time_zone_format.cc.html,0.050620347394540945,9,subconverter-MDEwOlJlcG9zaXRvcnkyMTg2ODY3NjM=-flat-settings.cpp,abseil-cpp-MDEwOlJlcG9zaXRvcnkxMDQyMzE1NDE=-flat-time_zone_format.cc,681,689,8,279,288,9
428210,https://htmlpreview.github.io/?https://github.com/Christina96/boilerplate-sample-matches/blob/main/Cpp/tesseract-MDEwOlJlcG9zaXRvcnkyMjg4NzA5NA==-flat-devanagari_processing.h-snap-MDEwOlJlcG9zaXRvcnk0Mjg4MzU3-flat-email.h.html,0.043859649122807015,10,tesseract-MDEwOlJlcG9zaXRvcnkyMjg4NzA5NA==-flat-devanagari_processing.h,snap-MDEwOlJlcG9zaXRvcnk0Mjg4MzU3-flat-email.h,27,32,5,121,122,1
428706,https://htmlpreview.github.io/?https://github.com/Christina96/boilerplate-sample-matches/blob/main/Cpp/snap-MDEwOlJlcG9zaXRvcnk0Mjg4MzU3-flat-wordco.cpp-snap-MDEwOlJlcG9zaXRvcnk0Mjg4MzU3-flat-bignet.h.html,0.04918032786885246,9,snap-MDEwOlJlcG9zaXRvcnk0Mjg4MzU3-flat-wordco.cpp,snap-MDEwOlJlcG9zaXRvcnk0Mjg4MzU3-flat-bignet.h,232,238,6,673,675,2
434213,https://htmlpreview.github.io/?https://github.com/Christina96/boilerplate-sample-matches/blob/main/Cpp/notepad-plus-plus-MDEwOlJlcG9zaXRvcnkzMzAxNDgxMQ==-flat-winmain.cpp-snap-MDEwOlJlcG9zaXRvcnk0Mjg4MzU3-flat-appsrv.cpp.html,0.07252124645892351,9,notepad-plus-plus-MDEwOlJlcG9zaXRvcnkzMzAxNDgxMQ==-flat-winmain.cpp,snap-MDEwOlJlcG9zaXRvcnk0Mjg4MzU3-flat-appsrv.cpp,478,485,7,20,28,8
435196,https://htmlpreview.github.io/?https://github.com/Christina96/boilerplate-sample-matches/blob/main/Cpp/snap-MDEwOlJlcG9zaXRvcnk0Mjg4MzU3-flat-subprocess.cpp-tesseract-MDEwOlJlcG9zaXRvcnkyMjg4NzA5NA==-flat-shapetable.cpp.html,0.024965325936199722,9,snap-MDEwOlJlcG9zaXRvcnk0Mjg4MzU3-flat-subprocess.cpp,tesseract-MDEwOlJlcG9zaXRvcnkyMjg4NzA5NA==-flat-shapetable.cpp,187,199,12,246,252,6
436100,https://htmlpreview.github.io/?https://github.com/Christina96/boilerplate-sample-matches/blob/main/Cpp/snap-MDEwOlJlcG9zaXRvcnk0Mjg4MzU3-flat-agmdirected.h-caffe-MDEwOlJlcG9zaXRvcnk2MTg3MDgwMw==-flat-mpicxx.h.html,0.011126031076155764,10,snap-MDEwOlJlcG9zaXRvcnk0Mjg4MzU3-flat-agmdirected.h,caffe-MDEwOlJlcG9zaXRvcnk2MTg3MDgwMw==-flat-mpicxx.h,40,43,3,1204,1205,1
442368,https://htmlpreview.github.io/?https://github.com/Christina96/boilerplate-sample-matches/blob/main/Cpp/tesseract-MDEwOlJlcG9zaXRvcnkyMjg4NzA5NA==-flat-statistc.cpp-snap-MDEwOlJlcG9zaXRvcnk0Mjg4MzU3-flat-bignet.h.html,0.044194756554307116,9,tesseract-MDEwOlJlcG9zaXRvcnkyMjg4NzA5NA==-flat-statistc.cpp,snap-MDEwOlJlcG9zaXRvcnk0Mjg4MzU3-flat-bignet.h,81,84,3,546,550,4
448637,https://htmlpreview.github.io/?https://github.com/Christina96/boilerplate-sample-matches/blob/main/Cpp/snap-MDEwOlJlcG9zaXRvcnk0Mjg4MzU3-flat-coda.cpp-tesseract-MDEwOlJlcG9zaXRvcnkyMjg4NzA5NA==-flat-degradeimage.cpp.html,0.22,10,snap-MDEwOlJlcG9zaXRvcnk0Mjg4MzU3-flat-coda.cpp,tesseract-MDEwOlJlcG9zaXRvcnkyMjg4NzA5NA==-flat-degradeimage.cpp,31,38,7,173,179,6
450393,https://htmlpreview.github.io/?https://github.com/Christina96/boilerplate-sample-matches/blob/main/Cpp/notepad-plus-plus-MDEwOlJlcG9zaXRvcnkzMzAxNDgxMQ==-flat-DocTabView.cpp-snap-MDEwOlJlcG9zaXRvcnk0Mjg4MzU3-flat-url.cpp.html,0.042269187986651836,9,notepad-plus-plus-MDEwOlJlcG9zaXRvcnkzMzAxNDgxMQ==-flat-DocTabView.cpp,snap-MDEwOlJlcG9zaXRvcnk0Mjg4MzU3-flat-url.cpp,104,111,7,308,313,5
459031,https://htmlpreview.github.io/?https://github.com/Christina96/boilerplate-sample-matches/blob/main/Cpp/snap-MDEwOlJlcG9zaXRvcnk0Mjg4MzU3-flat-tbval.cpp-snap-MDEwOlJlcG9zaXRvcnk0Mjg4MzU3-flat-http.cpp.html,0.07176709546377792,9,snap-MDEwOlJlcG9zaXRvcnk0Mjg4MzU3-flat-tbval.cpp,snap-MDEwOlJlcG9zaXRvcnk0Mjg4MzU3-flat-http.cpp,98,101,3,689,696,7
467545,https://htmlpreview.github.io/?https://github.com/Christina96/boilerplate-sample-matches/blob/main/Cpp/snap-MDEwOlJlcG9zaXRvcnk0Mjg4MzU3-flat-ggen.h-snap-MDEwOlJlcG9zaXRvcnk0Mjg4MzU3-flat-network.h.html,0.025207142023573346,10,snap-MDEwOlJlcG9zaXRvcnk0Mjg4MzU3-flat-ggen.h,snap-MDEwOlJlcG9zaXRvcnk0Mjg4MzU3-flat-network.h,134,137,3,220,223,3
468543,https://htmlpreview.github.io/?https://github.com/Christina96/boilerplate-sample-matches/blob/main/Cpp/snap-MDEwOlJlcG9zaXRvcnk0Mjg4MzU3-flat-appsrv.h-nano-node-MDEwOlJlcG9zaXRvcnkxOTM0NzM0MA==-flat-node_46.cpp.html,0.039301310043668124,12,snap-MDEwOlJlcG9zaXRvcnk0Mjg4MzU3-flat-appsrv.h,nano-node-MDEwOlJlcG9zaXRvcnkxOTM0NzM0MA==-flat-node_46.cpp,122,125,3,1306,1320,14
470615,https://htmlpreview.github.io/?https://github.com/Christina96/boilerplate-sample-matches/blob/main/Cpp/tesseract-MDEwOlJlcG9zaXRvcnkyMjg4NzA5NA==-flat-blamer.h-MMKV-MDEwOlJlcG9zaXRvcnkxNDkxMTE4MTM=-flat-openssl_aes_core.cpp.html,0.036885245901639344,9,tesseract-MDEwOlJlcG9zaXRvcnkyMjg4NzA5NA==-flat-blamer.h,MMKV-MDEwOlJlcG9zaXRvcnkxNDkxMTE4MTM=-flat-openssl_aes_core.cpp,139,147,8,689,692,3
473108,https://htmlpreview.github.io/?https://github.com/Christina96/boilerplate-sample-matches/blob/main/Cpp/abseil-cpp-MDEwOlJlcG9zaXRvcnkxMDQyMzE1NDE=-flat-cord_rep_btree_test.cc-snap-MDEwOlJlcG9zaXRvcnk0Mjg4MzU3-flat-pi.cpp.html,0.026694766420793818,10,abseil-cpp-MDEwOlJlcG9zaXRvcnkxMDQyMzE1NDE=-flat-cord_rep_btree_test.cc,snap-MDEwOlJlcG9zaXRvcnk0Mjg4MzU3-flat-pi.cpp,903,908,5,101,108,7
480145,https://htmlpreview.github.io/?https://github.com/Christina96/boilerplate-sample-matches/blob/main/Cpp/abseil-cpp-MDEwOlJlcG9zaXRvcnkxMDQyMzE1NDE=-flat-time_zone_format.cc-snap-MDEwOlJlcG9zaXRvcnk0Mjg4MzU3-flat-timenet.cpp.html,0.05469593378913278,11,abseil-cpp-MDEwOlJlcG9zaXRvcnkxMDQyMzE1NDE=-flat-time_zone_format.cc,snap-MDEwOlJlcG9zaXRvcnk0Mjg4MzU3-flat-timenet.cpp,474,480,6,941,946,5
480523,https://htmlpreview.github.io/?https://github.com/Christina96/boilerplate-sample-matches/blob/main/Cpp/caffe-MDEwOlJlcG9zaXRvcnk2MTg3MDgwMw==-flat-mkl_eltwise_layer.cpp-abseil-cpp-MDEwOlJlcG9zaXRvcnkxMDQyMzE1NDE=-flat-time_zone_libc.cc.html,0.03597122302158273,10,caffe-MDEwOlJlcG9zaXRvcnk2MTg3MDgwMw==-flat-mkl_eltwise_layer.cpp,abseil-cpp-MDEwOlJlcG9zaXRvcnkxMDQyMzE1NDE=-flat-time_zone_libc.cc,141,149,8,128,134,6
482440,https://htmlpreview.github.io/?https://github.com/Christina96/boilerplate-sample-matches/blob/main/Cpp/abseil-cpp-MDEwOlJlcG9zaXRvcnkxMDQyMzE1NDE=-flat-city.cc-snap-MDEwOlJlcG9zaXRvcnk0Mjg4MzU3-flat-vizmapgks.cpp.html,0.03581267217630854,16,abseil-cpp-MDEwOlJlcG9zaXRvcnkxMDQyMzE1NDE=-flat-city.cc,snap-MDEwOlJlcG9zaXRvcnk0Mjg4MzU3-flat-vizmapgks.cpp,87,100,13,3,18,15
484901,https://htmlpreview.github.io/?https://github.com/Christina96/boilerplate-sample-matches/blob/main/Cpp/caffe-MDEwOlJlcG9zaXRvcnk2MTg3MDgwMw==-flat-eval_detection_layer.cpp-snap-MDEwOlJlcG9zaXRvcnk0Mjg4MzU3-flat-email.cpp.html,0.11678832116788321,14,caffe-MDEwOlJlcG9zaXRvcnk2MTg3MDgwMw==-flat-eval_detection_layer.cpp,snap-MDEwOlJlcG9zaXRvcnk0Mjg4MzU3-flat-email.cpp,98,105,7,101,107,6
497707,https://htmlpreview.github.io/?https://github.com/Christina96/boilerplate-sample-matches/blob/main/Cpp/snap-MDEwOlJlcG9zaXRvcnk0Mjg4MzU3-flat-centr.cpp-tesseract-MDEwOlJlcG9zaXRvcnkyMjg4NzA5NA==-flat-makerow.cpp.html,0.06213364595545135,9,snap-MDEwOlJlcG9zaXRvcnk0Mjg4MzU3-flat-centr.cpp,tesseract-MDEwOlJlcG9zaXRvcnkyMjg4NzA5NA==-flat-makerow.cpp,471,477,6,597,613,16
499403,https://htmlpreview.github.io/?https://github.com/Christina96/boilerplate-sample-matches/blob/main/Cpp/snap-MDEwOlJlcG9zaXRvcnk0Mjg4MzU3-flat-priorityqueue.h-snap-MDEwOlJlcG9zaXRvcnk0Mjg4MzU3-flat-bowclust.cpp.html,0.022538552787663108,9,snap-MDEwOlJlcG9zaXRvcnk0Mjg4MzU3-flat-priorityqueue.h,snap-MDEwOlJlcG9zaXRvcnk0Mjg4MzU3-flat-bowclust.cpp,56,61,5,310,316,6
500218,https://htmlpreview.github.io/?https://github.com/Christina96/boilerplate-sample-matches/blob/main/Cpp/tesseract-MDEwOlJlcG9zaXRvcnkyMjg4NzA5NA==-flat-fixxht.cpp-snap-MDEwOlJlcG9zaXRvcnk0Mjg4MzU3-flat-bowclust.cpp.html,0.03555045871559633,10,tesseract-MDEwOlJlcG9zaXRvcnkyMjg4NzA5NA==-flat-fixxht.cpp,snap-MDEwOlJlcG9zaXRvcnk0Mjg4MzU3-flat-bowclust.cpp,45,51,6,146,151,5
510318,https://htmlpreview.github.io/?https://github.com/Christina96/boilerplate-sample-matches/blob/main/Cpp/nano-node-MDEwOlJlcG9zaXRvcnkxOTM0NzM0MA==-flat-logging.cpp-tesseract-MDEwOlJlcG9zaXRvcnkyMjg4NzA5NA==-flat-blobbox.h.html,0.15217391304347827,9,nano-node-MDEwOlJlcG9zaXRvcnkxOTM0NzM0MA==-flat-logging.cpp,tesseract-MDEwOlJlcG9zaXRvcnkyMjg4NzA5NA==-flat-blobbox.h,202,210,8,331,337,6
513014,https://htmlpreview.github.io/?https://github.com/Christina96/boilerplate-sample-matches/blob/main/Cpp/caffe-MDEwOlJlcG9zaXRvcnk2MTg3MDgwMw==-flat-async_param_server.cpp-tesseract-MDEwOlJlcG9zaXRvcnkyMjg4NzA5NA==-flat-tablefind.cpp.html,0.03790924755887421,10,caffe-MDEwOlJlcG9zaXRvcnk2MTg3MDgwMw==-flat-async_param_server.cpp,tesseract-MDEwOlJlcG9zaXRvcnkyMjg4NzA5NA==-flat-tablefind.cpp,122,128,6,1332,1337,5
516166,https://htmlpreview.github.io/?https://github.com/Christina96/boilerplate-sample-matches/blob/main/Cpp/tesseract-MDEwOlJlcG9zaXRvcnkyMjg4NzA5NA==-flat-lstm_test.h-nano-node-MDEwOlJlcG9zaXRvcnkxOTM0NzM0MA==-flat-block_store_64.cpp.html,0.05641025641025641,11,tesseract-MDEwOlJlcG9zaXRvcnkyMjg4NzA5NA==-flat-lstm_test.h,nano-node-MDEwOlJlcG9zaXRvcnkxOTM0NzM0MA==-flat-block_store_64.cpp,32,39,7,154,163,9
516769,https://htmlpreview.github.io/?https://github.com/Christina96/boilerplate-sample-matches/blob/main/Cpp/caffe-MDEwOlJlcG9zaXRvcnk2MTg3MDgwMw==-flat-base_conv_layer.cpp-snap-MDEwOlJlcG9zaXRvcnk0Mjg4MzU3-flat-linkpred.cpp.html,0.08680351906158358,9,caffe-MDEwOlJlcG9zaXRvcnk2MTg3MDgwMw==-flat-base_conv_layer.cpp,snap-MDEwOlJlcG9zaXRvcnk0Mjg4MzU3-flat-linkpred.cpp,32,38,6,619,625,6
517799,https://htmlpreview.github.io/?https://github.com/Christina96/boilerplate-sample-matches/blob/main/Cpp/tesseract-MDEwOlJlcG9zaXRvcnkyMjg4NzA5NA==-flat-genericvector.h-snap-MDEwOlJlcG9zaXRvcnk0Mjg4MzU3-flat-semspace.cpp.html,0.052655889145496536,10,tesseract-MDEwOlJlcG9zaXRvcnkyMjg4NzA5NA==-flat-genericvector.h,snap-MDEwOlJlcG9zaXRvcnk0Mjg4MzU3-flat-semspace.cpp,340,345,5,725,736,11
519903,https://htmlpreview.github.io/?https://github.com/Christina96/boilerplate-sample-matches/blob/main/Cpp/snap-MDEwOlJlcG9zaXRvcnk0Mjg4MzU3-flat-test-TUndirNet.cpp-snap-MDEwOlJlcG9zaXRvcnk0Mjg4MzU3-flat-nmobj.cpp.html,0.030067895247332686,11,snap-MDEwOlJlcG9zaXRvcnk0Mjg4MzU3-flat-test-TUndirNet.cpp,snap-MDEwOlJlcG9zaXRvcnk0Mjg4MzU3-flat-nmobj.cpp,166,176,10,696,701,5
525304,https://htmlpreview.github.io/?https://github.com/Christina96/boilerplate-sample-matches/blob/main/Cpp/snap-MDEwOlJlcG9zaXRvcnk0Mjg4MzU3-flat-gridvcl.cpp-abseil-cpp-MDEwOlJlcG9zaXRvcnkxMDQyMzE1NDE=-flat-cord_rep_btree_test.cc.html,0.01824632539280284,9,snap-MDEwOlJlcG9zaXRvcnk0Mjg4MzU3-flat-gridvcl.cpp,abseil-cpp-MDEwOlJlcG9zaXRvcnkxMDQyMzE1NDE=-flat-cord_rep_btree_test.cc,349,361,12,678,695,17
532721,https://htmlpreview.github.io/?https://github.com/Christina96/boilerplate-sample-matches/blob/main/Cpp/snap-MDEwOlJlcG9zaXRvcnk0Mjg4MzU3-flat-lsionto.h-tesseract-MDEwOlJlcG9zaXRvcnkyMjg4NzA5NA==-flat-unicharset.h.html,0.1679571173317451,13,snap-MDEwOlJlcG9zaXRvcnk0Mjg4MzU3-flat-lsionto.h,tesseract-MDEwOlJlcG9zaXRvcnkyMjg4NzA5NA==-flat-unicharset.h,312,315,3,122,124,2
537578,https://htmlpreview.github.io/?https://github.com/Christina96/boilerplate-sample-matches/blob/main/Cpp/snap-MDEwOlJlcG9zaXRvcnk0Mjg4MzU3-flat-tb.h-snap-MDEwOlJlcG9zaXRvcnk0Mjg4MzU3-flat-network.h.html,0.05407872219053052,10,snap-MDEwOlJlcG9zaXRvcnk0Mjg4MzU3-flat-tb.h,snap-MDEwOlJlcG9zaXRvcnk0Mjg4MzU3-flat-network.h,96,100,4,504,505,1
538608,https://htmlpreview.github.io/?https://github.com/Christina96/boilerplate-sample-matches/blob/main/Cpp/notepad-plus-plus-MDEwOlJlcG9zaXRvcnkzMzAxNDgxMQ==-flat-TabBar.cpp-snap-MDEwOlJlcG9zaXRvcnk0Mjg4MzU3-flat-bignet.h.html,0.042464114832535885,9,notepad-plus-plus-MDEwOlJlcG9zaXRvcnkzMzAxNDgxMQ==-flat-TabBar.cpp,snap-MDEwOlJlcG9zaXRvcnk0Mjg4MzU3-flat-bignet.h,1112,1118,6,711,714,3
539100,https://htmlpreview.github.io/?https://github.com/Christina96/boilerplate-sample-matches/blob/main/Cpp/snap-MDEwOlJlcG9zaXRvcnk0Mjg4MzU3-flat-crawler.cpp-snap-MDEwOlJlcG9zaXRvcnk0Mjg4MzU3-flat-table.cpp.html,0.05880736466062105,13,snap-MDEwOlJlcG9zaXRvcnk0Mjg4MzU3-flat-crawler.cpp,snap-MDEwOlJlcG9zaXRvcnk0Mjg4MzU3-flat-table.cpp,147,151,4,2810,2816,6
544249,https://htmlpreview.github.io/?https://github.com/Christina96/boilerplate-sample-matches/blob/main/Cpp/snap-MDEwOlJlcG9zaXRvcnk0Mjg4MzU3-flat-nytngrams.cpp-snap-MDEwOlJlcG9zaXRvcnk0Mjg4MzU3-flat-tnt.cpp.html,0.042105263157894736,11,snap-MDEwOlJlcG9zaXRvcnk0Mjg4MzU3-flat-nytngrams.cpp,snap-MDEwOlJlcG9zaXRvcnk0Mjg4MzU3-flat-tnt.cpp,65,69,4,233,238,5
544800,https://htmlpreview.github.io/?https://github.com/Christina96/boilerplate-sample-matches/blob/main/Cpp/snap-MDEwOlJlcG9zaXRvcnk0Mjg4MzU3-flat-signnet.h-snap-MDEwOlJlcG9zaXRvcnk0Mjg4MzU3-flat-xmath.cpp.html,0.08307307932542161,9,snap-MDEwOlJlcG9zaXRvcnk0Mjg4MzU3-flat-signnet.h,snap-MDEwOlJlcG9zaXRvcnk0Mjg4MzU3-flat-xmath.cpp,177,180,3,271,274,3
556393,https://htmlpreview.github.io/?https://github.com/Christina96/boilerplate-sample-matches/blob/main/Cpp/snap-MDEwOlJlcG9zaXRvcnk0Mjg4MzU3-flat-svmPrLoqo.h-snap-MDEwOlJlcG9zaXRvcnk0Mjg4MzU3-flat-temporalmotifs.h.html,0.15517241379310345,18,snap-MDEwOlJlcG9zaXRvcnk0Mjg4MzU3-flat-svmPrLoqo.h,snap-MDEwOlJlcG9zaXRvcnk0Mjg4MzU3-flat-temporalmotifs.h,34,38,4,90,100,10
558390,https://htmlpreview.github.io/?https://github.com/Christina96/boilerplate-sample-matches/blob/main/Cpp/abseil-cpp-MDEwOlJlcG9zaXRvcnkxMDQyMzE1NDE=-flat-fast_uniform_bits_test.cc-caffe-MDEwOlJlcG9zaXRvcnk2MTg3MDgwMw==-flat-lrn_layer.cpp.html,0.055900621118012424,9,abseil-cpp-MDEwOlJlcG9zaXRvcnkxMDQyMzE1NDE=-flat-fast_uniform_bits_test.cc,caffe-MDEwOlJlcG9zaXRvcnk2MTg3MDgwMw==-flat-lrn_layer.cpp,13,21,8,172,181,9
559531,https://htmlpreview.github.io/?https://github.com/Christina96/boilerplate-sample-matches/blob/main/Cpp/notepad-plus-plus-MDEwOlJlcG9zaXRvcnkzMzAxNDgxMQ==-flat-basic_regex.hpp-snap-MDEwOlJlcG9zaXRvcnk0Mjg4MzU3-flat-bowbs.h.html,0.05910852713178295,9,notepad-plus-plus-MDEwOlJlcG9zaXRvcnkzMzAxNDgxMQ==-flat-basic_regex.hpp,snap-MDEwOlJlcG9zaXRvcnk0Mjg4MzU3-flat-bowbs.h,217,223,6,151,152,1
559535,https://htmlpreview.github.io/?https://github.com/Christina96/boilerplate-sample-matches/blob/main/Cpp/caffe-MDEwOlJlcG9zaXRvcnk2MTg3MDgwMw==-flat-mkldnn_pooling_layer.cpp-snap-MDEwOlJlcG9zaXRvcnk0Mjg4MzU3-flat-lx.cpp.html,0.020232675771370764,9,caffe-MDEwOlJlcG9zaXRvcnk2MTg3MDgwMw==-flat-mkldnn_pooling_layer.cpp,snap-MDEwOlJlcG9zaXRvcnk0Mjg4MzU3-flat-lx.cpp,272,278,6,423,425,2
563762,https://htmlpreview.github.io/?https://github.com/Christina96/boilerplate-sample-matches/blob/main/Cpp/snap-MDEwOlJlcG9zaXRvcnk0Mjg4MzU3-flat-bits.cpp-snap-MDEwOlJlcG9zaXRvcnk0Mjg4MzU3-flat-agmattr.h.html,0.11458333333333333,10,snap-MDEwOlJlcG9zaXRvcnk0Mjg4MzU3-flat-bits.cpp,snap-MDEwOlJlcG9zaXRvcnk0Mjg4MzU3-flat-agmattr.h,109,112,3,467,469,2
565307,https://htmlpreview.github.io/?https://github.com/Christina96/boilerplate-sample-matches/blob/main/Cpp/snap-MDEwOlJlcG9zaXRvcnk0Mjg4MzU3-flat-devGraph_v1.2.cpp-abseil-cpp-MDEwOlJlcG9zaXRvcnkxMDQyMzE1NDE=-flat-poisson_distribution_test.cc.html,0.07719298245614035,10,snap-MDEwOlJlcG9zaXRvcnk0Mjg4MzU3-flat-devGraph_v1.2.cpp,abseil-cpp-MDEwOlJlcG9zaXRvcnkxMDQyMzE1NDE=-flat-poisson_distribution_test.cc,36,40,4,132,137,5
565617,https://htmlpreview.github.io/?https://github.com/Christina96/boilerplate-sample-matches/blob/main/Cpp/tesseract-MDEwOlJlcG9zaXRvcnkyMjg4NzA5NA==-flat-paramsd.cpp-tesseract-MDEwOlJlcG9zaXRvcnkyMjg4NzA5NA==-flat-tabvector.cpp.html,0.031198686371100164,9,tesseract-MDEwOlJlcG9zaXRvcnkyMjg4NzA5NA==-flat-paramsd.cpp,tesseract-MDEwOlJlcG9zaXRvcnkyMjg4NzA5NA==-flat-tabvector.cpp,197,201,4,419,423,4
573151,https://htmlpreview.github.io/?https://github.com/Christina96/boilerplate-sample-matches/blob/main/Cpp/snap-MDEwOlJlcG9zaXRvcnk0Mjg4MzU3-flat-svmbasic.cpp-snap-MDEwOlJlcG9zaXRvcnk0Mjg4MzU3-flat-graph.cpp.html,0.11553963278101209,13,snap-MDEwOlJlcG9zaXRvcnk0Mjg4MzU3-flat-svmbasic.cpp,snap-MDEwOlJlcG9zaXRvcnk0Mjg4MzU3-flat-graph.cpp,416,423,7,849,859,10
577478,https://htmlpreview.github.io/?https://github.com/Christina96/boilerplate-sample-matches/blob/main/Cpp/caffe-MDEwOlJlcG9zaXRvcnk2MTg3MDgwMw==-flat-compute_image_mean.cpp-caffe-MDEwOlJlcG9zaXRvcnk2MTg3MDgwMw==-flat-batch_classification.cpp.html,0.07303370786516854,13,caffe-MDEwOlJlcG9zaXRvcnk2MTg3MDgwMw==-flat-compute_image_mean.cpp,caffe-MDEwOlJlcG9zaXRvcnk2MTg3MDgwMw==-flat-batch_classification.cpp,98,103,5,200,208,8
581466,https://htmlpreview.github.io/?https://github.com/Christina96/boilerplate-sample-matches/blob/main/Cpp/notepad-plus-plus-MDEwOlJlcG9zaXRvcnkzMzAxNDgxMQ==-flat-pluginsAdmin.cpp-notepad-plus-plus-MDEwOlJlcG9zaXRvcnkzMzAxNDgxMQ==-flat-WindowsDlg.cpp.html,0.07776049766718507,10,notepad-plus-plus-MDEwOlJlcG9zaXRvcnkzMzAxNDgxMQ==-flat-pluginsAdmin.cpp,notepad-plus-plus-MDEwOlJlcG9zaXRvcnkzMzAxNDgxMQ==-flat-WindowsDlg.cpp,352,360,8,295,303,8
589715,https://htmlpreview.github.io/?https://github.com/Christina96/boilerplate-sample-matches/blob/main/Cpp/abseil-cpp-MDEwOlJlcG9zaXRvcnkxMDQyMzE1NDE=-flat-optional_exception_safety_test.cc-nano-node-MDEwOlJlcG9zaXRvcnkxOTM0NzM0MA==-flat-receivable.cpp.html,0.1951219512195122,12,abseil-cpp-MDEwOlJlcG9zaXRvcnkxMDQyMzE1NDE=-flat-optional_exception_safety_test.cc,nano-node-MDEwOlJlcG9zaXRvcnkxOTM0NzM0MA==-flat-receivable.cpp,95,108,13,71,83,12
591287,https://htmlpreview.github.io/?https://github.com/Christina96/boilerplate-sample-matches/blob/main/Cpp/abseil-cpp-MDEwOlJlcG9zaXRvcnkxMDQyMzE1NDE=-flat-compressed_tuple_test.cc-snap-MDEwOlJlcG9zaXRvcnk0Mjg4MzU3-flat-gks.h.html,0.011811023622047244,9,abseil-cpp-MDEwOlJlcG9zaXRvcnkxMDQyMzE1NDE=-flat-compressed_tuple_test.cc,snap-MDEwOlJlcG9zaXRvcnk0Mjg4MzU3-flat-gks.h,14,16,2,186,188,2
592399,https://htmlpreview.github.io/?https://github.com/Christina96/boilerplate-sample-matches/blob/main/Cpp/nano-node-MDEwOlJlcG9zaXRvcnkxOTM0NzM0MA==-flat-confirmation_height_store_81.hpp-abseil-cpp-MDEwOlJlcG9zaXRvcnkxMDQyMzE1NDE=-flat-cord.h.html,0.017094017094017096,10,nano-node-MDEwOlJlcG9zaXRvcnkxOTM0NzM0MA==-flat-confirmation_height_store_81.hpp,abseil-cpp-MDEwOlJlcG9zaXRvcnkxMDQyMzE1NDE=-flat-cord.h,21,25,4,243,263,20
593659,https://htmlpreview.github.io/?https://github.com/Christina96/boilerplate-sample-matches/blob/main/Cpp/snap-MDEwOlJlcG9zaXRvcnk0Mjg4MzU3-flat-bfs-dev.h-snap-MDEwOlJlcG9zaXRvcnk0Mjg4MzU3-flat-mxdag.cpp.html,0.18243243243243243,9,snap-MDEwOlJlcG9zaXRvcnk0Mjg4MzU3-flat-bfs-dev.h,snap-MDEwOlJlcG9zaXRvcnk0Mjg4MzU3-flat-mxdag.cpp,46,50,4,30,32,2
598092,https://htmlpreview.github.io/?https://github.com/Christina96/boilerplate-sample-matches/blob/main/Cpp/nano-node-MDEwOlJlcG9zaXRvcnkxOTM0NzM0MA==-flat-final_vote_store.hpp-nano-node-MDEwOlJlcG9zaXRvcnkxOTM0NzM0MA==-flat-block_store.cpp.html,0.019627085377821395,10,nano-node-MDEwOlJlcG9zaXRvcnkxOTM0NzM0MA==-flat-final_vote_store.hpp,nano-node-MDEwOlJlcG9zaXRvcnkxOTM0NzM0MA==-flat-block_store.cpp,20,25,5,26,32,6
603106,https://htmlpreview.github.io/?https://github.com/Christina96/boilerplate-sample-matches/blob/main/Cpp/snap-MDEwOlJlcG9zaXRvcnk0Mjg4MzU3-flat-vizmap.h-nano-node-MDEwOlJlcG9zaXRvcnkxOTM0NzM0MA==-flat-cl.hpp.html,0.015488312060805965,9,snap-MDEwOlJlcG9zaXRvcnk0Mjg4MzU3-flat-vizmap.h,nano-node-MDEwOlJlcG9zaXRvcnkxOTM0NzM0MA==-flat-cl.hpp,116,117,1,445,449,4
605454,https://htmlpreview.github.io/?https://github.com/Christina96/boilerplate-sample-matches/blob/main/Cpp/tesseract-MDEwOlJlcG9zaXRvcnkyMjg4NzA5NA==-flat-cluster.cpp-caffe-MDEwOlJlcG9zaXRvcnk2MTg3MDgwMw==-flat-bbox_util.cpp.html,0.08474254227626829,13,tesseract-MDEwOlJlcG9zaXRvcnkyMjg4NzA5NA==-flat-cluster.cpp,caffe-MDEwOlJlcG9zaXRvcnk2MTg3MDgwMw==-flat-bbox_util.cpp,1663,1668,5,1635,1640,5
606382,https://htmlpreview.github.io/?https://github.com/Christina96/boilerplate-sample-matches/blob/main/Cpp/snap-MDEwOlJlcG9zaXRvcnk0Mjg4MzU3-flat-mdtr.cpp-tesseract-MDEwOlJlcG9zaXRvcnkyMjg4NzA5NA==-flat-tessedit.cpp.html,0.048,9,snap-MDEwOlJlcG9zaXRvcnk0Mjg4MzU3-flat-mdtr.cpp,tesseract-MDEwOlJlcG9zaXRvcnkyMjg4NzA5NA==-flat-tessedit.cpp,11,14,3,283,288,5
610927,https://htmlpreview.github.io/?https://github.com/Christina96/boilerplate-sample-matches/blob/main/Cpp/snap-MDEwOlJlcG9zaXRvcnk0Mjg4MzU3-flat-webtxtbs.cpp-snap-MDEwOlJlcG9zaXRvcnk0Mjg4MzU3-flat-hashmp.h.html,0.03128491620111732,10,snap-MDEwOlJlcG9zaXRvcnk0Mjg4MzU3-flat-webtxtbs.cpp,snap-MDEwOlJlcG9zaXRvcnk0Mjg4MzU3-flat-hashmp.h,277,283,6,83,85,2
611906,https://htmlpreview.github.io/?https://github.com/Christina96/boilerplate-sample-matches/blob/main/Cpp/snap-MDEwOlJlcG9zaXRvcnk0Mjg4MzU3-flat-agmfast.h-tesseract-MDEwOlJlcG9zaXRvcnkyMjg4NzA5NA==-flat-lstmrecognizer.cpp.html,0.03476669716376944,10,snap-MDEwOlJlcG9zaXRvcnk0Mjg4MzU3-flat-agmfast.h,tesseract-MDEwOlJlcG9zaXRvcnkyMjg4NzA5NA==-flat-lstmrecognizer.cpp,123,126,3,405,408,3
612861,https://htmlpreview.github.io/?https://github.com/Christina96/boilerplate-sample-matches/blob/main/Cpp/tesseract-MDEwOlJlcG9zaXRvcnkyMjg4NzA5NA==-flat-matrix.cpp-caffe-MDEwOlJlcG9zaXRvcnk2MTg3MDgwMw==-flat-test_mkl_pooling_layer.cpp.html,0.07705779334500876,11,tesseract-MDEwOlJlcG9zaXRvcnkyMjg4NzA5NA==-flat-matrix.cpp,caffe-MDEwOlJlcG9zaXRvcnk2MTg3MDgwMw==-flat-test_mkl_pooling_layer.cpp,33,37,4,373,376,3
614618,https://htmlpreview.github.io/?https://github.com/Christina96/boilerplate-sample-matches/blob/main/Cpp/tesseract-MDEwOlJlcG9zaXRvcnkyMjg4NzA5NA==-flat-split.cpp-tesseract-MDEwOlJlcG9zaXRvcnkyMjg4NzA5NA==-flat-blobs.cpp.html,0.10647010647010648,11,tesseract-MDEwOlJlcG9zaXRvcnkyMjg4NzA5NA==-flat-split.cpp,tesseract-MDEwOlJlcG9zaXRvcnkyMjg4NzA5NA==-flat-blobs.cpp,45,50,5,402,407,5
616206,https://htmlpreview.github.io/?https://github.com/Christina96/boilerplate-sample-matches/blob/main/Cpp/snap-MDEwOlJlcG9zaXRvcnk0Mjg4MzU3-flat-exset.cpp-tesseract-MDEwOlJlcG9zaXRvcnkyMjg4NzA5NA==-flat-mastertrainer.cpp.html,0.030716723549488054,9,snap-MDEwOlJlcG9zaXRvcnk0Mjg4MzU3-flat-exset.cpp,tesseract-MDEwOlJlcG9zaXRvcnkyMjg4NzA5NA==-flat-mastertrainer.cpp,11,13,2,257,261,4
619713,https://htmlpreview.github.io/?https://github.com/Christina96/boilerplate-sample-matches/blob/main/Cpp/snap-MDEwOlJlcG9zaXRvcnk0Mjg4MzU3-flat-linalg.h-tesseract-MDEwOlJlcG9zaXRvcnkyMjg4NzA5NA==-flat-networkio.cpp.html,0.017110266159695818,9,snap-MDEwOlJlcG9zaXRvcnk0Mjg4MzU3-flat-linalg.h,tesseract-MDEwOlJlcG9zaXRvcnkyMjg4NzA5NA==-flat-networkio.cpp,21,24,3,14,20,6
620425,https://htmlpreview.github.io/?https://github.com/Christina96/boilerplate-sample-matches/blob/main/Cpp/tesseract-MDEwOlJlcG9zaXRvcnkyMjg4NzA5NA==-flat-tordmain.cpp-caffe-MDEwOlJlcG9zaXRvcnk2MTg3MDgwMw==-flat-im2col.cpp.html,0.045835662381218556,10,tesseract-MDEwOlJlcG9zaXRvcnkyMjg4NzA5NA==-flat-tordmain.cpp,caffe-MDEwOlJlcG9zaXRvcnk2MTg3MDgwMw==-flat-im2col.cpp,293,299,6,87,95,8
624783,https://htmlpreview.github.io/?https://github.com/Christina96/boilerplate-sample-matches/blob/main/Cpp/snap-MDEwOlJlcG9zaXRvcnk0Mjg4MzU3-flat-postag.cpp-snap-MDEwOlJlcG9zaXRvcnk0Mjg4MzU3-flat-gridvcl.cpp.html,0.09477124183006536,9,snap-MDEwOlJlcG9zaXRvcnk0Mjg4MzU3-flat-postag.cpp,snap-MDEwOlJlcG9zaXRvcnk0Mjg4MzU3-flat-gridvcl.cpp,198,201,3,544,550,6
625107,https://htmlpreview.github.io/?https://github.com/Christina96/boilerplate-sample-matches/blob/main/Cpp/tesseract-MDEwOlJlcG9zaXRvcnkyMjg4NzA5NA==-flat-applybox.cpp-snap-MDEwOlJlcG9zaXRvcnk0Mjg4MzU3-flat-googlex.cpp.html,0.05690574985180794,9,tesseract-MDEwOlJlcG9zaXRvcnkyMjg4NzA5NA==-flat-applybox.cpp,snap-MDEwOlJlcG9zaXRvcnk0Mjg4MzU3-flat-googlex.cpp,41,44,3,223,226,3
626529,https://htmlpreview.github.io/?https://github.com/Christina96/boilerplate-sample-matches/blob/main/Cpp/caffe-MDEwOlJlcG9zaXRvcnk2MTg3MDgwMw==-flat-layer.hpp-snap-MDEwOlJlcG9zaXRvcnk0Mjg4MzU3-flat-vizmap.cpp.html,0.014608695652173913,12,caffe-MDEwOlJlcG9zaXRvcnk2MTg3MDgwMw==-flat-layer.hpp,snap-MDEwOlJlcG9zaXRvcnk0Mjg4MzU3-flat-vizmap.cpp,164,180,16,225,231,6
628432,https://htmlpreview.github.io/?https://github.com/Christina96/boilerplate-sample-matches/blob/main/Cpp/snap-MDEwOlJlcG9zaXRvcnk0Mjg4MzU3-flat-wmine.h-snap-MDEwOlJlcG9zaXRvcnk0Mjg4MzU3-flat-semspace.h.html,0.0620384047267356,11,snap-MDEwOlJlcG9zaXRvcnk0Mjg4MzU3-flat-wmine.h,snap-MDEwOlJlcG9zaXRvcnk0Mjg4MzU3-flat-semspace.h,27,28,1,170,172,2
629733,https://htmlpreview.github.io/?https://github.com/Christina96/boilerplate-sample-matches/blob/main/Cpp/snap-MDEwOlJlcG9zaXRvcnk0Mjg4MzU3-flat-websrv.h-snap-MDEwOlJlcG9zaXRvcnk0Mjg4MzU3-flat-bits.h.html,0.07585568917668825,11,snap-MDEwOlJlcG9zaXRvcnk0Mjg4MzU3-flat-websrv.h,snap-MDEwOlJlcG9zaXRvcnk0Mjg4MzU3-flat-bits.h,83,86,3,119,123,4
634807,https://htmlpreview.github.io/?https://github.com/Christina96/boilerplate-sample-matches/blob/main/Cpp/snap-MDEwOlJlcG9zaXRvcnk0Mjg4MzU3-flat-agmattr.h-tesseract-MDEwOlJlcG9zaXRvcnkyMjg4NzA5NA==-flat-colpartition.cpp.html,0.08321038654470345,9,snap-MDEwOlJlcG9zaXRvcnk0Mjg4MzU3-flat-agmattr.h,tesseract-MDEwOlJlcG9zaXRvcnkyMjg4NzA5NA==-flat-colpartition.cpp,442,446,4,917,919,2
635412,https://htmlpreview.github.io/?https://github.com/Christina96/boilerplate-sample-matches/blob/main/Cpp/tesseract-MDEwOlJlcG9zaXRvcnkyMjg4NzA5NA==-flat-ctc.cpp-nano-node-MDEwOlJlcG9zaXRvcnkxOTM0NzM0MA==-flat-lmdb.cpp.html,0.024390243902439025,9,tesseract-MDEwOlJlcG9zaXRvcnkyMjg4NzA5NA==-flat-ctc.cpp,nano-node-MDEwOlJlcG9zaXRvcnkxOTM0NzM0MA==-flat-lmdb.cpp,214,220,6,958,966,8
636081,https://htmlpreview.github.io/?https://github.com/Christina96/boilerplate-sample-matches/blob/main/Cpp/snap-MDEwOlJlcG9zaXRvcnk0Mjg4MzU3-flat-mmnet.cpp-snap-MDEwOlJlcG9zaXRvcnk0Mjg4MzU3-flat-dt.cpp.html,0.08387329013678906,10,snap-MDEwOlJlcG9zaXRvcnk0Mjg4MzU3-flat-mmnet.cpp,snap-MDEwOlJlcG9zaXRvcnk0Mjg4MzU3-flat-dt.cpp,98,104,6,459,464,5
639677,https://htmlpreview.github.io/?https://github.com/Christina96/boilerplate-sample-matches/blob/main/Cpp/tesseract-MDEwOlJlcG9zaXRvcnkyMjg4NzA5NA==-flat-rejctmap.h-abseil-cpp-MDEwOlJlcG9zaXRvcnkxMDQyMzE1NDE=-flat-inlined_vector.h.html,0.1861198738170347,9,tesseract-MDEwOlJlcG9zaXRvcnkyMjg4NzA5NA==-flat-rejctmap.h,abseil-cpp-MDEwOlJlcG9zaXRvcnkxMDQyMzE1NDE=-flat-inlined_vector.h,62,67,5,335,342,7
640180,https://htmlpreview.github.io/?https://github.com/Christina96/boilerplate-sample-matches/blob/main/Cpp/nano-node-MDEwOlJlcG9zaXRvcnkxOTM0NzM0MA==-flat-logging.hpp-snap-MDEwOlJlcG9zaXRvcnk0Mjg4MzU3-flat-dnet.h.html,0.05154639175257732,10,nano-node-MDEwOlJlcG9zaXRvcnkxOTM0NzM0MA==-flat-logging.hpp,snap-MDEwOlJlcG9zaXRvcnk0Mjg4MzU3-flat-dnet.h,52,61,9,117,122,5
642665,https://htmlpreview.github.io/?https://github.com/Christina96/boilerplate-sample-matches/blob/main/Cpp/tesseract-MDEwOlJlcG9zaXRvcnkyMjg4NzA5NA==-flat-stopper.cpp-tesseract-MDEwOlJlcG9zaXRvcnkyMjg4NzA5NA==-flat-coutln.cpp.html,0.02704626334519573,10,tesseract-MDEwOlJlcG9zaXRvcnkyMjg4NzA5NA==-flat-stopper.cpp,tesseract-MDEwOlJlcG9zaXRvcnkyMjg4NzA5NA==-flat-coutln.cpp,378,382,4,525,536,11
647566,https://htmlpreview.github.io/?https://github.com/Christina96/boilerplate-sample-matches/blob/main/Cpp/notepad-plus-plus-MDEwOlJlcG9zaXRvcnkzMzAxNDgxMQ==-flat-WinMgr.cpp-caffe-MDEwOlJlcG9zaXRvcnk2MTg3MDgwMw==-flat-im_transforms.cpp.html,0.07188940092165899,10,notepad-plus-plus-MDEwOlJlcG9zaXRvcnkzMzAxNDgxMQ==-flat-WinMgr.cpp,caffe-MDEwOlJlcG9zaXRvcnk2MTg3MDgwMw==-flat-im_transforms.cpp,334,343,9,224,232,8
649959,https://htmlpreview.github.io/?https://github.com/Christina96/boilerplate-sample-matches/blob/main/Cpp/snap-MDEwOlJlcG9zaXRvcnk0Mjg4MzU3-flat-soap.cpp-snap-MDEwOlJlcG9zaXRvcnk0Mjg4MzU3-flat-bowlearn.cpp.html,0.13956550362080317,10,snap-MDEwOlJlcG9zaXRvcnk0Mjg4MzU3-flat-soap.cpp,snap-MDEwOlJlcG9zaXRvcnk0Mjg4MzU3-flat-bowlearn.cpp,397,405,8,43,48,5
651317,https://htmlpreview.github.io/?https://github.com/Christina96/boilerplate-sample-matches/blob/main/Cpp/snap-MDEwOlJlcG9zaXRvcnk0Mjg4MzU3-flat-signnet.cpp-subconverter-MDEwOlJlcG9zaXRvcnkyMTg2ODY3NjM=-flat-json.hpp.html,0.04228380315336837,12,snap-MDEwOlJlcG9zaXRvcnk0Mjg4MzU3-flat-signnet.cpp,subconverter-MDEwOlJlcG9zaXRvcnkyMTg2ODY3NjM=-flat-json.hpp,367,368,1,8392,8404,12
652760,https://htmlpreview.github.io/?https://github.com/Christina96/boilerplate-sample-matches/blob/main/Cpp/notepad-plus-plus-MDEwOlJlcG9zaXRvcnkzMzAxNDgxMQ==-flat-ViewStyle.h-tesseract-MDEwOlJlcG9zaXRvcnkyMjg4NzA5NA==-flat-clst.h.html,0.02654867256637168,9,notepad-plus-plus-MDEwOlJlcG9zaXRvcnkzMzAxNDgxMQ==-flat-ViewStyle.h,tesseract-MDEwOlJlcG9zaXRvcnkyMjg4NzA5NA==-flat-clst.h,156,162,6,61,64,3
658493,https://htmlpreview.github.io/?https://github.com/Christina96/boilerplate-sample-matches/blob/main/Cpp/tesseract-MDEwOlJlcG9zaXRvcnkyMjg4NzA5NA==-flat-textlineprojection.cpp-notepad-plus-plus-MDEwOlJlcG9zaXRvcnkzMzAxNDgxMQ==-flat-Common.cpp.html,0.016423357664233577,9,tesseract-MDEwOlJlcG9zaXRvcnkyMjg4NzA5NA==-flat-textlineprojection.cpp,notepad-plus-plus-MDEwOlJlcG9zaXRvcnkzMzAxNDgxMQ==-flat-Common.cpp,226,233,7,752,762,10
659132,https://htmlpreview.github.io/?https://github.com/Christina96/boilerplate-sample-matches/blob/main/Cpp/abseil-cpp-MDEwOlJlcG9zaXRvcnkxMDQyMzE1NDE=-flat-str_replace_benchmark.cc-abseil-cpp-MDEwOlJlcG9zaXRvcnkxMDQyMzE1NDE=-flat-city_test.cc.html,0.06985769728331177,13,abseil-cpp-MDEwOlJlcG9zaXRvcnkxMDQyMzE1NDE=-flat-str_replace_benchmark.cc,abseil-cpp-MDEwOlJlcG9zaXRvcnkxMDQyMzE1NDE=-flat-city_test.cc,73,78,5,542,554,12
662196,https://htmlpreview.github.io/?https://github.com/Christina96/boilerplate-sample-matches/blob/main/Cpp/MMKV-MDEwOlJlcG9zaXRvcnkxNDkxMTE4MTM=-flat-CodedInputData.cpp-tesseract-MDEwOlJlcG9zaXRvcnkyMjg4NzA5NA==-flat-topitch.cpp.html,0.011292346298619825,9,MMKV-MDEwOlJlcG9zaXRvcnkxNDkxMTE4MTM=-flat-CodedInputData.cpp,tesseract-MDEwOlJlcG9zaXRvcnkyMjg4NzA5NA==-flat-topitch.cpp,104,109,5,673,679,6
674605,https://htmlpreview.github.io/?https://github.com/Christina96/boilerplate-sample-matches/blob/main/Cpp/snap-MDEwOlJlcG9zaXRvcnk0Mjg4MzU3-flat-signnet.cpp-snap-MDEwOlJlcG9zaXRvcnk0Mjg4MzU3-flat-ds.h.html,0.0929894660370505,9,snap-MDEwOlJlcG9zaXRvcnk0Mjg4MzU3-flat-signnet.cpp,snap-MDEwOlJlcG9zaXRvcnk0Mjg4MzU3-flat-ds.h,1128,1131,3,1002,1006,4
683061,https://htmlpreview.github.io/?https://github.com/Christina96/boilerplate-sample-matches/blob/main/Cpp/abseil-cpp-MDEwOlJlcG9zaXRvcnkxMDQyMzE1NDE=-flat-strerror_test.cc-snap-MDEwOlJlcG9zaXRvcnk0Mjg4MzU3-flat-exset.cpp.html,0.16981132075471697,9,abseil-cpp-MDEwOlJlcG9zaXRvcnkxMDQyMzE1NDE=-flat-strerror_test.cc,snap-MDEwOlJlcG9zaXRvcnk0Mjg4MzU3-flat-exset.cpp,45,50,5,45,50,5
688443,https://htmlpreview.github.io/?https://github.com/Christina96/boilerplate-sample-matches/blob/main/Cpp/notepad-plus-plus-MDEwOlJlcG9zaXRvcnkzMzAxNDgxMQ==-flat-ScintillaEditView.h-notepad-plus-plus-MDEwOlJlcG9zaXRvcnkzMzAxNDgxMQ==-flat-basic_regex_creator.hpp.html,0.04953308972797402,9,notepad-plus-plus-MDEwOlJlcG9zaXRvcnkzMzAxNDgxMQ==-flat-ScintillaEditView.h,notepad-plus-plus-MDEwOlJlcG9zaXRvcnkzMzAxNDgxMQ==-flat-basic_regex_creator.hpp,879,887,8,1306,1314,8
690870,https://htmlpreview.github.io/?https://github.com/Christina96/boilerplate-sample-matches/blob/main/Cpp/snap-MDEwOlJlcG9zaXRvcnk0Mjg4MzU3-flat-mmnet.cpp-snap-MDEwOlJlcG9zaXRvcnk0Mjg4MzU3-flat-xmath.cpp.html,0.14894159653149708,9,snap-MDEwOlJlcG9zaXRvcnk0Mjg4MzU3-flat-mmnet.cpp,snap-MDEwOlJlcG9zaXRvcnk0Mjg4MzU3-flat-xmath.cpp,648,652,4,200,203,3
693800,https://htmlpreview.github.io/?https://github.com/Christina96/boilerplate-sample-matches/blob/main/Cpp/nano-node-MDEwOlJlcG9zaXRvcnkxOTM0NzM0MA==-flat-message.cpp-snap-MDEwOlJlcG9zaXRvcnk0Mjg4MzU3-flat-sir.cpp.html,0.019313304721030045,9,nano-node-MDEwOlJlcG9zaXRvcnkxOTM0NzM0MA==-flat-message.cpp,snap-MDEwOlJlcG9zaXRvcnk0Mjg4MzU3-flat-sir.cpp,332,336,4,47,53,6
699370,https://htmlpreview.github.io/?https://github.com/Christina96/boilerplate-sample-matches/blob/main/Cpp/nano-node-MDEwOlJlcG9zaXRvcnkxOTM0NzM0MA==-flat-inactive_cache_status.cpp-nano-node-MDEwOlJlcG9zaXRvcnkxOTM0NzM0MA==-flat-block_store_64.cpp.html,0.06818181818181818,9,nano-node-MDEwOlJlcG9zaXRvcnkxOTM0NzM0MA==-flat-inactive_cache_status.cpp,nano-node-MDEwOlJlcG9zaXRvcnkxOTM0NzM0MA==-flat-block_store_64.cpp,2,17,15,123,132,9
705899,https://htmlpreview.github.io/?https://github.com/Christina96/boilerplate-sample-matches/blob/main/Cpp/caffe-MDEwOlJlcG9zaXRvcnk2MTg3MDgwMw==-flat-lrn_layer.cpp-snap-MDEwOlJlcG9zaXRvcnk0Mjg4MzU3-flat-localmotifcluster.cpp.html,0.04785478547854786,11,caffe-MDEwOlJlcG9zaXRvcnk2MTg3MDgwMw==-flat-lrn_layer.cpp,snap-MDEwOlJlcG9zaXRvcnk0Mjg4MzU3-flat-localmotifcluster.cpp,114,125,11,130,132,2
719154,https://htmlpreview.github.io/?https://github.com/Christina96/boilerplate-sample-matches/blob/main/Cpp/snap-MDEwOlJlcG9zaXRvcnk0Mjg4MzU3-flat-subgraph.cpp-snap-MDEwOlJlcG9zaXRvcnk0Mjg4MzU3-flat-semspace.cpp.html,0.15323645970937913,9,snap-MDEwOlJlcG9zaXRvcnk0Mjg4MzU3-flat-subgraph.cpp,snap-MDEwOlJlcG9zaXRvcnk0Mjg4MzU3-flat-semspace.cpp,52,54,2,244,246,2
724043,https://htmlpreview.github.io/?https://github.com/Christina96/boilerplate-sample-matches/blob/main/Cpp/tesseract-MDEwOlJlcG9zaXRvcnkyMjg4NzA5NA==-flat-tesseractclass.h-snap-MDEwOlJlcG9zaXRvcnk0Mjg4MzU3-flat-network.h.html,0.02861534823223365,9,tesseract-MDEwOlJlcG9zaXRvcnkyMjg4NzA5NA==-flat-tesseractclass.h,snap-MDEwOlJlcG9zaXRvcnk0Mjg4MzU3-flat-network.h,235,247,12,504,506,2
726815,https://htmlpreview.github.io/?https://github.com/Christina96/boilerplate-sample-matches/blob/main/Cpp/abseil-cpp-MDEwOlJlcG9zaXRvcnkxMDQyMzE1NDE=-flat-throw_delegate_test.cc-nano-node-MDEwOlJlcG9zaXRvcnkxOTM0NzM0MA==-flat-config.hpp.html,0.05569620253164557,11,abseil-cpp-MDEwOlJlcG9zaXRvcnkxMDQyMzE1NDE=-flat-throw_delegate_test.cc,nano-node-MDEwOlJlcG9zaXRvcnkxOTM0NzM0MA==-flat-config.hpp,57,72,15,220,235,15
735280,https://htmlpreview.github.io/?https://github.com/Christina96/boilerplate-sample-matches/blob/main/Cpp/tesseract-MDEwOlJlcG9zaXRvcnkyMjg4NzA5NA==-flat-tprintf.cpp-tesseract-MDEwOlJlcG9zaXRvcnkyMjg4NzA5NA==-flat-baselinedetect.cpp.html,0.025380710659898477,10,tesseract-MDEwOlJlcG9zaXRvcnkyMjg4NzA5NA==-flat-tprintf.cpp,tesseract-MDEwOlJlcG9zaXRvcnkyMjg4NzA5NA==-flat-baselinedetect.cpp,16,25,9,346,352,6
739602,https://htmlpreview.github.io/?https://github.com/Christina96/boilerplate-sample-matches/blob/main/Cpp/abseil-cpp-MDEwOlJlcG9zaXRvcnkxMDQyMzE1NDE=-flat-inlined_vector_18.h-snap-MDEwOlJlcG9zaXRvcnk0Mjg4MzU3-flat-util.cpp.html,0.05194805194805195,11,abseil-cpp-MDEwOlJlcG9zaXRvcnkxMDQyMzE1NDE=-flat-inlined_vector_18.h,snap-MDEwOlJlcG9zaXRvcnk0Mjg4MzU3-flat-util.cpp,289,297,8,15,26,11
740557,https://htmlpreview.github.io/?https://github.com/Christina96/boilerplate-sample-matches/blob/main/Cpp/tesseract-MDEwOlJlcG9zaXRvcnkyMjg4NzA5NA==-flat-dotproductfma.cpp-tesseract-MDEwOlJlcG9zaXRvcnkyMjg4NzA5NA==-flat-ratngs.cpp.html,0.0835881753312946,12,tesseract-MDEwOlJlcG9zaXRvcnkyMjg4NzA5NA==-flat-dotproductfma.cpp,tesseract-MDEwOlJlcG9zaXRvcnkyMjg4NzA5NA==-flat-ratngs.cpp,16,27,11,56,67,11
740653,https://htmlpreview.github.io/?https://github.com/Christina96/boilerplate-sample-matches/blob/main/Cpp/snap-MDEwOlJlcG9zaXRvcnk0Mjg4MzU3-flat-gksvml.h-snap-MDEwOlJlcG9zaXRvcnk0Mjg4MzU3-flat-unicode.h.html,0.012187434334944316,9,snap-MDEwOlJlcG9zaXRvcnk0Mjg4MzU3-flat-gksvml.h,snap-MDEwOlJlcG9zaXRvcnk0Mjg4MzU3-flat-unicode.h,37,38,1,1232,1233,1
742527,https://htmlpreview.github.io/?https://github.com/Christina96/boilerplate-sample-matches/blob/main/Cpp/caffe-MDEwOlJlcG9zaXRvcnk2MTg3MDgwMw==-flat-caffe.cpp-snap-MDEwOlJlcG9zaXRvcnk0Mjg4MzU3-flat-flx.cpp.html,0.06448202959830866,9,caffe-MDEwOlJlcG9zaXRvcnk2MTg3MDgwMw==-flat-caffe.cpp,snap-MDEwOlJlcG9zaXRvcnk0Mjg4MzU3-flat-flx.cpp,494,501,7,254,257,3
743198,https://htmlpreview.github.io/?https://github.com/Christina96/boilerplate-sample-matches/blob/main/Cpp/tesseract-MDEwOlJlcG9zaXRvcnkyMjg4NzA5NA==-flat-language_model.cpp-nano-node-MDEwOlJlcG9zaXRvcnkxOTM0NzM0MA==-flat-json_handler.cpp.html,0.10040307805056797,12,tesseract-MDEwOlJlcG9zaXRvcnkyMjg4NzA5NA==-flat-language_model.cpp,nano-node-MDEwOlJlcG9zaXRvcnkxOTM0NzM0MA==-flat-json_handler.cpp,851,855,4,5161,5170,9
746641,https://htmlpreview.github.io/?https://github.com/Christina96/boilerplate-sample-matches/blob/main/Cpp/snap-MDEwOlJlcG9zaXRvcnk0Mjg4MzU3-flat-spinn3r.cpp-snap-MDEwOlJlcG9zaXRvcnk0Mjg4MzU3-flat-tb.cpp.html,0.015189873417721518,12,snap-MDEwOlJlcG9zaXRvcnk0Mjg4MzU3-flat-spinn3r.cpp,snap-MDEwOlJlcG9zaXRvcnk0Mjg4MzU3-flat-tb.cpp,428,438,10,193,198,5
750663,https://htmlpreview.github.io/?https://github.com/Christina96/boilerplate-sample-matches/blob/main/Cpp/tesseract-MDEwOlJlcG9zaXRvcnkyMjg4NzA5NA==-flat-ocrrow.cpp-tesseract-MDEwOlJlcG9zaXRvcnkyMjg4NzA5NA==-flat-fpchop.cpp.html,0.056417489421720736,11,tesseract-MDEwOlJlcG9zaXRvcnkyMjg4NzA5NA==-flat-ocrrow.cpp,tesseract-MDEwOlJlcG9zaXRvcnkyMjg4NzA5NA==-flat-fpchop.cpp,137,147,10,41,57,16
755315,https://htmlpreview.github.io/?https://github.com/Christina96/boilerplate-sample-matches/blob/main/Cpp/caffe-MDEwOlJlcG9zaXRvcnk2MTg3MDgwMw==-flat-psroi_pooling_layer.cpp-snap-MDEwOlJlcG9zaXRvcnk0Mjg4MzU3-flat-wch.h.html,0.044444444444444446,13,caffe-MDEwOlJlcG9zaXRvcnk2MTg3MDgwMw==-flat-psroi_pooling_layer.cpp,snap-MDEwOlJlcG9zaXRvcnk0Mjg4MzU3-flat-wch.h,131,137,6,77,81,4
756916,https://htmlpreview.github.io/?https://github.com/Christina96/boilerplate-sample-matches/blob/main/Cpp/snap-MDEwOlJlcG9zaXRvcnk0Mjg4MzU3-flat-crawler.h-nano-node-MDEwOlJlcG9zaXRvcnkxOTM0NzM0MA==-flat-numbers.cpp.html,0.16666666666666666,11,snap-MDEwOlJlcG9zaXRvcnk0Mjg4MzU3-flat-crawler.h,nano-node-MDEwOlJlcG9zaXRvcnkxOTM0NzM0MA==-flat-numbers.cpp,233,235,2,600,605,5
757201,https://htmlpreview.github.io/?https://github.com/Christina96/boilerplate-sample-matches/blob/main/Cpp/snap-MDEwOlJlcG9zaXRvcnk0Mjg4MzU3-flat-graph-construct-exp.cpp-snap-MDEwOlJlcG9zaXRvcnk0Mjg4MzU3-flat-sappsrv.cpp.html,0.07531380753138076,9,snap-MDEwOlJlcG9zaXRvcnk0Mjg4MzU3-flat-graph-construct-exp.cpp,snap-MDEwOlJlcG9zaXRvcnk0Mjg4MzU3-flat-sappsrv.cpp,30,35,5,53,57,4
772045,https://htmlpreview.github.io/?https://github.com/Christina96/boilerplate-sample-matches/blob/main/Cpp/caffe-MDEwOlJlcG9zaXRvcnk2MTg3MDgwMw==-flat-gtest-internal-inl.h-snap-MDEwOlJlcG9zaXRvcnk0Mjg4MzU3-flat-kronecker.h.html,0.09163346613545817,17,caffe-MDEwOlJlcG9zaXRvcnk2MTg3MDgwMw==-flat-gtest-internal-inl.h,snap-MDEwOlJlcG9zaXRvcnk0Mjg4MzU3-flat-kronecker.h,408,414,6,59,61,2
774269,https://htmlpreview.github.io/?https://github.com/Christina96/boilerplate-sample-matches/blob/main/Cpp/subconverter-MDEwOlJlcG9zaXRvcnkyMTg2ODY3NjM=-flat-subexport.h-MMKV-MDEwOlJlcG9zaXRvcnkxNDkxMTE4MTM=-flat-MMKV.h.html,0.08733624454148471,10,subconverter-MDEwOlJlcG9zaXRvcnkyMTg2ODY3NjM=-flat-subexport.h,MMKV-MDEwOlJlcG9zaXRvcnkxNDkxMTE4MTM=-flat-MMKV.h,16,27,11,150,154,4
782557,https://htmlpreview.github.io/?https://github.com/Christina96/boilerplate-sample-matches/blob/main/Cpp/snap-MDEwOlJlcG9zaXRvcnk0Mjg4MzU3-flat-json.h-caffe-MDEwOlJlcG9zaXRvcnk2MTg3MDgwMw==-flat-gtest.cc.html,0.04129955947136564,9,snap-MDEwOlJlcG9zaXRvcnk0Mjg4MzU3-flat-json.h,caffe-MDEwOlJlcG9zaXRvcnk2MTg3MDgwMw==-flat-gtest.cc,71,72,1,437,442,5
783995,https://htmlpreview.github.io/?https://github.com/Christina96/boilerplate-sample-matches/blob/main/Cpp/snap-MDEwOlJlcG9zaXRvcnk0Mjg4MzU3-flat-bde.h-snap-MDEwOlJlcG9zaXRvcnk0Mjg4MzU3-flat-sch.h.html,0.14339622641509434,12,snap-MDEwOlJlcG9zaXRvcnk0Mjg4MzU3-flat-bde.h,snap-MDEwOlJlcG9zaXRvcnk0Mjg4MzU3-flat-sch.h,119,122,3,44,47,3
785542,https://htmlpreview.github.io/?https://github.com/Christina96/boilerplate-sample-matches/blob/main/Cpp/tesseract-MDEwOlJlcG9zaXRvcnkyMjg4NzA5NA==-flat-layout_test.cc-notepad-plus-plus-MDEwOlJlcG9zaXRvcnkzMzAxNDgxMQ==-flat-shortcut.cpp.html,0.02737642585551331,9,tesseract-MDEwOlJlcG9zaXRvcnkyMjg4NzA5NA==-flat-layout_test.cc,notepad-plus-plus-MDEwOlJlcG9zaXRvcnkzMzAxNDgxMQ==-flat-shortcut.cpp,147,156,9,791,799,8
788125,https://htmlpreview.github.io/?https://github.com/Christina96/boilerplate-sample-matches/blob/main/Cpp/snap-MDEwOlJlcG9zaXRvcnk0Mjg4MzU3-flat-cncom.h-snap-MDEwOlJlcG9zaXRvcnk0Mjg4MzU3-flat-table.cpp.html,0.035275408414052335,9,snap-MDEwOlJlcG9zaXRvcnk0Mjg4MzU3-flat-cncom.h,snap-MDEwOlJlcG9zaXRvcnk0Mjg4MzU3-flat-table.cpp,173,175,2,579,582,3
788330,https://htmlpreview.github.io/?https://github.com/Christina96/boilerplate-sample-matches/blob/main/Cpp/snap-MDEwOlJlcG9zaXRvcnk0Mjg4MzU3-flat-hysgen.cpp-snap-MDEwOlJlcG9zaXRvcnk0Mjg4MzU3-flat-signnet.cpp.html,0.22269705603038936,12,snap-MDEwOlJlcG9zaXRvcnk0Mjg4MzU3-flat-hysgen.cpp,snap-MDEwOlJlcG9zaXRvcnk0Mjg4MzU3-flat-signnet.cpp,504,509,5,1350,1351,1
788378,https://htmlpreview.github.io/?https://github.com/Christina96/boilerplate-sample-matches/blob/main/Cpp/tesseract-MDEwOlJlcG9zaXRvcnkyMjg4NzA5NA==-flat-tablerecog.cpp-tesseract-MDEwOlJlcG9zaXRvcnkyMjg4NzA5NA==-flat-shapetable.cpp.html,0.10961848468565287,10,tesseract-MDEwOlJlcG9zaXRvcnkyMjg4NzA5NA==-flat-tablerecog.cpp,tesseract-MDEwOlJlcG9zaXRvcnkyMjg4NzA5NA==-flat-shapetable.cpp,248,254,6,83,89,6
788539,https://htmlpreview.github.io/?https://github.com/Christina96/boilerplate-sample-matches/blob/main/Cpp/caffe-MDEwOlJlcG9zaXRvcnk2MTg3MDgwMw==-flat-video_data_layer.cpp-snap-MDEwOlJlcG9zaXRvcnk0Mjg4MzU3-flat-kronecker.cpp.html,0.014582770726438023,9,caffe-MDEwOlJlcG9zaXRvcnk2MTg3MDgwMw==-flat-video_data_layer.cpp,snap-MDEwOlJlcG9zaXRvcnk0Mjg4MzU3-flat-kronecker.cpp,44,55,11,1655,1662,7
788816,https://htmlpreview.github.io/?https://github.com/Christina96/boilerplate-sample-matches/blob/main/Cpp/caffe-MDEwOlJlcG9zaXRvcnk2MTg3MDgwMw==-flat-pooling_layer.cpp-snap-MDEwOlJlcG9zaXRvcnk0Mjg4MzU3-flat-timenet.cpp.html,0.08653457339264052,9,caffe-MDEwOlJlcG9zaXRvcnk2MTg3MDgwMw==-flat-pooling_layer.cpp,snap-MDEwOlJlcG9zaXRvcnk0Mjg4MzU3-flat-timenet.cpp,434,436,2,110,113,3
789999,https://htmlpreview.github.io/?https://github.com/Christina96/boilerplate-sample-matches/blob/main/Cpp/caffe-MDEwOlJlcG9zaXRvcnk2MTg3MDgwMw==-flat-apply_mn_param.cpp-snap-MDEwOlJlcG9zaXRvcnk0Mjg4MzU3-flat-gridvcl.cpp.html,0.11847233047544817,9,caffe-MDEwOlJlcG9zaXRvcnk2MTg3MDgwMw==-flat-apply_mn_param.cpp,snap-MDEwOlJlcG9zaXRvcnk0Mjg4MzU3-flat-gridvcl.cpp,94,101,7,337,341,4
792231,https://htmlpreview.github.io/?https://github.com/Christina96/boilerplate-sample-matches/blob/main/Cpp/caffe-MDEwOlJlcG9zaXRvcnk2MTg3MDgwMw==-flat-reshape_layer.cpp-abseil-cpp-MDEwOlJlcG9zaXRvcnkxMDQyMzE1NDE=-flat-time_zone_format_test.cc.html,0.08083140877598152,11,caffe-MDEwOlJlcG9zaXRvcnk2MTg3MDgwMw==-flat-reshape_layer.cpp,abseil-cpp-MDEwOlJlcG9zaXRvcnkxMDQyMzE1NDE=-flat-time_zone_format_test.cc,127,136,9,1047,1049,2
793500,https://htmlpreview.github.io/?https://github.com/Christina96/boilerplate-sample-matches/blob/main/Cpp/notepad-plus-plus-MDEwOlJlcG9zaXRvcnkzMzAxNDgxMQ==-flat-shortcut.cpp-notepad-plus-plus-MDEwOlJlcG9zaXRvcnkzMzAxNDgxMQ==-flat-NppDarkMode.cpp.html,0.057570523891767415,9,notepad-plus-plus-MDEwOlJlcG9zaXRvcnkzMzAxNDgxMQ==-flat-shortcut.cpp,notepad-plus-plus-MDEwOlJlcG9zaXRvcnkzMzAxNDgxMQ==-flat-NppDarkMode.cpp,437,446,9,1782,1789,7
797776,https://htmlpreview.github.io/?https://github.com/Christina96/boilerplate-sample-matches/blob/main/Cpp/abseil-cpp-MDEwOlJlcG9zaXRvcnkxMDQyMzE1NDE=-flat-substitute.h-snap-MDEwOlJlcG9zaXRvcnk0Mjg4MzU3-flat-wikinet.h.html,0.1781609195402299,15,abseil-cpp-MDEwOlJlcG9zaXRvcnkxMDQyMzE1NDE=-flat-substitute.h,snap-MDEwOlJlcG9zaXRvcnk0Mjg4MzU3-flat-wikinet.h,275,297,22,305,309,4
819825,https://htmlpreview.github.io/?https://github.com/Christina96/boilerplate-sample-matches/blob/main/Cpp/snap-MDEwOlJlcG9zaXRvcnk0Mjg4MzU3-flat-node2vec.cpp-tesseract-MDEwOlJlcG9zaXRvcnkyMjg4NzA5NA==-flat-errorcounter.cpp.html,0.032490974729241874,9,snap-MDEwOlJlcG9zaXRvcnk0Mjg4MzU3-flat-node2vec.cpp,tesseract-MDEwOlJlcG9zaXRvcnkyMjg4NzA5NA==-flat-errorcounter.cpp,48,51,3,234,239,5
822441,https://htmlpreview.github.io/?https://github.com/Christina96/boilerplate-sample-matches/blob/main/Cpp/snap-MDEwOlJlcG9zaXRvcnk0Mjg4MzU3-flat-googlex.h-snap-MDEwOlJlcG9zaXRvcnk0Mjg4MzU3-flat-mmnet.h.html,0.049008168028004666,9,snap-MDEwOlJlcG9zaXRvcnk0Mjg4MzU3-flat-googlex.h,snap-MDEwOlJlcG9zaXRvcnk0Mjg4MzU3-flat-mmnet.h,25,28,3,463,465,2
825485,https://htmlpreview.github.io/?https://github.com/Christina96/boilerplate-sample-matches/blob/main/Cpp/snap-MDEwOlJlcG9zaXRvcnk0Mjg4MzU3-flat-hysgen.cpp-snap-MDEwOlJlcG9zaXRvcnk0Mjg4MzU3-flat-linalg.cpp.html,0.1727447216890595,10,snap-MDEwOlJlcG9zaXRvcnk0Mjg4MzU3-flat-hysgen.cpp,snap-MDEwOlJlcG9zaXRvcnk0Mjg4MzU3-flat-linalg.cpp,329,335,6,1328,1333,5
825693,https://htmlpreview.github.io/?https://github.com/Christina96/boilerplate-sample-matches/blob/main/Cpp/tesseract-MDEwOlJlcG9zaXRvcnkyMjg4NzA5NA==-flat-cjkpitch.cpp-tesseract-MDEwOlJlcG9zaXRvcnkyMjg4NzA5NA==-flat-tablefind.cpp.html,0.08743599842457661,10,tesseract-MDEwOlJlcG9zaXRvcnkyMjg4NzA5NA==-flat-cjkpitch.cpp,tesseract-MDEwOlJlcG9zaXRvcnkyMjg4NzA5NA==-flat-tablefind.cpp,375,379,4,1432,1436,4
834085,https://htmlpreview.github.io/?https://github.com/Christina96/boilerplate-sample-matches/blob/main/Cpp/tesseract-MDEwOlJlcG9zaXRvcnkyMjg4NzA5NA==-flat-ccutil.cpp-nano-node-MDEwOlJlcG9zaXRvcnkxOTM0NzM0MA==-flat-websocket_59.cpp.html,0.030373831775700934,13,tesseract-MDEwOlJlcG9zaXRvcnkyMjg4NzA5NA==-flat-ccutil.cpp,nano-node-MDEwOlJlcG9zaXRvcnkxOTM0NzM0MA==-flat-websocket_59.cpp,18,24,6,328,338,10
840518,https://htmlpreview.github.io/?https://github.com/Christina96/boilerplate-sample-matches/blob/main/Cpp/glm-MDEwOlJlcG9zaXRvcnk4NDM2MzE=-flat-dummy_0.cpp-abseil-cpp-MDEwOlJlcG9zaXRvcnkxMDQyMzE1NDE=-flat-mutex_test.cc.html,0.015332197614991482,9,glm-MDEwOlJlcG9zaXRvcnk4NDM2MzE=-flat-dummy_0.cpp,abseil-cpp-MDEwOlJlcG9zaXRvcnkxMDQyMzE1NDE=-flat-mutex_test.cc,4,12,8,995,999,4
847075,https://htmlpreview.github.io/?https://github.com/Christina96/boilerplate-sample-matches/blob/main/Cpp/snap-MDEwOlJlcG9zaXRvcnk0Mjg4MzU3-flat-infonet.cpp-tesseract-MDEwOlJlcG9zaXRvcnkyMjg4NzA5NA==-flat-recodebeam.cpp.html,0.07103825136612021,10,snap-MDEwOlJlcG9zaXRvcnk0Mjg4MzU3-flat-infonet.cpp,tesseract-MDEwOlJlcG9zaXRvcnkyMjg4NzA5NA==-flat-recodebeam.cpp,589,591,2,688,689,1
847780,https://htmlpreview.github.io/?https://github.com/Christina96/boilerplate-sample-matches/blob/main/Cpp/notepad-plus-plus-MDEwOlJlcG9zaXRvcnkzMzAxNDgxMQ==-flat-Printer.cpp-notepad-plus-plus-MDEwOlJlcG9zaXRvcnkzMzAxNDgxMQ==-flat-NppCommands.cpp.html,0.02441860465116279,14,notepad-plus-plus-MDEwOlJlcG9zaXRvcnkzMzAxNDgxMQ==-flat-Printer.cpp,notepad-plus-plus-MDEwOlJlcG9zaXRvcnkzMzAxNDgxMQ==-flat-NppCommands.cpp,147,160,13,2158,2171,13
853263,https://htmlpreview.github.io/?https://github.com/Christina96/boilerplate-sample-matches/blob/main/Cpp/snap-MDEwOlJlcG9zaXRvcnk0Mjg4MzU3-flat-flx.cpp-snap-MDEwOlJlcG9zaXRvcnk0Mjg4MzU3-flat-motifcluster.cpp.html,0.12410680707032719,9,snap-MDEwOlJlcG9zaXRvcnk0Mjg4MzU3-flat-flx.cpp,snap-MDEwOlJlcG9zaXRvcnk0Mjg4MzU3-flat-motifcluster.cpp,229,231,2,704,709,5
856648,https://htmlpreview.github.io/?https://github.com/Christina96/boilerplate-sample-matches/blob/main/Cpp/snap-MDEwOlJlcG9zaXRvcnk0Mjg4MzU3-flat-nyta.h-snap-MDEwOlJlcG9zaXRvcnk0Mjg4MzU3-flat-semspace.cpp.html,0.011194029850746268,9,snap-MDEwOlJlcG9zaXRvcnk0Mjg4MzU3-flat-nyta.h,snap-MDEwOlJlcG9zaXRvcnk0Mjg4MzU3-flat-semspace.cpp,109,111,2,798,804,6
857966,https://htmlpreview.github.io/?https://github.com/Christina96/boilerplate-sample-matches/blob/main/Cpp/snap-MDEwOlJlcG9zaXRvcnk0Mjg4MzU3-flat-gks.cpp-abseil-cpp-MDEwOlJlcG9zaXRvcnkxMDQyMzE1NDE=-flat-time_zone_info.cc.html,0.015170670037926675,12,snap-MDEwOlJlcG9zaXRvcnk0Mjg4MzU3-flat-gks.cpp,abseil-cpp-MDEwOlJlcG9zaXRvcnkxMDQyMzE1NDE=-flat-time_zone_info.cc,147,152,5,38,47,9
866628,https://htmlpreview.github.io/?https://github.com/Christina96/boilerplate-sample-matches/blob/main/Cpp/tesseract-MDEwOlJlcG9zaXRvcnkyMjg4NzA5NA==-flat-dawg2wordlist.cpp-caffe-MDEwOlJlcG9zaXRvcnk2MTg3MDgwMw==-flat-permute_layer.cpp.html,0.06923076923076923,9,tesseract-MDEwOlJlcG9zaXRvcnkyMjg4NzA5NA==-flat-dawg2wordlist.cpp,caffe-MDEwOlJlcG9zaXRvcnk2MTg3MDgwMw==-flat-permute_layer.cpp,58,60,2,93,95,2
884945,https://htmlpreview.github.io/?https://github.com/Christina96/boilerplate-sample-matches/blob/main/Cpp/snap-MDEwOlJlcG9zaXRvcnk0Mjg4MzU3-flat-sim.cpp-snap-MDEwOlJlcG9zaXRvcnk0Mjg4MzU3-flat-bowbs.cpp.html,0.0704626334519573,11,snap-MDEwOlJlcG9zaXRvcnk0Mjg4MzU3-flat-sim.cpp,snap-MDEwOlJlcG9zaXRvcnk0Mjg4MzU3-flat-bowbs.cpp,133,144,11,1313,1318,5
886286,https://htmlpreview.github.io/?https://github.com/Christina96/boilerplate-sample-matches/blob/main/Cpp/snap-MDEwOlJlcG9zaXRvcnk0Mjg4MzU3-flat-stemming.h-snap-MDEwOlJlcG9zaXRvcnk0Mjg4MzU3-flat-bowbs.h.html,0.04734484964811261,18,snap-MDEwOlJlcG9zaXRvcnk0Mjg4MzU3-flat-stemming.h,snap-MDEwOlJlcG9zaXRvcnk0Mjg4MzU3-flat-bowbs.h,14,23,9,147,151,4
888755,https://htmlpreview.github.io/?https://github.com/Christina96/boilerplate-sample-matches/blob/main/Cpp/snap-MDEwOlJlcG9zaXRvcnk0Mjg4MzU3-flat-svmbasic.cpp-snap-MDEwOlJlcG9zaXRvcnk0Mjg4MzU3-flat-signnet.cpp.html,0.12649214659685865,9,snap-MDEwOlJlcG9zaXRvcnk0Mjg4MzU3-flat-svmbasic.cpp,snap-MDEwOlJlcG9zaXRvcnk0Mjg4MzU3-flat-signnet.cpp,824,827,3,181,183,2
889011,https://htmlpreview.github.io/?https://github.com/Christina96/boilerplate-sample-matches/blob/main/Cpp/notepad-plus-plus-MDEwOlJlcG9zaXRvcnkzMzAxNDgxMQ==-flat-Buffer.h-nano-node-MDEwOlJlcG9zaXRvcnkxOTM0NzM0MA==-flat-errors.cpp.html,0.02102803738317757,9,notepad-plus-plus-MDEwOlJlcG9zaXRvcnkzMzAxNDgxMQ==-flat-Buffer.h,nano-node-MDEwOlJlcG9zaXRvcnkxOTM0NzM0MA==-flat-errors.cpp,127,129,2,274,281,7
894416,https://htmlpreview.github.io/?https://github.com/Christina96/boilerplate-sample-matches/blob/main/Cpp/abseil-cpp-MDEwOlJlcG9zaXRvcnkxMDQyMzE1NDE=-flat-common_policy_traits.h-abseil-cpp-MDEwOlJlcG9zaXRvcnkxMDQyMzE1NDE=-flat-raw_hash_set_test.cc.html,0.021883920076117985,23,abseil-cpp-MDEwOlJlcG9zaXRvcnkxMDQyMzE1NDE=-flat-common_policy_traits.h,abseil-cpp-MDEwOlJlcG9zaXRvcnkxMDQyMzE1NDE=-flat-raw_hash_set_test.cc,14,27,13,247,262,15
894456,https://htmlpreview.github.io/?https://github.com/Christina96/boilerplate-sample-matches/blob/main/Cpp/tesseract-MDEwOlJlcG9zaXRvcnkyMjg4NzA5NA==-flat-findseam.cpp-snap-MDEwOlJlcG9zaXRvcnk0Mjg4MzU3-flat-tql.cpp.html,0.027816411682892908,10,tesseract-MDEwOlJlcG9zaXRvcnkyMjg4NzA5NA==-flat-findseam.cpp,snap-MDEwOlJlcG9zaXRvcnk0Mjg4MzU3-flat-tql.cpp,108,111,3,11,14,3
905408,https://htmlpreview.github.io/?https://github.com/Christina96/boilerplate-sample-matches/blob/main/Cpp/notepad-plus-plus-MDEwOlJlcG9zaXRvcnkzMzAxNDgxMQ==-flat-Window.h-snap-MDEwOlJlcG9zaXRvcnk0Mjg4MzU3-flat-tm.h.html,0.016216216216216217,9,notepad-plus-plus-MDEwOlJlcG9zaXRvcnkzMzAxNDgxMQ==-flat-Window.h,snap-MDEwOlJlcG9zaXRvcnk0Mjg4MzU3-flat-tm.h,61,68,7,230,232,2
907855,https://htmlpreview.github.io/?https://github.com/Christina96/boilerplate-sample-matches/blob/main/Cpp/tesseract-MDEwOlJlcG9zaXRvcnkyMjg4NzA5NA==-flat-tabfind.cpp-snap-MDEwOlJlcG9zaXRvcnk0Mjg4MzU3-flat-network.cpp.html,0.023941707147814018,10,tesseract-MDEwOlJlcG9zaXRvcnkyMjg4NzA5NA==-flat-tabfind.cpp,snap-MDEwOlJlcG9zaXRvcnk0Mjg4MzU3-flat-network.cpp,501,508,7,986,996,10
912733,https://htmlpreview.github.io/?https://github.com/Christina96/boilerplate-sample-matches/blob/main/Cpp/tesseract-MDEwOlJlcG9zaXRvcnkyMjg4NzA5NA==-flat-validate_indic.cpp-notepad-plus-plus-MDEwOlJlcG9zaXRvcnkzMzAxNDgxMQ==-flat-NppDarkMode.cpp.html,0.044977511244377814,14,tesseract-MDEwOlJlcG9zaXRvcnkyMjg4NzA5NA==-flat-validate_indic.cpp,notepad-plus-plus-MDEwOlJlcG9zaXRvcnkzMzAxNDgxMQ==-flat-NppDarkMode.cpp,55,65,10,2023,2037,14
912753,https://htmlpreview.github.io/?https://github.com/Christina96/boilerplate-sample-matches/blob/main/Cpp/snap-MDEwOlJlcG9zaXRvcnk0Mjg4MzU3-flat-lsionto.h-snap-MDEwOlJlcG9zaXRvcnk0Mjg4MzU3-flat-biling.cpp.html,0.023781212841854936,10,snap-MDEwOlJlcG9zaXRvcnk0Mjg4MzU3-flat-lsionto.h,snap-MDEwOlJlcG9zaXRvcnk0Mjg4MzU3-flat-biling.cpp,312,315,3,539,541,2
924021,https://htmlpreview.github.io/?https://github.com/Christina96/boilerplate-sample-matches/blob/main/Cpp/snap-MDEwOlJlcG9zaXRvcnk0Mjg4MzU3-flat-nytngrams.cpp-snap-MDEwOlJlcG9zaXRvcnk0Mjg4MzU3-flat-wordnet.cpp.html,0.14873837981407703,10,snap-MDEwOlJlcG9zaXRvcnk0Mjg4MzU3-flat-nytngrams.cpp,snap-MDEwOlJlcG9zaXRvcnk0Mjg4MzU3-flat-wordnet.cpp,66,74,8,191,197,6
925833,https://htmlpreview.github.io/?https://github.com/Christina96/boilerplate-sample-matches/blob/main/Cpp/notepad-plus-plus-MDEwOlJlcG9zaXRvcnkzMzAxNDgxMQ==-flat-columnEditor.cpp-abseil-cpp-MDEwOlJlcG9zaXRvcnkxMDQyMzE1NDE=-flat-container.h.html,0.06206896551724138,9,notepad-plus-plus-MDEwOlJlcG9zaXRvcnkzMzAxNDgxMQ==-flat-columnEditor.cpp,abseil-cpp-MDEwOlJlcG9zaXRvcnkxMDQyMzE1NDE=-flat-container.h,146,150,4,188,192,4
929792,https://htmlpreview.github.io/?https://github.com/Christina96/boilerplate-sample-matches/blob/main/Cpp/snap-MDEwOlJlcG9zaXRvcnk0Mjg4MzU3-flat-fa.cpp-snap-MDEwOlJlcG9zaXRvcnk0Mjg4MzU3-flat-soap.cpp.html,0.10286458333333333,10,snap-MDEwOlJlcG9zaXRvcnk0Mjg4MzU3-flat-fa.cpp,snap-MDEwOlJlcG9zaXRvcnk0Mjg4MzU3-flat-soap.cpp,12,15,3,48,52,4
929831,https://htmlpreview.github.io/?https://github.com/Christina96/boilerplate-sample-matches/blob/main/Cpp/snap-MDEwOlJlcG9zaXRvcnk0Mjg4MzU3-flat-vizmap.h-caffe-MDEwOlJlcG9zaXRvcnk2MTg3MDgwMw==-flat-bbox_util.cpp.html,0.08062473617560152,9,snap-MDEwOlJlcG9zaXRvcnk0Mjg4MzU3-flat-vizmap.h,caffe-MDEwOlJlcG9zaXRvcnk2MTg3MDgwMw==-flat-bbox_util.cpp,277,279,2,594,598,4
930255,https://htmlpreview.github.io/?https://github.com/Christina96/boilerplate-sample-matches/blob/main/Cpp/snap-MDEwOlJlcG9zaXRvcnk0Mjg4MzU3-flat-spinn3r.cpp-caffe-MDEwOlJlcG9zaXRvcnk2MTg3MDgwMw==-flat-bbox_util.cpp.html,0.04603212658834812,10,snap-MDEwOlJlcG9zaXRvcnk0Mjg4MzU3-flat-spinn3r.cpp,caffe-MDEwOlJlcG9zaXRvcnk2MTg3MDgwMw==-flat-bbox_util.cpp,354,357,3,1999,2005,6
934209,https://htmlpreview.github.io/?https://github.com/Christina96/boilerplate-sample-matches/blob/main/Cpp/snap-MDEwOlJlcG9zaXRvcnk0Mjg4MzU3-flat-gsearch.cpp-snap-MDEwOlJlcG9zaXRvcnk0Mjg4MzU3-flat-network.h.html,0.05604307937774232,11,snap-MDEwOlJlcG9zaXRvcnk0Mjg4MzU3-flat-gsearch.cpp,snap-MDEwOlJlcG9zaXRvcnk0Mjg4MzU3-flat-network.h,1097,1101,4,1806,1812,6
934711,https://htmlpreview.github.io/?https://github.com/Christina96/boilerplate-sample-matches/blob/main/Cpp/caffe-MDEwOlJlcG9zaXRvcnk2MTg3MDgwMw==-flat-caffe.cpp-tesseract-MDEwOlJlcG9zaXRvcnkyMjg4NzA5NA==-flat-recodebeam.cpp.html,0.07428571428571429,11,caffe-MDEwOlJlcG9zaXRvcnk2MTg3MDgwMw==-flat-caffe.cpp,tesseract-MDEwOlJlcG9zaXRvcnkyMjg4NzA5NA==-flat-recodebeam.cpp,483,488,5,687,689,2
941409,https://htmlpreview.github.io/?https://github.com/Christina96/boilerplate-sample-matches/blob/main/Cpp/caffe-MDEwOlJlcG9zaXRvcnk2MTg3MDgwMw==-flat-annotated_data_layer.cpp-snap-MDEwOlJlcG9zaXRvcnk0Mjg4MzU3-flat-bowclust.cpp.html,0.046009389671361506,9,caffe-MDEwOlJlcG9zaXRvcnk2MTg3MDgwMw==-flat-annotated_data_layer.cpp,snap-MDEwOlJlcG9zaXRvcnk0Mjg4MzU3-flat-bowclust.cpp,398,402,4,303,310,7
943142,https://htmlpreview.github.io/?https://github.com/Christina96/boilerplate-sample-matches/blob/main/Cpp/tesseract-MDEwOlJlcG9zaXRvcnkyMjg4NzA5NA==-flat-textlineprojection.h-abseil-cpp-MDEwOlJlcG9zaXRvcnkxMDQyMzE1NDE=-flat-memutil.h.html,0.08490566037735849,9,tesseract-MDEwOlJlcG9zaXRvcnkyMjg4NzA5NA==-flat-textlineprojection.h,abseil-cpp-MDEwOlJlcG9zaXRvcnkxMDQyMzE1NDE=-flat-memutil.h,40,44,4,14,16,2
949756,https://htmlpreview.github.io/?https://github.com/Christina96/boilerplate-sample-matches/blob/main/Cpp/snap-MDEwOlJlcG9zaXRvcnk0Mjg4MzU3-flat-wix.h-snap-MDEwOlJlcG9zaXRvcnk0Mjg4MzU3-flat-tb.h.html,0.1958041958041958,18,snap-MDEwOlJlcG9zaXRvcnk0Mjg4MzU3-flat-wix.h,snap-MDEwOlJlcG9zaXRvcnk0Mjg4MzU3-flat-tb.h,51,64,13,184,199,15
950372,https://htmlpreview.github.io/?https://github.com/Christina96/boilerplate-sample-matches/blob/main/Cpp/Cpp_Primer_Answers-MDEwOlJlcG9zaXRvcnk0NzE3MDI2MQ==-flat-exercise12_2.h-tesseract-MDEwOlJlcG9zaXRvcnkyMjg4NzA5NA==-flat-tesseractclass.h.html,0.041666666666666664,9,Cpp_Primer_Answers-MDEwOlJlcG9zaXRvcnk0NzE3MDI2MQ==-flat-exercise12_2.h,tesseract-MDEwOlJlcG9zaXRvcnkyMjg4NzA5NA==-flat-tesseractclass.h,12,20,8,108,114,6
951475,https://htmlpreview.github.io/?https://github.com/Christina96/boilerplate-sample-matches/blob/main/Cpp/notepad-plus-plus-MDEwOlJlcG9zaXRvcnkzMzAxNDgxMQ==-flat-Notepad_plus_Window.cpp-tesseract-MDEwOlJlcG9zaXRvcnkyMjg4NzA5NA==-flat-blobbox.h.html,0.019672131147540985,9,notepad-plus-plus-MDEwOlJlcG9zaXRvcnkzMzAxNDgxMQ==-flat-Notepad_plus_Window.cpp,tesseract-MDEwOlJlcG9zaXRvcnkyMjg4NzA5NA==-flat-blobbox.h,39,46,7,405,422,17
952977,https://htmlpreview.github.io/?https://github.com/Christina96/boilerplate-sample-matches/blob/main/Cpp/snap-MDEwOlJlcG9zaXRvcnk0Mjg4MzU3-flat-netobj.h-snap-MDEwOlJlcG9zaXRvcnk0Mjg4MzU3-flat-rids.h.html,0.04242156429518339,9,snap-MDEwOlJlcG9zaXRvcnk0Mjg4MzU3-flat-netobj.h,snap-MDEwOlJlcG9zaXRvcnk0Mjg4MzU3-flat-rids.h,18,19,1,371,372,1
955740,https://htmlpreview.github.io/?https://github.com/Christina96/boilerplate-sample-matches/blob/main/Cpp/nano-node-MDEwOlJlcG9zaXRvcnkxOTM0NzM0MA==-flat-telemetry_41.hpp-snap-MDEwOlJlcG9zaXRvcnk0Mjg4MzU3-flat-tb.h.html,0.02610966057441253,10,nano-node-MDEwOlJlcG9zaXRvcnkxOTM0NzM0MA==-flat-telemetry_41.hpp,snap-MDEwOlJlcG9zaXRvcnk0Mjg4MzU3-flat-tb.h,35,40,5,192,198,6
956613,https://htmlpreview.github.io/?https://github.com/Christina96/boilerplate-sample-matches/blob/main/Cpp/tesseract-MDEwOlJlcG9zaXRvcnkyMjg4NzA5NA==-flat-mergenf.cpp-notepad-plus-plus-MDEwOlJlcG9zaXRvcnkzMzAxNDgxMQ==-flat-ScintillaEditView.cpp.html,0.029015544041450778,9,tesseract-MDEwOlJlcG9zaXRvcnkyMjg4NzA5NA==-flat-mergenf.cpp,notepad-plus-plus-MDEwOlJlcG9zaXRvcnkzMzAxNDgxMQ==-flat-ScintillaEditView.cpp,121,125,4,1540,1548,8
961995,https://htmlpreview.github.io/?https://github.com/Christina96/boilerplate-sample-matches/blob/main/Cpp/abseil-cpp-MDEwOlJlcG9zaXRvcnkxMDQyMzE1NDE=-flat-log_format.cc-snap-MDEwOlJlcG9zaXRvcnk0Mjg4MzU3-flat-graph.cpp.html,0.01992825827022718,15,abseil-cpp-MDEwOlJlcG9zaXRvcnkxMDQyMzE1NDE=-flat-log_format.cc,snap-MDEwOlJlcG9zaXRvcnk0Mjg4MzU3-flat-graph.cpp,73,88,15,14,24,10
964180,https://htmlpreview.github.io/?https://github.com/Christina96/boilerplate-sample-matches/blob/main/Cpp/abseil-cpp-MDEwOlJlcG9zaXRvcnkxMDQyMzE1NDE=-flat-exception_safety_testing_test.cc-subconverter-MDEwOlJlcG9zaXRvcnkyMTg2ODY3NjM=-flat-json.hpp.html,0.010890024200053777,13,abseil-cpp-MDEwOlJlcG9zaXRvcnkxMDQyMzE1NDE=-flat-exception_safety_testing_test.cc,subconverter-MDEwOlJlcG9zaXRvcnkyMTg2ODY3NjM=-flat-json.hpp,377,386,9,2535,2547,12
965865,https://htmlpreview.github.io/?https://github.com/Christina96/boilerplate-sample-matches/blob/main/Cpp/caffe-MDEwOlJlcG9zaXRvcnk2MTg3MDgwMw==-flat-sigmoid_layer.cpp-snap-MDEwOlJlcG9zaXRvcnk0Mjg4MzU3-flat-exset.cpp.html,0.0947867298578199,10,caffe-MDEwOlJlcG9zaXRvcnk2MTg3MDgwMw==-flat-sigmoid_layer.cpp,snap-MDEwOlJlcG9zaXRvcnk0Mjg4MzU3-flat-exset.cpp,17,24,7,11,14,3
967909,https://htmlpreview.github.io/?https://github.com/Christina96/boilerplate-sample-matches/blob/main/Cpp/tesseract-MDEwOlJlcG9zaXRvcnkyMjg4NzA5NA==-flat-linefind.cpp-snap-MDEwOlJlcG9zaXRvcnk0Mjg4MzU3-flat-memes.cpp.html,0.05656795747911921,11,tesseract-MDEwOlJlcG9zaXRvcnkyMjg4NzA5NA==-flat-linefind.cpp,snap-MDEwOlJlcG9zaXRvcnk0Mjg4MzU3-flat-memes.cpp,173,178,5,232,241,9
968545,https://htmlpreview.github.io/?https://github.com/Christina96/boilerplate-sample-matches/blob/main/Cpp/nano-node-MDEwOlJlcG9zaXRvcnkxOTM0NzM0MA==-flat-online_reps.cpp-nano-node-MDEwOlJlcG9zaXRvcnkxOTM0NzM0MA==-flat-common_12.cpp.html,0.023872679045092837,9,nano-node-MDEwOlJlcG9zaXRvcnkxOTM0NzM0MA==-flat-online_reps.cpp,nano-node-MDEwOlJlcG9zaXRvcnkxOTM0NzM0MA==-flat-common_12.cpp,112,116,4,580,584,4
970617,https://htmlpreview.github.io/?https://github.com/Christina96/boilerplate-sample-matches/blob/main/Cpp/snap-MDEwOlJlcG9zaXRvcnk0Mjg4MzU3-flat-phrase.cpp-snap-MDEwOlJlcG9zaXRvcnk0Mjg4MzU3-flat-ds.h.html,0.027449728694541972,9,snap-MDEwOlJlcG9zaXRvcnk0Mjg4MzU3-flat-phrase.cpp,snap-MDEwOlJlcG9zaXRvcnk0Mjg4MzU3-flat-ds.h,232,238,6,531,532,1
973353,https://htmlpreview.github.io/?https://github.com/Christina96/boilerplate-sample-matches/blob/main/Cpp/caffe-MDEwOlJlcG9zaXRvcnk2MTg3MDgwMw==-flat-mpio.h-tesseract-MDEwOlJlcG9zaXRvcnkyMjg4NzA5NA==-flat-blobbox.h.html,0.11143695014662756,24,caffe-MDEwOlJlcG9zaXRvcnk2MTg3MDgwMw==-flat-mpio.h,tesseract-MDEwOlJlcG9zaXRvcnkyMjg4NzA5NA==-flat-blobbox.h,360,378,18,525,558,33
973793,https://htmlpreview.github.io/?https://github.com/Christina96/boilerplate-sample-matches/blob/main/Cpp/snap-MDEwOlJlcG9zaXRvcnk0Mjg4MzU3-flat-agmdirected.h-snap-MDEwOlJlcG9zaXRvcnk0Mjg4MzU3-flat-timenet.cpp.html,0.06947282386595832,13,snap-MDEwOlJlcG9zaXRvcnk0Mjg4MzU3-flat-agmdirected.h,snap-MDEwOlJlcG9zaXRvcnk0Mjg4MzU3-flat-timenet.cpp,258,270,12,681,685,4
974306,https://htmlpreview.github.io/?https://github.com/Christina96/boilerplate-sample-matches/blob/main/Cpp/tesseract-MDEwOlJlcG9zaXRvcnkyMjg4NzA5NA==-flat-osdetect.cpp-snap-MDEwOlJlcG9zaXRvcnk0Mjg4MzU3-flat-nmobj.cpp.html,0.09107806691449814,10,tesseract-MDEwOlJlcG9zaXRvcnkyMjg4NzA5NA==-flat-osdetect.cpp,snap-MDEwOlJlcG9zaXRvcnk0Mjg4MzU3-flat-nmobj.cpp,236,243,7,534,538,4
975560,https://htmlpreview.github.io/?https://github.com/Christina96/boilerplate-sample-matches/blob/main/Cpp/notepad-plus-plus-MDEwOlJlcG9zaXRvcnkzMzAxNDgxMQ==-flat-source_location.hpp-abseil-cpp-MDEwOlJlcG9zaXRvcnkxMDQyMzE1NDE=-flat-cord_rep_ring.h.html,0.06208425720620843,14,notepad-plus-plus-MDEwOlJlcG9zaXRvcnkzMzAxNDgxMQ==-flat-source_location.hpp,abseil-cpp-MDEwOlJlcG9zaXRvcnkxMDQyMzE1NDE=-flat-cord_rep_ring.h,39,61,22,32,35,3
975678,https://htmlpreview.github.io/?https://github.com/Christina96/boilerplate-sample-matches/blob/main/Cpp/nano-node-MDEwOlJlcG9zaXRvcnkxOTM0NzM0MA==-flat-final_vote_store_84.hpp-snap-MDEwOlJlcG9zaXRvcnk0Mjg4MzU3-flat-timenet.h.html,0.11049723756906077,10,nano-node-MDEwOlJlcG9zaXRvcnkxOTM0NzM0MA==-flat-final_vote_store_84.hpp,snap-MDEwOlJlcG9zaXRvcnk0Mjg4MzU3-flat-timenet.h,15,19,4,40,43,3
975920,https://htmlpreview.github.io/?https://github.com/Christina96/boilerplate-sample-matches/blob/main/Cpp/notepad-plus-plus-MDEwOlJlcG9zaXRvcnkzMzAxNDgxMQ==-flat-SparseVector.h-abseil-cpp-MDEwOlJlcG9zaXRvcnkxMDQyMzE1NDE=-flat-cord_test.cc.html,0.02531645569620253,10,notepad-plus-plus-MDEwOlJlcG9zaXRvcnkzMzAxNDgxMQ==-flat-SparseVector.h,abseil-cpp-MDEwOlJlcG9zaXRvcnkxMDQyMzE1NDE=-flat-cord_test.cc,28,34,6,54,61,7
976282,https://htmlpreview.github.io/?https://github.com/Christina96/boilerplate-sample-matches/blob/main/Cpp/tesseract-MDEwOlJlcG9zaXRvcnkyMjg4NzA5NA==-flat-intfx.cpp-tesseract-MDEwOlJlcG9zaXRvcnkyMjg4NzA5NA==-flat-control.cpp.html,0.0555812876331635,10,tesseract-MDEwOlJlcG9zaXRvcnkyMjg4NzA5NA==-flat-intfx.cpp,tesseract-MDEwOlJlcG9zaXRvcnkyMjg4NzA5NA==-flat-control.cpp,208,224,16,441,447,6
977067,https://htmlpreview.github.io/?https://github.com/Christina96/boilerplate-sample-matches/blob/main/Cpp/caffe-MDEwOlJlcG9zaXRvcnk2MTg3MDgwMw==-flat-concat_layer.cpp-abseil-cpp-MDEwOlJlcG9zaXRvcnkxMDQyMzE1NDE=-flat-charconv_bigint_test.cc.html,0.14652014652014653,10,caffe-MDEwOlJlcG9zaXRvcnk2MTg3MDgwMw==-flat-concat_layer.cpp,abseil-cpp-MDEwOlJlcG9zaXRvcnkxMDQyMzE1NDE=-flat-charconv_bigint_test.cc,90,102,12,183,194,11
978662,https://htmlpreview.github.io/?https://github.com/Christina96/boilerplate-sample-matches/blob/main/Cpp/tesseract-MDEwOlJlcG9zaXRvcnkyMjg4NzA5NA==-flat-dawg.cpp-tesseract-MDEwOlJlcG9zaXRvcnkyMjg4NzA5NA==-flat-scrollview.cpp.html,0.02891566265060241,9,tesseract-MDEwOlJlcG9zaXRvcnkyMjg4NzA5NA==-flat-dawg.cpp,tesseract-MDEwOlJlcG9zaXRvcnkyMjg4NzA5NA==-flat-scrollview.cpp,155,160,5,444,450,6
979920,https://htmlpreview.github.io/?https://github.com/Christina96/boilerplate-sample-matches/blob/main/Cpp/tesseract-MDEwOlJlcG9zaXRvcnkyMjg4NzA5NA==-flat-mod128.h-tesseract-MDEwOlJlcG9zaXRvcnkyMjg4NzA5NA==-flat-errorcounter.cpp.html,0.035856573705179286,9,tesseract-MDEwOlJlcG9zaXRvcnkyMjg4NzA5NA==-flat-mod128.h,tesseract-MDEwOlJlcG9zaXRvcnkyMjg4NzA5NA==-flat-errorcounter.cpp,33,37,4,147,152,5
990869,https://htmlpreview.github.io/?https://github.com/Christina96/boilerplate-sample-matches/blob/main/Cpp/snap-MDEwOlJlcG9zaXRvcnk0Mjg4MzU3-flat-linkpred.h-snap-MDEwOlJlcG9zaXRvcnk0Mjg4MzU3-flat-euproj.h.html,0.08149405772495756,10,snap-MDEwOlJlcG9zaXRvcnk0Mjg4MzU3-flat-linkpred.h,snap-MDEwOlJlcG9zaXRvcnk0Mjg4MzU3-flat-euproj.h,89,92,3,55,59,4
992377,https://htmlpreview.github.io/?https://github.com/Christina96/boilerplate-sample-matches/blob/main/Cpp/nano-node-MDEwOlJlcG9zaXRvcnkxOTM0NzM0MA==-flat-logging.hpp-snap-MDEwOlJlcG9zaXRvcnk0Mjg4MzU3-flat-nyta.h.html,0.05187319884726225,9,nano-node-MDEwOlJlcG9zaXRvcnkxOTM0NzM0MA==-flat-logging.hpp,snap-MDEwOlJlcG9zaXRvcnk0Mjg4MzU3-flat-nyta.h,60,64,4,56,60,4
992756,https://htmlpreview.github.io/?https://github.com/Christina96/boilerplate-sample-matches/blob/main/Cpp/tesseract-MDEwOlJlcG9zaXRvcnkyMjg4NzA5NA==-flat-ctc.cpp-snap-MDEwOlJlcG9zaXRvcnk0Mjg4MzU3-flat-vizmap.cpp.html,0.11398624303963314,11,tesseract-MDEwOlJlcG9zaXRvcnkyMjg4NzA5NA==-flat-ctc.cpp,snap-MDEwOlJlcG9zaXRvcnk0Mjg4MzU3-flat-vizmap.cpp,199,205,6,361,364,3
1000967,https://htmlpreview.github.io/?https://github.com/Christina96/boilerplate-sample-matches/blob/main/Cpp/snap-MDEwOlJlcG9zaXRvcnk0Mjg4MzU3-flat-centr.cpp-snap-MDEwOlJlcG9zaXRvcnk0Mjg4MzU3-flat-wikinet.cpp.html,0.14184162671515954,9,snap-MDEwOlJlcG9zaXRvcnk0Mjg4MzU3-flat-centr.cpp,snap-MDEwOlJlcG9zaXRvcnk0Mjg4MzU3-flat-wikinet.cpp,397,401,4,2598,2606,8
1006350,https://htmlpreview.github.io/?https://github.com/Christina96/boilerplate-sample-matches/blob/main/Cpp/caffe-MDEwOlJlcG9zaXRvcnk2MTg3MDgwMw==-flat-test_mkl_pooling_layer.cpp-tesseract-MDEwOlJlcG9zaXRvcnkyMjg4NzA5NA==-flat-baselinedetect.cpp.html,0.015584415584415584,9,caffe-MDEwOlJlcG9zaXRvcnk2MTg3MDgwMw==-flat-test_mkl_pooling_layer.cpp,tesseract-MDEwOlJlcG9zaXRvcnkyMjg4NzA5NA==-flat-baselinedetect.cpp,86,97,11,232,237,5
1008948,https://htmlpreview.github.io/?https://github.com/Christina96/boilerplate-sample-matches/blob/main/Cpp/snap-MDEwOlJlcG9zaXRvcnk0Mjg4MzU3-flat-sappsrv.h-snap-MDEwOlJlcG9zaXRvcnk0Mjg4MzU3-flat-conjgrad.h.html,0.041604754829123326,14,snap-MDEwOlJlcG9zaXRvcnk0Mjg4MzU3-flat-sappsrv.h,snap-MDEwOlJlcG9zaXRvcnk0Mjg4MzU3-flat-conjgrad.h,11,13,2,16,18,2
1012248,https://htmlpreview.github.io/?https://github.com/Christina96/boilerplate-sample-matches/blob/main/Cpp/caffe-MDEwOlJlcG9zaXRvcnk2MTg3MDgwMw==-flat-gmock-spec-builders.cc-snap-MDEwOlJlcG9zaXRvcnk0Mjg4MzU3-flat-mmnet.h.html,0.01060695344725987,9,caffe-MDEwOlJlcG9zaXRvcnk2MTg3MDgwMw==-flat-gmock-spec-builders.cc,snap-MDEwOlJlcG9zaXRvcnk0Mjg4MzU3-flat-mmnet.h,469,477,8,419,427,8
1013478,https://htmlpreview.github.io/?https://github.com/Christina96/boilerplate-sample-matches/blob/main/Cpp/notepad-plus-plus-MDEwOlJlcG9zaXRvcnkzMzAxNDgxMQ==-flat-Selection.h-snap-MDEwOlJlcG9zaXRvcnk0Mjg4MzU3-flat-ghash.cpp.html,0.028277634961439587,11,notepad-plus-plus-MDEwOlJlcG9zaXRvcnkzMzAxNDgxMQ==-flat-Selection.h,snap-MDEwOlJlcG9zaXRvcnk0Mjg4MzU3-flat-ghash.cpp,53,60,7,209,211,2
1017050,https://htmlpreview.github.io/?https://github.com/Christina96/boilerplate-sample-matches/blob/main/Cpp/snap-MDEwOlJlcG9zaXRvcnk0Mjg4MzU3-flat-sock-new.h-snap-MDEwOlJlcG9zaXRvcnk0Mjg4MzU3-flat-kronecker.h.html,0.11391375101708706,10,snap-MDEwOlJlcG9zaXRvcnk0Mjg4MzU3-flat-sock-new.h,snap-MDEwOlJlcG9zaXRvcnk0Mjg4MzU3-flat-kronecker.h,124,126,2,20,21,1
1031338,https://htmlpreview.github.io/?https://github.com/Christina96/boilerplate-sample-matches/blob/main/Cpp/caffe-MDEwOlJlcG9zaXRvcnk2MTg3MDgwMw==-flat-cpu_info.cpp-snap-MDEwOlJlcG9zaXRvcnk0Mjg4MzU3-flat-rids.h.html,0.01592215833701902,9,caffe-MDEwOlJlcG9zaXRvcnk2MTg3MDgwMw==-flat-cpu_info.cpp,snap-MDEwOlJlcG9zaXRvcnk0Mjg4MzU3-flat-rids.h,331,339,8,136,146,10
1032124,https://htmlpreview.github.io/?https://github.com/Christina96/boilerplate-sample-matches/blob/main/Cpp/snap-MDEwOlJlcG9zaXRvcnk0Mjg4MzU3-flat-bits.cpp-snap-MDEwOlJlcG9zaXRvcnk0Mjg4MzU3-flat-googlex.cpp.html,0.17224199288256228,11,snap-MDEwOlJlcG9zaXRvcnk0Mjg4MzU3-flat-bits.cpp,snap-MDEwOlJlcG9zaXRvcnk0Mjg4MzU3-flat-googlex.cpp,131,133,2,131,134,3
1043865,https://htmlpreview.github.io/?https://github.com/Christina96/boilerplate-sample-matches/blob/main/Cpp/nano-node-MDEwOlJlcG9zaXRvcnkxOTM0NzM0MA==-flat-entry_2.cpp-snap-MDEwOlJlcG9zaXRvcnk0Mjg4MzU3-flat-webnetobj.cpp.html,0.03543307086614173,9,nano-node-MDEwOlJlcG9zaXRvcnkxOTM0NzM0MA==-flat-entry_2.cpp,snap-MDEwOlJlcG9zaXRvcnk0Mjg4MzU3-flat-webnetobj.cpp,135,143,8,86,93,7
1063811,https://htmlpreview.github.io/?https://github.com/Christina96/boilerplate-sample-matches/blob/main/Cpp/snap-MDEwOlJlcG9zaXRvcnk0Mjg4MzU3-flat-dzs.h-abseil-cpp-MDEwOlJlcG9zaXRvcnkxMDQyMzE1NDE=-flat-gaussian_distribution_test.cc.html,0.05665024630541872,9,snap-MDEwOlJlcG9zaXRvcnk0Mjg4MzU3-flat-dzs.h,abseil-cpp-MDEwOlJlcG9zaXRvcnkxMDQyMzE1NDE=-flat-gaussian_distribution_test.cc,34,35,1,111,112,1
1065355,https://htmlpreview.github.io/?https://github.com/Christina96/boilerplate-sample-matches/blob/main/Cpp/snap-MDEwOlJlcG9zaXRvcnk0Mjg4MzU3-flat-ssqldm.cpp-tesseract-MDEwOlJlcG9zaXRvcnkyMjg4NzA5NA==-flat-tospace.cpp.html,0.12995245641838352,9,snap-MDEwOlJlcG9zaXRvcnk0Mjg4MzU3-flat-ssqldm.cpp,tesseract-MDEwOlJlcG9zaXRvcnkyMjg4NzA5NA==-flat-tospace.cpp,261,263,2,1183,1188,5
1070837,https://htmlpreview.github.io/?https://github.com/Christina96/boilerplate-sample-matches/blob/main/Cpp/notepad-plus-plus-MDEwOlJlcG9zaXRvcnkzMzAxNDgxMQ==-flat-QuartzTextStyle.h-snap-MDEwOlJlcG9zaXRvcnk0Mjg4MzU3-flat-webtxtbs.h.html,0.05970149253731343,10,notepad-plus-plus-MDEwOlJlcG9zaXRvcnkzMzAxNDgxMQ==-flat-QuartzTextStyle.h,snap-MDEwOlJlcG9zaXRvcnk0Mjg4MzU3-flat-webtxtbs.h,51,61,10,49,51,2
1071187,https://htmlpreview.github.io/?https://github.com/Christina96/boilerplate-sample-matches/blob/main/Cpp/snap-MDEwOlJlcG9zaXRvcnk0Mjg4MzU3-flat-googlex.cpp-caffe-MDEwOlJlcG9zaXRvcnk2MTg3MDgwMw==-flat-data_transformer.cpp.html,0.09865796155241205,9,snap-MDEwOlJlcG9zaXRvcnk0Mjg4MzU3-flat-googlex.cpp,caffe-MDEwOlJlcG9zaXRvcnk2MTg3MDgwMw==-flat-data_transformer.cpp,167,171,4,1115,1119,4
1071738,https://htmlpreview.github.io/?https://github.com/Christina96/boilerplate-sample-matches/blob/main/Cpp/abseil-cpp-MDEwOlJlcG9zaXRvcnkxMDQyMzE1NDE=-flat-numbers_test.cc-subconverter-MDEwOlJlcG9zaXRvcnkyMTg2ODY3NjM=-flat-interfaces.cpp.html,0.04434180138568129,28,abseil-cpp-MDEwOlJlcG9zaXRvcnkxMDQyMzE1NDE=-flat-numbers_test.cc,subconverter-MDEwOlJlcG9zaXRvcnkyMTg2ODY3NjM=-flat-interfaces.cpp,166,187,21,56,69,13
1081331,https://htmlpreview.github.io/?https://github.com/Christina96/boilerplate-sample-matches/blob/main/Cpp/notepad-plus-plus-MDEwOlJlcG9zaXRvcnkzMzAxNDgxMQ==-flat-ScintillaCall.h-snap-MDEwOlJlcG9zaXRvcnk0Mjg4MzU3-flat-agmattr.h.html,0.03717026378896882,10,notepad-plus-plus-MDEwOlJlcG9zaXRvcnkzMzAxNDgxMQ==-flat-ScintillaCall.h,snap-MDEwOlJlcG9zaXRvcnk0Mjg4MzU3-flat-agmattr.h,369,379,10,424,424,0
1094465,https://htmlpreview.github.io/?https://github.com/Christina96/boilerplate-sample-matches/blob/main/Cpp/snap-MDEwOlJlcG9zaXRvcnk0Mjg4MzU3-flat-gks.cpp-snap-MDEwOlJlcG9zaXRvcnk0Mjg4MzU3-flat-memes.cpp.html,0.027439024390243903,14,snap-MDEwOlJlcG9zaXRvcnk0Mjg4MzU3-flat-gks.cpp,snap-MDEwOlJlcG9zaXRvcnk0Mjg4MzU3-flat-memes.cpp,98,102,4,2464,2469,5
1098376,https://htmlpreview.github.io/?https://github.com/Christina96/boilerplate-sample-matches/blob/main/Cpp/Cpp_Primer_Answers-MDEwOlJlcG9zaXRvcnk0NzE3MDI2MQ==-flat-exercise14_7.h-snap-MDEwOlJlcG9zaXRvcnk0Mjg4MzU3-flat-btalarms.h.html,0.04085422469823584,13,Cpp_Primer_Answers-MDEwOlJlcG9zaXRvcnk0NzE3MDI2MQ==-flat-exercise14_7.h,snap-MDEwOlJlcG9zaXRvcnk0Mjg4MzU3-flat-btalarms.h,14,16,2,162,164,2
1099487,https://htmlpreview.github.io/?https://github.com/Christina96/boilerplate-sample-matches/blob/main/Cpp/snap-MDEwOlJlcG9zaXRvcnk0Mjg4MzU3-flat-ncpplot.cpp-abseil-cpp-MDEwOlJlcG9zaXRvcnkxMDQyMzE1NDE=-flat-memutil.h.html,0.0972972972972973,9,snap-MDEwOlJlcG9zaXRvcnk0Mjg4MzU3-flat-ncpplot.cpp,abseil-cpp-MDEwOlJlcG9zaXRvcnkxMDQyMzE1NDE=-flat-memutil.h,16,18,2,26,28,2
1101282,https://htmlpreview.github.io/?https://github.com/Christina96/boilerplate-sample-matches/blob/main/Cpp/tesseract-MDEwOlJlcG9zaXRvcnkyMjg4NzA5NA==-flat-cjkpitch.cpp-notepad-plus-plus-MDEwOlJlcG9zaXRvcnkzMzAxNDgxMQ==-flat-json.hpp.html,0.01941169465285221,9,tesseract-MDEwOlJlcG9zaXRvcnkyMjg4NzA5NA==-flat-cjkpitch.cpp,notepad-plus-plus-MDEwOlJlcG9zaXRvcnkzMzAxNDgxMQ==-flat-json.hpp,677,683,6,5270,5283,13
1103407,https://htmlpreview.github.io/?https://github.com/Christina96/boilerplate-sample-matches/blob/main/Cpp/snap-MDEwOlJlcG9zaXRvcnk0Mjg4MzU3-flat-test-TNGraph.cpp-snap-MDEwOlJlcG9zaXRvcnk0Mjg4MzU3-flat-ds.h.html,0.01406717074028486,10,snap-MDEwOlJlcG9zaXRvcnk0Mjg4MzU3-flat-test-TNGraph.cpp,snap-MDEwOlJlcG9zaXRvcnk0Mjg4MzU3-flat-ds.h,83,104,21,1883,1887,4
1105048,https://htmlpreview.github.io/?https://github.com/Christina96/boilerplate-sample-matches/blob/main/Cpp/abseil-cpp-MDEwOlJlcG9zaXRvcnkxMDQyMzE1NDE=-flat-fixed_array_test.cc-caffe-MDEwOlJlcG9zaXRvcnk2MTg3MDgwMw==-flat-im2col.cpp.html,0.07796610169491526,10,abseil-cpp-MDEwOlJlcG9zaXRvcnkxMDQyMzE1NDE=-flat-fixed_array_test.cc,caffe-MDEwOlJlcG9zaXRvcnk2MTg3MDgwMw==-flat-im2col.cpp,242,243,1,273,274,1
1108620,https://htmlpreview.github.io/?https://github.com/Christina96/boilerplate-sample-matches/blob/main/Cpp/tesseract-MDEwOlJlcG9zaXRvcnkyMjg4NzA5NA==-flat-stringrenderer.cpp-notepad-plus-plus-MDEwOlJlcG9zaXRvcnkzMzAxNDgxMQ==-flat-BabyGrid.cpp.html,0.051451187335092345,10,tesseract-MDEwOlJlcG9zaXRvcnkyMjg4NzA5NA==-flat-stringrenderer.cpp,notepad-plus-plus-MDEwOlJlcG9zaXRvcnkzMzAxNDgxMQ==-flat-BabyGrid.cpp,33,40,7,2510,2519,9
1115850,https://htmlpreview.github.io/?https://github.com/Christina96/boilerplate-sample-matches/blob/main/Cpp/snap-MDEwOlJlcG9zaXRvcnk0Mjg4MzU3-flat-acquis.cpp-snap-MDEwOlJlcG9zaXRvcnk0Mjg4MzU3-flat-bowactlearn.cpp.html,0.05787781350482315,9,snap-MDEwOlJlcG9zaXRvcnk0Mjg4MzU3-flat-acquis.cpp,snap-MDEwOlJlcG9zaXRvcnk0Mjg4MzU3-flat-bowactlearn.cpp,31,36,5,127,131,4
1118507,https://htmlpreview.github.io/?https://github.com/Christina96/boilerplate-sample-matches/blob/main/Cpp/caffe-MDEwOlJlcG9zaXRvcnk2MTg3MDgwMw==-flat-test_io.cpp-caffe-MDEwOlJlcG9zaXRvcnk2MTg3MDgwMw==-flat-test_normalize_layer.cpp.html,0.2529411764705882,15,caffe-MDEwOlJlcG9zaXRvcnk2MTg3MDgwMw==-flat-test_io.cpp,caffe-MDEwOlJlcG9zaXRvcnk2MTg3MDgwMw==-flat-test_normalize_layer.cpp,37,39,2,125,127,2
1120838,https://htmlpreview.github.io/?https://github.com/Christina96/boilerplate-sample-matches/blob/main/Cpp/snap-MDEwOlJlcG9zaXRvcnk0Mjg4MzU3-flat-ultra.cpp-subconverter-MDEwOlJlcG9zaXRvcnkyMTg2ODY3NjM=-flat-json.hpp.html,0.03370655470025659,13,snap-MDEwOlJlcG9zaXRvcnk0Mjg4MzU3-flat-ultra.cpp,subconverter-MDEwOlJlcG9zaXRvcnkyMTg2ODY3NjM=-flat-json.hpp,45,59,14,12408,12430,22
1121096,https://htmlpreview.github.io/?https://github.com/Christina96/boilerplate-sample-matches/blob/main/Cpp/caffe-MDEwOlJlcG9zaXRvcnk2MTg3MDgwMw==-flat-test_image_data_layer.cpp-snap-MDEwOlJlcG9zaXRvcnk0Mjg4MzU3-flat-flx.cpp.html,0.011795543905635648,9,caffe-MDEwOlJlcG9zaXRvcnk2MTg3MDgwMw==-flat-test_image_data_layer.cpp,snap-MDEwOlJlcG9zaXRvcnk0Mjg4MzU3-flat-flx.cpp,209,212,3,300,303,3
1122140,https://htmlpreview.github.io/?https://github.com/Christina96/boilerplate-sample-matches/blob/main/Cpp/abseil-cpp-MDEwOlJlcG9zaXRvcnkxMDQyMzE1NDE=-flat-charconv_bigint_test.cc-caffe-MDEwOlJlcG9zaXRvcnk2MTg3MDgwMw==-flat-test_io.cpp.html,0.21841541755888652,14,abseil-cpp-MDEwOlJlcG9zaXRvcnkxMDQyMzE1NDE=-flat-charconv_bigint_test.cc,caffe-MDEwOlJlcG9zaXRvcnk2MTg3MDgwMw==-flat-test_io.cpp,147,158,11,363,370,7
1122921,https://htmlpreview.github.io/?https://github.com/Christina96/boilerplate-sample-matches/blob/main/Cpp/snap-MDEwOlJlcG9zaXRvcnk0Mjg4MzU3-flat-infonet.h-snap-MDEwOlJlcG9zaXRvcnk0Mjg4MzU3-flat-btalarms.h.html,0.2957920792079208,9,snap-MDEwOlJlcG9zaXRvcnk0Mjg4MzU3-flat-infonet.h,snap-MDEwOlJlcG9zaXRvcnk0Mjg4MzU3-flat-btalarms.h,131,134,3,99,100,1
1125465,https://htmlpreview.github.io/?https://github.com/Christina96/boilerplate-sample-matches/blob/main/Cpp/snap-MDEwOlJlcG9zaXRvcnk0Mjg4MzU3-flat-mkcca.h-snap-MDEwOlJlcG9zaXRvcnk0Mjg4MzU3-flat-agm.h.html,0.09492635024549918,18,snap-MDEwOlJlcG9zaXRvcnk0Mjg4MzU3-flat-mkcca.h,snap-MDEwOlJlcG9zaXRvcnk0Mjg4MzU3-flat-agm.h,15,19,4,15,16,1
1126362,https://htmlpreview.github.io/?https://github.com/Christina96/boilerplate-sample-matches/blob/main/Cpp/snap-MDEwOlJlcG9zaXRvcnk0Mjg4MzU3-flat-ssch.cpp-snap-MDEwOlJlcG9zaXRvcnk0Mjg4MzU3-flat-shash.h.html,0.03890089533806731,9,snap-MDEwOlJlcG9zaXRvcnk0Mjg4MzU3-flat-ssch.cpp,snap-MDEwOlJlcG9zaXRvcnk0Mjg4MzU3-flat-shash.h,12,20,8,13,16,3
1132283,https://htmlpreview.github.io/?https://github.com/Christina96/boilerplate-sample-matches/blob/main/Cpp/nano-node-MDEwOlJlcG9zaXRvcnkxOTM0NzM0MA==-flat-confirmation_height_processor.hpp-caffe-MDEwOlJlcG9zaXRvcnk2MTg3MDgwMw==-flat-gmock-generated-nice-strict.h.html,0.05275779376498801,11,nano-node-MDEwOlJlcG9zaXRvcnkxOTM0NzM0MA==-flat-confirmation_height_processor.hpp,caffe-MDEwOlJlcG9zaXRvcnk2MTg3MDgwMw==-flat-gmock-generated-nice-strict.h,35,42,7,73,75,2
1133989,https://htmlpreview.github.io/?https://github.com/Christina96/boilerplate-sample-matches/blob/main/Cpp/snap-MDEwOlJlcG9zaXRvcnk0Mjg4MzU3-flat-bits.h-snap-MDEwOlJlcG9zaXRvcnk0Mjg4MzU3-flat-mmnet.h.html,0.12363290537327627,20,snap-MDEwOlJlcG9zaXRvcnk0Mjg4MzU3-flat-bits.h,snap-MDEwOlJlcG9zaXRvcnk0Mjg4MzU3-flat-mmnet.h,104,107,3,139,142,3
1137440,https://htmlpreview.github.io/?https://github.com/Christina96/boilerplate-sample-matches/blob/main/Cpp/tesseract-MDEwOlJlcG9zaXRvcnkyMjg4NzA5NA==-flat-intproto.cpp-tesseract-MDEwOlJlcG9zaXRvcnkyMjg4NzA5NA==-flat-topitch.cpp.html,0.12222222222222222,11,tesseract-MDEwOlJlcG9zaXRvcnkyMjg4NzA5NA==-flat-intproto.cpp,tesseract-MDEwOlJlcG9zaXRvcnkyMjg4NzA5NA==-flat-topitch.cpp,843,852,9,101,113,12
1138057,https://htmlpreview.github.io/?https://github.com/Christina96/boilerplate-sample-matches/blob/main/Cpp/snap-MDEwOlJlcG9zaXRvcnk0Mjg4MzU3-flat-webtxtbs.cpp-caffe-MDEwOlJlcG9zaXRvcnk2MTg3MDgwMw==-flat-data_transformer.cpp.html,0.09282700421940929,9,snap-MDEwOlJlcG9zaXRvcnk0Mjg4MzU3-flat-webtxtbs.cpp,caffe-MDEwOlJlcG9zaXRvcnk2MTg3MDgwMw==-flat-data_transformer.cpp,42,47,5,300,312,12
1144808,https://htmlpreview.github.io/?https://github.com/Christina96/boilerplate-sample-matches/blob/main/Cpp/notepad-plus-plus-MDEwOlJlcG9zaXRvcnkzMzAxNDgxMQ==-flat-SplitterContainer.h-snap-MDEwOlJlcG9zaXRvcnk0Mjg4MzU3-flat-cyc.cpp.html,0.025839793281653745,10,notepad-plus-plus-MDEwOlJlcG9zaXRvcnkzMzAxNDgxMQ==-flat-SplitterContainer.h,snap-MDEwOlJlcG9zaXRvcnk0Mjg4MzU3-flat-cyc.cpp,35,41,6,267,271,4
1145243,https://htmlpreview.github.io/?https://github.com/Christina96/boilerplate-sample-matches/blob/main/Cpp/tesseract-MDEwOlJlcG9zaXRvcnkyMjg4NzA5NA==-flat-elst.cpp-tesseract-MDEwOlJlcG9zaXRvcnkyMjg4NzA5NA==-flat-paragraphs.cpp.html,0.05894736842105263,10,tesseract-MDEwOlJlcG9zaXRvcnkyMjg4NzA5NA==-flat-elst.cpp,tesseract-MDEwOlJlcG9zaXRvcnkyMjg4NzA5NA==-flat-paragraphs.cpp,46,51,5,690,695,5
1148825,https://htmlpreview.github.io/?https://github.com/Christina96/boilerplate-sample-matches/blob/main/Cpp/snap-MDEwOlJlcG9zaXRvcnk0Mjg4MzU3-flat-dt.cpp-notepad-plus-plus-MDEwOlJlcG9zaXRvcnkzMzAxNDgxMQ==-flat-preferenceDlg.cpp.html,0.036049382716049384,13,snap-MDEwOlJlcG9zaXRvcnk0Mjg4MzU3-flat-dt.cpp,notepad-plus-plus-MDEwOlJlcG9zaXRvcnkzMzAxNDgxMQ==-flat-preferenceDlg.cpp,1555,1561,6,569,587,18
1151231,https://htmlpreview.github.io/?https://github.com/Christina96/boilerplate-sample-matches/blob/main/Cpp/caffe-MDEwOlJlcG9zaXRvcnk2MTg3MDgwMw==-flat-blob.cpp-caffe-MDEwOlJlcG9zaXRvcnk2MTg3MDgwMw==-flat-test_mkl_convolution_layer.cpp.html,0.012077294685990338,10,caffe-MDEwOlJlcG9zaXRvcnk2MTg3MDgwMw==-flat-blob.cpp,caffe-MDEwOlJlcG9zaXRvcnk2MTg3MDgwMw==-flat-test_mkl_convolution_layer.cpp,557,565,8,41,47,6
1154667,https://htmlpreview.github.io/?https://github.com/Christina96/boilerplate-sample-matches/blob/main/Cpp/subconverter-MDEwOlJlcG9zaXRvcnkyMTg2ODY3NjM=-flat-webserver_libevent.cpp-abseil-cpp-MDEwOlJlcG9zaXRvcnkxMDQyMzE1NDE=-flat-inlined_vector_test.cc.html,0.022727272727272728,9,subconverter-MDEwOlJlcG9zaXRvcnkyMTg2ODY3NjM=-flat-webserver_libevent.cpp,abseil-cpp-MDEwOlJlcG9zaXRvcnkxMDQyMzE1NDE=-flat-inlined_vector_test.cc,51,54,3,355,379,24
1159154,https://htmlpreview.github.io/?https://github.com/Christina96/boilerplate-sample-matches/blob/main/Cpp/snap-MDEwOlJlcG9zaXRvcnk0Mjg4MzU3-flat-wgtnet.cpp-snap-MDEwOlJlcG9zaXRvcnk0Mjg4MzU3-flat-conv.h.html,0.08723336517032793,11,snap-MDEwOlJlcG9zaXRvcnk0Mjg4MzU3-flat-wgtnet.cpp,snap-MDEwOlJlcG9zaXRvcnk0Mjg4MzU3-flat-conv.h,276,279,3,1064,1067,3
1160112,https://htmlpreview.github.io/?https://github.com/Christina96/boilerplate-sample-matches/blob/main/Cpp/tesseract-MDEwOlJlcG9zaXRvcnkyMjg4NzA5NA==-flat-language_model.cpp-notepad-plus-plus-MDEwOlJlcG9zaXRvcnkzMzAxNDgxMQ==-flat-preferenceDlg.cpp.html,0.04471321238775884,13,tesseract-MDEwOlJlcG9zaXRvcnkyMjg4NzA5NA==-flat-language_model.cpp,notepad-plus-plus-MDEwOlJlcG9zaXRvcnkzMzAxNDgxMQ==-flat-preferenceDlg.cpp,895,901,6,1710,1723,13
1160467,https://htmlpreview.github.io/?https://github.com/Christina96/boilerplate-sample-matches/blob/main/Cpp/caffe-MDEwOlJlcG9zaXRvcnk2MTg3MDgwMw==-flat-gmock-cardinalities.cc-abseil-cpp-MDEwOlJlcG9zaXRvcnkxMDQyMzE1NDE=-flat-cord_analysis.cc.html,0.09195402298850575,12,caffe-MDEwOlJlcG9zaXRvcnk2MTg3MDgwMw==-flat-gmock-cardinalities.cc,abseil-cpp-MDEwOlJlcG9zaXRvcnkxMDQyMzE1NDE=-flat-cord_analysis.cc,65,71,6,98,104,6
1163685,https://htmlpreview.github.io/?https://github.com/Christina96/boilerplate-sample-matches/blob/main/Cpp/abseil-cpp-MDEwOlJlcG9zaXRvcnkxMDQyMzE1NDE=-flat-cord_rep_ring.cc-MMKV-MDEwOlJlcG9zaXRvcnkxNDkxMTE4MTM=-flat-MMKV_IO.cpp.html,0.06547960941987363,10,abseil-cpp-MDEwOlJlcG9zaXRvcnkxMDQyMzE1NDE=-flat-cord_rep_ring.cc,MMKV-MDEwOlJlcG9zaXRvcnkxNDkxMTE4MTM=-flat-MMKV_IO.cpp,116,126,10,933,940,7
1174832,https://htmlpreview.github.io/?https://github.com/Christina96/boilerplate-sample-matches/blob/main/Cpp/caffe-MDEwOlJlcG9zaXRvcnk2MTg3MDgwMw==-flat-net.hpp-caffe-MDEwOlJlcG9zaXRvcnk2MTg3MDgwMw==-flat-gmock-generated-actions.h.html,0.04527712724434036,10,caffe-MDEwOlJlcG9zaXRvcnk2MTg3MDgwMw==-flat-net.hpp,caffe-MDEwOlJlcG9zaXRvcnk2MTg3MDgwMw==-flat-gmock-generated-actions.h,234,246,12,624,625,1
1178969,https://htmlpreview.github.io/?https://github.com/Christina96/boilerplate-sample-matches/blob/main/Cpp/snap-MDEwOlJlcG9zaXRvcnk0Mjg4MzU3-flat-postag.cpp-caffe-MDEwOlJlcG9zaXRvcnk2MTg3MDgwMw==-flat-bbox_util.cpp.html,0.09916974169741698,12,snap-MDEwOlJlcG9zaXRvcnk0Mjg4MzU3-flat-postag.cpp,caffe-MDEwOlJlcG9zaXRvcnk2MTg3MDgwMw==-flat-bbox_util.cpp,205,210,5,2209,2212,3
1184588,https://htmlpreview.github.io/?https://github.com/Christina96/boilerplate-sample-matches/blob/main/Cpp/snap-MDEwOlJlcG9zaXRvcnk0Mjg4MzU3-flat-demo-TNodeEDatNet.cpp-snap-MDEwOlJlcG9zaXRvcnk0Mjg4MzU3-flat-unicode.cpp.html,0.013883532587736213,9,snap-MDEwOlJlcG9zaXRvcnk0Mjg4MzU3-flat-demo-TNodeEDatNet.cpp,snap-MDEwOlJlcG9zaXRvcnk0Mjg4MzU3-flat-unicode.cpp,48,50,2,530,534,4
1185294,https://htmlpreview.github.io/?https://github.com/Christina96/boilerplate-sample-matches/blob/main/Cpp/caffe-MDEwOlJlcG9zaXRvcnk2MTg3MDgwMw==-flat-psroi_pooling_layer.cpp-snap-MDEwOlJlcG9zaXRvcnk0Mjg4MzU3-flat-bowflx.cpp.html,0.08285004142502071,10,caffe-MDEwOlJlcG9zaXRvcnk2MTg3MDgwMw==-flat-psroi_pooling_layer.cpp,snap-MDEwOlJlcG9zaXRvcnk0Mjg4MzU3-flat-bowflx.cpp,100,104,4,526,532,6
1187193,https://htmlpreview.github.io/?https://github.com/Christina96/boilerplate-sample-matches/blob/main/Cpp/caffe-MDEwOlJlcG9zaXRvcnk2MTg3MDgwMw==-flat-test_mkldnn_convolution_layer.cpp-snap-MDEwOlJlcG9zaXRvcnk0Mjg4MzU3-flat-graph_2.cpp.html,0.0375487070492384,13,caffe-MDEwOlJlcG9zaXRvcnk2MTg3MDgwMw==-flat-test_mkldnn_convolution_layer.cpp,snap-MDEwOlJlcG9zaXRvcnk0Mjg4MzU3-flat-graph_2.cpp,818,828,10,377,383,6
1189559,https://htmlpreview.github.io/?https://github.com/Christina96/boilerplate-sample-matches/blob/main/Cpp/snap-MDEwOlJlcG9zaXRvcnk0Mjg4MzU3-flat-odbc.cpp-tesseract-MDEwOlJlcG9zaXRvcnkyMjg4NzA5NA==-flat-tospace.cpp.html,0.050724637681159424,10,snap-MDEwOlJlcG9zaXRvcnk0Mjg4MzU3-flat-odbc.cpp,tesseract-MDEwOlJlcG9zaXRvcnkyMjg4NzA5NA==-flat-tospace.cpp,217,236,19,91,95,4
1190216,https://htmlpreview.github.io/?https://github.com/Christina96/boilerplate-sample-matches/blob/main/Cpp/snap-MDEwOlJlcG9zaXRvcnk0Mjg4MzU3-flat-logreg.h-snap-MDEwOlJlcG9zaXRvcnk0Mjg4MzU3-flat-mkcca.h.html,0.27611940298507465,14,snap-MDEwOlJlcG9zaXRvcnk0Mjg4MzU3-flat-logreg.h,snap-MDEwOlJlcG9zaXRvcnk0Mjg4MzU3-flat-mkcca.h,12,13,1,41,42,1
1191803,https://htmlpreview.github.io/?https://github.com/Christina96/boilerplate-sample-matches/blob/main/Cpp/notepad-plus-plus-MDEwOlJlcG9zaXRvcnkzMzAxNDgxMQ==-flat-WordStyleDlg.cpp-snap-MDEwOlJlcG9zaXRvcnk0Mjg4MzU3-flat-ss.cpp.html,0.09251101321585903,29,notepad-plus-plus-MDEwOlJlcG9zaXRvcnkzMzAxNDgxMQ==-flat-WordStyleDlg.cpp,snap-MDEwOlJlcG9zaXRvcnk0Mjg4MzU3-flat-ss.cpp,774,798,24,258,272,14
1192012,https://htmlpreview.github.io/?https://github.com/Christina96/boilerplate-sample-matches/blob/main/Cpp/snap-MDEwOlJlcG9zaXRvcnk0Mjg4MzU3-flat-fa.cpp-snap-MDEwOlJlcG9zaXRvcnk0Mjg4MzU3-flat-agmattr.cpp.html,0.11709047900650503,12,snap-MDEwOlJlcG9zaXRvcnk0Mjg4MzU3-flat-fa.cpp,snap-MDEwOlJlcG9zaXRvcnk0Mjg4MzU3-flat-agmattr.cpp,147,152,5,227,231,4
1192672,https://htmlpreview.github.io/?https://github.com/Christina96/boilerplate-sample-matches/blob/main/Cpp/snap-MDEwOlJlcG9zaXRvcnk0Mjg4MzU3-flat-timenet.cpp-snap-MDEwOlJlcG9zaXRvcnk0Mjg4MzU3-flat-mag.cpp.html,0.1760520430981907,15,snap-MDEwOlJlcG9zaXRvcnk0Mjg4MzU3-flat-timenet.cpp,snap-MDEwOlJlcG9zaXRvcnk0Mjg4MzU3-flat-mag.cpp,674,680,6,145,152,7
1193357,https://htmlpreview.github.io/?https://github.com/Christina96/boilerplate-sample-matches/blob/main/Cpp/notepad-plus-plus-MDEwOlJlcG9zaXRvcnkzMzAxNDgxMQ==-flat-NppDarkMode.h-tesseract-MDEwOlJlcG9zaXRvcnkyMjg4NzA5NA==-flat-ratngs.h.html,0.06033182503770739,11,notepad-plus-plus-MDEwOlJlcG9zaXRvcnkzMzAxNDgxMQ==-flat-NppDarkMode.h,tesseract-MDEwOlJlcG9zaXRvcnkyMjg4NzA5NA==-flat-ratngs.h,7,17,10,30,40,10
1195042,https://htmlpreview.github.io/?https://github.com/Christina96/boilerplate-sample-matches/blob/main/Cpp/tesseract-MDEwOlJlcG9zaXRvcnkyMjg4NzA5NA==-flat-matrix_test.cc-snap-MDEwOlJlcG9zaXRvcnk0Mjg4MzU3-flat-cncom.cpp.html,0.09565217391304348,11,tesseract-MDEwOlJlcG9zaXRvcnkyMjg4NzA5NA==-flat-matrix_test.cc,snap-MDEwOlJlcG9zaXRvcnk0Mjg4MzU3-flat-cncom.cpp,11,14,3,68,70,2
1199216,https://htmlpreview.github.io/?https://github.com/Christina96/boilerplate-sample-matches/blob/main/Cpp/tesseract-MDEwOlJlcG9zaXRvcnkyMjg4NzA5NA==-flat-paragraphs_internal.h-notepad-plus-plus-MDEwOlJlcG9zaXRvcnkzMzAxNDgxMQ==-flat-FindReplaceDlg.h.html,0.026041666666666668,10,tesseract-MDEwOlJlcG9zaXRvcnkyMjg4NzA5NA==-flat-paragraphs_internal.h,notepad-plus-plus-MDEwOlJlcG9zaXRvcnkzMzAxNDgxMQ==-flat-FindReplaceDlg.h,91,97,6,226,230,4
1203908,https://htmlpreview.github.io/?https://github.com/Christina96/boilerplate-sample-matches/blob/main/Cpp/snap-MDEwOlJlcG9zaXRvcnk0Mjg4MzU3-flat-graphmp-exp.h-caffe-MDEwOlJlcG9zaXRvcnk2MTg3MDgwMw==-flat-mpicxx.h.html,0.03676767676767677,11,snap-MDEwOlJlcG9zaXRvcnk0Mjg4MzU3-flat-graphmp-exp.h,caffe-MDEwOlJlcG9zaXRvcnk2MTg3MDgwMw==-flat-mpicxx.h,98,100,2,1204,1204,0
1208399,https://htmlpreview.github.io/?https://github.com/Christina96/boilerplate-sample-matches/blob/main/Cpp/caffe-MDEwOlJlcG9zaXRvcnk2MTg3MDgwMw==-flat-gtest-death-test.cc-snap-MDEwOlJlcG9zaXRvcnk0Mjg4MzU3-flat-cache.h.html,0.011516314779270634,9,caffe-MDEwOlJlcG9zaXRvcnk2MTg3MDgwMw==-flat-gtest-death-test.cc,snap-MDEwOlJlcG9zaXRvcnk0Mjg4MzU3-flat-cache.h,317,321,4,158,165,7
1208627,https://htmlpreview.github.io/?https://github.com/Christina96/boilerplate-sample-matches/blob/main/Cpp/snap-MDEwOlJlcG9zaXRvcnk0Mjg4MzU3-flat-prolog.cpp-caffe-MDEwOlJlcG9zaXRvcnk2MTg3MDgwMw==-flat-net.cpp.html,0.02531645569620253,9,snap-MDEwOlJlcG9zaXRvcnk0Mjg4MzU3-flat-prolog.cpp,caffe-MDEwOlJlcG9zaXRvcnk2MTg3MDgwMw==-flat-net.cpp,56,63,7,1294,1301,7
1208922,https://htmlpreview.github.io/?https://github.com/Christina96/boilerplate-sample-matches/blob/main/Cpp/snap-MDEwOlJlcG9zaXRvcnk0Mjg4MzU3-flat-cascdynetinf.h-tesseract-MDEwOlJlcG9zaXRvcnkyMjg4NzA5NA==-flat-blobbox.h.html,0.11559633027522936,10,snap-MDEwOlJlcG9zaXRvcnk0Mjg4MzU3-flat-cascdynetinf.h,tesseract-MDEwOlJlcG9zaXRvcnkyMjg4NzA5NA==-flat-blobbox.h,79,81,2,301,307,6
1215630,https://htmlpreview.github.io/?https://github.com/Christina96/boilerplate-sample-matches/blob/main/Cpp/abseil-cpp-MDEwOlJlcG9zaXRvcnkxMDQyMzE1NDE=-flat-civil_time_detail.h-snap-MDEwOlJlcG9zaXRvcnk0Mjg4MzU3-flat-conv.h.html,0.024837007140639553,11,abseil-cpp-MDEwOlJlcG9zaXRvcnkxMDQyMzE1NDE=-flat-civil_time_detail.h,snap-MDEwOlJlcG9zaXRvcnk0Mjg4MzU3-flat-conv.h,86,93,7,1264,1272,8
1217743,https://htmlpreview.github.io/?https://github.com/Christina96/boilerplate-sample-matches/blob/main/Cpp/abseil-cpp-MDEwOlJlcG9zaXRvcnkxMDQyMzE1NDE=-flat-string_view_benchmark.cc-abseil-cpp-MDEwOlJlcG9zaXRvcnkxMDQyMzE1NDE=-flat-inlined_vector_benchmark.cc.html,0.06414662084765177,10,abseil-cpp-MDEwOlJlcG9zaXRvcnkxMDQyMzE1NDE=-flat-string_view_benchmark.cc,abseil-cpp-MDEwOlJlcG9zaXRvcnkxMDQyMzE1NDE=-flat-inlined_vector_benchmark.cc,114,123,9,441,450,9
1217863,https://htmlpreview.github.io/?https://github.com/Christina96/boilerplate-sample-matches/blob/main/Cpp/snap-MDEwOlJlcG9zaXRvcnk0Mjg4MzU3-flat-cfyres.cpp-snap-MDEwOlJlcG9zaXRvcnk0Mjg4MzU3-flat-strkernel.cpp.html,0.046674445740956826,11,snap-MDEwOlJlcG9zaXRvcnk0Mjg4MzU3-flat-cfyres.cpp,snap-MDEwOlJlcG9zaXRvcnk0Mjg4MzU3-flat-strkernel.cpp,117,119,2,97,102,5
1220686,https://htmlpreview.github.io/?https://github.com/Christina96/boilerplate-sample-matches/blob/main/Cpp/tesseract-MDEwOlJlcG9zaXRvcnkyMjg4NzA5NA==-flat-intmatcher.cpp-tesseract-MDEwOlJlcG9zaXRvcnkyMjg4NzA5NA==-flat-pageres.cpp.html,0.10504885993485343,20,tesseract-MDEwOlJlcG9zaXRvcnkyMjg4NzA5NA==-flat-intmatcher.cpp,tesseract-MDEwOlJlcG9zaXRvcnkyMjg4NzA5NA==-flat-pageres.cpp,117,129,12,170,189,19
1220918,https://htmlpreview.github.io/?https://github.com/Christina96/boilerplate-sample-matches/blob/main/Cpp/snap-MDEwOlJlcG9zaXRvcnk0Mjg4MzU3-flat-priorityqueue.h-abseil-cpp-MDEwOlJlcG9zaXRvcnkxMDQyMzE1NDE=-flat-symbolize_test.cc.html,0.04835164835164835,11,snap-MDEwOlJlcG9zaXRvcnk0Mjg4MzU3-flat-priorityqueue.h,abseil-cpp-MDEwOlJlcG9zaXRvcnkxMDQyMzE1NDE=-flat-symbolize_test.cc,66,68,2,341,349,8
1223215,https://htmlpreview.github.io/?https://github.com/Christina96/boilerplate-sample-matches/blob/main/Cpp/nano-node-MDEwOlJlcG9zaXRvcnkxOTM0NzM0MA==-flat-confirmation_height_store_76.cpp-snap-MDEwOlJlcG9zaXRvcnk0Mjg4MzU3-flat-googlex.h.html,0.03125,9,nano-node-MDEwOlJlcG9zaXRvcnkxOTM0NzM0MA==-flat-confirmation_height_store_76.cpp,snap-MDEwOlJlcG9zaXRvcnk0Mjg4MzU3-flat-googlex.h,52,59,7,78,79,1
1225481,https://htmlpreview.github.io/?https://github.com/Christina96/boilerplate-sample-matches/blob/main/Cpp/tesseract-MDEwOlJlcG9zaXRvcnkyMjg4NzA5NA==-flat-indexmapbidi.cpp-caffe-MDEwOlJlcG9zaXRvcnk2MTg3MDgwMw==-flat-gmock-matchers.cc.html,0.059113300492610835,9,tesseract-MDEwOlJlcG9zaXRvcnkyMjg4NzA5NA==-flat-indexmapbidi.cpp,caffe-MDEwOlJlcG9zaXRvcnk2MTg3MDgwMw==-flat-gmock-matchers.cc,144,151,7,187,196,9
1226220,https://htmlpreview.github.io/?https://github.com/Christina96/boilerplate-sample-matches/blob/main/Cpp/tesseract-MDEwOlJlcG9zaXRvcnkyMjg4NzA5NA==-flat-control.cpp-snap-MDEwOlJlcG9zaXRvcnk0Mjg4MzU3-flat-btalarms.cpp.html,0.06415552855407047,9,tesseract-MDEwOlJlcG9zaXRvcnkyMjg4NzA5NA==-flat-control.cpp,snap-MDEwOlJlcG9zaXRvcnk0Mjg4MzU3-flat-btalarms.cpp,621,623,2,679,682,3
1226315,https://htmlpreview.github.io/?https://github.com/Christina96/boilerplate-sample-matches/blob/main/Cpp/snap-MDEwOlJlcG9zaXRvcnk0Mjg4MzU3-flat-odbc.cpp-snap-MDEwOlJlcG9zaXRvcnk0Mjg4MzU3-flat-mag.cpp.html,0.04460771451062713,11,snap-MDEwOlJlcG9zaXRvcnk0Mjg4MzU3-flat-odbc.cpp,snap-MDEwOlJlcG9zaXRvcnk0Mjg4MzU3-flat-mag.cpp,384,389,5,1126,1130,4
1236243,https://htmlpreview.github.io/?https://github.com/Christina96/boilerplate-sample-matches/blob/main/Cpp/Cpp_Primer_Answers-MDEwOlJlcG9zaXRvcnk0NzE3MDI2MQ==-flat-exercise7_32.h-snap-MDEwOlJlcG9zaXRvcnk0Mjg4MzU3-flat-zipcode.h.html,0.11518324607329843,11,Cpp_Primer_Answers-MDEwOlJlcG9zaXRvcnk0NzE3MDI2MQ==-flat-exercise7_32.h,snap-MDEwOlJlcG9zaXRvcnk0Mjg4MzU3-flat-zipcode.h,22,24,2,33,35,2
1237570,https://htmlpreview.github.io/?https://github.com/Christina96/boilerplate-sample-matches/blob/main/Cpp/tesseract-MDEwOlJlcG9zaXRvcnkyMjg4NzA5NA==-flat-dict.cpp-notepad-plus-plus-MDEwOlJlcG9zaXRvcnkzMzAxNDgxMQ==-flat-ProjectPanel.cpp.html,0.053231939163498096,11,tesseract-MDEwOlJlcG9zaXRvcnkyMjg4NzA5NA==-flat-dict.cpp,notepad-plus-plus-MDEwOlJlcG9zaXRvcnkzMzAxNDgxMQ==-flat-ProjectPanel.cpp,695,702,7,476,488,12
1239174,https://htmlpreview.github.io/?https://github.com/Christina96/boilerplate-sample-matches/blob/main/Cpp/tesseract-MDEwOlJlcG9zaXRvcnkyMjg4NzA5NA==-flat-sw.cpp-tesseract-MDEwOlJlcG9zaXRvcnkyMjg4NzA5NA==-flat-colpartition.cpp.html,0.015683037556747832,9,tesseract-MDEwOlJlcG9zaXRvcnkyMjg4NzA5NA==-flat-sw.cpp,tesseract-MDEwOlJlcG9zaXRvcnkyMjg4NzA5NA==-flat-colpartition.cpp,9,17,8,96,104,8
1243344,https://htmlpreview.github.io/?https://github.com/Christina96/boilerplate-sample-matches/blob/main/Cpp/snap-MDEwOlJlcG9zaXRvcnk0Mjg4MzU3-flat-agm.h-tesseract-MDEwOlJlcG9zaXRvcnkyMjg4NzA5NA==-flat-oclkernels.h.html,0.0851985559566787,15,snap-MDEwOlJlcG9zaXRvcnk0Mjg4MzU3-flat-agm.h,tesseract-MDEwOlJlcG9zaXRvcnkyMjg4NzA5NA==-flat-oclkernels.h,15,15,0,295,295,0
1245157,https://htmlpreview.github.io/?https://github.com/Christina96/boilerplate-sample-matches/blob/main/Cpp/snap-MDEwOlJlcG9zaXRvcnk0Mjg4MzU3-flat-tbhc.h-snap-MDEwOlJlcG9zaXRvcnk0Mjg4MzU3-flat-linalg.cpp.html,0.015542211232779936,13,snap-MDEwOlJlcG9zaXRvcnk0Mjg4MzU3-flat-tbhc.h,snap-MDEwOlJlcG9zaXRvcnk0Mjg4MzU3-flat-linalg.cpp,43,45,2,272,280,8
1251799,https://htmlpreview.github.io/?https://github.com/Christina96/boilerplate-sample-matches/blob/main/Cpp/snap-MDEwOlJlcG9zaXRvcnk0Mjg4MzU3-flat-wgtnet.cpp-snap-MDEwOlJlcG9zaXRvcnk0Mjg4MzU3-flat-cncom.h.html,0.07757404795486601,9,snap-MDEwOlJlcG9zaXRvcnk0Mjg4MzU3-flat-wgtnet.cpp,snap-MDEwOlJlcG9zaXRvcnk0Mjg4MzU3-flat-cncom.h,165,167,2,236,238,2
1253171,https://htmlpreview.github.io/?https://github.com/Christina96/boilerplate-sample-matches/blob/main/Cpp/abseil-cpp-MDEwOlJlcG9zaXRvcnkxMDQyMzE1NDE=-flat-statusor_internal.h-snap-MDEwOlJlcG9zaXRvcnk0Mjg4MzU3-flat-memes.h.html,0.016129032258064516,10,abseil-cpp-MDEwOlJlcG9zaXRvcnkxMDQyMzE1NDE=-flat-statusor_internal.h,snap-MDEwOlJlcG9zaXRvcnk0Mjg4MzU3-flat-memes.h,161,168,7,30,31,1
1254832,https://htmlpreview.github.io/?https://github.com/Christina96/boilerplate-sample-matches/blob/main/Cpp/snap-MDEwOlJlcG9zaXRvcnk0Mjg4MzU3-flat-url.cpp-snap-MDEwOlJlcG9zaXRvcnk0Mjg4MzU3-flat-appsrv.cpp.html,0.10010427528675704,9,snap-MDEwOlJlcG9zaXRvcnk0Mjg4MzU3-flat-url.cpp,snap-MDEwOlJlcG9zaXRvcnk0Mjg4MzU3-flat-appsrv.cpp,208,213,5,917,920,3
1255263,https://htmlpreview.github.io/?https://github.com/Christina96/boilerplate-sample-matches/blob/main/Cpp/notepad-plus-plus-MDEwOlJlcG9zaXRvcnkzMzAxNDgxMQ==-flat-FunctionCallTip.h-caffe-MDEwOlJlcG9zaXRvcnk2MTg3MDgwMw==-flat-test_mkldnn_convolution_layer.cpp.html,0.019267822736030827,10,notepad-plus-plus-MDEwOlJlcG9zaXRvcnkzMzAxNDgxMQ==-flat-FunctionCallTip.h,caffe-MDEwOlJlcG9zaXRvcnk2MTg3MDgwMw==-flat-test_mkldnn_convolution_layer.cpp,16,28,12,657,666,9
1258319,https://htmlpreview.github.io/?https://github.com/Christina96/boilerplate-sample-matches/blob/main/Cpp/caffe-MDEwOlJlcG9zaXRvcnk2MTg3MDgwMw==-flat-mkl_lrn_layer.cpp-nano-node-MDEwOlJlcG9zaXRvcnkxOTM0NzM0MA==-flat-confirmation_height_bounded.cpp.html,0.055800293685756244,10,caffe-MDEwOlJlcG9zaXRvcnk2MTg3MDgwMw==-flat-mkl_lrn_layer.cpp,nano-node-MDEwOlJlcG9zaXRvcnkxOTM0NzM0MA==-flat-confirmation_height_bounded.cpp,197,208,11,255,267,12
1258742,https://htmlpreview.github.io/?https://github.com/Christina96/boilerplate-sample-matches/blob/main/Cpp/snap-MDEwOlJlcG9zaXRvcnk0Mjg4MzU3-flat-hldoc.h-snap-MDEwOlJlcG9zaXRvcnk0Mjg4MzU3-flat-tb.h.html,0.2412818096135721,10,snap-MDEwOlJlcG9zaXRvcnk0Mjg4MzU3-flat-hldoc.h,snap-MDEwOlJlcG9zaXRvcnk0Mjg4MzU3-flat-tb.h,91,93,2,261,264,3
1261080,https://htmlpreview.github.io/?https://github.com/Christina96/boilerplate-sample-matches/blob/main/Cpp/snap-MDEwOlJlcG9zaXRvcnk0Mjg4MzU3-flat-localmotifcluster.h-notepad-plus-plus-MDEwOlJlcG9zaXRvcnkzMzAxNDgxMQ==-flat-XPM.h.html,0.10227272727272728,9,snap-MDEwOlJlcG9zaXRvcnk0Mjg4MzU3-flat-localmotifcluster.h,notepad-plus-plus-MDEwOlJlcG9zaXRvcnkzMzAxNDgxMQ==-flat-XPM.h,49,50,1,19,20,1
1263705,https://htmlpreview.github.io/?https://github.com/Christina96/boilerplate-sample-matches/blob/main/Cpp/abseil-cpp-MDEwOlJlcG9zaXRvcnkxMDQyMzE1NDE=-flat-duration_test.cc-snap-MDEwOlJlcG9zaXRvcnk0Mjg4MzU3-flat-test-subgraph.cpp.html,0.07889793362554791,10,abseil-cpp-MDEwOlJlcG9zaXRvcnkxMDQyMzE1NDE=-flat-duration_test.cc,snap-MDEwOlJlcG9zaXRvcnk0Mjg4MzU3-flat-test-subgraph.cpp,744,764,20,153,172,19
1266909,https://htmlpreview.github.io/?https://github.com/Christina96/boilerplate-sample-matches/blob/main/Cpp/tesseract-MDEwOlJlcG9zaXRvcnkyMjg4NzA5NA==-flat-edgloop.cpp-snap-MDEwOlJlcG9zaXRvcnk0Mjg4MzU3-flat-svmmodels.cpp.html,0.02549800796812749,10,tesseract-MDEwOlJlcG9zaXRvcnkyMjg4NzA5NA==-flat-edgloop.cpp,snap-MDEwOlJlcG9zaXRvcnk0Mjg4MzU3-flat-svmmodels.cpp,38,43,5,870,875,5
1267395,https://htmlpreview.github.io/?https://github.com/Christina96/boilerplate-sample-matches/blob/main/Cpp/abseil-cpp-MDEwOlJlcG9zaXRvcnkxMDQyMzE1NDE=-flat-variant_test.cc-subconverter-MDEwOlJlcG9zaXRvcnkyMTg2ODY3NjM=-flat-json.hpp.html,0.013538690845857657,9,abseil-cpp-MDEwOlJlcG9zaXRvcnkxMDQyMzE1NDE=-flat-variant_test.cc,subconverter-MDEwOlJlcG9zaXRvcnkyMTg2ODY3NjM=-flat-json.hpp,2010,2021,11,10951,10953,2
1273514,https://htmlpreview.github.io/?https://github.com/Christina96/boilerplate-sample-matches/blob/main/Cpp/snap-MDEwOlJlcG9zaXRvcnk0Mjg4MzU3-flat-biasedrandomwalk.cpp-tesseract-MDEwOlJlcG9zaXRvcnkyMjg4NzA5NA==-flat-recogtraining.cpp.html,0.09549071618037135,9,snap-MDEwOlJlcG9zaXRvcnk0Mjg4MzU3-flat-biasedrandomwalk.cpp,tesseract-MDEwOlJlcG9zaXRvcnkyMjg4NzA5NA==-flat-recogtraining.cpp,72,79,7,71,77,6
1277236,https://htmlpreview.github.io/?https://github.com/Christina96/boilerplate-sample-matches/blob/main/Cpp/tesseract-MDEwOlJlcG9zaXRvcnkyMjg4NzA5NA==-flat-tesseractclass.h-snap-MDEwOlJlcG9zaXRvcnk0Mjg4MzU3-flat-bd.h.html,0.09090909090909091,16,tesseract-MDEwOlJlcG9zaXRvcnkyMjg4NzA5NA==-flat-tesseractclass.h,snap-MDEwOlJlcG9zaXRvcnk0Mjg4MzU3-flat-bd.h,129,137,8,283,287,4
1282160,https://htmlpreview.github.io/?https://github.com/Christina96/boilerplate-sample-matches/blob/main/Cpp/snap-MDEwOlJlcG9zaXRvcnk0Mjg4MzU3-flat-amazon.cpp-snap-MDEwOlJlcG9zaXRvcnk0Mjg4MzU3-flat-infonet.cpp.html,0.07933194154488518,12,snap-MDEwOlJlcG9zaXRvcnk0Mjg4MzU3-flat-amazon.cpp,snap-MDEwOlJlcG9zaXRvcnk0Mjg4MzU3-flat-infonet.cpp,234,244,10,610,615,5
1282197,https://htmlpreview.github.io/?https://github.com/Christina96/boilerplate-sample-matches/blob/main/Cpp/snap-MDEwOlJlcG9zaXRvcnk0Mjg4MzU3-flat-signnet.cpp-notepad-plus-plus-MDEwOlJlcG9zaXRvcnkzMzAxNDgxMQ==-flat-preferenceDlg.cpp.html,0.061358655953250546,13,snap-MDEwOlJlcG9zaXRvcnk0Mjg4MzU3-flat-signnet.cpp,notepad-plus-plus-MDEwOlJlcG9zaXRvcnkzMzAxNDgxMQ==-flat-preferenceDlg.cpp,408,414,6,569,587,18
1285635,https://htmlpreview.github.io/?https://github.com/Christina96/boilerplate-sample-matches/blob/main/Cpp/abseil-cpp-MDEwOlJlcG9zaXRvcnkxMDQyMzE1NDE=-flat-fixed_array_test.cc-snap-MDEwOlJlcG9zaXRvcnk0Mjg4MzU3-flat-agmdirected.cpp.html,0.08110599078341015,9,abseil-cpp-MDEwOlJlcG9zaXRvcnkxMDQyMzE1NDE=-flat-fixed_array_test.cc,snap-MDEwOlJlcG9zaXRvcnk0Mjg4MzU3-flat-agmdirected.cpp,160,164,4,132,140,8
1287447,https://htmlpreview.github.io/?https://github.com/Christina96/boilerplate-sample-matches/blob/main/Cpp/snap-MDEwOlJlcG9zaXRvcnk0Mjg4MzU3-flat-infonet.cpp-snap-MDEwOlJlcG9zaXRvcnk0Mjg4MzU3-flat-fl.cpp.html,0.0457222029788708,9,snap-MDEwOlJlcG9zaXRvcnk0Mjg4MzU3-flat-infonet.cpp,snap-MDEwOlJlcG9zaXRvcnk0Mjg4MzU3-flat-fl.cpp,104,108,4,348,349,1
1290325,https://htmlpreview.github.io/?https://github.com/Christina96/boilerplate-sample-matches/blob/main/Cpp/snap-MDEwOlJlcG9zaXRvcnk0Mjg4MzU3-flat-btalarms.cpp-snap-MDEwOlJlcG9zaXRvcnk0Mjg4MzU3-flat-ds.h.html,0.036072653372285025,11,snap-MDEwOlJlcG9zaXRvcnk0Mjg4MzU3-flat-btalarms.cpp,snap-MDEwOlJlcG9zaXRvcnk0Mjg4MzU3-flat-ds.h,425,427,2,258,260,2
1294487,https://htmlpreview.github.io/?https://github.com/Christina96/boilerplate-sample-matches/blob/main/Cpp/notepad-plus-plus-MDEwOlJlcG9zaXRvcnkzMzAxNDgxMQ==-flat-BabyGrid.cpp-notepad-plus-plus-MDEwOlJlcG9zaXRvcnkzMzAxNDgxMQ==-flat-NppDarkMode.cpp.html,0.05564007824386003,9,notepad-plus-plus-MDEwOlJlcG9zaXRvcnkzMzAxNDgxMQ==-flat-BabyGrid.cpp,notepad-plus-plus-MDEwOlJlcG9zaXRvcnkzMzAxNDgxMQ==-flat-NppDarkMode.cpp,1816,1825,9,1846,1855,9
1294713,https://htmlpreview.github.io/?https://github.com/Christina96/boilerplate-sample-matches/blob/main/Cpp/snap-MDEwOlJlcG9zaXRvcnk0Mjg4MzU3-flat-sir.cpp-snap-MDEwOlJlcG9zaXRvcnk0Mjg4MzU3-flat-bowbs.h.html,0.059356136820925554,12,snap-MDEwOlJlcG9zaXRvcnk0Mjg4MzU3-flat-sir.cpp,snap-MDEwOlJlcG9zaXRvcnk0Mjg4MzU3-flat-bowbs.h,173,180,7,281,284,3
1296033,https://htmlpreview.github.io/?https://github.com/Christina96/boilerplate-sample-matches/blob/main/Cpp/snap-MDEwOlJlcG9zaXRvcnk0Mjg4MzU3-flat-testgraph.cpp-tesseract-MDEwOlJlcG9zaXRvcnkyMjg4NzA5NA==-flat-parallel.cpp.html,0.09448818897637795,12,snap-MDEwOlJlcG9zaXRvcnk0Mjg4MzU3-flat-testgraph.cpp,tesseract-MDEwOlJlcG9zaXRvcnkyMjg4NzA5NA==-flat-parallel.cpp,61,66,5,33,41,8
