ID,Link,Tokens,File 1,File 2,Start 1,End 1,Detected Lines 1,Start 2,End 2,Detected Lines 2
0,https://htmlpreview.github.io/?https://github.com/Christina96/boilerplate-sample-matches/blob/main/Cpp/caffe-MDEwOlJlcG9zaXRvcnk2MTg3MDgwMw==-flat-annotated_data_layer.cpp-caffe-MDEwOlJlcG9zaXRvcnk2MTg3MDgwMw==-flat-annotated_data_layer.cpp.html,61,caffe-MDEwOlJlcG9zaXRvcnk2MTg3MDgwMw==-flat-annotated_data_layer.cpp,caffe-MDEwOlJlcG9zaXRvcnk2MTg3MDgwMw==-flat-annotated_data_layer.cpp,300,307,7,300,307,7
1,https://htmlpreview.github.io/?https://github.com/Christina96/boilerplate-sample-matches/blob/main/Cpp/snap-MDEwOlJlcG9zaXRvcnk0Mjg4MzU3-flat-table.h-snap-MDEwOlJlcG9zaXRvcnk0Mjg4MzU3-flat-table.h.html,73,snap-MDEwOlJlcG9zaXRvcnk0Mjg4MzU3-flat-table.h,snap-MDEwOlJlcG9zaXRvcnk0Mjg4MzU3-flat-table.h,1018,1028,10,1029,1039,10
2,https://htmlpreview.github.io/?https://github.com/Christina96/boilerplate-sample-matches/blob/main/Cpp/notepad-plus-plus-MDEwOlJlcG9zaXRvcnkzMzAxNDgxMQ==-flat-BabyGrid.cpp-notepad-plus-plus-MDEwOlJlcG9zaXRvcnkzMzAxNDgxMQ==-flat-BabyGrid.cpp.html,45,notepad-plus-plus-MDEwOlJlcG9zaXRvcnkzMzAxNDgxMQ==-flat-BabyGrid.cpp,notepad-plus-plus-MDEwOlJlcG9zaXRvcnkzMzAxNDgxMQ==-flat-BabyGrid.cpp,699,710,11,669,680,11
3,https://htmlpreview.github.io/?https://github.com/Christina96/boilerplate-sample-matches/blob/main/Cpp/snap-MDEwOlJlcG9zaXRvcnk0Mjg4MzU3-flat-xmath.cpp-snap-MDEwOlJlcG9zaXRvcnk0Mjg4MzU3-flat-network.cpp.html,14,snap-MDEwOlJlcG9zaXRvcnk0Mjg4MzU3-flat-xmath.cpp,snap-MDEwOlJlcG9zaXRvcnk0Mjg4MzU3-flat-network.cpp,778,780,2,1158,1160,2
4,https://htmlpreview.github.io/?https://github.com/Christina96/boilerplate-sample-matches/blob/main/Cpp/snap-MDEwOlJlcG9zaXRvcnk0Mjg4MzU3-flat-circles_128.cpp-snap-MDEwOlJlcG9zaXRvcnk0Mjg4MzU3-flat-circles.h.html,32,snap-MDEwOlJlcG9zaXRvcnk0Mjg4MzU3-flat-circles_128.cpp,snap-MDEwOlJlcG9zaXRvcnk0Mjg4MzU3-flat-circles.h,75,78,3,219,222,3
5,https://htmlpreview.github.io/?https://github.com/Christina96/boilerplate-sample-matches/blob/main/Cpp/tesseract-MDEwOlJlcG9zaXRvcnkyMjg4NzA5NA==-flat-topitch.cpp-tesseract-MDEwOlJlcG9zaXRvcnkyMjg4NzA5NA==-flat-topitch.h.html,14,tesseract-MDEwOlJlcG9zaXRvcnkyMjg4NzA5NA==-flat-topitch.cpp,tesseract-MDEwOlJlcG9zaXRvcnkyMjg4NzA5NA==-flat-topitch.h,844,848,4,79,83,4
6,https://htmlpreview.github.io/?https://github.com/Christina96/boilerplate-sample-matches/blob/main/Cpp/snap-MDEwOlJlcG9zaXRvcnk0Mjg4MzU3-flat-wmine.cpp-snap-MDEwOlJlcG9zaXRvcnk0Mjg4MzU3-flat-ss.cpp.html,16,snap-MDEwOlJlcG9zaXRvcnk0Mjg4MzU3-flat-wmine.cpp,snap-MDEwOlJlcG9zaXRvcnk0Mjg4MzU3-flat-ss.cpp,176,177,1,166,167,1
7,https://htmlpreview.github.io/?https://github.com/Christina96/boilerplate-sample-matches/blob/main/Cpp/tesseract-MDEwOlJlcG9zaXRvcnkyMjg4NzA5NA==-flat-network.cpp-notepad-plus-plus-MDEwOlJlcG9zaXRvcnkzMzAxNDgxMQ==-flat-EditView.cxx.html,16,tesseract-MDEwOlJlcG9zaXRvcnkyMjg4NzA5NA==-flat-network.cpp,notepad-plus-plus-MDEwOlJlcG9zaXRvcnkzMzAxNDgxMQ==-flat-EditView.cxx,276,278,2,1768,1770,2
8,https://htmlpreview.github.io/?https://github.com/Christina96/boilerplate-sample-matches/blob/main/Cpp/abseil-cpp-MDEwOlJlcG9zaXRvcnkxMDQyMzE1NDE=-flat-node_hash_map_test.cc-abseil-cpp-MDEwOlJlcG9zaXRvcnkxMDQyMzE1NDE=-flat-raw_hash_set_test.cc.html,18,abseil-cpp-MDEwOlJlcG9zaXRvcnkxMDQyMzE1NDE=-flat-node_hash_map_test.cc,abseil-cpp-MDEwOlJlcG9zaXRvcnkxMDQyMzE1NDE=-flat-raw_hash_set_test.cc,58,60,2,1212,1214,2
9,https://htmlpreview.github.io/?https://github.com/Christina96/boilerplate-sample-matches/blob/main/Cpp/abseil-cpp-MDEwOlJlcG9zaXRvcnkxMDQyMzE1NDE=-flat-char_formatting_test.cc-abseil-cpp-MDEwOlJlcG9zaXRvcnkxMDQyMzE1NDE=-flat-char_formatting_test.cc.html,18,abseil-cpp-MDEwOlJlcG9zaXRvcnkxMDQyMzE1NDE=-flat-char_formatting_test.cc,abseil-cpp-MDEwOlJlcG9zaXRvcnkxMDQyMzE1NDE=-flat-char_formatting_test.cc,12,14,2,79,81,2
10,https://htmlpreview.github.io/?https://github.com/Christina96/boilerplate-sample-matches/blob/main/Cpp/notepad-plus-plus-MDEwOlJlcG9zaXRvcnkzMzAxNDgxMQ==-flat-catch.hpp-notepad-plus-plus-MDEwOlJlcG9zaXRvcnkzMzAxNDgxMQ==-flat-catch.hpp.html,11999,notepad-plus-plus-MDEwOlJlcG9zaXRvcnkzMzAxNDgxMQ==-flat-catch.hpp,notepad-plus-plus-MDEwOlJlcG9zaXRvcnkzMzAxNDgxMQ==-flat-catch.hpp,12214,13690,1476,12214,13690,1476
11,https://htmlpreview.github.io/?https://github.com/Christina96/boilerplate-sample-matches/blob/main/Cpp/notepad-plus-plus-MDEwOlJlcG9zaXRvcnkzMzAxNDgxMQ==-flat-ScintillaEditBase.cpp-notepad-plus-plus-MDEwOlJlcG9zaXRvcnkzMzAxNDgxMQ==-flat-ScintillaEditBase.cpp.html,18,notepad-plus-plus-MDEwOlJlcG9zaXRvcnkzMzAxNDgxMQ==-flat-ScintillaEditBase.cpp,notepad-plus-plus-MDEwOlJlcG9zaXRvcnkzMzAxNDgxMQ==-flat-ScintillaEditBase.cpp,351,352,1,351,352,1
12,https://htmlpreview.github.io/?https://github.com/Christina96/boilerplate-sample-matches/blob/main/Cpp/caffe-MDEwOlJlcG9zaXRvcnk2MTg3MDgwMw==-flat-gtest-internal.h-caffe-MDEwOlJlcG9zaXRvcnk2MTg3MDgwMw==-flat-gtest-internal.h.html,18,caffe-MDEwOlJlcG9zaXRvcnk2MTg3MDgwMw==-flat-gtest-internal.h,caffe-MDEwOlJlcG9zaXRvcnk2MTg3MDgwMw==-flat-gtest-internal.h,459,461,2,457,459,2
13,https://htmlpreview.github.io/?https://github.com/Christina96/boilerplate-sample-matches/blob/main/Cpp/caffe-MDEwOlJlcG9zaXRvcnk2MTg3MDgwMw==-flat-batch_classification.cpp-caffe-MDEwOlJlcG9zaXRvcnk2MTg3MDgwMw==-flat-classification.cpp.html,61,caffe-MDEwOlJlcG9zaXRvcnk2MTg3MDgwMw==-flat-batch_classification.cpp,caffe-MDEwOlJlcG9zaXRvcnk2MTg3MDgwMw==-flat-classification.cpp,234,244,10,149,159,10
14,https://htmlpreview.github.io/?https://github.com/Christina96/boilerplate-sample-matches/blob/main/Cpp/nano-node-MDEwOlJlcG9zaXRvcnkxOTM0NzM0MA==-flat-stats.hpp-nano-node-MDEwOlJlcG9zaXRvcnkxOTM0NzM0MA==-flat-stats.hpp.html,28,nano-node-MDEwOlJlcG9zaXRvcnkxOTM0NzM0MA==-flat-stats.hpp,nano-node-MDEwOlJlcG9zaXRvcnkxOTM0NzM0MA==-flat-stats.hpp,63,66,3,63,66,3
15,https://htmlpreview.github.io/?https://github.com/Christina96/boilerplate-sample-matches/blob/main/Cpp/abseil-cpp-MDEwOlJlcG9zaXRvcnkxMDQyMzE1NDE=-flat-cord_rep_btree_test.cc-abseil-cpp-MDEwOlJlcG9zaXRvcnkxMDQyMzE1NDE=-flat-cord_rep_btree_test.cc.html,51,abseil-cpp-MDEwOlJlcG9zaXRvcnkxMDQyMzE1NDE=-flat-cord_rep_btree_test.cc,abseil-cpp-MDEwOlJlcG9zaXRvcnkxMDQyMzE1NDE=-flat-cord_rep_btree_test.cc,748,752,4,701,705,4
16,https://htmlpreview.github.io/?https://github.com/Christina96/boilerplate-sample-matches/blob/main/Cpp/snap-MDEwOlJlcG9zaXRvcnk0Mjg4MzU3-flat-rinetmatch.h-snap-MDEwOlJlcG9zaXRvcnk0Mjg4MzU3-flat-rinetmatch.h.html,545,snap-MDEwOlJlcG9zaXRvcnk0Mjg4MzU3-flat-rinetmatch.h,snap-MDEwOlJlcG9zaXRvcnk0Mjg4MzU3-flat-rinetmatch.h,369,441,72,369,441,72
17,https://htmlpreview.github.io/?https://github.com/Christina96/boilerplate-sample-matches/blob/main/Cpp/notepad-plus-plus-MDEwOlJlcG9zaXRvcnkzMzAxNDgxMQ==-flat-LexBash.cxx-notepad-plus-plus-MDEwOlJlcG9zaXRvcnkzMzAxNDgxMQ==-flat-LexBash.cxx.html,22,notepad-plus-plus-MDEwOlJlcG9zaXRvcnkzMzAxNDgxMQ==-flat-LexBash.cxx,notepad-plus-plus-MDEwOlJlcG9zaXRvcnkzMzAxNDgxMQ==-flat-LexBash.cxx,43,52,9,48,57,9
18,https://htmlpreview.github.io/?https://github.com/Christina96/boilerplate-sample-matches/blob/main/Cpp/snap-MDEwOlJlcG9zaXRvcnk0Mjg4MzU3-flat-benchmark-weighted.cpp-snap-MDEwOlJlcG9zaXRvcnk0Mjg4MzU3-flat-benchmark-weighted.cpp.html,369,snap-MDEwOlJlcG9zaXRvcnk0Mjg4MzU3-flat-benchmark-weighted.cpp,snap-MDEwOlJlcG9zaXRvcnk0Mjg4MzU3-flat-benchmark-weighted.cpp,31,64,33,31,64,33
19,https://htmlpreview.github.io/?https://github.com/Christina96/boilerplate-sample-matches/blob/main/Cpp/snap-MDEwOlJlcG9zaXRvcnk0Mjg4MzU3-flat-dt.h-snap-MDEwOlJlcG9zaXRvcnk0Mjg4MzU3-flat-dt.h.html,18,snap-MDEwOlJlcG9zaXRvcnk0Mjg4MzU3-flat-dt.h,snap-MDEwOlJlcG9zaXRvcnk0Mjg4MzU3-flat-dt.h,435,436,1,437,438,1
20,https://htmlpreview.github.io/?https://github.com/Christina96/boilerplate-sample-matches/blob/main/Cpp/tesseract-MDEwOlJlcG9zaXRvcnkyMjg4NzA5NA==-flat-resultiterator.cpp-tesseract-MDEwOlJlcG9zaXRvcnkyMjg4NzA5NA==-flat-resultiterator.cpp.html,15,tesseract-MDEwOlJlcG9zaXRvcnkyMjg4NzA5NA==-flat-resultiterator.cpp,tesseract-MDEwOlJlcG9zaXRvcnkyMjg4NzA5NA==-flat-resultiterator.cpp,323,326,3,323,326,3
21,https://htmlpreview.github.io/?https://github.com/Christina96/boilerplate-sample-matches/blob/main/Cpp/snap-MDEwOlJlcG9zaXRvcnk0Mjg4MzU3-flat-btaserver.cpp-snap-MDEwOlJlcG9zaXRvcnk0Mjg4MzU3-flat-btaserver.cpp.html,17,snap-MDEwOlJlcG9zaXRvcnk0Mjg4MzU3-flat-btaserver.cpp,snap-MDEwOlJlcG9zaXRvcnk0Mjg4MzU3-flat-btaserver.cpp,496,497,1,685,686,1
22,https://htmlpreview.github.io/?https://github.com/Christina96/boilerplate-sample-matches/blob/main/Cpp/abseil-cpp-MDEwOlJlcG9zaXRvcnkxMDQyMzE1NDE=-flat-btree_test.cc-abseil-cpp-MDEwOlJlcG9zaXRvcnkxMDQyMzE1NDE=-flat-flat_hash_map_test.cc.html,20,abseil-cpp-MDEwOlJlcG9zaXRvcnkxMDQyMzE1NDE=-flat-btree_test.cc,abseil-cpp-MDEwOlJlcG9zaXRvcnkxMDQyMzE1NDE=-flat-flat_hash_map_test.cc,2165,2169,4,163,167,4
23,https://htmlpreview.github.io/?https://github.com/Christina96/boilerplate-sample-matches/blob/main/Cpp/abseil-cpp-MDEwOlJlcG9zaXRvcnkxMDQyMzE1NDE=-flat-parse_test.cc-abseil-cpp-MDEwOlJlcG9zaXRvcnkxMDQyMzE1NDE=-flat-parse_test.cc.html,21,abseil-cpp-MDEwOlJlcG9zaXRvcnkxMDQyMzE1NDE=-flat-parse_test.cc,abseil-cpp-MDEwOlJlcG9zaXRvcnkxMDQyMzE1NDE=-flat-parse_test.cc,248,251,3,302,305,3
24,https://htmlpreview.github.io/?https://github.com/Christina96/boilerplate-sample-matches/blob/main/Cpp/notepad-plus-plus-MDEwOlJlcG9zaXRvcnkzMzAxNDgxMQ==-flat-NppIO.cpp-tesseract-MDEwOlJlcG9zaXRvcnkyMjg4NzA5NA==-flat-helpers.h.html,15,notepad-plus-plus-MDEwOlJlcG9zaXRvcnkzMzAxNDgxMQ==-flat-NppIO.cpp,tesseract-MDEwOlJlcG9zaXRvcnkyMjg4NzA5NA==-flat-helpers.h,152,158,6,68,73,5
25,https://htmlpreview.github.io/?https://github.com/Christina96/boilerplate-sample-matches/blob/main/Cpp/nano-node-MDEwOlJlcG9zaXRvcnkxOTM0NzM0MA==-flat-work_pool.cpp-nano-node-MDEwOlJlcG9zaXRvcnkxOTM0NzM0MA==-flat-work_pool.cpp.html,71,nano-node-MDEwOlJlcG9zaXRvcnkxOTM0NzM0MA==-flat-work_pool.cpp,nano-node-MDEwOlJlcG9zaXRvcnkxOTM0NzM0MA==-flat-work_pool.cpp,155,163,8,128,136,8
26,https://htmlpreview.github.io/?https://github.com/Christina96/boilerplate-sample-matches/blob/main/Cpp/caffe-MDEwOlJlcG9zaXRvcnk2MTg3MDgwMw==-flat-cudnn.hpp-caffe-MDEwOlJlcG9zaXRvcnk2MTg3MDgwMw==-flat-cudnn.hpp.html,31,caffe-MDEwOlJlcG9zaXRvcnk2MTg3MDgwMw==-flat-cudnn.hpp,caffe-MDEwOlJlcG9zaXRvcnk2MTg3MDgwMw==-flat-cudnn.hpp,91,96,5,91,96,5
27,https://htmlpreview.github.io/?https://github.com/Christina96/boilerplate-sample-matches/blob/main/Cpp/tesseract-MDEwOlJlcG9zaXRvcnkyMjg4NzA5NA==-flat-colfind.cpp-tesseract-MDEwOlJlcG9zaXRvcnkyMjg4NzA5NA==-flat-colfind.cpp.html,50,tesseract-MDEwOlJlcG9zaXRvcnkyMjg4NzA5NA==-flat-colfind.cpp,tesseract-MDEwOlJlcG9zaXRvcnkyMjg4NzA5NA==-flat-colfind.cpp,997,1010,13,997,1010,13
28,https://htmlpreview.github.io/?https://github.com/Christina96/boilerplate-sample-matches/blob/main/Cpp/notepad-plus-plus-MDEwOlJlcG9zaXRvcnkzMzAxNDgxMQ==-flat-LexBasic.cxx-notepad-plus-plus-MDEwOlJlcG9zaXRvcnkzMzAxNDgxMQ==-flat-LexHollywood.cxx.html,83,notepad-plus-plus-MDEwOlJlcG9zaXRvcnkzMzAxNDgxMQ==-flat-LexBasic.cxx,notepad-plus-plus-MDEwOlJlcG9zaXRvcnkzMzAxNDgxMQ==-flat-LexHollywood.cxx,244,260,16,270,286,16
29,https://htmlpreview.github.io/?https://github.com/Christina96/boilerplate-sample-matches/blob/main/Cpp/snap-MDEwOlJlcG9zaXRvcnk0Mjg4MzU3-flat-geoip.cpp-snap-MDEwOlJlcG9zaXRvcnk0Mjg4MzU3-flat-geoip.cpp.html,14,snap-MDEwOlJlcG9zaXRvcnk0Mjg4MzU3-flat-geoip.cpp,snap-MDEwOlJlcG9zaXRvcnk0Mjg4MzU3-flat-geoip.cpp,80,82,2,104,106,2
30,https://htmlpreview.github.io/?https://github.com/Christina96/boilerplate-sample-matches/blob/main/Cpp/nano-node-MDEwOlJlcG9zaXRvcnkxOTM0NzM0MA==-flat-conflicts.cpp-nano-node-MDEwOlJlcG9zaXRvcnkxOTM0NzM0MA==-flat-wallets.cpp.html,20,nano-node-MDEwOlJlcG9zaXRvcnkxOTM0NzM0MA==-flat-conflicts.cpp,nano-node-MDEwOlJlcG9zaXRvcnkxOTM0NzM0MA==-flat-wallets.cpp,187,191,4,17,21,4
31,https://htmlpreview.github.io/?https://github.com/Christina96/boilerplate-sample-matches/blob/main/Cpp/notepad-plus-plus-MDEwOlJlcG9zaXRvcnkzMzAxNDgxMQ==-flat-LexObjC.cxx-snap-MDEwOlJlcG9zaXRvcnk0Mjg4MzU3-flat-shash.h.html,14,notepad-plus-plus-MDEwOlJlcG9zaXRvcnkzMzAxNDgxMQ==-flat-LexObjC.cxx,snap-MDEwOlJlcG9zaXRvcnk0Mjg4MzU3-flat-shash.h,474,475,1,539,540,1
32,https://htmlpreview.github.io/?https://github.com/Christina96/boilerplate-sample-matches/blob/main/Cpp/notepad-plus-plus-MDEwOlJlcG9zaXRvcnkzMzAxNDgxMQ==-flat-PlatQt.cpp-notepad-plus-plus-MDEwOlJlcG9zaXRvcnkzMzAxNDgxMQ==-flat-PlatQt.cpp.html,16,notepad-plus-plus-MDEwOlJlcG9zaXRvcnkzMzAxNDgxMQ==-flat-PlatQt.cpp,notepad-plus-plus-MDEwOlJlcG9zaXRvcnkzMzAxNDgxMQ==-flat-PlatQt.cpp,445,447,2,550,552,2
33,https://htmlpreview.github.io/?https://github.com/Christina96/boilerplate-sample-matches/blob/main/Cpp/abseil-cpp-MDEwOlJlcG9zaXRvcnkxMDQyMzE1NDE=-flat-dynamic_annotations.h-abseil-cpp-MDEwOlJlcG9zaXRvcnkxMDQyMzE1NDE=-flat-dynamic_annotations_34.h.html,52,abseil-cpp-MDEwOlJlcG9zaXRvcnkxMDQyMzE1NDE=-flat-dynamic_annotations.h,abseil-cpp-MDEwOlJlcG9zaXRvcnkxMDQyMzE1NDE=-flat-dynamic_annotations_34.h,199,209,10,154,164,10
34,https://htmlpreview.github.io/?https://github.com/Christina96/boilerplate-sample-matches/blob/main/Cpp/abseil-cpp-MDEwOlJlcG9zaXRvcnkxMDQyMzE1NDE=-flat-container_test.cc-snap-MDEwOlJlcG9zaXRvcnk0Mjg4MzU3-flat-test-alg.cpp.html,14,abseil-cpp-MDEwOlJlcG9zaXRvcnkxMDQyMzE1NDE=-flat-container_test.cc,snap-MDEwOlJlcG9zaXRvcnk0Mjg4MzU3-flat-test-alg.cpp,920,922,2,1194,1196,2
35,https://htmlpreview.github.io/?https://github.com/Christina96/boilerplate-sample-matches/blob/main/Cpp/snap-MDEwOlJlcG9zaXRvcnk0Mjg4MzU3-flat-memes.cpp-snap-MDEwOlJlcG9zaXRvcnk0Mjg4MzU3-flat-memes.cpp.html,28,snap-MDEwOlJlcG9zaXRvcnk0Mjg4MzU3-flat-memes.cpp,snap-MDEwOlJlcG9zaXRvcnk0Mjg4MzU3-flat-memes.cpp,392,396,4,392,396,4
36,https://htmlpreview.github.io/?https://github.com/Christina96/boilerplate-sample-matches/blob/main/Cpp/abseil-cpp-MDEwOlJlcG9zaXRvcnkxMDQyMzE1NDE=-flat-cord_rep_btree.h-abseil-cpp-MDEwOlJlcG9zaXRvcnkxMDQyMzE1NDE=-flat-cord_rep_btree.h.html,37,abseil-cpp-MDEwOlJlcG9zaXRvcnkxMDQyMzE1NDE=-flat-cord_rep_btree.h,abseil-cpp-MDEwOlJlcG9zaXRvcnkxMDQyMzE1NDE=-flat-cord_rep_btree.h,369,374,5,369,374,5
37,https://htmlpreview.github.io/?https://github.com/Christina96/boilerplate-sample-matches/blob/main/Cpp/notepad-plus-plus-MDEwOlJlcG9zaXRvcnkzMzAxNDgxMQ==-flat-catch_14.hpp-notepad-plus-plus-MDEwOlJlcG9zaXRvcnkzMzAxNDgxMQ==-flat-catch_14.hpp.html,86409,notepad-plus-plus-MDEwOlJlcG9zaXRvcnkzMzAxNDgxMQ==-flat-catch_14.hpp,notepad-plus-plus-MDEwOlJlcG9zaXRvcnkzMzAxNDgxMQ==-flat-catch_14.hpp,1455,13690,12235,1455,13690,12235
38,https://htmlpreview.github.io/?https://github.com/Christina96/boilerplate-sample-matches/blob/main/Cpp/notepad-plus-plus-MDEwOlJlcG9zaXRvcnkzMzAxNDgxMQ==-flat-catch.hpp-notepad-plus-plus-MDEwOlJlcG9zaXRvcnkzMzAxNDgxMQ==-flat-catch_14.hpp.html,17633,notepad-plus-plus-MDEwOlJlcG9zaXRvcnkzMzAxNDgxMQ==-flat-catch.hpp,notepad-plus-plus-MDEwOlJlcG9zaXRvcnkzMzAxNDgxMQ==-flat-catch_14.hpp,11331,13690,2359,11331,13690,2359
39,https://htmlpreview.github.io/?https://github.com/Christina96/boilerplate-sample-matches/blob/main/Cpp/subconverter-MDEwOlJlcG9zaXRvcnkyMTg2ODY3NjM=-flat-nodemanip.cpp-notepad-plus-plus-MDEwOlJlcG9zaXRvcnkzMzAxNDgxMQ==-flat-PlatQt.cpp.html,15,subconverter-MDEwOlJlcG9zaXRvcnkyMTg2ODY3NjM=-flat-nodemanip.cpp,notepad-plus-plus-MDEwOlJlcG9zaXRvcnkzMzAxNDgxMQ==-flat-PlatQt.cpp,38,40,2,89,91,2
40,https://htmlpreview.github.io/?https://github.com/Christina96/boilerplate-sample-matches/blob/main/Cpp/snap-MDEwOlJlcG9zaXRvcnk0Mjg4MzU3-flat-html.cpp-snap-MDEwOlJlcG9zaXRvcnk0Mjg4MzU3-flat-sskj.cpp.html,48,snap-MDEwOlJlcG9zaXRvcnk0Mjg4MzU3-flat-html.cpp,snap-MDEwOlJlcG9zaXRvcnk0Mjg4MzU3-flat-sskj.cpp,31,38,7,16,23,7
41,https://htmlpreview.github.io/?https://github.com/Christina96/boilerplate-sample-matches/blob/main/Cpp/snap-MDEwOlJlcG9zaXRvcnk0Mjg4MzU3-flat-ExplicitStringTableTest4.cpp-snap-MDEwOlJlcG9zaXRvcnk0Mjg4MzU3-flat-ExplicitStringTableTest2.cpp.html,32,snap-MDEwOlJlcG9zaXRvcnk0Mjg4MzU3-flat-ExplicitStringTableTest4.cpp,snap-MDEwOlJlcG9zaXRvcnk0Mjg4MzU3-flat-ExplicitStringTableTest2.cpp,11,16,5,11,16,5
42,https://htmlpreview.github.io/?https://github.com/Christina96/boilerplate-sample-matches/blob/main/Cpp/notepad-plus-plus-MDEwOlJlcG9zaXRvcnkzMzAxNDgxMQ==-flat-catch.hpp-notepad-plus-plus-MDEwOlJlcG9zaXRvcnkzMzAxNDgxMQ==-flat-catch_14.hpp.html,51845,notepad-plus-plus-MDEwOlJlcG9zaXRvcnkzMzAxNDgxMQ==-flat-catch.hpp,notepad-plus-plus-MDEwOlJlcG9zaXRvcnkzMzAxNDgxMQ==-flat-catch_14.hpp,6339,13690,7351,6339,13690,7351
43,https://htmlpreview.github.io/?https://github.com/Christina96/boilerplate-sample-matches/blob/main/Cpp/snap-MDEwOlJlcG9zaXRvcnk0Mjg4MzU3-flat-http.h-snap-MDEwOlJlcG9zaXRvcnk0Mjg4MzU3-flat-xml.h.html,15,snap-MDEwOlJlcG9zaXRvcnk0Mjg4MzU3-flat-http.h,snap-MDEwOlJlcG9zaXRvcnk0Mjg4MzU3-flat-xml.h,144,145,1,208,209,1
44,https://htmlpreview.github.io/?https://github.com/Christina96/boilerplate-sample-matches/blob/main/Cpp/caffe-MDEwOlJlcG9zaXRvcnk2MTg3MDgwMw==-flat-normalize_layer.cpp-caffe-MDEwOlJlcG9zaXRvcnk2MTg3MDgwMw==-flat-normalize_layer.cpp.html,100,caffe-MDEwOlJlcG9zaXRvcnk2MTg3MDgwMw==-flat-normalize_layer.cpp,caffe-MDEwOlJlcG9zaXRvcnk2MTg3MDgwMw==-flat-normalize_layer.cpp,45,58,13,45,58,13
45,https://htmlpreview.github.io/?https://github.com/Christina96/boilerplate-sample-matches/blob/main/Cpp/nano-node-MDEwOlJlcG9zaXRvcnkxOTM0NzM0MA==-flat-blockprocessor_52.cpp-nano-node-MDEwOlJlcG9zaXRvcnkxOTM0NzM0MA==-flat-bootstrap_frontier.cpp.html,22,nano-node-MDEwOlJlcG9zaXRvcnkxOTM0NzM0MA==-flat-blockprocessor_52.cpp,nano-node-MDEwOlJlcG9zaXRvcnkxOTM0NzM0MA==-flat-bootstrap_frontier.cpp,113,115,2,82,84,2
46,https://htmlpreview.github.io/?https://github.com/Christina96/boilerplate-sample-matches/blob/main/Cpp/tesseract-MDEwOlJlcG9zaXRvcnkyMjg4NzA5NA==-flat-pageiterator.h-nano-node-MDEwOlJlcG9zaXRvcnkxOTM0NzM0MA==-flat-stats.hpp.html,15,tesseract-MDEwOlJlcG9zaXRvcnkyMjg4NzA5NA==-flat-pageiterator.h,nano-node-MDEwOlJlcG9zaXRvcnkxOTM0NzM0MA==-flat-stats.hpp,11,16,5,15,21,6
47,https://htmlpreview.github.io/?https://github.com/Christina96/boilerplate-sample-matches/blob/main/Cpp/tesseract-MDEwOlJlcG9zaXRvcnkyMjg4NzA5NA==-flat-matrix.h-tesseract-MDEwOlJlcG9zaXRvcnkyMjg4NzA5NA==-flat-matrix.h.html,21,tesseract-MDEwOlJlcG9zaXRvcnkyMjg4NzA5NA==-flat-matrix.h,tesseract-MDEwOlJlcG9zaXRvcnkyMjg4NzA5NA==-flat-matrix.h,416,420,4,416,420,4
48,https://htmlpreview.github.io/?https://github.com/Christina96/boilerplate-sample-matches/blob/main/Cpp/abseil-cpp-MDEwOlJlcG9zaXRvcnkxMDQyMzE1NDE=-flat-inline_variable_test_a.cc-abseil-cpp-MDEwOlJlcG9zaXRvcnkxMDQyMzE1NDE=-flat-inline_variable_test_a.cc.html,31,abseil-cpp-MDEwOlJlcG9zaXRvcnkxMDQyMzE1NDE=-flat-inline_variable_test_a.cc,abseil-cpp-MDEwOlJlcG9zaXRvcnkxMDQyMzE1NDE=-flat-inline_variable_test_a.cc,2,9,7,2,9,7
49,https://htmlpreview.github.io/?https://github.com/Christina96/boilerplate-sample-matches/blob/main/Cpp/notepad-plus-plus-MDEwOlJlcG9zaXRvcnkzMzAxNDgxMQ==-flat-perl_matcher_non_recursive.hpp-notepad-plus-plus-MDEwOlJlcG9zaXRvcnkzMzAxNDgxMQ==-flat-perl_matcher_non_recursive.hpp.html,123,notepad-plus-plus-MDEwOlJlcG9zaXRvcnkzMzAxNDgxMQ==-flat-perl_matcher_non_recursive.hpp,notepad-plus-plus-MDEwOlJlcG9zaXRvcnkzMzAxNDgxMQ==-flat-perl_matcher_non_recursive.hpp,735,747,12,735,747,12
50,https://htmlpreview.github.io/?https://github.com/Christina96/boilerplate-sample-matches/blob/main/Cpp/notepad-plus-plus-MDEwOlJlcG9zaXRvcnkzMzAxNDgxMQ==-flat-unicode_iterator.hpp-notepad-plus-plus-MDEwOlJlcG9zaXRvcnkzMzAxNDgxMQ==-flat-unicode_iterator.hpp.html,44,notepad-plus-plus-MDEwOlJlcG9zaXRvcnkzMzAxNDgxMQ==-flat-unicode_iterator.hpp,notepad-plus-plus-MDEwOlJlcG9zaXRvcnkzMzAxNDgxMQ==-flat-unicode_iterator.hpp,106,119,13,106,119,13
51,https://htmlpreview.github.io/?https://github.com/Christina96/boilerplate-sample-matches/blob/main/Cpp/snap-MDEwOlJlcG9zaXRvcnk0Mjg4MzU3-flat-hash.cpp-tesseract-MDEwOlJlcG9zaXRvcnkyMjg4NzA5NA==-flat-tablerecog.cpp.html,17,snap-MDEwOlJlcG9zaXRvcnk0Mjg4MzU3-flat-hash.cpp,tesseract-MDEwOlJlcG9zaXRvcnkyMjg4NzA5NA==-flat-tablerecog.cpp,112,114,2,496,498,2
52,https://htmlpreview.github.io/?https://github.com/Christina96/boilerplate-sample-matches/blob/main/Cpp/notepad-plus-plus-MDEwOlJlcG9zaXRvcnkzMzAxNDgxMQ==-flat-LexErlang.cxx-notepad-plus-plus-MDEwOlJlcG9zaXRvcnkzMzAxNDgxMQ==-flat-LexKVIrc.cxx.html,30,notepad-plus-plus-MDEwOlJlcG9zaXRvcnkzMzAxNDgxMQ==-flat-LexErlang.cxx,notepad-plus-plus-MDEwOlJlcG9zaXRvcnkzMzAxNDgxMQ==-flat-LexKVIrc.cxx,488,492,4,237,241,4
53,https://htmlpreview.github.io/?https://github.com/Christina96/boilerplate-sample-matches/blob/main/Cpp/abseil-cpp-MDEwOlJlcG9zaXRvcnkxMDQyMzE1NDE=-flat-cord_rep_btree_test.cc-abseil-cpp-MDEwOlJlcG9zaXRvcnkxMDQyMzE1NDE=-flat-str_split.cc.html,15,abseil-cpp-MDEwOlJlcG9zaXRvcnkxMDQyMzE1NDE=-flat-cord_rep_btree_test.cc,abseil-cpp-MDEwOlJlcG9zaXRvcnkxMDQyMzE1NDE=-flat-str_split.cc,413,414,1,73,74,1
54,https://htmlpreview.github.io/?https://github.com/Christina96/boilerplate-sample-matches/blob/main/Cpp/snap-MDEwOlJlcG9zaXRvcnk0Mjg4MzU3-flat-spinn3r.cpp-snap-MDEwOlJlcG9zaXRvcnk0Mjg4MzU3-flat-gstat.cpp.html,21,snap-MDEwOlJlcG9zaXRvcnk0Mjg4MzU3-flat-spinn3r.cpp,snap-MDEwOlJlcG9zaXRvcnk0Mjg4MzU3-flat-gstat.cpp,124,127,3,368,371,3
55,https://htmlpreview.github.io/?https://github.com/Christina96/boilerplate-sample-matches/blob/main/Cpp/snap-MDEwOlJlcG9zaXRvcnk0Mjg4MzU3-flat-hash.h-snap-MDEwOlJlcG9zaXRvcnk0Mjg4MzU3-flat-hash.h.html,15,snap-MDEwOlJlcG9zaXRvcnk0Mjg4MzU3-flat-hash.h,snap-MDEwOlJlcG9zaXRvcnk0Mjg4MzU3-flat-hash.h,488,492,4,488,492,4
56,https://htmlpreview.github.io/?https://github.com/Christina96/boilerplate-sample-matches/blob/main/Cpp/snap-MDEwOlJlcG9zaXRvcnk0Mjg4MzU3-flat-corrgr.cpp-snap-MDEwOlJlcG9zaXRvcnk0Mjg4MzU3-flat-wikinet.cpp.html,15,snap-MDEwOlJlcG9zaXRvcnk0Mjg4MzU3-flat-corrgr.cpp,snap-MDEwOlJlcG9zaXRvcnk0Mjg4MzU3-flat-wikinet.cpp,154,157,3,2355,2359,4
57,https://htmlpreview.github.io/?https://github.com/Christina96/boilerplate-sample-matches/blob/main/Cpp/caffe-MDEwOlJlcG9zaXRvcnk2MTg3MDgwMw==-flat-bbox_util.cpp-caffe-MDEwOlJlcG9zaXRvcnk2MTg3MDgwMw==-flat-bbox_util.cpp.html,14,caffe-MDEwOlJlcG9zaXRvcnk2MTg3MDgwMw==-flat-bbox_util.cpp,caffe-MDEwOlJlcG9zaXRvcnk2MTg3MDgwMw==-flat-bbox_util.cpp,949,953,4,949,953,4
58,https://htmlpreview.github.io/?https://github.com/Christina96/boilerplate-sample-matches/blob/main/Cpp/abseil-cpp-MDEwOlJlcG9zaXRvcnkxMDQyMzE1NDE=-flat-mutex.cc-abseil-cpp-MDEwOlJlcG9zaXRvcnkxMDQyMzE1NDE=-flat-mutex.cc.html,30,abseil-cpp-MDEwOlJlcG9zaXRvcnkxMDQyMzE1NDE=-flat-mutex.cc,abseil-cpp-MDEwOlJlcG9zaXRvcnkxMDQyMzE1NDE=-flat-mutex.cc,1175,1181,6,1190,1196,6
59,https://htmlpreview.github.io/?https://github.com/Christina96/boilerplate-sample-matches/blob/main/Cpp/notepad-plus-plus-MDEwOlJlcG9zaXRvcnkzMzAxNDgxMQ==-flat-ScintillaWin.cxx-notepad-plus-plus-MDEwOlJlcG9zaXRvcnkzMzAxNDgxMQ==-flat-ScintillaWin.cxx.html,14,notepad-plus-plus-MDEwOlJlcG9zaXRvcnkzMzAxNDgxMQ==-flat-ScintillaWin.cxx,notepad-plus-plus-MDEwOlJlcG9zaXRvcnkzMzAxNDgxMQ==-flat-ScintillaWin.cxx,409,410,1,404,405,1
60,https://htmlpreview.github.io/?https://github.com/Christina96/boilerplate-sample-matches/blob/main/Cpp/abseil-cpp-MDEwOlJlcG9zaXRvcnkxMDQyMzE1NDE=-flat-cord_rep_btree_test.cc-abseil-cpp-MDEwOlJlcG9zaXRvcnkxMDQyMzE1NDE=-flat-cord_rep_btree_test.cc.html,54,abseil-cpp-MDEwOlJlcG9zaXRvcnkxMDQyMzE1NDE=-flat-cord_rep_btree_test.cc,abseil-cpp-MDEwOlJlcG9zaXRvcnkxMDQyMzE1NDE=-flat-cord_rep_btree_test.cc,700,705,5,700,705,5
61,https://htmlpreview.github.io/?https://github.com/Christina96/boilerplate-sample-matches/blob/main/Cpp/notepad-plus-plus-MDEwOlJlcG9zaXRvcnkzMzAxNDgxMQ==-flat-Parameters.cpp-notepad-plus-plus-MDEwOlJlcG9zaXRvcnkzMzAxNDgxMQ==-flat-Parameters.cpp.html,25,notepad-plus-plus-MDEwOlJlcG9zaXRvcnkzMzAxNDgxMQ==-flat-Parameters.cpp,notepad-plus-plus-MDEwOlJlcG9zaXRvcnkzMzAxNDgxMQ==-flat-Parameters.cpp,3252,3254,2,3252,3254,2
62,https://htmlpreview.github.io/?https://github.com/Christina96/boilerplate-sample-matches/blob/main/Cpp/notepad-plus-plus-MDEwOlJlcG9zaXRvcnkzMzAxNDgxMQ==-flat-ScintillaGTK.cxx-notepad-plus-plus-MDEwOlJlcG9zaXRvcnkzMzAxNDgxMQ==-flat-ScintillaQt.cpp.html,16,notepad-plus-plus-MDEwOlJlcG9zaXRvcnkzMzAxNDgxMQ==-flat-ScintillaGTK.cxx,notepad-plus-plus-MDEwOlJlcG9zaXRvcnkzMzAxNDgxMQ==-flat-ScintillaQt.cpp,2283,2285,2,646,648,2
63,https://htmlpreview.github.io/?https://github.com/Christina96/boilerplate-sample-matches/blob/main/Cpp/abseil-cpp-MDEwOlJlcG9zaXRvcnkxMDQyMzE1NDE=-flat-match_test.cc-abseil-cpp-MDEwOlJlcG9zaXRvcnkxMDQyMzE1NDE=-flat-match_test.cc.html,33,abseil-cpp-MDEwOlJlcG9zaXRvcnkxMDQyMzE1NDE=-flat-match_test.cc,abseil-cpp-MDEwOlJlcG9zaXRvcnkxMDQyMzE1NDE=-flat-match_test.cc,150,154,4,150,154,4
64,https://htmlpreview.github.io/?https://github.com/Christina96/boilerplate-sample-matches/blob/main/Cpp/abseil-cpp-MDEwOlJlcG9zaXRvcnkxMDQyMzE1NDE=-flat-cord_test.cc-abseil-cpp-MDEwOlJlcG9zaXRvcnkxMDQyMzE1NDE=-flat-cord_test.cc.html,19,abseil-cpp-MDEwOlJlcG9zaXRvcnkxMDQyMzE1NDE=-flat-cord_test.cc,abseil-cpp-MDEwOlJlcG9zaXRvcnkxMDQyMzE1NDE=-flat-cord_test.cc,517,519,2,517,519,2
65,https://htmlpreview.github.io/?https://github.com/Christina96/boilerplate-sample-matches/blob/main/Cpp/snap-MDEwOlJlcG9zaXRvcnk0Mjg4MzU3-flat-bix.cpp-snap-MDEwOlJlcG9zaXRvcnk0Mjg4MzU3-flat-txtbs.cpp.html,26,snap-MDEwOlJlcG9zaXRvcnk0Mjg4MzU3-flat-bix.cpp,snap-MDEwOlJlcG9zaXRvcnk0Mjg4MzU3-flat-txtbs.cpp,204,208,4,17,21,4
66,https://htmlpreview.github.io/?https://github.com/Christina96/boilerplate-sample-matches/blob/main/Cpp/snap-MDEwOlJlcG9zaXRvcnk0Mjg4MzU3-flat-bfs-hybrid.h-snap-MDEwOlJlcG9zaXRvcnk0Mjg4MzU3-flat-bfs-hybrid.h.html,42,snap-MDEwOlJlcG9zaXRvcnk0Mjg4MzU3-flat-bfs-hybrid.h,snap-MDEwOlJlcG9zaXRvcnk0Mjg4MzU3-flat-bfs-hybrid.h,25,29,4,25,29,4
67,https://htmlpreview.github.io/?https://github.com/Christina96/boilerplate-sample-matches/blob/main/Cpp/snap-MDEwOlJlcG9zaXRvcnk0Mjg4MzU3-flat-demo-TUndirNet.cpp-snap-MDEwOlJlcG9zaXRvcnk0Mjg4MzU3-flat-demo-TDirNet.cpp.html,18,snap-MDEwOlJlcG9zaXRvcnk0Mjg4MzU3-flat-demo-TUndirNet.cpp,snap-MDEwOlJlcG9zaXRvcnk0Mjg4MzU3-flat-demo-TDirNet.cpp,203,206,3,202,205,3
68,https://htmlpreview.github.io/?https://github.com/Christina96/boilerplate-sample-matches/blob/main/Cpp/snap-MDEwOlJlcG9zaXRvcnk0Mjg4MzU3-flat-graph.cpp-snap-MDEwOlJlcG9zaXRvcnk0Mjg4MzU3-flat-graph.cpp.html,22,snap-MDEwOlJlcG9zaXRvcnk0Mjg4MzU3-flat-graph.cpp,snap-MDEwOlJlcG9zaXRvcnk0Mjg4MzU3-flat-graph.cpp,639,642,3,607,610,3
69,https://htmlpreview.github.io/?https://github.com/Christina96/boilerplate-sample-matches/blob/main/Cpp/snap-MDEwOlJlcG9zaXRvcnk0Mjg4MzU3-flat-flow.cpp-snap-MDEwOlJlcG9zaXRvcnk0Mjg4MzU3-flat-http.cpp.html,15,snap-MDEwOlJlcG9zaXRvcnk0Mjg4MzU3-flat-flow.cpp,snap-MDEwOlJlcG9zaXRvcnk0Mjg4MzU3-flat-http.cpp,339,341,2,239,241,2
70,https://htmlpreview.github.io/?https://github.com/Christina96/boilerplate-sample-matches/blob/main/Cpp/tesseract-MDEwOlJlcG9zaXRvcnkyMjg4NzA5NA==-flat-blobbox.h-caffe-MDEwOlJlcG9zaXRvcnk2MTg3MDgwMw==-flat-region_loss_layer.hpp.html,15,tesseract-MDEwOlJlcG9zaXRvcnkyMjg4NzA5NA==-flat-blobbox.h,caffe-MDEwOlJlcG9zaXRvcnk2MTg3MDgwMw==-flat-region_loss_layer.hpp,529,534,5,55,60,5
71,https://htmlpreview.github.io/?https://github.com/Christina96/boilerplate-sample-matches/blob/main/Cpp/notepad-plus-plus-MDEwOlJlcG9zaXRvcnkzMzAxNDgxMQ==-flat-CallTip.cxx-tesseract-MDEwOlJlcG9zaXRvcnkyMjg4NzA5NA==-flat-lm_consistency.h.html,16,notepad-plus-plus-MDEwOlJlcG9zaXRvcnkzMzAxNDgxMQ==-flat-CallTip.cxx,tesseract-MDEwOlJlcG9zaXRvcnkyMjg4NzA5NA==-flat-lm_consistency.h,36,40,4,27,31,4
72,https://htmlpreview.github.io/?https://github.com/Christina96/boilerplate-sample-matches/blob/main/Cpp/caffe-MDEwOlJlcG9zaXRvcnk2MTg3MDgwMw==-flat-data_layer.hpp-caffe-MDEwOlJlcG9zaXRvcnk2MTg3MDgwMw==-flat-box_data_layer.hpp.html,15,caffe-MDEwOlJlcG9zaXRvcnk2MTg3MDgwMw==-flat-data_layer.hpp,caffe-MDEwOlJlcG9zaXRvcnk2MTg3MDgwMw==-flat-box_data_layer.hpp,26,28,2,27,29,2
73,https://htmlpreview.github.io/?https://github.com/Christina96/boilerplate-sample-matches/blob/main/Cpp/notepad-plus-plus-MDEwOlJlcG9zaXRvcnkzMzAxNDgxMQ==-flat-catch.hpp-notepad-plus-plus-MDEwOlJlcG9zaXRvcnkzMzAxNDgxMQ==-flat-catch_14.hpp.html,29383,notepad-plus-plus-MDEwOlJlcG9zaXRvcnkzMzAxNDgxMQ==-flat-catch.hpp,notepad-plus-plus-MDEwOlJlcG9zaXRvcnkzMzAxNDgxMQ==-flat-catch_14.hpp,9602,13690,4088,9602,13690,4088
74,https://htmlpreview.github.io/?https://github.com/Christina96/boilerplate-sample-matches/blob/main/Cpp/tesseract-MDEwOlJlcG9zaXRvcnkyMjg4NzA5NA==-flat-unicharmap.cpp-tesseract-MDEwOlJlcG9zaXRvcnkyMjg4NzA5NA==-flat-unicharmap.cpp.html,16,tesseract-MDEwOlJlcG9zaXRvcnkyMjg4NzA5NA==-flat-unicharmap.cpp,tesseract-MDEwOlJlcG9zaXRvcnkyMjg4NzA5NA==-flat-unicharmap.cpp,9,10,1,9,10,1
75,https://htmlpreview.github.io/?https://github.com/Christina96/boilerplate-sample-matches/blob/main/Cpp/notepad-plus-plus-MDEwOlJlcG9zaXRvcnkzMzAxNDgxMQ==-flat-catch.hpp-notepad-plus-plus-MDEwOlJlcG9zaXRvcnkzMzAxNDgxMQ==-flat-catch.hpp.html,56799,notepad-plus-plus-MDEwOlJlcG9zaXRvcnkzMzAxNDgxMQ==-flat-catch.hpp,notepad-plus-plus-MDEwOlJlcG9zaXRvcnkzMzAxNDgxMQ==-flat-catch.hpp,5614,13690,8076,5614,13690,8076
76,https://htmlpreview.github.io/?https://github.com/Christina96/boilerplate-sample-matches/blob/main/Cpp/notepad-plus-plus-MDEwOlJlcG9zaXRvcnkzMzAxNDgxMQ==-flat-tinyxmlA.cpp-notepad-plus-plus-MDEwOlJlcG9zaXRvcnkzMzAxNDgxMQ==-flat-tinyxml.cpp.html,458,notepad-plus-plus-MDEwOlJlcG9zaXRvcnkzMzAxNDgxMQ==-flat-tinyxmlA.cpp,notepad-plus-plus-MDEwOlJlcG9zaXRvcnkzMzAxNDgxMQ==-flat-tinyxml.cpp,119,213,94,125,219,94
77,https://htmlpreview.github.io/?https://github.com/Christina96/boilerplate-sample-matches/blob/main/Cpp/notepad-plus-plus-MDEwOlJlcG9zaXRvcnkzMzAxNDgxMQ==-flat-ColourPopup.cpp-notepad-plus-plus-MDEwOlJlcG9zaXRvcnkzMzAxNDgxMQ==-flat-ColourPopup.cpp.html,15,notepad-plus-plus-MDEwOlJlcG9zaXRvcnkzMzAxNDgxMQ==-flat-ColourPopup.cpp,notepad-plus-plus-MDEwOlJlcG9zaXRvcnkzMzAxNDgxMQ==-flat-ColourPopup.cpp,166,171,5,166,171,5
78,https://htmlpreview.github.io/?https://github.com/Christina96/boilerplate-sample-matches/blob/main/Cpp/tesseract-MDEwOlJlcG9zaXRvcnkyMjg4NzA5NA==-flat-paragraphs_test.cc-tesseract-MDEwOlJlcG9zaXRvcnkyMjg4NzA5NA==-flat-paragraphs_test.cc.html,19,tesseract-MDEwOlJlcG9zaXRvcnkyMjg4NzA5NA==-flat-paragraphs_test.cc,tesseract-MDEwOlJlcG9zaXRvcnkyMjg4NzA5NA==-flat-paragraphs_test.cc,165,166,1,165,166,1
79,https://htmlpreview.github.io/?https://github.com/Christina96/boilerplate-sample-matches/blob/main/Cpp/tesseract-MDEwOlJlcG9zaXRvcnkyMjg4NzA5NA==-flat-imagefind.cpp-tesseract-MDEwOlJlcG9zaXRvcnkyMjg4NzA5NA==-flat-imagefind.cpp.html,63,tesseract-MDEwOlJlcG9zaXRvcnkyMjg4NzA5NA==-flat-imagefind.cpp,tesseract-MDEwOlJlcG9zaXRvcnkyMjg4NzA5NA==-flat-imagefind.cpp,381,388,7,342,349,7
80,https://htmlpreview.github.io/?https://github.com/Christina96/boilerplate-sample-matches/blob/main/Cpp/caffe-MDEwOlJlcG9zaXRvcnk2MTg3MDgwMw==-flat-net.cpp-caffe-MDEwOlJlcG9zaXRvcnk2MTg3MDgwMw==-flat-test_mkl_deconvolution_layer.cpp.html,20,caffe-MDEwOlJlcG9zaXRvcnk2MTg3MDgwMw==-flat-net.cpp,caffe-MDEwOlJlcG9zaXRvcnk2MTg3MDgwMw==-flat-test_mkl_deconvolution_layer.cpp,1622,1623,1,168,169,1
81,https://htmlpreview.github.io/?https://github.com/Christina96/boilerplate-sample-matches/blob/main/Cpp/tesseract-MDEwOlJlcG9zaXRvcnkyMjg4NzA5NA==-flat-makerow.h-tesseract-MDEwOlJlcG9zaXRvcnkyMjg4NzA5NA==-flat-topitch.h.html,14,tesseract-MDEwOlJlcG9zaXRvcnkyMjg4NzA5NA==-flat-makerow.h,tesseract-MDEwOlJlcG9zaXRvcnkyMjg4NzA5NA==-flat-topitch.h,176,179,3,17,21,4
82,https://htmlpreview.github.io/?https://github.com/Christina96/boilerplate-sample-matches/blob/main/Cpp/snap-MDEwOlJlcG9zaXRvcnk0Mjg4MzU3-flat-triad.h-snap-MDEwOlJlcG9zaXRvcnk0Mjg4MzU3-flat-triad.h.html,39,snap-MDEwOlJlcG9zaXRvcnk0Mjg4MzU3-flat-triad.h,snap-MDEwOlJlcG9zaXRvcnk0Mjg4MzU3-flat-triad.h,186,191,5,186,191,5
83,https://htmlpreview.github.io/?https://github.com/Christina96/boilerplate-sample-matches/blob/main/Cpp/notepad-plus-plus-MDEwOlJlcG9zaXRvcnkzMzAxNDgxMQ==-flat-LexCSS.cxx-notepad-plus-plus-MDEwOlJlcG9zaXRvcnkzMzAxNDgxMQ==-flat-LexCSS.cxx.html,41,notepad-plus-plus-MDEwOlJlcG9zaXRvcnkzMzAxNDgxMQ==-flat-LexCSS.cxx,notepad-plus-plus-MDEwOlJlcG9zaXRvcnkzMzAxNDgxMQ==-flat-LexCSS.cxx,124,130,6,124,130,6
84,https://htmlpreview.github.io/?https://github.com/Christina96/boilerplate-sample-matches/blob/main/Cpp/caffe-MDEwOlJlcG9zaXRvcnk2MTg3MDgwMw==-flat-test_mkl_deconvolution_layer.cpp-caffe-MDEwOlJlcG9zaXRvcnk2MTg3MDgwMw==-flat-test_mkldnn_convolution_layer.cpp.html,75,caffe-MDEwOlJlcG9zaXRvcnk2MTg3MDgwMw==-flat-test_mkl_deconvolution_layer.cpp,caffe-MDEwOlJlcG9zaXRvcnk2MTg3MDgwMw==-flat-test_mkldnn_convolution_layer.cpp,241,248,7,761,768,7
85,https://htmlpreview.github.io/?https://github.com/Christina96/boilerplate-sample-matches/blob/main/Cpp/abseil-cpp-MDEwOlJlcG9zaXRvcnkxMDQyMzE1NDE=-flat-numbers_test.cc-abseil-cpp-MDEwOlJlcG9zaXRvcnkxMDQyMzE1NDE=-flat-numbers_test.cc.html,32,abseil-cpp-MDEwOlJlcG9zaXRvcnkxMDQyMzE1NDE=-flat-numbers_test.cc,abseil-cpp-MDEwOlJlcG9zaXRvcnkxMDQyMzE1NDE=-flat-numbers_test.cc,155,157,2,155,157,2
86,https://htmlpreview.github.io/?https://github.com/Christina96/boilerplate-sample-matches/blob/main/Cpp/abseil-cpp-MDEwOlJlcG9zaXRvcnkxMDQyMzE1NDE=-flat-inlined_vector_benchmark.cc-abseil-cpp-MDEwOlJlcG9zaXRvcnkxMDQyMzE1NDE=-flat-inlined_vector_benchmark.cc.html,23,abseil-cpp-MDEwOlJlcG9zaXRvcnkxMDQyMzE1NDE=-flat-inlined_vector_benchmark.cc,abseil-cpp-MDEwOlJlcG9zaXRvcnkxMDQyMzE1NDE=-flat-inlined_vector_benchmark.cc,171,173,2,171,173,2
87,https://htmlpreview.github.io/?https://github.com/Christina96/boilerplate-sample-matches/blob/main/Cpp/abseil-cpp-MDEwOlJlcG9zaXRvcnkxMDQyMzE1NDE=-flat-container_test.cc-abseil-cpp-MDEwOlJlcG9zaXRvcnkxMDQyMzE1NDE=-flat-container_test.cc.html,18,abseil-cpp-MDEwOlJlcG9zaXRvcnkxMDQyMzE1NDE=-flat-container_test.cc,abseil-cpp-MDEwOlJlcG9zaXRvcnkxMDQyMzE1NDE=-flat-container_test.cc,726,727,1,788,789,1
88,https://htmlpreview.github.io/?https://github.com/Christina96/boilerplate-sample-matches/blob/main/Cpp/caffe-MDEwOlJlcG9zaXRvcnk2MTg3MDgwMw==-flat-gtest-internal.h-caffe-MDEwOlJlcG9zaXRvcnk2MTg3MDgwMw==-flat-gtest-internal.h.html,17,caffe-MDEwOlJlcG9zaXRvcnk2MTg3MDgwMw==-flat-gtest-internal.h,caffe-MDEwOlJlcG9zaXRvcnk2MTg3MDgwMw==-flat-gtest-internal.h,490,494,4,490,494,4
89,https://htmlpreview.github.io/?https://github.com/Christina96/boilerplate-sample-matches/blob/main/Cpp/notepad-plus-plus-MDEwOlJlcG9zaXRvcnkzMzAxNDgxMQ==-flat-Buffer.cpp-notepad-plus-plus-MDEwOlJlcG9zaXRvcnkzMzAxNDgxMQ==-flat-Buffer.cpp.html,74,notepad-plus-plus-MDEwOlJlcG9zaXRvcnkzMzAxNDgxMQ==-flat-Buffer.cpp,notepad-plus-plus-MDEwOlJlcG9zaXRvcnkzMzAxNDgxMQ==-flat-Buffer.cpp,882,891,9,882,891,9
90,https://htmlpreview.github.io/?https://github.com/Christina96/boilerplate-sample-matches/blob/main/Cpp/abseil-cpp-MDEwOlJlcG9zaXRvcnkxMDQyMzE1NDE=-flat-variant_4.h-abseil-cpp-MDEwOlJlcG9zaXRvcnkxMDQyMzE1NDE=-flat-variant_4.h.html,16,abseil-cpp-MDEwOlJlcG9zaXRvcnkxMDQyMzE1NDE=-flat-variant_4.h,abseil-cpp-MDEwOlJlcG9zaXRvcnkxMDQyMzE1NDE=-flat-variant_4.h,1147,1150,3,1147,1150,3
91,https://htmlpreview.github.io/?https://github.com/Christina96/boilerplate-sample-matches/blob/main/Cpp/abseil-cpp-MDEwOlJlcG9zaXRvcnkxMDQyMzE1NDE=-flat-unordered_set_constructor_test.h-abseil-cpp-MDEwOlJlcG9zaXRvcnkxMDQyMzE1NDE=-flat-unordered_set_constructor_test.h.html,799,abseil-cpp-MDEwOlJlcG9zaXRvcnkxMDQyMzE1NDE=-flat-unordered_set_constructor_test.h,abseil-cpp-MDEwOlJlcG9zaXRvcnkxMDQyMzE1NDE=-flat-unordered_set_constructor_test.h,321,417,96,321,417,96
92,https://htmlpreview.github.io/?https://github.com/Christina96/boilerplate-sample-matches/blob/main/Cpp/caffe-MDEwOlJlcG9zaXRvcnk2MTg3MDgwMw==-flat-test_mkl_pooling_layer.cpp-caffe-MDEwOlJlcG9zaXRvcnk2MTg3MDgwMw==-flat-test_pooling_layer.cpp.html,20,caffe-MDEwOlJlcG9zaXRvcnk2MTg3MDgwMw==-flat-test_mkl_pooling_layer.cpp,caffe-MDEwOlJlcG9zaXRvcnk2MTg3MDgwMw==-flat-test_pooling_layer.cpp,20,22,2,22,24,2
93,https://htmlpreview.github.io/?https://github.com/Christina96/boilerplate-sample-matches/blob/main/Cpp/abseil-cpp-MDEwOlJlcG9zaXRvcnkxMDQyMzE1NDE=-flat-raw_hash_set_benchmark.cc-abseil-cpp-MDEwOlJlcG9zaXRvcnkxMDQyMzE1NDE=-flat-raw_hash_set_benchmark.cc.html,19,abseil-cpp-MDEwOlJlcG9zaXRvcnkxMDQyMzE1NDE=-flat-raw_hash_set_benchmark.cc,abseil-cpp-MDEwOlJlcG9zaXRvcnkxMDQyMzE1NDE=-flat-raw_hash_set_benchmark.cc,118,121,3,118,121,3
94,https://htmlpreview.github.io/?https://github.com/Christina96/boilerplate-sample-matches/blob/main/Cpp/caffe-MDEwOlJlcG9zaXRvcnk2MTg3MDgwMw==-flat-io.hpp-caffe-MDEwOlJlcG9zaXRvcnk2MTg3MDgwMw==-flat-io.hpp.html,41,caffe-MDEwOlJlcG9zaXRvcnk2MTg3MDgwMw==-flat-io.hpp,caffe-MDEwOlJlcG9zaXRvcnk2MTg3MDgwMw==-flat-io.hpp,98,103,5,98,103,5
95,https://htmlpreview.github.io/?https://github.com/Christina96/boilerplate-sample-matches/blob/main/Cpp/glm-MDEwOlJlcG9zaXRvcnk4NDM2MzE=-flat-loader_tga.hpp-glm-MDEwOlJlcG9zaXRvcnk4NDM2MzE=-flat-loader_dds9.hpp.html,24,glm-MDEwOlJlcG9zaXRvcnk4NDM2MzE=-flat-loader_tga.hpp,glm-MDEwOlJlcG9zaXRvcnk4NDM2MzE=-flat-loader_dds9.hpp,11,15,4,10,14,4
96,https://htmlpreview.github.io/?https://github.com/Christina96/boilerplate-sample-matches/blob/main/Cpp/notepad-plus-plus-MDEwOlJlcG9zaXRvcnkzMzAxNDgxMQ==-flat-ScintillaBase.cxx-notepad-plus-plus-MDEwOlJlcG9zaXRvcnkzMzAxNDgxMQ==-flat-ScintillaBase.cxx.html,28,notepad-plus-plus-MDEwOlJlcG9zaXRvcnkzMzAxNDgxMQ==-flat-ScintillaBase.cxx,notepad-plus-plus-MDEwOlJlcG9zaXRvcnkzMzAxNDgxMQ==-flat-ScintillaBase.cxx,611,617,6,605,611,6
97,https://htmlpreview.github.io/?https://github.com/Christina96/boilerplate-sample-matches/blob/main/Cpp/snap-MDEwOlJlcG9zaXRvcnk0Mjg4MzU3-flat-mmnet.cpp-snap-MDEwOlJlcG9zaXRvcnk0Mjg4MzU3-flat-network.cpp.html,37,snap-MDEwOlJlcG9zaXRvcnk0Mjg4MzU3-flat-mmnet.cpp,snap-MDEwOlJlcG9zaXRvcnk0Mjg4MzU3-flat-network.cpp,571,575,4,1543,1547,4
98,https://htmlpreview.github.io/?https://github.com/Christina96/boilerplate-sample-matches/blob/main/Cpp/nano-node-MDEwOlJlcG9zaXRvcnkxOTM0NzM0MA==-flat-cl_platform.h-nano-node-MDEwOlJlcG9zaXRvcnkxOTM0NzM0MA==-flat-cl_platform.h.html,20,nano-node-MDEwOlJlcG9zaXRvcnkxOTM0NzM0MA==-flat-cl_platform.h,nano-node-MDEwOlJlcG9zaXRvcnkxOTM0NzM0MA==-flat-cl_platform.h,482,484,2,416,418,2
99,https://htmlpreview.github.io/?https://github.com/Christina96/boilerplate-sample-matches/blob/main/Cpp/notepad-plus-plus-MDEwOlJlcG9zaXRvcnkzMzAxNDgxMQ==-flat-perl_matcher_non_recursive.hpp-notepad-plus-plus-MDEwOlJlcG9zaXRvcnkzMzAxNDgxMQ==-flat-perl_matcher_non_recursive.hpp.html,14,notepad-plus-plus-MDEwOlJlcG9zaXRvcnkzMzAxNDgxMQ==-flat-perl_matcher_non_recursive.hpp,notepad-plus-plus-MDEwOlJlcG9zaXRvcnkzMzAxNDgxMQ==-flat-perl_matcher_non_recursive.hpp,1161,1163,2,1082,1084,2
100,https://htmlpreview.github.io/?https://github.com/Christina96/boilerplate-sample-matches/blob/main/Cpp/nano-node-MDEwOlJlcG9zaXRvcnkxOTM0NzM0MA==-flat-ipc_access_config.cpp-nano-node-MDEwOlJlcG9zaXRvcnkxOTM0NzM0MA==-flat-ipc_access_config.cpp.html,15,nano-node-MDEwOlJlcG9zaXRvcnkxOTM0NzM0MA==-flat-ipc_access_config.cpp,nano-node-MDEwOlJlcG9zaXRvcnkxOTM0NzM0MA==-flat-ipc_access_config.cpp,10,12,2,32,34,2
101,https://htmlpreview.github.io/?https://github.com/Christina96/boilerplate-sample-matches/blob/main/Cpp/MMKV-MDEwOlJlcG9zaXRvcnkxNDkxMTE4MTM=-flat-native-bridge.cpp-MMKV-MDEwOlJlcG9zaXRvcnkxNDkxMTE4MTM=-flat-native-bridge.cpp.html,15,MMKV-MDEwOlJlcG9zaXRvcnkxNDkxMTE4MTM=-flat-native-bridge.cpp,MMKV-MDEwOlJlcG9zaXRvcnkxNDkxMTE4MTM=-flat-native-bridge.cpp,624,625,1,624,625,1
102,https://htmlpreview.github.io/?https://github.com/Christina96/boilerplate-sample-matches/blob/main/Cpp/snap-MDEwOlJlcG9zaXRvcnk0Mjg4MzU3-flat-rinetmatch.h-snap-MDEwOlJlcG9zaXRvcnk0Mjg4MzU3-flat-rids.h.html,44,snap-MDEwOlJlcG9zaXRvcnk0Mjg4MzU3-flat-rinetmatch.h,snap-MDEwOlJlcG9zaXRvcnk0Mjg4MzU3-flat-rids.h,112,118,6,405,411,6
103,https://htmlpreview.github.io/?https://github.com/Christina96/boilerplate-sample-matches/blob/main/Cpp/notepad-plus-plus-MDEwOlJlcG9zaXRvcnkzMzAxNDgxMQ==-flat-LexRaku.cxx-notepad-plus-plus-MDEwOlJlcG9zaXRvcnkzMzAxNDgxMQ==-flat-LexRaku.cxx.html,16,notepad-plus-plus-MDEwOlJlcG9zaXRvcnkzMzAxNDgxMQ==-flat-LexRaku.cxx,notepad-plus-plus-MDEwOlJlcG9zaXRvcnkzMzAxNDgxMQ==-flat-LexRaku.cxx,440,445,5,440,445,5
104,https://htmlpreview.github.io/?https://github.com/Christina96/boilerplate-sample-matches/blob/main/Cpp/glm-MDEwOlJlcG9zaXRvcnk4NDM2MzE=-flat-half_float.hpp-glm-MDEwOlJlcG9zaXRvcnk4NDM2MzE=-flat-half_float.hpp.html,172,glm-MDEwOlJlcG9zaXRvcnk4NDM2MzE=-flat-half_float.hpp,glm-MDEwOlJlcG9zaXRvcnk4NDM2MzE=-flat-half_float.hpp,46,58,12,98,110,12
105,https://htmlpreview.github.io/?https://github.com/Christina96/boilerplate-sample-matches/blob/main/Cpp/snap-MDEwOlJlcG9zaXRvcnk0Mjg4MzU3-flat-bowfl.cpp-snap-MDEwOlJlcG9zaXRvcnk0Mjg4MzU3-flat-bowflx.cpp.html,15,snap-MDEwOlJlcG9zaXRvcnk0Mjg4MzU3-flat-bowfl.cpp,snap-MDEwOlJlcG9zaXRvcnk0Mjg4MzU3-flat-bowflx.cpp,248,250,2,170,172,2
106,https://htmlpreview.github.io/?https://github.com/Christina96/boilerplate-sample-matches/blob/main/Cpp/tesseract-MDEwOlJlcG9zaXRvcnkyMjg4NzA5NA==-flat-adaptive.cpp-tesseract-MDEwOlJlcG9zaXRvcnkyMjg4NzA5NA==-flat-adaptive.cpp.html,19,tesseract-MDEwOlJlcG9zaXRvcnkyMjg4NzA5NA==-flat-adaptive.cpp,tesseract-MDEwOlJlcG9zaXRvcnkyMjg4NzA5NA==-flat-adaptive.cpp,156,157,1,157,158,1
107,https://htmlpreview.github.io/?https://github.com/Christina96/boilerplate-sample-matches/blob/main/Cpp/nano-node-MDEwOlJlcG9zaXRvcnkxOTM0NzM0MA==-flat-versioning.cpp-nano-node-MDEwOlJlcG9zaXRvcnkxOTM0NzM0MA==-flat-versioning.cpp.html,74,nano-node-MDEwOlJlcG9zaXRvcnkxOTM0NzM0MA==-flat-versioning.cpp,nano-node-MDEwOlJlcG9zaXRvcnkxOTM0NzM0MA==-flat-versioning.cpp,207,219,12,207,219,12
108,https://htmlpreview.github.io/?https://github.com/Christina96/boilerplate-sample-matches/blob/main/Cpp/snap-MDEwOlJlcG9zaXRvcnk0Mjg4MzU3-flat-tnt.cpp-snap-MDEwOlJlcG9zaXRvcnk0Mjg4MzU3-flat-tnt.cpp.html,771,snap-MDEwOlJlcG9zaXRvcnk0Mjg4MzU3-flat-tnt.cpp,snap-MDEwOlJlcG9zaXRvcnk0Mjg4MzU3-flat-tnt.cpp,23,105,82,23,105,82
109,https://htmlpreview.github.io/?https://github.com/Christina96/boilerplate-sample-matches/blob/main/Cpp/notepad-plus-plus-MDEwOlJlcG9zaXRvcnkzMzAxNDgxMQ==-flat-ViewStyle.cxx-notepad-plus-plus-MDEwOlJlcG9zaXRvcnkzMzAxNDgxMQ==-flat-ViewStyle.cxx.html,21,notepad-plus-plus-MDEwOlJlcG9zaXRvcnkzMzAxNDgxMQ==-flat-ViewStyle.cxx,notepad-plus-plus-MDEwOlJlcG9zaXRvcnkzMzAxNDgxMQ==-flat-ViewStyle.cxx,633,637,4,633,637,4
110,https://htmlpreview.github.io/?https://github.com/Christina96/boilerplate-sample-matches/blob/main/Cpp/notepad-plus-plus-MDEwOlJlcG9zaXRvcnkzMzAxNDgxMQ==-flat-catch.hpp-notepad-plus-plus-MDEwOlJlcG9zaXRvcnkzMzAxNDgxMQ==-flat-catch.hpp.html,87042,notepad-plus-plus-MDEwOlJlcG9zaXRvcnkzMzAxNDgxMQ==-flat-catch.hpp,notepad-plus-plus-MDEwOlJlcG9zaXRvcnkzMzAxNDgxMQ==-flat-catch.hpp,1350,13690,12340,1350,13690,12340
111,https://htmlpreview.github.io/?https://github.com/Christina96/boilerplate-sample-matches/blob/main/Cpp/abseil-cpp-MDEwOlJlcG9zaXRvcnkxMDQyMzE1NDE=-flat-layout.h-abseil-cpp-MDEwOlJlcG9zaXRvcnkxMDQyMzE1NDE=-flat-layout.h.html,42,abseil-cpp-MDEwOlJlcG9zaXRvcnkxMDQyMzE1NDE=-flat-layout.h,abseil-cpp-MDEwOlJlcG9zaXRvcnkxMDQyMzE1NDE=-flat-layout.h,165,170,5,177,182,5
112,https://htmlpreview.github.io/?https://github.com/Christina96/boilerplate-sample-matches/blob/main/Cpp/snap-MDEwOlJlcG9zaXRvcnk0Mjg4MzU3-flat-table.cpp-snap-MDEwOlJlcG9zaXRvcnk0Mjg4MzU3-flat-table.cpp.html,17,snap-MDEwOlJlcG9zaXRvcnk0Mjg4MzU3-flat-table.cpp,snap-MDEwOlJlcG9zaXRvcnk0Mjg4MzU3-flat-table.cpp,1723,1724,1,1723,1724,1
113,https://htmlpreview.github.io/?https://github.com/Christina96/boilerplate-sample-matches/blob/main/Cpp/snap-MDEwOlJlcG9zaXRvcnk0Mjg4MzU3-flat-localmotifcluster.cpp-snap-MDEwOlJlcG9zaXRvcnk0Mjg4MzU3-flat-localmotifcluster.cpp.html,33,snap-MDEwOlJlcG9zaXRvcnk0Mjg4MzU3-flat-localmotifcluster.cpp,snap-MDEwOlJlcG9zaXRvcnk0Mjg4MzU3-flat-localmotifcluster.cpp,174,182,8,431,439,8
114,https://htmlpreview.github.io/?https://github.com/Christina96/boilerplate-sample-matches/blob/main/Cpp/snap-MDEwOlJlcG9zaXRvcnk0Mjg4MzU3-flat-fa.h-snap-MDEwOlJlcG9zaXRvcnk0Mjg4MzU3-flat-fa.h.html,24,snap-MDEwOlJlcG9zaXRvcnk0Mjg4MzU3-flat-fa.h,snap-MDEwOlJlcG9zaXRvcnk0Mjg4MzU3-flat-fa.h,190,193,3,185,188,3
115,https://htmlpreview.github.io/?https://github.com/Christina96/boilerplate-sample-matches/blob/main/Cpp/abseil-cpp-MDEwOlJlcG9zaXRvcnkxMDQyMzE1NDE=-flat-cord_rep_ring.cc-abseil-cpp-MDEwOlJlcG9zaXRvcnkxMDQyMzE1NDE=-flat-cord_rep_ring.cc.html,58,abseil-cpp-MDEwOlJlcG9zaXRvcnkxMDQyMzE1NDE=-flat-cord_rep_ring.cc,abseil-cpp-MDEwOlJlcG9zaXRvcnkxMDQyMzE1NDE=-flat-cord_rep_ring.cc,522,531,9,498,507,9
116,https://htmlpreview.github.io/?https://github.com/Christina96/boilerplate-sample-matches/blob/main/Cpp/tesseract-MDEwOlJlcG9zaXRvcnkyMjg4NzA5NA==-flat-shapetable_test.cc-tesseract-MDEwOlJlcG9zaXRvcnkyMjg4NzA5NA==-flat-shapetable_test.cc.html,24,tesseract-MDEwOlJlcG9zaXRvcnkyMjg4NzA5NA==-flat-shapetable_test.cc,tesseract-MDEwOlJlcG9zaXRvcnkyMjg4NzA5NA==-flat-shapetable_test.cc,80,82,2,81,83,2
117,https://htmlpreview.github.io/?https://github.com/Christina96/boilerplate-sample-matches/blob/main/Cpp/abseil-cpp-MDEwOlJlcG9zaXRvcnkxMDQyMzE1NDE=-flat-crc_memcpy_x86_64.cc-abseil-cpp-MDEwOlJlcG9zaXRvcnkxMDQyMzE1NDE=-flat-crc_memcpy_x86_64.cc.html,23,abseil-cpp-MDEwOlJlcG9zaXRvcnkxMDQyMzE1NDE=-flat-crc_memcpy_x86_64.cc,abseil-cpp-MDEwOlJlcG9zaXRvcnkxMDQyMzE1NDE=-flat-crc_memcpy_x86_64.cc,240,243,3,212,215,3
118,https://htmlpreview.github.io/?https://github.com/Christina96/boilerplate-sample-matches/blob/main/Cpp/notepad-plus-plus-MDEwOlJlcG9zaXRvcnkzMzAxNDgxMQ==-flat-catch_14.hpp-notepad-plus-plus-MDEwOlJlcG9zaXRvcnkzMzAxNDgxMQ==-flat-catch.hpp.html,41507,notepad-plus-plus-MDEwOlJlcG9zaXRvcnkzMzAxNDgxMQ==-flat-catch_14.hpp,notepad-plus-plus-MDEwOlJlcG9zaXRvcnkzMzAxNDgxMQ==-flat-catch.hpp,7793,13690,5897,7793,13690,5897
119,https://htmlpreview.github.io/?https://github.com/Christina96/boilerplate-sample-matches/blob/main/Cpp/nano-node-MDEwOlJlcG9zaXRvcnkxOTM0NzM0MA==-flat-tcp_server.cpp-nano-node-MDEwOlJlcG9zaXRvcnkxOTM0NzM0MA==-flat-tcp_server.cpp.html,15,nano-node-MDEwOlJlcG9zaXRvcnkxOTM0NzM0MA==-flat-tcp_server.cpp,nano-node-MDEwOlJlcG9zaXRvcnkxOTM0NzM0MA==-flat-tcp_server.cpp,223,225,2,255,257,2
120,https://htmlpreview.github.io/?https://github.com/Christina96/boilerplate-sample-matches/blob/main/Cpp/snap-MDEwOlJlcG9zaXRvcnk0Mjg4MzU3-flat-flx.cpp-snap-MDEwOlJlcG9zaXRvcnk0Mjg4MzU3-flat-flx.cpp.html,44,snap-MDEwOlJlcG9zaXRvcnk0Mjg4MzU3-flat-flx.cpp,snap-MDEwOlJlcG9zaXRvcnk0Mjg4MzU3-flat-flx.cpp,658,664,6,658,664,6
121,https://htmlpreview.github.io/?https://github.com/Christina96/boilerplate-sample-matches/blob/main/Cpp/notepad-plus-plus-MDEwOlJlcG9zaXRvcnkzMzAxNDgxMQ==-flat-Sorters.h-notepad-plus-plus-MDEwOlJlcG9zaXRvcnkzMzAxNDgxMQ==-flat-Sorters.h.html,359,notepad-plus-plus-MDEwOlJlcG9zaXRvcnkzMzAxNDgxMQ==-flat-Sorters.h,notepad-plus-plus-MDEwOlJlcG9zaXRvcnkzMzAxNDgxMQ==-flat-Sorters.h,182,257,75,182,257,75
122,https://htmlpreview.github.io/?https://github.com/Christina96/boilerplate-sample-matches/blob/main/Cpp/notepad-plus-plus-MDEwOlJlcG9zaXRvcnkzMzAxNDgxMQ==-flat-catch.hpp-notepad-plus-plus-MDEwOlJlcG9zaXRvcnkzMzAxNDgxMQ==-flat-catch.hpp.html,50023,notepad-plus-plus-MDEwOlJlcG9zaXRvcnkzMzAxNDgxMQ==-flat-catch.hpp,notepad-plus-plus-MDEwOlJlcG9zaXRvcnkzMzAxNDgxMQ==-flat-catch.hpp,6613,13690,7077,6613,13690,7077
123,https://htmlpreview.github.io/?https://github.com/Christina96/boilerplate-sample-matches/blob/main/Cpp/tesseract-MDEwOlJlcG9zaXRvcnkyMjg4NzA5NA==-flat-elst.h-tesseract-MDEwOlJlcG9zaXRvcnkyMjg4NzA5NA==-flat-clst.h.html,16,tesseract-MDEwOlJlcG9zaXRvcnkyMjg4NzA5NA==-flat-elst.h,tesseract-MDEwOlJlcG9zaXRvcnkyMjg4NzA5NA==-flat-clst.h,77,82,5,78,83,5
124,https://htmlpreview.github.io/?https://github.com/Christina96/boilerplate-sample-matches/blob/main/Cpp/subconverter-MDEwOlJlcG9zaXRvcnkyMTg2ODY3NjM=-flat-inja.hpp-subconverter-MDEwOlJlcG9zaXRvcnkyMTg2ODY3NjM=-flat-inja.hpp.html,14,subconverter-MDEwOlJlcG9zaXRvcnkyMTg2ODY3NjM=-flat-inja.hpp,subconverter-MDEwOlJlcG9zaXRvcnkyMTg2ODY3NjM=-flat-inja.hpp,348,349,1,348,349,1
125,https://htmlpreview.github.io/?https://github.com/Christina96/boilerplate-sample-matches/blob/main/Cpp/snap-MDEwOlJlcG9zaXRvcnk0Mjg4MzU3-flat-demo-alg.cpp-snap-MDEwOlJlcG9zaXRvcnk0Mjg4MzU3-flat-demo-alg.cpp.html,16,snap-MDEwOlJlcG9zaXRvcnk0Mjg4MzU3-flat-demo-alg.cpp,snap-MDEwOlJlcG9zaXRvcnk0Mjg4MzU3-flat-demo-alg.cpp,121,123,2,103,105,2
126,https://htmlpreview.github.io/?https://github.com/Christina96/boilerplate-sample-matches/blob/main/Cpp/abseil-cpp-MDEwOlJlcG9zaXRvcnkxMDQyMzE1NDE=-flat-cord.h-snap-MDEwOlJlcG9zaXRvcnk0Mjg4MzU3-flat-memes.cpp.html,15,abseil-cpp-MDEwOlJlcG9zaXRvcnkxMDQyMzE1NDE=-flat-cord.h,snap-MDEwOlJlcG9zaXRvcnk0Mjg4MzU3-flat-memes.cpp,492,493,1,2008,2009,1
127,https://htmlpreview.github.io/?https://github.com/Christina96/boilerplate-sample-matches/blob/main/Cpp/abseil-cpp-MDEwOlJlcG9zaXRvcnkxMDQyMzE1NDE=-flat-cordz_info_test.cc-abseil-cpp-MDEwOlJlcG9zaXRvcnkxMDQyMzE1NDE=-flat-cordz_info_test.cc.html,17,abseil-cpp-MDEwOlJlcG9zaXRvcnkxMDQyMzE1NDE=-flat-cordz_info_test.cc,abseil-cpp-MDEwOlJlcG9zaXRvcnkxMDQyMzE1NDE=-flat-cordz_info_test.cc,33,34,1,33,34,1
128,https://htmlpreview.github.io/?https://github.com/Christina96/boilerplate-sample-matches/blob/main/Cpp/abseil-cpp-MDEwOlJlcG9zaXRvcnkxMDQyMzE1NDE=-flat-btree_test.cc-abseil-cpp-MDEwOlJlcG9zaXRvcnkxMDQyMzE1NDE=-flat-btree_test.cc.html,24,abseil-cpp-MDEwOlJlcG9zaXRvcnkxMDQyMzE1NDE=-flat-btree_test.cc,abseil-cpp-MDEwOlJlcG9zaXRvcnkxMDQyMzE1NDE=-flat-btree_test.cc,309,312,3,347,350,3
129,https://htmlpreview.github.io/?https://github.com/Christina96/boilerplate-sample-matches/blob/main/Cpp/abseil-cpp-MDEwOlJlcG9zaXRvcnkxMDQyMzE1NDE=-flat-distribution_caller.h-abseil-cpp-MDEwOlJlcG9zaXRvcnkxMDQyMzE1NDE=-flat-distribution_caller.h.html,15,abseil-cpp-MDEwOlJlcG9zaXRvcnkxMDQyMzE1NDE=-flat-distribution_caller.h,abseil-cpp-MDEwOlJlcG9zaXRvcnkxMDQyMzE1NDE=-flat-distribution_caller.h,24,25,1,24,25,1
130,https://htmlpreview.github.io/?https://github.com/Christina96/boilerplate-sample-matches/blob/main/Cpp/snap-MDEwOlJlcG9zaXRvcnk0Mjg4MzU3-flat-flx.h-snap-MDEwOlJlcG9zaXRvcnk0Mjg4MzU3-flat-fl.h.html,18,snap-MDEwOlJlcG9zaXRvcnk0Mjg4MzU3-flat-flx.h,snap-MDEwOlJlcG9zaXRvcnk0Mjg4MzU3-flat-fl.h,120,122,2,122,124,2
131,https://htmlpreview.github.io/?https://github.com/Christina96/boilerplate-sample-matches/blob/main/Cpp/abseil-cpp-MDEwOlJlcG9zaXRvcnkxMDQyMzE1NDE=-flat-scoped_mock_log_test.cc-abseil-cpp-MDEwOlJlcG9zaXRvcnkxMDQyMzE1NDE=-flat-scoped_mock_log_test.cc.html,15,abseil-cpp-MDEwOlJlcG9zaXRvcnkxMDQyMzE1NDE=-flat-scoped_mock_log_test.cc,abseil-cpp-MDEwOlJlcG9zaXRvcnkxMDQyMzE1NDE=-flat-scoped_mock_log_test.cc,156,159,3,184,187,3
132,https://htmlpreview.github.io/?https://github.com/Christina96/boilerplate-sample-matches/blob/main/Cpp/notepad-plus-plus-MDEwOlJlcG9zaXRvcnkzMzAxNDgxMQ==-flat-Parameters.cpp-notepad-plus-plus-MDEwOlJlcG9zaXRvcnkzMzAxNDgxMQ==-flat-Parameters.cpp.html,14,notepad-plus-plus-MDEwOlJlcG9zaXRvcnkzMzAxNDgxMQ==-flat-Parameters.cpp,notepad-plus-plus-MDEwOlJlcG9zaXRvcnkzMzAxNDgxMQ==-flat-Parameters.cpp,6686,6687,1,6697,6698,1
133,https://htmlpreview.github.io/?https://github.com/Christina96/boilerplate-sample-matches/blob/main/Cpp/abseil-cpp-MDEwOlJlcG9zaXRvcnkxMDQyMzE1NDE=-flat-time.cc-abseil-cpp-MDEwOlJlcG9zaXRvcnkxMDQyMzE1NDE=-flat-time.cc.html,14,abseil-cpp-MDEwOlJlcG9zaXRvcnkxMDQyMzE1NDE=-flat-time.cc,abseil-cpp-MDEwOlJlcG9zaXRvcnkxMDQyMzE1NDE=-flat-time.cc,115,117,2,174,176,2
134,https://htmlpreview.github.io/?https://github.com/Christina96/boilerplate-sample-matches/blob/main/Cpp/snap-MDEwOlJlcG9zaXRvcnk0Mjg4MzU3-flat-webold.cpp-snap-MDEwOlJlcG9zaXRvcnk0Mjg4MzU3-flat-test-THash.cpp.html,15,snap-MDEwOlJlcG9zaXRvcnk0Mjg4MzU3-flat-webold.cpp,snap-MDEwOlJlcG9zaXRvcnk0Mjg4MzU3-flat-test-THash.cpp,55,60,5,204,209,5
135,https://htmlpreview.github.io/?https://github.com/Christina96/boilerplate-sample-matches/blob/main/Cpp/snap-MDEwOlJlcG9zaXRvcnk0Mjg4MzU3-flat-yahoobs.cpp-snap-MDEwOlJlcG9zaXRvcnk0Mjg4MzU3-flat-yahoobs.cpp.html,16,snap-MDEwOlJlcG9zaXRvcnk0Mjg4MzU3-flat-yahoobs.cpp,snap-MDEwOlJlcG9zaXRvcnk0Mjg4MzU3-flat-yahoobs.cpp,3,4,1,3,4,1
136,https://htmlpreview.github.io/?https://github.com/Christina96/boilerplate-sample-matches/blob/main/Cpp/nano-node-MDEwOlJlcG9zaXRvcnkxOTM0NzM0MA==-flat-cl2.hpp-nano-node-MDEwOlJlcG9zaXRvcnkxOTM0NzM0MA==-flat-cl.hpp.html,72,nano-node-MDEwOlJlcG9zaXRvcnkxOTM0NzM0MA==-flat-cl2.hpp,nano-node-MDEwOlJlcG9zaXRvcnkxOTM0NzM0MA==-flat-cl.hpp,3022,3044,22,2714,2736,22
137,https://htmlpreview.github.io/?https://github.com/Christina96/boilerplate-sample-matches/blob/main/Cpp/notepad-plus-plus-MDEwOlJlcG9zaXRvcnkzMzAxNDgxMQ==-flat-PositionCache.cxx-notepad-plus-plus-MDEwOlJlcG9zaXRvcnkzMzAxNDgxMQ==-flat-PositionCache.cxx.html,14,notepad-plus-plus-MDEwOlJlcG9zaXRvcnkzMzAxNDgxMQ==-flat-PositionCache.cxx,notepad-plus-plus-MDEwOlJlcG9zaXRvcnkzMzAxNDgxMQ==-flat-PositionCache.cxx,502,504,2,430,432,2
138,https://htmlpreview.github.io/?https://github.com/Christina96/boilerplate-sample-matches/blob/main/Cpp/snap-MDEwOlJlcG9zaXRvcnk0Mjg4MzU3-flat-xml.cpp-snap-MDEwOlJlcG9zaXRvcnk0Mjg4MzU3-flat-xml.cpp.html,23,snap-MDEwOlJlcG9zaXRvcnk0Mjg4MzU3-flat-xml.cpp,snap-MDEwOlJlcG9zaXRvcnk0Mjg4MzU3-flat-xml.cpp,808,810,2,808,810,2
139,https://htmlpreview.github.io/?https://github.com/Christina96/boilerplate-sample-matches/blob/main/Cpp/notepad-plus-plus-MDEwOlJlcG9zaXRvcnkzMzAxNDgxMQ==-flat-catch_14.hpp-notepad-plus-plus-MDEwOlJlcG9zaXRvcnkzMzAxNDgxMQ==-flat-catch.hpp.html,19,notepad-plus-plus-MDEwOlJlcG9zaXRvcnkzMzAxNDgxMQ==-flat-catch_14.hpp,notepad-plus-plus-MDEwOlJlcG9zaXRvcnkzMzAxNDgxMQ==-flat-catch.hpp,11997,12000,3,12009,12012,3
140,https://htmlpreview.github.io/?https://github.com/Christina96/boilerplate-sample-matches/blob/main/Cpp/notepad-plus-plus-MDEwOlJlcG9zaXRvcnkzMzAxNDgxMQ==-flat-LexPerl.cxx-notepad-plus-plus-MDEwOlJlcG9zaXRvcnkzMzAxNDgxMQ==-flat-LexEScript.cxx.html,22,notepad-plus-plus-MDEwOlJlcG9zaXRvcnkzMzAxNDgxMQ==-flat-LexPerl.cxx,notepad-plus-plus-MDEwOlJlcG9zaXRvcnkzMzAxNDgxMQ==-flat-LexEScript.cxx,1422,1425,3,135,138,3
141,https://htmlpreview.github.io/?https://github.com/Christina96/boilerplate-sample-matches/blob/main/Cpp/tesseract-MDEwOlJlcG9zaXRvcnkyMjg4NzA5NA==-flat-paragraphs.cpp-tesseract-MDEwOlJlcG9zaXRvcnkyMjg4NzA5NA==-flat-paragraphs.cpp.html,16,tesseract-MDEwOlJlcG9zaXRvcnkyMjg4NzA5NA==-flat-paragraphs.cpp,tesseract-MDEwOlJlcG9zaXRvcnkyMjg4NzA5NA==-flat-paragraphs.cpp,693,694,1,695,697,2
142,https://htmlpreview.github.io/?https://github.com/Christina96/boilerplate-sample-matches/blob/main/Cpp/snap-MDEwOlJlcG9zaXRvcnk0Mjg4MzU3-flat-delete-exp.cpp-snap-MDEwOlJlcG9zaXRvcnk0Mjg4MzU3-flat-delete-exp.cpp.html,14,snap-MDEwOlJlcG9zaXRvcnk0Mjg4MzU3-flat-delete-exp.cpp,snap-MDEwOlJlcG9zaXRvcnk0Mjg4MzU3-flat-delete-exp.cpp,7,9,2,7,9,2
143,https://htmlpreview.github.io/?https://github.com/Christina96/boilerplate-sample-matches/blob/main/Cpp/tesseract-MDEwOlJlcG9zaXRvcnkyMjg4NzA5NA==-flat-validator_test.cc-tesseract-MDEwOlJlcG9zaXRvcnkyMjg4NzA5NA==-flat-validator_test.cc.html,16,tesseract-MDEwOlJlcG9zaXRvcnkyMjg4NzA5NA==-flat-validator_test.cc,tesseract-MDEwOlJlcG9zaXRvcnkyMjg4NzA5NA==-flat-validator_test.cc,20,21,1,16,17,1
144,https://htmlpreview.github.io/?https://github.com/Christina96/boilerplate-sample-matches/blob/main/Cpp/snap-MDEwOlJlcG9zaXRvcnk0Mjg4MzU3-flat-ConvBenchmarkMP.cpp-snap-MDEwOlJlcG9zaXRvcnk0Mjg4MzU3-flat-ConvBenchmark.cpp.html,469,snap-MDEwOlJlcG9zaXRvcnk0Mjg4MzU3-flat-ConvBenchmarkMP.cpp,snap-MDEwOlJlcG9zaXRvcnk0Mjg4MzU3-flat-ConvBenchmark.cpp,14,69,55,14,69,55
145,https://htmlpreview.github.io/?https://github.com/Christina96/boilerplate-sample-matches/blob/main/Cpp/snap-MDEwOlJlcG9zaXRvcnk0Mjg4MzU3-flat-googlex.h-snap-MDEwOlJlcG9zaXRvcnk0Mjg4MzU3-flat-googlex.h.html,203,snap-MDEwOlJlcG9zaXRvcnk0Mjg4MzU3-flat-googlex.h,snap-MDEwOlJlcG9zaXRvcnk0Mjg4MzU3-flat-googlex.h,218,247,29,218,247,29
146,https://htmlpreview.github.io/?https://github.com/Christina96/boilerplate-sample-matches/blob/main/Cpp/nano-node-MDEwOlJlcG9zaXRvcnkxOTM0NzM0MA==-flat-cl2.hpp-nano-node-MDEwOlJlcG9zaXRvcnkxOTM0NzM0MA==-flat-cl.hpp.html,48,nano-node-MDEwOlJlcG9zaXRvcnkxOTM0NzM0MA==-flat-cl2.hpp,nano-node-MDEwOlJlcG9zaXRvcnkxOTM0NzM0MA==-flat-cl.hpp,1310,1317,7,1440,1447,7
147,https://htmlpreview.github.io/?https://github.com/Christina96/boilerplate-sample-matches/blob/main/Cpp/notepad-plus-plus-MDEwOlJlcG9zaXRvcnkzMzAxNDgxMQ==-flat-PlatWin.cxx-notepad-plus-plus-MDEwOlJlcG9zaXRvcnkzMzAxNDgxMQ==-flat-PlatWin.cxx.html,16,notepad-plus-plus-MDEwOlJlcG9zaXRvcnkzMzAxNDgxMQ==-flat-PlatWin.cxx,notepad-plus-plus-MDEwOlJlcG9zaXRvcnkzMzAxNDgxMQ==-flat-PlatWin.cxx,1385,1387,2,621,623,2
148,https://htmlpreview.github.io/?https://github.com/Christina96/boilerplate-sample-matches/blob/main/Cpp/nano-node-MDEwOlJlcG9zaXRvcnkxOTM0NzM0MA==-flat-qt.cpp-nano-node-MDEwOlJlcG9zaXRvcnkxOTM0NzM0MA==-flat-qt.cpp.html,25,nano-node-MDEwOlJlcG9zaXRvcnkxOTM0NzM0MA==-flat-qt.cpp,nano-node-MDEwOlJlcG9zaXRvcnkxOTM0NzM0MA==-flat-qt.cpp,2245,2253,8,2408,2416,8
149,https://htmlpreview.github.io/?https://github.com/Christina96/boilerplate-sample-matches/blob/main/Cpp/notepad-plus-plus-MDEwOlJlcG9zaXRvcnkzMzAxNDgxMQ==-flat-CustomFileDialog.cpp-notepad-plus-plus-MDEwOlJlcG9zaXRvcnkzMzAxNDgxMQ==-flat-CustomFileDialog.cpp.html,34,notepad-plus-plus-MDEwOlJlcG9zaXRvcnkzMzAxNDgxMQ==-flat-CustomFileDialog.cpp,notepad-plus-plus-MDEwOlJlcG9zaXRvcnkzMzAxNDgxMQ==-flat-CustomFileDialog.cpp,195,204,9,206,215,9
150,https://htmlpreview.github.io/?https://github.com/Christina96/boilerplate-sample-matches/blob/main/Cpp/notepad-plus-plus-MDEwOlJlcG9zaXRvcnkzMzAxNDgxMQ==-flat-Editor.cxx-notepad-plus-plus-MDEwOlJlcG9zaXRvcnkzMzAxNDgxMQ==-flat-Editor.cxx.html,33,notepad-plus-plus-MDEwOlJlcG9zaXRvcnkzMzAxNDgxMQ==-flat-Editor.cxx,notepad-plus-plus-MDEwOlJlcG9zaXRvcnkzMzAxNDgxMQ==-flat-Editor.cxx,473,475,2,471,472,1
151,https://htmlpreview.github.io/?https://github.com/Christina96/boilerplate-sample-matches/blob/main/Cpp/caffe-MDEwOlJlcG9zaXRvcnk2MTg3MDgwMw==-flat-sgd_solver.cpp-caffe-MDEwOlJlcG9zaXRvcnk2MTg3MDgwMw==-flat-sgd_solver.cpp.html,20,caffe-MDEwOlJlcG9zaXRvcnk2MTg3MDgwMw==-flat-sgd_solver.cpp,caffe-MDEwOlJlcG9zaXRvcnk2MTg3MDgwMw==-flat-sgd_solver.cpp,203,204,1,206,207,1
152,https://htmlpreview.github.io/?https://github.com/Christina96/boilerplate-sample-matches/blob/main/Cpp/nano-node-MDEwOlJlcG9zaXRvcnkxOTM0NzM0MA==-flat-cl2.hpp-nano-node-MDEwOlJlcG9zaXRvcnkxOTM0NzM0MA==-flat-cl.hpp.html,151,nano-node-MDEwOlJlcG9zaXRvcnkxOTM0NzM0MA==-flat-cl2.hpp,nano-node-MDEwOlJlcG9zaXRvcnkxOTM0NzM0MA==-flat-cl.hpp,5093,5119,26,4266,4292,26
153,https://htmlpreview.github.io/?https://github.com/Christina96/boilerplate-sample-matches/blob/main/Cpp/snap-MDEwOlJlcG9zaXRvcnk0Mjg4MzU3-flat-memes.cpp-snap-MDEwOlJlcG9zaXRvcnk0Mjg4MzU3-flat-memes.cpp.html,16,snap-MDEwOlJlcG9zaXRvcnk0Mjg4MzU3-flat-memes.cpp,snap-MDEwOlJlcG9zaXRvcnk0Mjg4MzU3-flat-memes.cpp,1743,1746,3,1743,1746,3
154,https://htmlpreview.github.io/?https://github.com/Christina96/boilerplate-sample-matches/blob/main/Cpp/glm-MDEwOlJlcG9zaXRvcnk4NDM2MzE=-flat-core_type_vec2.cpp-glm-MDEwOlJlcG9zaXRvcnk4NDM2MzE=-flat-core_type_vec2.cpp.html,19,glm-MDEwOlJlcG9zaXRvcnk4NDM2MzE=-flat-core_type_vec2.cpp,glm-MDEwOlJlcG9zaXRvcnk4NDM2MzE=-flat-core_type_vec2.cpp,79,80,1,79,80,1
155,https://htmlpreview.github.io/?https://github.com/Christina96/boilerplate-sample-matches/blob/main/Cpp/caffe-MDEwOlJlcG9zaXRvcnk2MTg3MDgwMw==-flat-gabor.hpp-caffe-MDEwOlJlcG9zaXRvcnk2MTg3MDgwMw==-flat-gabor.hpp.html,17,caffe-MDEwOlJlcG9zaXRvcnk2MTg3MDgwMw==-flat-gabor.hpp,caffe-MDEwOlJlcG9zaXRvcnk2MTg3MDgwMw==-flat-gabor.hpp,72,74,2,141,143,2
156,https://htmlpreview.github.io/?https://github.com/Christina96/boilerplate-sample-matches/blob/main/Cpp/abseil-cpp-MDEwOlJlcG9zaXRvcnkxMDQyMzE1NDE=-flat-cord_rep_btree_test.cc-abseil-cpp-MDEwOlJlcG9zaXRvcnkxMDQyMzE1NDE=-flat-cord_ring_test.cc.html,93,abseil-cpp-MDEwOlJlcG9zaXRvcnkxMDQyMzE1NDE=-flat-cord_rep_btree_test.cc,abseil-cpp-MDEwOlJlcG9zaXRvcnkxMDQyMzE1NDE=-flat-cord_ring_test.cc,824,832,8,1202,1210,8
157,https://htmlpreview.github.io/?https://github.com/Christina96/boilerplate-sample-matches/blob/main/Cpp/caffe-MDEwOlJlcG9zaXRvcnk2MTg3MDgwMw==-flat-test_rnn_layer.cpp-caffe-MDEwOlJlcG9zaXRvcnk2MTg3MDgwMw==-flat-test_rnn_layer.cpp.html,24,caffe-MDEwOlJlcG9zaXRvcnk2MTg3MDgwMw==-flat-test_rnn_layer.cpp,caffe-MDEwOlJlcG9zaXRvcnk2MTg3MDgwMw==-flat-test_rnn_layer.cpp,22,25,3,26,29,3
158,https://htmlpreview.github.io/?https://github.com/Christina96/boilerplate-sample-matches/blob/main/Cpp/notepad-plus-plus-MDEwOlJlcG9zaXRvcnkzMzAxNDgxMQ==-flat-catch_14.hpp-notepad-plus-plus-MDEwOlJlcG9zaXRvcnkzMzAxNDgxMQ==-flat-catch.hpp.html,87016,notepad-plus-plus-MDEwOlJlcG9zaXRvcnkzMzAxNDgxMQ==-flat-catch_14.hpp,notepad-plus-plus-MDEwOlJlcG9zaXRvcnkzMzAxNDgxMQ==-flat-catch.hpp,1354,13690,12336,1354,13690,12336
159,https://htmlpreview.github.io/?https://github.com/Christina96/boilerplate-sample-matches/blob/main/Cpp/abseil-cpp-MDEwOlJlcG9zaXRvcnkxMDQyMzE1NDE=-flat-str_split.h-abseil-cpp-MDEwOlJlcG9zaXRvcnkxMDQyMzE1NDE=-flat-str_split.h.html,24,abseil-cpp-MDEwOlJlcG9zaXRvcnkxMDQyMzE1NDE=-flat-str_split.h,abseil-cpp-MDEwOlJlcG9zaXRvcnkxMDQyMzE1NDE=-flat-str_split.h,143,146,3,120,123,3
160,https://htmlpreview.github.io/?https://github.com/Christina96/boilerplate-sample-matches/blob/main/Cpp/snap-MDEwOlJlcG9zaXRvcnk0Mjg4MzU3-flat-conv.h-snap-MDEwOlJlcG9zaXRvcnk0Mjg4MzU3-flat-conv.h.html,15,snap-MDEwOlJlcG9zaXRvcnk0Mjg4MzU3-flat-conv.h,snap-MDEwOlJlcG9zaXRvcnk0Mjg4MzU3-flat-conv.h,1626,1627,1,36,37,1
161,https://htmlpreview.github.io/?https://github.com/Christina96/boilerplate-sample-matches/blob/main/Cpp/notepad-plus-plus-MDEwOlJlcG9zaXRvcnkzMzAxNDgxMQ==-flat-NppNotification.cpp-notepad-plus-plus-MDEwOlJlcG9zaXRvcnkzMzAxNDgxMQ==-flat-NppNotification.cpp.html,25,notepad-plus-plus-MDEwOlJlcG9zaXRvcnkzMzAxNDgxMQ==-flat-NppNotification.cpp,notepad-plus-plus-MDEwOlJlcG9zaXRvcnkzMzAxNDgxMQ==-flat-NppNotification.cpp,515,518,3,515,518,3
162,https://htmlpreview.github.io/?https://github.com/Christina96/boilerplate-sample-matches/blob/main/Cpp/notepad-plus-plus-MDEwOlJlcG9zaXRvcnkzMzAxNDgxMQ==-flat-catch_14.hpp-notepad-plus-plus-MDEwOlJlcG9zaXRvcnkzMzAxNDgxMQ==-flat-catch_14.hpp.html,72190,notepad-plus-plus-MDEwOlJlcG9zaXRvcnkzMzAxNDgxMQ==-flat-catch_14.hpp,notepad-plus-plus-MDEwOlJlcG9zaXRvcnkzMzAxNDgxMQ==-flat-catch_14.hpp,3436,13690,10254,3436,13690,10254
163,https://htmlpreview.github.io/?https://github.com/Christina96/boilerplate-sample-matches/blob/main/Cpp/abseil-cpp-MDEwOlJlcG9zaXRvcnkxMDQyMzE1NDE=-flat-btree.h-abseil-cpp-MDEwOlJlcG9zaXRvcnkxMDQyMzE1NDE=-flat-btree.h.html,187,abseil-cpp-MDEwOlJlcG9zaXRvcnkxMDQyMzE1NDE=-flat-btree.h,abseil-cpp-MDEwOlJlcG9zaXRvcnkxMDQyMzE1NDE=-flat-btree.h,76,92,16,50,66,16
164,https://htmlpreview.github.io/?https://github.com/Christina96/boilerplate-sample-matches/blob/main/Cpp/snap-MDEwOlJlcG9zaXRvcnk0Mjg4MzU3-flat-bowflx.cpp-snap-MDEwOlJlcG9zaXRvcnk0Mjg4MzU3-flat-bowflx.cpp.html,918,snap-MDEwOlJlcG9zaXRvcnk0Mjg4MzU3-flat-bowflx.cpp,snap-MDEwOlJlcG9zaXRvcnk0Mjg4MzU3-flat-bowflx.cpp,113,206,93,113,206,93
165,https://htmlpreview.github.io/?https://github.com/Christina96/boilerplate-sample-matches/blob/main/Cpp/notepad-plus-plus-MDEwOlJlcG9zaXRvcnkzMzAxNDgxMQ==-flat-LexPython.cxx-notepad-plus-plus-MDEwOlJlcG9zaXRvcnkzMzAxNDgxMQ==-flat-LexGDScript.cxx.html,138,notepad-plus-plus-MDEwOlJlcG9zaXRvcnkzMzAxNDgxMQ==-flat-LexPython.cxx,notepad-plus-plus-MDEwOlJlcG9zaXRvcnkzMzAxNDgxMQ==-flat-LexGDScript.cxx,504,516,12,365,377,12
166,https://htmlpreview.github.io/?https://github.com/Christina96/boilerplate-sample-matches/blob/main/Cpp/nano-node-MDEwOlJlcG9zaXRvcnkxOTM0NzM0MA==-flat-blocks.cpp-nano-node-MDEwOlJlcG9zaXRvcnkxOTM0NzM0MA==-flat-blocks.cpp.html,49,nano-node-MDEwOlJlcG9zaXRvcnkxOTM0NzM0MA==-flat-blocks.cpp,nano-node-MDEwOlJlcG9zaXRvcnkxOTM0NzM0MA==-flat-blocks.cpp,1320,1326,6,1320,1326,6
167,https://htmlpreview.github.io/?https://github.com/Christina96/boilerplate-sample-matches/blob/main/Cpp/caffe-MDEwOlJlcG9zaXRvcnk2MTg3MDgwMw==-flat-bbox_util.cpp-caffe-MDEwOlJlcG9zaXRvcnk2MTg3MDgwMw==-flat-bbox_util.cpp.html,16,caffe-MDEwOlJlcG9zaXRvcnk2MTg3MDgwMw==-flat-bbox_util.cpp,caffe-MDEwOlJlcG9zaXRvcnk2MTg3MDgwMw==-flat-bbox_util.cpp,577,578,1,576,577,1
168,https://htmlpreview.github.io/?https://github.com/Christina96/boilerplate-sample-matches/blob/main/Cpp/snap-MDEwOlJlcG9zaXRvcnk0Mjg4MzU3-flat-mmgraph-exp.h-snap-MDEwOlJlcG9zaXRvcnk0Mjg4MzU3-flat-mmgraph-exp.h.html,46,snap-MDEwOlJlcG9zaXRvcnk0Mjg4MzU3-flat-mmgraph-exp.h,snap-MDEwOlJlcG9zaXRvcnk0Mjg4MzU3-flat-mmgraph-exp.h,55,60,5,45,50,5
169,https://htmlpreview.github.io/?https://github.com/Christina96/boilerplate-sample-matches/blob/main/Cpp/snap-MDEwOlJlcG9zaXRvcnk0Mjg4MzU3-flat-dzs.cpp-snap-MDEwOlJlcG9zaXRvcnk0Mjg4MzU3-flat-svmmodels.cpp.html,15,snap-MDEwOlJlcG9zaXRvcnk0Mjg4MzU3-flat-dzs.cpp,snap-MDEwOlJlcG9zaXRvcnk0Mjg4MzU3-flat-svmmodels.cpp,61,63,2,1003,1004,1
170,https://htmlpreview.github.io/?https://github.com/Christina96/boilerplate-sample-matches/blob/main/Cpp/caffe-MDEwOlJlcG9zaXRvcnk2MTg3MDgwMw==-flat-net.cpp-tesseract-MDEwOlJlcG9zaXRvcnkyMjg4NzA5NA==-flat-combine_tessdata.cpp.html,16,caffe-MDEwOlJlcG9zaXRvcnk2MTg3MDgwMw==-flat-net.cpp,tesseract-MDEwOlJlcG9zaXRvcnkyMjg4NzA5NA==-flat-combine_tessdata.cpp,1190,1192,2,30,32,2
171,https://htmlpreview.github.io/?https://github.com/Christina96/boilerplate-sample-matches/blob/main/Cpp/glm-MDEwOlJlcG9zaXRvcnk4NDM2MzE=-flat-glm_core.cpp-glm-MDEwOlJlcG9zaXRvcnk4NDM2MzE=-flat-glm_core.cpp.html,69,glm-MDEwOlJlcG9zaXRvcnk4NDM2MzE=-flat-glm_core.cpp,glm-MDEwOlJlcG9zaXRvcnk4NDM2MzE=-flat-glm_core.cpp,83,92,9,19,28,9
172,https://htmlpreview.github.io/?https://github.com/Christina96/boilerplate-sample-matches/blob/main/Cpp/notepad-plus-plus-MDEwOlJlcG9zaXRvcnkzMzAxNDgxMQ==-flat-catch_14.hpp-notepad-plus-plus-MDEwOlJlcG9zaXRvcnkzMzAxNDgxMQ==-flat-catch_14.hpp.html,65672,notepad-plus-plus-MDEwOlJlcG9zaXRvcnkzMzAxNDgxMQ==-flat-catch_14.hpp,notepad-plus-plus-MDEwOlJlcG9zaXRvcnkzMzAxNDgxMQ==-flat-catch_14.hpp,4443,13690,9247,4443,13690,9247
173,https://htmlpreview.github.io/?https://github.com/Christina96/boilerplate-sample-matches/blob/main/Cpp/notepad-plus-plus-MDEwOlJlcG9zaXRvcnkzMzAxNDgxMQ==-flat-regExtDlg.cpp-notepad-plus-plus-MDEwOlJlcG9zaXRvcnkzMzAxNDgxMQ==-flat-VerticalFileSwitcher.cpp.html,16,notepad-plus-plus-MDEwOlJlcG9zaXRvcnkzMzAxNDgxMQ==-flat-regExtDlg.cpp,notepad-plus-plus-MDEwOlJlcG9zaXRvcnkzMzAxNDgxMQ==-flat-VerticalFileSwitcher.cpp,141,144,3,263,266,3
174,https://htmlpreview.github.io/?https://github.com/Christina96/boilerplate-sample-matches/blob/main/Cpp/notepad-plus-plus-MDEwOlJlcG9zaXRvcnkzMzAxNDgxMQ==-flat-LexErlang.cxx-notepad-plus-plus-MDEwOlJlcG9zaXRvcnkzMzAxNDgxMQ==-flat-LexErlang.cxx.html,54,notepad-plus-plus-MDEwOlJlcG9zaXRvcnkzMzAxNDgxMQ==-flat-LexErlang.cxx,notepad-plus-plus-MDEwOlJlcG9zaXRvcnkzMzAxNDgxMQ==-flat-LexErlang.cxx,81,91,10,91,101,10
175,https://htmlpreview.github.io/?https://github.com/Christina96/boilerplate-sample-matches/blob/main/Cpp/nano-node-MDEwOlJlcG9zaXRvcnkxOTM0NzM0MA==-flat-node_6.cpp-nano-node-MDEwOlJlcG9zaXRvcnkxOTM0NzM0MA==-flat-node_6.cpp.html,25,nano-node-MDEwOlJlcG9zaXRvcnkxOTM0NzM0MA==-flat-node_6.cpp,nano-node-MDEwOlJlcG9zaXRvcnkxOTM0NzM0MA==-flat-node_6.cpp,85,86,1,85,86,1
176,https://htmlpreview.github.io/?https://github.com/Christina96/boilerplate-sample-matches/blob/main/Cpp/notepad-plus-plus-MDEwOlJlcG9zaXRvcnkzMzAxNDgxMQ==-flat-Parameters.cpp-notepad-plus-plus-MDEwOlJlcG9zaXRvcnkzMzAxNDgxMQ==-flat-Parameters.cpp.html,17,notepad-plus-plus-MDEwOlJlcG9zaXRvcnkzMzAxNDgxMQ==-flat-Parameters.cpp,notepad-plus-plus-MDEwOlJlcG9zaXRvcnkzMzAxNDgxMQ==-flat-Parameters.cpp,2397,2399,2,2397,2399,2
177,https://htmlpreview.github.io/?https://github.com/Christina96/boilerplate-sample-matches/blob/main/Cpp/tesseract-MDEwOlJlcG9zaXRvcnkyMjg4NzA5NA==-flat-normmatch.cpp-tesseract-MDEwOlJlcG9zaXRvcnkyMjg4NzA5NA==-flat-cutoffs.cpp.html,15,tesseract-MDEwOlJlcG9zaXRvcnkyMjg4NzA5NA==-flat-normmatch.cpp,tesseract-MDEwOlJlcG9zaXRvcnkyMjg4NzA5NA==-flat-cutoffs.cpp,107,109,2,27,29,2
178,https://htmlpreview.github.io/?https://github.com/Christina96/boilerplate-sample-matches/blob/main/Cpp/notepad-plus-plus-MDEwOlJlcG9zaXRvcnkzMzAxNDgxMQ==-flat-Editor.cxx-notepad-plus-plus-MDEwOlJlcG9zaXRvcnkzMzAxNDgxMQ==-flat-Editor.cxx.html,24,notepad-plus-plus-MDEwOlJlcG9zaXRvcnkzMzAxNDgxMQ==-flat-Editor.cxx,notepad-plus-plus-MDEwOlJlcG9zaXRvcnkzMzAxNDgxMQ==-flat-Editor.cxx,4203,4205,2,3885,3887,2
179,https://htmlpreview.github.io/?https://github.com/Christina96/boilerplate-sample-matches/blob/main/Cpp/snap-MDEwOlJlcG9zaXRvcnk0Mjg4MzU3-flat-test-bfsdfs.cpp-snap-MDEwOlJlcG9zaXRvcnk0Mjg4MzU3-flat-test-bfsdfs.cpp.html,97,snap-MDEwOlJlcG9zaXRvcnk0Mjg4MzU3-flat-test-bfsdfs.cpp,snap-MDEwOlJlcG9zaXRvcnk0Mjg4MzU3-flat-test-bfsdfs.cpp,195,207,12,195,207,12
180,https://htmlpreview.github.io/?https://github.com/Christina96/boilerplate-sample-matches/blob/main/Cpp/notepad-plus-plus-MDEwOlJlcG9zaXRvcnkzMzAxNDgxMQ==-flat-catch_14.hpp-notepad-plus-plus-MDEwOlJlcG9zaXRvcnkzMzAxNDgxMQ==-flat-catch_14.hpp.html,61353,notepad-plus-plus-MDEwOlJlcG9zaXRvcnkzMzAxNDgxMQ==-flat-catch_14.hpp,notepad-plus-plus-MDEwOlJlcG9zaXRvcnkzMzAxNDgxMQ==-flat-catch_14.hpp,5070,13690,8620,5070,13690,8620
181,https://htmlpreview.github.io/?https://github.com/Christina96/boilerplate-sample-matches/blob/main/Cpp/abseil-cpp-MDEwOlJlcG9zaXRvcnkxMDQyMzE1NDE=-flat-string_view_test.cc-abseil-cpp-MDEwOlJlcG9zaXRvcnkxMDQyMzE1NDE=-flat-string_view_test.cc.html,39,abseil-cpp-MDEwOlJlcG9zaXRvcnkxMDQyMzE1NDE=-flat-string_view_test.cc,abseil-cpp-MDEwOlJlcG9zaXRvcnkxMDQyMzE1NDE=-flat-string_view_test.cc,952,955,3,950,953,3
182,https://htmlpreview.github.io/?https://github.com/Christina96/boilerplate-sample-matches/blob/main/Cpp/notepad-plus-plus-MDEwOlJlcG9zaXRvcnkzMzAxNDgxMQ==-flat-LexPerl.cxx-notepad-plus-plus-MDEwOlJlcG9zaXRvcnkzMzAxNDgxMQ==-flat-LexPerl.cxx.html,24,notepad-plus-plus-MDEwOlJlcG9zaXRvcnkzMzAxNDgxMQ==-flat-LexPerl.cxx,notepad-plus-plus-MDEwOlJlcG9zaXRvcnkzMzAxNDgxMQ==-flat-LexPerl.cxx,1190,1193,3,1190,1193,3
183,https://htmlpreview.github.io/?https://github.com/Christina96/boilerplate-sample-matches/blob/main/Cpp/snap-MDEwOlJlcG9zaXRvcnk0Mjg4MzU3-flat-cascades.cpp-snap-MDEwOlJlcG9zaXRvcnk0Mjg4MzU3-flat-cascades.cpp.html,61,snap-MDEwOlJlcG9zaXRvcnk0Mjg4MzU3-flat-cascades.cpp,snap-MDEwOlJlcG9zaXRvcnk0Mjg4MzU3-flat-cascades.cpp,207,213,6,207,213,6
184,https://htmlpreview.github.io/?https://github.com/Christina96/boilerplate-sample-matches/blob/main/Cpp/nano-node-MDEwOlJlcG9zaXRvcnkxOTM0NzM0MA==-flat-observer_set.hpp-nano-node-MDEwOlJlcG9zaXRvcnkxOTM0NzM0MA==-flat-observer_set.hpp.html,14,nano-node-MDEwOlJlcG9zaXRvcnkxOTM0NzM0MA==-flat-observer_set.hpp,nano-node-MDEwOlJlcG9zaXRvcnkxOTM0NzM0MA==-flat-observer_set.hpp,43,44,1,43,44,1
185,https://htmlpreview.github.io/?https://github.com/Christina96/boilerplate-sample-matches/blob/main/Cpp/notepad-plus-plus-MDEwOlJlcG9zaXRvcnkzMzAxNDgxMQ==-flat-LexRust.cxx-notepad-plus-plus-MDEwOlJlcG9zaXRvcnkzMzAxNDgxMQ==-flat-LexRust.cxx.html,17,notepad-plus-plus-MDEwOlJlcG9zaXRvcnkzMzAxNDgxMQ==-flat-LexRust.cxx,notepad-plus-plus-MDEwOlJlcG9zaXRvcnkzMzAxNDgxMQ==-flat-LexRust.cxx,411,413,2,490,492,2
186,https://htmlpreview.github.io/?https://github.com/Christina96/boilerplate-sample-matches/blob/main/Cpp/nano-node-MDEwOlJlcG9zaXRvcnkxOTM0NzM0MA==-flat-cl.hpp-nano-node-MDEwOlJlcG9zaXRvcnkxOTM0NzM0MA==-flat-cl2.hpp.html,134,nano-node-MDEwOlJlcG9zaXRvcnkxOTM0NzM0MA==-flat-cl.hpp,nano-node-MDEwOlJlcG9zaXRvcnkxOTM0NzM0MA==-flat-cl2.hpp,3219,3243,24,3549,3573,24
187,https://htmlpreview.github.io/?https://github.com/Christina96/boilerplate-sample-matches/blob/main/Cpp/snap-MDEwOlJlcG9zaXRvcnk0Mjg4MzU3-flat-nlpwinlf.cpp-snap-MDEwOlJlcG9zaXRvcnk0Mjg4MzU3-flat-nlpwinlf.cpp.html,15,snap-MDEwOlJlcG9zaXRvcnk0Mjg4MzU3-flat-nlpwinlf.cpp,snap-MDEwOlJlcG9zaXRvcnk0Mjg4MzU3-flat-nlpwinlf.cpp,308,309,1,308,309,1
188,https://htmlpreview.github.io/?https://github.com/Christina96/boilerplate-sample-matches/blob/main/Cpp/snap-MDEwOlJlcG9zaXRvcnk0Mjg4MzU3-flat-test-ggen.cpp-snap-MDEwOlJlcG9zaXRvcnk0Mjg4MzU3-flat-test-ggen.cpp.html,14,snap-MDEwOlJlcG9zaXRvcnk0Mjg4MzU3-flat-test-ggen.cpp,snap-MDEwOlJlcG9zaXRvcnk0Mjg4MzU3-flat-test-ggen.cpp,591,595,4,370,374,4
189,https://htmlpreview.github.io/?https://github.com/Christina96/boilerplate-sample-matches/blob/main/Cpp/caffe-MDEwOlJlcG9zaXRvcnk2MTg3MDgwMw==-flat-apply_mn_param.cpp-caffe-MDEwOlJlcG9zaXRvcnk2MTg3MDgwMw==-flat-apply_mn_param.cpp.html,33,caffe-MDEwOlJlcG9zaXRvcnk2MTg3MDgwMw==-flat-apply_mn_param.cpp,caffe-MDEwOlJlcG9zaXRvcnk2MTg3MDgwMw==-flat-apply_mn_param.cpp,144,148,4,144,148,4
190,https://htmlpreview.github.io/?https://github.com/Christina96/boilerplate-sample-matches/blob/main/Cpp/notepad-plus-plus-MDEwOlJlcG9zaXRvcnkzMzAxNDgxMQ==-flat-perl_matcher_non_recursive.hpp-notepad-plus-plus-MDEwOlJlcG9zaXRvcnkzMzAxNDgxMQ==-flat-perl_matcher_non_recursive.hpp.html,92,notepad-plus-plus-MDEwOlJlcG9zaXRvcnkzMzAxNDgxMQ==-flat-perl_matcher_non_recursive.hpp,notepad-plus-plus-MDEwOlJlcG9zaXRvcnkzMzAxNDgxMQ==-flat-perl_matcher_non_recursive.hpp,612,625,13,612,625,13
191,https://htmlpreview.github.io/?https://github.com/Christina96/boilerplate-sample-matches/blob/main/Cpp/caffe-MDEwOlJlcG9zaXRvcnk2MTg3MDgwMw==-flat-mkl_deconvolution_layer.cpp-caffe-MDEwOlJlcG9zaXRvcnk2MTg3MDgwMw==-flat-mkl_convolution_layer.cpp.html,209,caffe-MDEwOlJlcG9zaXRvcnk2MTg3MDgwMw==-flat-mkl_deconvolution_layer.cpp,caffe-MDEwOlJlcG9zaXRvcnk2MTg3MDgwMw==-flat-mkl_convolution_layer.cpp,31,55,24,28,52,24
192,https://htmlpreview.github.io/?https://github.com/Christina96/boilerplate-sample-matches/blob/main/Cpp/tesseract-MDEwOlJlcG9zaXRvcnkyMjg4NzA5NA==-flat-colfind.cpp-tesseract-MDEwOlJlcG9zaXRvcnkyMjg4NzA5NA==-flat-colfind.cpp.html,18,tesseract-MDEwOlJlcG9zaXRvcnkyMjg4NzA5NA==-flat-colfind.cpp,tesseract-MDEwOlJlcG9zaXRvcnkyMjg4NzA5NA==-flat-colfind.cpp,709,712,3,709,712,3
193,https://htmlpreview.github.io/?https://github.com/Christina96/boilerplate-sample-matches/blob/main/Cpp/glm-MDEwOlJlcG9zaXRvcnk4NDM2MzE=-flat-color_space.hpp-glm-MDEwOlJlcG9zaXRvcnk4NDM2MzE=-flat-color_space.hpp.html,20,glm-MDEwOlJlcG9zaXRvcnk4NDM2MzE=-flat-color_space.hpp,glm-MDEwOlJlcG9zaXRvcnk4NDM2MzE=-flat-color_space.hpp,24,27,3,24,27,3
194,https://htmlpreview.github.io/?https://github.com/Christina96/boilerplate-sample-matches/blob/main/Cpp/abseil-cpp-MDEwOlJlcG9zaXRvcnkxMDQyMzE1NDE=-flat-raw_hash_map.h-abseil-cpp-MDEwOlJlcG9zaXRvcnkxMDQyMzE1NDE=-flat-raw_hash_map.h.html,19,abseil-cpp-MDEwOlJlcG9zaXRvcnkxMDQyMzE1NDE=-flat-raw_hash_map.h,abseil-cpp-MDEwOlJlcG9zaXRvcnkxMDQyMzE1NDE=-flat-raw_hash_map.h,19,20,1,16,17,1
195,https://htmlpreview.github.io/?https://github.com/Christina96/boilerplate-sample-matches/blob/main/Cpp/snap-MDEwOlJlcG9zaXRvcnk0Mjg4MzU3-flat-appsrv.cpp-snap-MDEwOlJlcG9zaXRvcnk0Mjg4MzU3-flat-appsrv.cpp.html,14,snap-MDEwOlJlcG9zaXRvcnk0Mjg4MzU3-flat-appsrv.cpp,snap-MDEwOlJlcG9zaXRvcnk0Mjg4MzU3-flat-appsrv.cpp,200,203,3,671,674,3
196,https://htmlpreview.github.io/?https://github.com/Christina96/boilerplate-sample-matches/blob/main/Cpp/snap-MDEwOlJlcG9zaXRvcnk0Mjg4MzU3-flat-fl.cpp-snap-MDEwOlJlcG9zaXRvcnk0Mjg4MzU3-flat-fl.cpp.html,16,snap-MDEwOlJlcG9zaXRvcnk0Mjg4MzU3-flat-fl.cpp,snap-MDEwOlJlcG9zaXRvcnk0Mjg4MzU3-flat-fl.cpp,525,530,5,525,530,5
197,https://htmlpreview.github.io/?https://github.com/Christina96/boilerplate-sample-matches/blob/main/Cpp/nano-node-MDEwOlJlcG9zaXRvcnkxOTM0NzM0MA==-flat-ledger.cpp-nano-node-MDEwOlJlcG9zaXRvcnkxOTM0NzM0MA==-flat-ledger.cpp.html,14,nano-node-MDEwOlJlcG9zaXRvcnkxOTM0NzM0MA==-flat-ledger.cpp,nano-node-MDEwOlJlcG9zaXRvcnkxOTM0NzM0MA==-flat-ledger.cpp,2176,2179,3,2165,2168,3
198,https://htmlpreview.github.io/?https://github.com/Christina96/boilerplate-sample-matches/blob/main/Cpp/snap-MDEwOlJlcG9zaXRvcnk0Mjg4MzU3-flat-memes.cpp-snap-MDEwOlJlcG9zaXRvcnk0Mjg4MzU3-flat-memes.cpp.html,20,snap-MDEwOlJlcG9zaXRvcnk0Mjg4MzU3-flat-memes.cpp,snap-MDEwOlJlcG9zaXRvcnk0Mjg4MzU3-flat-memes.cpp,1826,1828,2,1826,1828,2
199,https://htmlpreview.github.io/?https://github.com/Christina96/boilerplate-sample-matches/blob/main/Cpp/abseil-cpp-MDEwOlJlcG9zaXRvcnkxMDQyMzE1NDE=-flat-proto.cc-abseil-cpp-MDEwOlJlcG9zaXRvcnkxMDQyMzE1NDE=-flat-arg.cc.html,15,abseil-cpp-MDEwOlJlcG9zaXRvcnkxMDQyMzE1NDE=-flat-proto.cc,abseil-cpp-MDEwOlJlcG9zaXRvcnkxMDQyMzE1NDE=-flat-arg.cc,103,106,3,256,259,3
200,https://htmlpreview.github.io/?https://github.com/Christina96/boilerplate-sample-matches/blob/main/Cpp/notepad-plus-plus-MDEwOlJlcG9zaXRvcnkzMzAxNDgxMQ==-flat-LexHTML.cxx-notepad-plus-plus-MDEwOlJlcG9zaXRvcnkzMzAxNDgxMQ==-flat-LexLisp.cxx.html,33,notepad-plus-plus-MDEwOlJlcG9zaXRvcnkzMzAxNDgxMQ==-flat-LexHTML.cxx,notepad-plus-plus-MDEwOlJlcG9zaXRvcnkzMzAxNDgxMQ==-flat-LexLisp.cxx,2234,2238,4,80,84,4
201,https://htmlpreview.github.io/?https://github.com/Christina96/boilerplate-sample-matches/blob/main/Cpp/abseil-cpp-MDEwOlJlcG9zaXRvcnkxMDQyMzE1NDE=-flat-civil_time_test_17.cc-tesseract-MDEwOlJlcG9zaXRvcnkyMjg4NzA5NA==-flat-tospace.cpp.html,15,abseil-cpp-MDEwOlJlcG9zaXRvcnkxMDQyMzE1NDE=-flat-civil_time_test_17.cc,tesseract-MDEwOlJlcG9zaXRvcnkyMjg4NzA5NA==-flat-tospace.cpp,359,362,3,659,662,3
202,https://htmlpreview.github.io/?https://github.com/Christina96/boilerplate-sample-matches/blob/main/Cpp/notepad-plus-plus-MDEwOlJlcG9zaXRvcnkzMzAxNDgxMQ==-flat-Editor.cxx-caffe-MDEwOlJlcG9zaXRvcnk2MTg3MDgwMw==-flat-multi_solver.cpp.html,15,notepad-plus-plus-MDEwOlJlcG9zaXRvcnkzMzAxNDgxMQ==-flat-Editor.cxx,caffe-MDEwOlJlcG9zaXRvcnk2MTg3MDgwMw==-flat-multi_solver.cpp,4327,4331,4,211,215,4
203,https://htmlpreview.github.io/?https://github.com/Christina96/boilerplate-sample-matches/blob/main/Cpp/abseil-cpp-MDEwOlJlcG9zaXRvcnkxMDQyMzE1NDE=-flat-mutex.cc-abseil-cpp-MDEwOlJlcG9zaXRvcnkxMDQyMzE1NDE=-flat-mutex.cc.html,22,abseil-cpp-MDEwOlJlcG9zaXRvcnkxMDQyMzE1NDE=-flat-mutex.cc,abseil-cpp-MDEwOlJlcG9zaXRvcnkxMDQyMzE1NDE=-flat-mutex.cc,1551,1553,2,1586,1588,2
204,https://htmlpreview.github.io/?https://github.com/Christina96/boilerplate-sample-matches/blob/main/Cpp/snap-MDEwOlJlcG9zaXRvcnk0Mjg4MzU3-flat-table.cpp-snap-MDEwOlJlcG9zaXRvcnk0Mjg4MzU3-flat-gstat.cpp.html,20,snap-MDEwOlJlcG9zaXRvcnk0Mjg4MzU3-flat-table.cpp,snap-MDEwOlJlcG9zaXRvcnk0Mjg4MzU3-flat-gstat.cpp,2883,2887,4,326,330,4
205,https://htmlpreview.github.io/?https://github.com/Christina96/boilerplate-sample-matches/blob/main/Cpp/caffe-MDEwOlJlcG9zaXRvcnk2MTg3MDgwMw==-flat-test_image_data_layer.cpp-caffe-MDEwOlJlcG9zaXRvcnk2MTg3MDgwMw==-flat-test_mkldnn_split_layer.cpp.html,16,caffe-MDEwOlJlcG9zaXRvcnk2MTg3MDgwMw==-flat-test_image_data_layer.cpp,caffe-MDEwOlJlcG9zaXRvcnk2MTg3MDgwMw==-flat-test_mkldnn_split_layer.cpp,116,117,1,62,63,1
206,https://htmlpreview.github.io/?https://github.com/Christina96/boilerplate-sample-matches/blob/main/Cpp/snap-MDEwOlJlcG9zaXRvcnk0Mjg4MzU3-flat-xml.cpp-snap-MDEwOlJlcG9zaXRvcnk0Mjg4MzU3-flat-euproj.cpp.html,15,snap-MDEwOlJlcG9zaXRvcnk0Mjg4MzU3-flat-xml.cpp,snap-MDEwOlJlcG9zaXRvcnk0Mjg4MzU3-flat-euproj.cpp,49,51,2,513,515,2
207,https://htmlpreview.github.io/?https://github.com/Christina96/boilerplate-sample-matches/blob/main/Cpp/notepad-plus-plus-MDEwOlJlcG9zaXRvcnkzMzAxNDgxMQ==-flat-UserDefineDialog.h-notepad-plus-plus-MDEwOlJlcG9zaXRvcnkzMzAxNDgxMQ==-flat-UserDefineDialog.h.html,20,notepad-plus-plus-MDEwOlJlcG9zaXRvcnkzMzAxNDgxMQ==-flat-UserDefineDialog.h,notepad-plus-plus-MDEwOlJlcG9zaXRvcnkzMzAxNDgxMQ==-flat-UserDefineDialog.h,119,121,2,76,78,2
208,https://htmlpreview.github.io/?https://github.com/Christina96/boilerplate-sample-matches/blob/main/Cpp/abseil-cpp-MDEwOlJlcG9zaXRvcnkxMDQyMzE1NDE=-flat-kernel_timeout_test.cc-abseil-cpp-MDEwOlJlcG9zaXRvcnkxMDQyMzE1NDE=-flat-kernel_timeout_test.cc.html,15,abseil-cpp-MDEwOlJlcG9zaXRvcnkxMDQyMzE1NDE=-flat-kernel_timeout_test.cc,abseil-cpp-MDEwOlJlcG9zaXRvcnkxMDQyMzE1NDE=-flat-kernel_timeout_test.cc,209,210,1,72,73,1
209,https://htmlpreview.github.io/?https://github.com/Christina96/boilerplate-sample-matches/blob/main/Cpp/tesseract-MDEwOlJlcG9zaXRvcnkyMjg4NzA5NA==-flat-tablefind.cpp-tesseract-MDEwOlJlcG9zaXRvcnkyMjg4NzA5NA==-flat-tablerecog.cpp.html,16,tesseract-MDEwOlJlcG9zaXRvcnkyMjg4NzA5NA==-flat-tablefind.cpp,tesseract-MDEwOlJlcG9zaXRvcnkyMjg4NzA5NA==-flat-tablerecog.cpp,453,455,2,373,375,2
210,https://htmlpreview.github.io/?https://github.com/Christina96/boilerplate-sample-matches/blob/main/Cpp/snap-MDEwOlJlcG9zaXRvcnk0Mjg4MzU3-flat-xmath.h-snap-MDEwOlJlcG9zaXRvcnk0Mjg4MzU3-flat-xmath.h.html,102,snap-MDEwOlJlcG9zaXRvcnk0Mjg4MzU3-flat-xmath.h,snap-MDEwOlJlcG9zaXRvcnk0Mjg4MzU3-flat-xmath.h,298,307,9,341,350,9
211,https://htmlpreview.github.io/?https://github.com/Christina96/boilerplate-sample-matches/blob/main/Cpp/nano-node-MDEwOlJlcG9zaXRvcnkxOTM0NzM0MA==-flat-bootstrap.hpp-nano-node-MDEwOlJlcG9zaXRvcnkxOTM0NzM0MA==-flat-node.hpp.html,25,nano-node-MDEwOlJlcG9zaXRvcnkxOTM0NzM0MA==-flat-bootstrap.hpp,nano-node-MDEwOlJlcG9zaXRvcnkxOTM0NzM0MA==-flat-node.hpp,87,88,1,79,80,1
212,https://htmlpreview.github.io/?https://github.com/Christina96/boilerplate-sample-matches/blob/main/Cpp/tesseract-MDEwOlJlcG9zaXRvcnkyMjg4NzA5NA==-flat-scanutils.cpp-tesseract-MDEwOlJlcG9zaXRvcnkyMjg4NzA5NA==-flat-scanutils.cpp.html,18,tesseract-MDEwOlJlcG9zaXRvcnkyMjg4NzA5NA==-flat-scanutils.cpp,tesseract-MDEwOlJlcG9zaXRvcnkyMjg4NzA5NA==-flat-scanutils.cpp,80,82,2,80,82,2
213,https://htmlpreview.github.io/?https://github.com/Christina96/boilerplate-sample-matches/blob/main/Cpp/notepad-plus-plus-MDEwOlJlcG9zaXRvcnkzMzAxNDgxMQ==-flat-CustomFileDialog.cpp-notepad-plus-plus-MDEwOlJlcG9zaXRvcnkzMzAxNDgxMQ==-flat-CustomFileDialog.cpp.html,38,notepad-plus-plus-MDEwOlJlcG9zaXRvcnkzMzAxNDgxMQ==-flat-CustomFileDialog.cpp,notepad-plus-plus-MDEwOlJlcG9zaXRvcnkzMzAxNDgxMQ==-flat-CustomFileDialog.cpp,824,829,5,824,829,5
214,https://htmlpreview.github.io/?https://github.com/Christina96/boilerplate-sample-matches/blob/main/Cpp/nano-node-MDEwOlJlcG9zaXRvcnkxOTM0NzM0MA==-flat-final_vote_store.cpp-nano-node-MDEwOlJlcG9zaXRvcnkxOTM0NzM0MA==-flat-final_vote_store.cpp.html,389,nano-node-MDEwOlJlcG9zaXRvcnkxOTM0NzM0MA==-flat-final_vote_store.cpp,nano-node-MDEwOlJlcG9zaXRvcnkxOTM0NzM0MA==-flat-final_vote_store.cpp,43,77,34,43,77,34
215,https://htmlpreview.github.io/?https://github.com/Christina96/boilerplate-sample-matches/blob/main/Cpp/notepad-plus-plus-MDEwOlJlcG9zaXRvcnkzMzAxNDgxMQ==-flat-catch_14.hpp-notepad-plus-plus-MDEwOlJlcG9zaXRvcnkzMzAxNDgxMQ==-flat-catch.hpp.html,52305,notepad-plus-plus-MDEwOlJlcG9zaXRvcnkzMzAxNDgxMQ==-flat-catch_14.hpp,notepad-plus-plus-MDEwOlJlcG9zaXRvcnkzMzAxNDgxMQ==-flat-catch.hpp,6278,13690,7412,6278,13690,7412
216,https://htmlpreview.github.io/?https://github.com/Christina96/boilerplate-sample-matches/blob/main/Cpp/abseil-cpp-MDEwOlJlcG9zaXRvcnkxMDQyMzE1NDE=-flat-cord_rep_btree_test.cc-tesseract-MDEwOlJlcG9zaXRvcnkyMjg4NzA5NA==-flat-unicharset.h.html,17,abseil-cpp-MDEwOlJlcG9zaXRvcnkxMDQyMzE1NDE=-flat-cord_rep_btree_test.cc,tesseract-MDEwOlJlcG9zaXRvcnkyMjg4NzA5NA==-flat-unicharset.h,57,59,2,147,149,2
217,https://htmlpreview.github.io/?https://github.com/Christina96/boilerplate-sample-matches/blob/main/Cpp/tesseract-MDEwOlJlcG9zaXRvcnkyMjg4NzA5NA==-flat-tospace.cpp-tesseract-MDEwOlJlcG9zaXRvcnkyMjg4NzA5NA==-flat-tospace.cpp.html,24,tesseract-MDEwOlJlcG9zaXRvcnkyMjg4NzA5NA==-flat-tospace.cpp,tesseract-MDEwOlJlcG9zaXRvcnkyMjg4NzA5NA==-flat-tospace.cpp,327,330,3,327,330,3
218,https://htmlpreview.github.io/?https://github.com/Christina96/boilerplate-sample-matches/blob/main/Cpp/MMKV-MDEwOlJlcG9zaXRvcnkxNDkxMTE4MTM=-flat-MiniPBCoder_OSX.cpp-MMKV-MDEwOlJlcG9zaXRvcnkxNDkxMTE4MTM=-flat-MiniPBCoder_OSX.cpp.html,15,MMKV-MDEwOlJlcG9zaXRvcnkxNDkxMTE4MTM=-flat-MiniPBCoder_OSX.cpp,MMKV-MDEwOlJlcG9zaXRvcnkxNDkxMTE4MTM=-flat-MiniPBCoder_OSX.cpp,107,109,2,107,109,2
219,https://htmlpreview.github.io/?https://github.com/Christina96/boilerplate-sample-matches/blob/main/Cpp/snap-MDEwOlJlcG9zaXRvcnk0Mjg4MzU3-flat-biling.cpp-snap-MDEwOlJlcG9zaXRvcnk0Mjg4MzU3-flat-biling.cpp.html,15,snap-MDEwOlJlcG9zaXRvcnk0Mjg4MzU3-flat-biling.cpp,snap-MDEwOlJlcG9zaXRvcnk0Mjg4MzU3-flat-biling.cpp,328,329,1,328,329,1
220,https://htmlpreview.github.io/?https://github.com/Christina96/boilerplate-sample-matches/blob/main/Cpp/snap-MDEwOlJlcG9zaXRvcnk0Mjg4MzU3-flat-nyta.cpp-snap-MDEwOlJlcG9zaXRvcnk0Mjg4MzU3-flat-nyta.cpp.html,25,snap-MDEwOlJlcG9zaXRvcnk0Mjg4MzU3-flat-nyta.cpp,snap-MDEwOlJlcG9zaXRvcnk0Mjg4MzU3-flat-nyta.cpp,37,38,1,24,25,1
221,https://htmlpreview.github.io/?https://github.com/Christina96/boilerplate-sample-matches/blob/main/Cpp/tesseract-MDEwOlJlcG9zaXRvcnkyMjg4NzA5NA==-flat-pageiterator.h-tesseract-MDEwOlJlcG9zaXRvcnkyMjg4NzA5NA==-flat-pageiterator.h.html,14,tesseract-MDEwOlJlcG9zaXRvcnkyMjg4NzA5NA==-flat-pageiterator.h,tesseract-MDEwOlJlcG9zaXRvcnkyMjg4NzA5NA==-flat-pageiterator.h,19,21,2,19,21,2
222,https://htmlpreview.github.io/?https://github.com/Christina96/boilerplate-sample-matches/blob/main/Cpp/abseil-cpp-MDEwOlJlcG9zaXRvcnkxMDQyMzE1NDE=-flat-cordz_test.cc-abseil-cpp-MDEwOlJlcG9zaXRvcnkxMDQyMzE1NDE=-flat-cordz_test.cc.html,82,abseil-cpp-MDEwOlJlcG9zaXRvcnkxMDQyMzE1NDE=-flat-cordz_test.cc,abseil-cpp-MDEwOlJlcG9zaXRvcnkxMDQyMzE1NDE=-flat-cordz_test.cc,159,169,10,159,169,10
223,https://htmlpreview.github.io/?https://github.com/Christina96/boilerplate-sample-matches/blob/main/Cpp/snap-MDEwOlJlcG9zaXRvcnk0Mjg4MzU3-flat-cordis.cpp-snap-MDEwOlJlcG9zaXRvcnk0Mjg4MzU3-flat-cordis.cpp.html,14,snap-MDEwOlJlcG9zaXRvcnk0Mjg4MzU3-flat-cordis.cpp,snap-MDEwOlJlcG9zaXRvcnk0Mjg4MzU3-flat-cordis.cpp,98,100,2,98,100,2
224,https://htmlpreview.github.io/?https://github.com/Christina96/boilerplate-sample-matches/blob/main/Cpp/abseil-cpp-MDEwOlJlcG9zaXRvcnkxMDQyMzE1NDE=-flat-raw_hash_set_test.cc-abseil-cpp-MDEwOlJlcG9zaXRvcnkxMDQyMzE1NDE=-flat-raw_hash_set_test.cc.html,22,abseil-cpp-MDEwOlJlcG9zaXRvcnkxMDQyMzE1NDE=-flat-raw_hash_set_test.cc,abseil-cpp-MDEwOlJlcG9zaXRvcnkxMDQyMzE1NDE=-flat-raw_hash_set_test.cc,388,395,7,381,388,7
225,https://htmlpreview.github.io/?https://github.com/Christina96/boilerplate-sample-matches/blob/main/Cpp/tesseract-MDEwOlJlcG9zaXRvcnkyMjg4NzA5NA==-flat-intproto.cpp-abseil-cpp-MDEwOlJlcG9zaXRvcnkxMDQyMzE1NDE=-flat-cord_internal.h.html,14,tesseract-MDEwOlJlcG9zaXRvcnkyMjg4NzA5NA==-flat-intproto.cpp,abseil-cpp-MDEwOlJlcG9zaXRvcnkxMDQyMzE1NDE=-flat-cord_internal.h,964,966,2,244,246,2
226,https://htmlpreview.github.io/?https://github.com/Christina96/boilerplate-sample-matches/blob/main/Cpp/caffe-MDEwOlJlcG9zaXRvcnk2MTg3MDgwMw==-flat-mkldnn_layers.hpp-caffe-MDEwOlJlcG9zaXRvcnk2MTg3MDgwMw==-flat-mkldnn_layers.hpp.html,17,caffe-MDEwOlJlcG9zaXRvcnk2MTg3MDgwMw==-flat-mkldnn_layers.hpp,caffe-MDEwOlJlcG9zaXRvcnk2MTg3MDgwMw==-flat-mkldnn_layers.hpp,189,193,4,289,293,4
227,https://htmlpreview.github.io/?https://github.com/Christina96/boilerplate-sample-matches/blob/main/Cpp/caffe-MDEwOlJlcG9zaXRvcnk2MTg3MDgwMw==-flat-mkl_batch_norm_layer.cpp-caffe-MDEwOlJlcG9zaXRvcnk2MTg3MDgwMw==-flat-mkl_pooling_layer.cpp.html,22,caffe-MDEwOlJlcG9zaXRvcnk2MTg3MDgwMw==-flat-mkl_batch_norm_layer.cpp,caffe-MDEwOlJlcG9zaXRvcnk2MTg3MDgwMw==-flat-mkl_pooling_layer.cpp,329,333,4,251,255,4
228,https://htmlpreview.github.io/?https://github.com/Christina96/boilerplate-sample-matches/blob/main/Cpp/abseil-cpp-MDEwOlJlcG9zaXRvcnkxMDQyMzE1NDE=-flat-spinlock_test_common.cc-abseil-cpp-MDEwOlJlcG9zaXRvcnkxMDQyMzE1NDE=-flat-spinlock_test_common.cc.html,21,abseil-cpp-MDEwOlJlcG9zaXRvcnkxMDQyMzE1NDE=-flat-spinlock_test_common.cc,abseil-cpp-MDEwOlJlcG9zaXRvcnkxMDQyMzE1NDE=-flat-spinlock_test_common.cc,156,160,4,156,160,4
229,https://htmlpreview.github.io/?https://github.com/Christina96/boilerplate-sample-matches/blob/main/Cpp/caffe-MDEwOlJlcG9zaXRvcnk2MTg3MDgwMw==-flat-test_lstm_layer.cpp-caffe-MDEwOlJlcG9zaXRvcnk2MTg3MDgwMw==-flat-test_rnn_layer.cpp.html,251,caffe-MDEwOlJlcG9zaXRvcnk2MTg3MDgwMw==-flat-test_lstm_layer.cpp,caffe-MDEwOlJlcG9zaXRvcnk2MTg3MDgwMw==-flat-test_rnn_layer.cpp,135,164,29,107,136,29
230,https://htmlpreview.github.io/?https://github.com/Christina96/boilerplate-sample-matches/blob/main/Cpp/abseil-cpp-MDEwOlJlcG9zaXRvcnkxMDQyMzE1NDE=-flat-mutex_test.cc-abseil-cpp-MDEwOlJlcG9zaXRvcnkxMDQyMzE1NDE=-flat-mutex_test.cc.html,17,abseil-cpp-MDEwOlJlcG9zaXRvcnkxMDQyMzE1NDE=-flat-mutex_test.cc,abseil-cpp-MDEwOlJlcG9zaXRvcnkxMDQyMzE1NDE=-flat-mutex_test.cc,1232,1233,1,1264,1265,1
231,https://htmlpreview.github.io/?https://github.com/Christina96/boilerplate-sample-matches/blob/main/Cpp/notepad-plus-plus-MDEwOlJlcG9zaXRvcnkzMzAxNDgxMQ==-flat-EditView.cxx-notepad-plus-plus-MDEwOlJlcG9zaXRvcnkzMzAxNDgxMQ==-flat-EditView.cxx.html,17,notepad-plus-plus-MDEwOlJlcG9zaXRvcnkzMzAxNDgxMQ==-flat-EditView.cxx,notepad-plus-plus-MDEwOlJlcG9zaXRvcnkzMzAxNDgxMQ==-flat-EditView.cxx,2163,2165,2,1360,1362,2
232,https://htmlpreview.github.io/?https://github.com/Christina96/boilerplate-sample-matches/blob/main/Cpp/notepad-plus-plus-MDEwOlJlcG9zaXRvcnkzMzAxNDgxMQ==-flat-ScintillaCocoa.h-notepad-plus-plus-MDEwOlJlcG9zaXRvcnkzMzAxNDgxMQ==-flat-ScintillaCocoa.h.html,16,notepad-plus-plus-MDEwOlJlcG9zaXRvcnkzMzAxNDgxMQ==-flat-ScintillaCocoa.h,notepad-plus-plus-MDEwOlJlcG9zaXRvcnkzMzAxNDgxMQ==-flat-ScintillaCocoa.h,107,108,1,101,102,1
233,https://htmlpreview.github.io/?https://github.com/Christina96/boilerplate-sample-matches/blob/main/Cpp/abseil-cpp-MDEwOlJlcG9zaXRvcnkxMDQyMzE1NDE=-flat-any_test.cc-abseil-cpp-MDEwOlJlcG9zaXRvcnkxMDQyMzE1NDE=-flat-any_test.cc.html,15,abseil-cpp-MDEwOlJlcG9zaXRvcnkxMDQyMzE1NDE=-flat-any_test.cc,abseil-cpp-MDEwOlJlcG9zaXRvcnkxMDQyMzE1NDE=-flat-any_test.cc,604,607,3,604,607,3
234,https://htmlpreview.github.io/?https://github.com/Christina96/boilerplate-sample-matches/blob/main/Cpp/abseil-cpp-MDEwOlJlcG9zaXRvcnkxMDQyMzE1NDE=-flat-cctz_benchmark.cc-abseil-cpp-MDEwOlJlcG9zaXRvcnkxMDQyMzE1NDE=-flat-cctz_benchmark.cc.html,64,abseil-cpp-MDEwOlJlcG9zaXRvcnkxMDQyMzE1NDE=-flat-cctz_benchmark.cc,abseil-cpp-MDEwOlJlcG9zaXRvcnkxMDQyMzE1NDE=-flat-cctz_benchmark.cc,812,822,10,812,822,10
235,https://htmlpreview.github.io/?https://github.com/Christina96/boilerplate-sample-matches/blob/main/Cpp/notepad-plus-plus-MDEwOlJlcG9zaXRvcnkzMzAxNDgxMQ==-flat-asciiListView.cpp-notepad-plus-plus-MDEwOlJlcG9zaXRvcnkzMzAxNDgxMQ==-flat-ansiCharPanel.cpp.html,16,notepad-plus-plus-MDEwOlJlcG9zaXRvcnkzMzAxNDgxMQ==-flat-asciiListView.cpp,notepad-plus-plus-MDEwOlJlcG9zaXRvcnkzMzAxNDgxMQ==-flat-ansiCharPanel.cpp,86,88,2,114,116,2
236,https://htmlpreview.github.io/?https://github.com/Christina96/boilerplate-sample-matches/blob/main/Cpp/nano-node-MDEwOlJlcG9zaXRvcnkxOTM0NzM0MA==-flat-tomlconfig.hpp-nano-node-MDEwOlJlcG9zaXRvcnkxOTM0NzM0MA==-flat-jsonconfig.hpp.html,25,nano-node-MDEwOlJlcG9zaXRvcnkxOTM0NzM0MA==-flat-tomlconfig.hpp,nano-node-MDEwOlJlcG9zaXRvcnkxOTM0NzM0MA==-flat-jsonconfig.hpp,120,125,5,85,90,5
237,https://htmlpreview.github.io/?https://github.com/Christina96/boilerplate-sample-matches/blob/main/Cpp/snap-MDEwOlJlcG9zaXRvcnk0Mjg4MzU3-flat-ff.cpp-snap-MDEwOlJlcG9zaXRvcnk0Mjg4MzU3-flat-ff.cpp.html,95,snap-MDEwOlJlcG9zaXRvcnk0Mjg4MzU3-flat-ff.cpp,snap-MDEwOlJlcG9zaXRvcnk0Mjg4MzU3-flat-ff.cpp,94,103,9,109,118,9
238,https://htmlpreview.github.io/?https://github.com/Christina96/boilerplate-sample-matches/blob/main/Cpp/nano-node-MDEwOlJlcG9zaXRvcnkxOTM0NzM0MA==-flat-wallets.cpp-nano-node-MDEwOlJlcG9zaXRvcnkxOTM0NzM0MA==-flat-wallets.cpp.html,16,nano-node-MDEwOlJlcG9zaXRvcnkxOTM0NzM0MA==-flat-wallets.cpp,nano-node-MDEwOlJlcG9zaXRvcnkxOTM0NzM0MA==-flat-wallets.cpp,169,170,1,157,158,1
239,https://htmlpreview.github.io/?https://github.com/Christina96/boilerplate-sample-matches/blob/main/Cpp/notepad-plus-plus-MDEwOlJlcG9zaXRvcnkzMzAxNDgxMQ==-flat-LexLua.cxx-notepad-plus-plus-MDEwOlJlcG9zaXRvcnkzMzAxNDgxMQ==-flat-LexLua.cxx.html,17,notepad-plus-plus-MDEwOlJlcG9zaXRvcnkzMzAxNDgxMQ==-flat-LexLua.cxx,notepad-plus-plus-MDEwOlJlcG9zaXRvcnkzMzAxNDgxMQ==-flat-LexLua.cxx,362,367,5,362,367,5
240,https://htmlpreview.github.io/?https://github.com/Christina96/boilerplate-sample-matches/blob/main/Cpp/notepad-plus-plus-MDEwOlJlcG9zaXRvcnkzMzAxNDgxMQ==-flat-ScintillaCall.h-notepad-plus-plus-MDEwOlJlcG9zaXRvcnkzMzAxNDgxMQ==-flat-CharacterCategoryMap.h.html,21,notepad-plus-plus-MDEwOlJlcG9zaXRvcnkzMzAxNDgxMQ==-flat-ScintillaCall.h,notepad-plus-plus-MDEwOlJlcG9zaXRvcnkzMzAxNDgxMQ==-flat-CharacterCategoryMap.h,161,164,3,13,16,3
241,https://htmlpreview.github.io/?https://github.com/Christina96/boilerplate-sample-matches/blob/main/Cpp/tesseract-MDEwOlJlcG9zaXRvcnkyMjg4NzA5NA==-flat-shapetable.cpp-notepad-plus-plus-MDEwOlJlcG9zaXRvcnkzMzAxNDgxMQ==-flat-ScintillaQt.cpp.html,14,tesseract-MDEwOlJlcG9zaXRvcnkyMjg4NzA5NA==-flat-shapetable.cpp,notepad-plus-plus-MDEwOlJlcG9zaXRvcnkzMzAxNDgxMQ==-flat-ScintillaQt.cpp,99,102,3,173,177,4
242,https://htmlpreview.github.io/?https://github.com/Christina96/boilerplate-sample-matches/blob/main/Cpp/caffe-MDEwOlJlcG9zaXRvcnk2MTg3MDgwMw==-flat-hdf5_output_layer.hpp-snap-MDEwOlJlcG9zaXRvcnk0Mjg4MzU3-flat-hysgen.h.html,15,caffe-MDEwOlJlcG9zaXRvcnk2MTg3MDgwMw==-flat-hdf5_output_layer.hpp,snap-MDEwOlJlcG9zaXRvcnk0Mjg4MzU3-flat-hysgen.h,39,42,3,42,45,3
243,https://htmlpreview.github.io/?https://github.com/Christina96/boilerplate-sample-matches/blob/main/Cpp/caffe-MDEwOlJlcG9zaXRvcnk2MTg3MDgwMw==-flat-mkl_memory.cpp-caffe-MDEwOlJlcG9zaXRvcnk2MTg3MDgwMw==-flat-mkl_memory.cpp.html,15,caffe-MDEwOlJlcG9zaXRvcnk2MTg3MDgwMw==-flat-mkl_memory.cpp,caffe-MDEwOlJlcG9zaXRvcnk2MTg3MDgwMw==-flat-mkl_memory.cpp,235,237,2,235,237,2
244,https://htmlpreview.github.io/?https://github.com/Christina96/boilerplate-sample-matches/blob/main/Cpp/snap-MDEwOlJlcG9zaXRvcnk0Mjg4MzU3-flat-valds.cpp-snap-MDEwOlJlcG9zaXRvcnk0Mjg4MzU3-flat-valds.cpp.html,17,snap-MDEwOlJlcG9zaXRvcnk0Mjg4MzU3-flat-valds.cpp,snap-MDEwOlJlcG9zaXRvcnk0Mjg4MzU3-flat-valds.cpp,56,58,2,20,22,2
245,https://htmlpreview.github.io/?https://github.com/Christina96/boilerplate-sample-matches/blob/main/Cpp/snap-MDEwOlJlcG9zaXRvcnk0Mjg4MzU3-flat-kronecker.cpp-snap-MDEwOlJlcG9zaXRvcnk0Mjg4MzU3-flat-kronecker.cpp.html,40,snap-MDEwOlJlcG9zaXRvcnk0Mjg4MzU3-flat-kronecker.cpp,snap-MDEwOlJlcG9zaXRvcnk0Mjg4MzU3-flat-kronecker.cpp,988,994,6,988,994,6
246,https://htmlpreview.github.io/?https://github.com/Christina96/boilerplate-sample-matches/blob/main/Cpp/snap-MDEwOlJlcG9zaXRvcnk0Mjg4MzU3-flat-phrase.cpp-snap-MDEwOlJlcG9zaXRvcnk0Mjg4MzU3-flat-phrase.cpp.html,21,snap-MDEwOlJlcG9zaXRvcnk0Mjg4MzU3-flat-phrase.cpp,snap-MDEwOlJlcG9zaXRvcnk0Mjg4MzU3-flat-phrase.cpp,403,409,6,403,409,6
247,https://htmlpreview.github.io/?https://github.com/Christina96/boilerplate-sample-matches/blob/main/Cpp/tesseract-MDEwOlJlcG9zaXRvcnkyMjg4NzA5NA==-flat-paragraphs.cpp-tesseract-MDEwOlJlcG9zaXRvcnkyMjg4NzA5NA==-flat-paragraphs.cpp.html,18,tesseract-MDEwOlJlcG9zaXRvcnkyMjg4NzA5NA==-flat-paragraphs.cpp,tesseract-MDEwOlJlcG9zaXRvcnkyMjg4NzA5NA==-flat-paragraphs.cpp,1823,1826,3,1823,1826,3
248,https://htmlpreview.github.io/?https://github.com/Christina96/boilerplate-sample-matches/blob/main/Cpp/notepad-plus-plus-MDEwOlJlcG9zaXRvcnkzMzAxNDgxMQ==-flat-Editor.cxx-notepad-plus-plus-MDEwOlJlcG9zaXRvcnkzMzAxNDgxMQ==-flat-Editor.cxx.html,15,notepad-plus-plus-MDEwOlJlcG9zaXRvcnkzMzAxNDgxMQ==-flat-Editor.cxx,notepad-plus-plus-MDEwOlJlcG9zaXRvcnkzMzAxNDgxMQ==-flat-Editor.cxx,2930,2933,3,2930,2933,3
249,https://htmlpreview.github.io/?https://github.com/Christina96/boilerplate-sample-matches/blob/main/Cpp/notepad-plus-plus-MDEwOlJlcG9zaXRvcnkzMzAxNDgxMQ==-flat-fileBrowser.cpp-notepad-plus-plus-MDEwOlJlcG9zaXRvcnkzMzAxNDgxMQ==-flat-fileBrowser.cpp.html,14,notepad-plus-plus-MDEwOlJlcG9zaXRvcnkzMzAxNDgxMQ==-flat-fileBrowser.cpp,notepad-plus-plus-MDEwOlJlcG9zaXRvcnkzMzAxNDgxMQ==-flat-fileBrowser.cpp,863,866,3,1041,1044,3
250,https://htmlpreview.github.io/?https://github.com/Christina96/boilerplate-sample-matches/blob/main/Cpp/snap-MDEwOlJlcG9zaXRvcnk0Mjg4MzU3-flat-agmdirected.cpp-snap-MDEwOlJlcG9zaXRvcnk0Mjg4MzU3-flat-hysgen.cpp.html,17,snap-MDEwOlJlcG9zaXRvcnk0Mjg4MzU3-flat-agmdirected.cpp,snap-MDEwOlJlcG9zaXRvcnk0Mjg4MzU3-flat-hysgen.cpp,390,393,3,700,704,4
251,https://htmlpreview.github.io/?https://github.com/Christina96/boilerplate-sample-matches/blob/main/Cpp/notepad-plus-plus-MDEwOlJlcG9zaXRvcnkzMzAxNDgxMQ==-flat-ScintillaEditView.h-notepad-plus-plus-MDEwOlJlcG9zaXRvcnkzMzAxNDgxMQ==-flat-ScintillaCall.h.html,17,notepad-plus-plus-MDEwOlJlcG9zaXRvcnkzMzAxNDgxMQ==-flat-ScintillaEditView.h,notepad-plus-plus-MDEwOlJlcG9zaXRvcnkzMzAxNDgxMQ==-flat-ScintillaCall.h,303,305,2,247,249,2
252,https://htmlpreview.github.io/?https://github.com/Christina96/boilerplate-sample-matches/blob/main/Cpp/snap-MDEwOlJlcG9zaXRvcnk0Mjg4MzU3-flat-tnt.h-snap-MDEwOlJlcG9zaXRvcnk0Mjg4MzU3-flat-cordis.h.html,19,snap-MDEwOlJlcG9zaXRvcnk0Mjg4MzU3-flat-tnt.h,snap-MDEwOlJlcG9zaXRvcnk0Mjg4MzU3-flat-cordis.h,230,233,3,5,8,3
253,https://htmlpreview.github.io/?https://github.com/Christina96/boilerplate-sample-matches/blob/main/Cpp/nano-node-MDEwOlJlcG9zaXRvcnkxOTM0NzM0MA==-flat-block_store_86.cpp-nano-node-MDEwOlJlcG9zaXRvcnkxOTM0NzM0MA==-flat-block_store_64.cpp.html,14,nano-node-MDEwOlJlcG9zaXRvcnkxOTM0NzM0MA==-flat-block_store_86.cpp,nano-node-MDEwOlJlcG9zaXRvcnkxOTM0NzM0MA==-flat-block_store_64.cpp,45,47,2,45,47,2
254,https://htmlpreview.github.io/?https://github.com/Christina96/boilerplate-sample-matches/blob/main/Cpp/abseil-cpp-MDEwOlJlcG9zaXRvcnkxMDQyMzE1NDE=-flat-civil_time_test.cc-abseil-cpp-MDEwOlJlcG9zaXRvcnkxMDQyMzE1NDE=-flat-civil_time_test.cc.html,33,abseil-cpp-MDEwOlJlcG9zaXRvcnkxMDQyMzE1NDE=-flat-civil_time_test.cc,abseil-cpp-MDEwOlJlcG9zaXRvcnkxMDQyMzE1NDE=-flat-civil_time_test.cc,251,254,3,249,252,3
255,https://htmlpreview.github.io/?https://github.com/Christina96/boilerplate-sample-matches/blob/main/Cpp/notepad-plus-plus-MDEwOlJlcG9zaXRvcnkzMzAxNDgxMQ==-flat-WinMgr.h-notepad-plus-plus-MDEwOlJlcG9zaXRvcnkzMzAxNDgxMQ==-flat-WinMgr.h.html,22,notepad-plus-plus-MDEwOlJlcG9zaXRvcnkzMzAxNDgxMQ==-flat-WinMgr.h,notepad-plus-plus-MDEwOlJlcG9zaXRvcnkzMzAxNDgxMQ==-flat-WinMgr.h,75,77,2,75,77,2
256,https://htmlpreview.github.io/?https://github.com/Christina96/boilerplate-sample-matches/blob/main/Cpp/tesseract-MDEwOlJlcG9zaXRvcnkyMjg4NzA5NA==-flat-topitch.cpp-tesseract-MDEwOlJlcG9zaXRvcnkyMjg4NzA5NA==-flat-pdfrenderer.cpp.html,32,tesseract-MDEwOlJlcG9zaXRvcnkyMjg4NzA5NA==-flat-topitch.cpp,tesseract-MDEwOlJlcG9zaXRvcnkyMjg4NzA5NA==-flat-pdfrenderer.cpp,822,831,9,441,450,9
257,https://htmlpreview.github.io/?https://github.com/Christina96/boilerplate-sample-matches/blob/main/Cpp/tesseract-MDEwOlJlcG9zaXRvcnkyMjg4NzA5NA==-flat-svpaint.cpp-tesseract-MDEwOlJlcG9zaXRvcnkyMjg4NzA5NA==-flat-svpaint.cpp.html,26,tesseract-MDEwOlJlcG9zaXRvcnkyMjg4NzA5NA==-flat-svpaint.cpp,tesseract-MDEwOlJlcG9zaXRvcnkyMjg4NzA5NA==-flat-svpaint.cpp,33,35,2,29,34,5
258,https://htmlpreview.github.io/?https://github.com/Christina96/boilerplate-sample-matches/blob/main/Cpp/snap-MDEwOlJlcG9zaXRvcnk0Mjg4MzU3-flat-triad.h-snap-MDEwOlJlcG9zaXRvcnk0Mjg4MzU3-flat-triad.h.html,43,snap-MDEwOlJlcG9zaXRvcnk0Mjg4MzU3-flat-triad.h,snap-MDEwOlJlcG9zaXRvcnk0Mjg4MzU3-flat-triad.h,87,92,5,56,61,5
259,https://htmlpreview.github.io/?https://github.com/Christina96/boilerplate-sample-matches/blob/main/Cpp/tesseract-MDEwOlJlcG9zaXRvcnkyMjg4NzA5NA==-flat-pithsync.cpp-tesseract-MDEwOlJlcG9zaXRvcnkyMjg4NzA5NA==-flat-coutln.cpp.html,14,tesseract-MDEwOlJlcG9zaXRvcnkyMjg4NzA5NA==-flat-pithsync.cpp,tesseract-MDEwOlJlcG9zaXRvcnkyMjg4NzA5NA==-flat-coutln.cpp,260,264,4,86,90,4
260,https://htmlpreview.github.io/?https://github.com/Christina96/boilerplate-sample-matches/blob/main/Cpp/notepad-plus-plus-MDEwOlJlcG9zaXRvcnkzMzAxNDgxMQ==-flat-tinyxmlA.cpp-notepad-plus-plus-MDEwOlJlcG9zaXRvcnkzMzAxNDgxMQ==-flat-tinyxml.cpp.html,27,notepad-plus-plus-MDEwOlJlcG9zaXRvcnkzMzAxNDgxMQ==-flat-tinyxmlA.cpp,notepad-plus-plus-MDEwOlJlcG9zaXRvcnkzMzAxNDgxMQ==-flat-tinyxml.cpp,567,575,8,579,587,8
261,https://htmlpreview.github.io/?https://github.com/Christina96/boilerplate-sample-matches/blob/main/Cpp/abseil-cpp-MDEwOlJlcG9zaXRvcnkxMDQyMzE1NDE=-flat-cord_ring_reader_test.cc-abseil-cpp-MDEwOlJlcG9zaXRvcnkxMDQyMzE1NDE=-flat-cord_ring_reader_test.cc.html,25,abseil-cpp-MDEwOlJlcG9zaXRvcnkxMDQyMzE1NDE=-flat-cord_ring_reader_test.cc,abseil-cpp-MDEwOlJlcG9zaXRvcnkxMDQyMzE1NDE=-flat-cord_ring_reader_test.cc,38,40,2,38,40,2
262,https://htmlpreview.github.io/?https://github.com/Christina96/boilerplate-sample-matches/blob/main/Cpp/Cpp_Primer_Answers-MDEwOlJlcG9zaXRvcnk0NzE3MDI2MQ==-flat-exercise10_16.cpp-Cpp_Primer_Answers-MDEwOlJlcG9zaXRvcnk0NzE3MDI2MQ==-flat-exercise10_16.cpp.html,24,Cpp_Primer_Answers-MDEwOlJlcG9zaXRvcnk0NzE3MDI2MQ==-flat-exercise10_16.cpp,Cpp_Primer_Answers-MDEwOlJlcG9zaXRvcnk0NzE3MDI2MQ==-flat-exercise10_16.cpp,33,37,4,33,37,4
263,https://htmlpreview.github.io/?https://github.com/Christina96/boilerplate-sample-matches/blob/main/Cpp/notepad-plus-plus-MDEwOlJlcG9zaXRvcnkzMzAxNDgxMQ==-flat-LexSTTXT.cxx-notepad-plus-plus-MDEwOlJlcG9zaXRvcnkzMzAxNDgxMQ==-flat-LexSTTXT.cxx.html,49,notepad-plus-plus-MDEwOlJlcG9zaXRvcnkzMzAxNDgxMQ==-flat-LexSTTXT.cxx,notepad-plus-plus-MDEwOlJlcG9zaXRvcnkzMzAxNDgxMQ==-flat-LexSTTXT.cxx,115,123,8,115,123,8
264,https://htmlpreview.github.io/?https://github.com/Christina96/boilerplate-sample-matches/blob/main/Cpp/abseil-cpp-MDEwOlJlcG9zaXRvcnkxMDQyMzE1NDE=-flat-cord_rep_ring.cc-abseil-cpp-MDEwOlJlcG9zaXRvcnkxMDQyMzE1NDE=-flat-cord_rep_ring.cc.html,24,abseil-cpp-MDEwOlJlcG9zaXRvcnkxMDQyMzE1NDE=-flat-cord_rep_ring.cc,abseil-cpp-MDEwOlJlcG9zaXRvcnkxMDQyMzE1NDE=-flat-cord_rep_ring.cc,527,531,4,527,531,4
265,https://htmlpreview.github.io/?https://github.com/Christina96/boilerplate-sample-matches/blob/main/Cpp/snap-MDEwOlJlcG9zaXRvcnk0Mjg4MzU3-flat-bowfl.cpp-snap-MDEwOlJlcG9zaXRvcnk0Mjg4MzU3-flat-bowfl.cpp.html,475,snap-MDEwOlJlcG9zaXRvcnk0Mjg4MzU3-flat-bowfl.cpp,snap-MDEwOlJlcG9zaXRvcnk0Mjg4MzU3-flat-bowfl.cpp,643,696,53,643,696,53
266,https://htmlpreview.github.io/?https://github.com/Christina96/boilerplate-sample-matches/blob/main/Cpp/caffe-MDEwOlJlcG9zaXRvcnk2MTg3MDgwMw==-flat-gtest.cc-caffe-MDEwOlJlcG9zaXRvcnk2MTg3MDgwMw==-flat-gtest.cc.html,36,caffe-MDEwOlJlcG9zaXRvcnk2MTg3MDgwMw==-flat-gtest.cc,caffe-MDEwOlJlcG9zaXRvcnk2MTg3MDgwMw==-flat-gtest.cc,1096,1111,15,1096,1111,15
267,https://htmlpreview.github.io/?https://github.com/Christina96/boilerplate-sample-matches/blob/main/Cpp/snap-MDEwOlJlcG9zaXRvcnk0Mjg4MzU3-flat-multimodal.cpp-snap-MDEwOlJlcG9zaXRvcnk0Mjg4MzU3-flat-multimodal.cpp.html,41,snap-MDEwOlJlcG9zaXRvcnk0Mjg4MzU3-flat-multimodal.cpp,snap-MDEwOlJlcG9zaXRvcnk0Mjg4MzU3-flat-multimodal.cpp,23,26,3,23,26,3
268,https://htmlpreview.github.io/?https://github.com/Christina96/boilerplate-sample-matches/blob/main/Cpp/nano-node-MDEwOlJlcG9zaXRvcnkxOTM0NzM0MA==-flat-locks_24.cpp-nano-node-MDEwOlJlcG9zaXRvcnkxOTM0NzM0MA==-flat-locks_24.cpp.html,46,nano-node-MDEwOlJlcG9zaXRvcnkxOTM0NzM0MA==-flat-locks_24.cpp,nano-node-MDEwOlJlcG9zaXRvcnkxOTM0NzM0MA==-flat-locks_24.cpp,25,32,7,44,51,7
269,https://htmlpreview.github.io/?https://github.com/Christina96/boilerplate-sample-matches/blob/main/Cpp/notepad-plus-plus-MDEwOlJlcG9zaXRvcnkzMzAxNDgxMQ==-flat-BabyGrid.cpp-notepad-plus-plus-MDEwOlJlcG9zaXRvcnkzMzAxNDgxMQ==-flat-BabyGrid.cpp.html,21,notepad-plus-plus-MDEwOlJlcG9zaXRvcnkzMzAxNDgxMQ==-flat-BabyGrid.cpp,notepad-plus-plus-MDEwOlJlcG9zaXRvcnkzMzAxNDgxMQ==-flat-BabyGrid.cpp,822,825,3,839,842,3
270,https://htmlpreview.github.io/?https://github.com/Christina96/boilerplate-sample-matches/blob/main/Cpp/abseil-cpp-MDEwOlJlcG9zaXRvcnkxMDQyMzE1NDE=-flat-str_format_test.cc-abseil-cpp-MDEwOlJlcG9zaXRvcnkxMDQyMzE1NDE=-flat-str_format_test.cc.html,22,abseil-cpp-MDEwOlJlcG9zaXRvcnkxMDQyMzE1NDE=-flat-str_format_test.cc,abseil-cpp-MDEwOlJlcG9zaXRvcnkxMDQyMzE1NDE=-flat-str_format_test.cc,897,902,5,910,915,5
271,https://htmlpreview.github.io/?https://github.com/Christina96/boilerplate-sample-matches/blob/main/Cpp/tesseract-MDEwOlJlcG9zaXRvcnkyMjg4NzA5NA==-flat-tablefind.cpp-tesseract-MDEwOlJlcG9zaXRvcnkyMjg4NzA5NA==-flat-tablefind.cpp.html,17,tesseract-MDEwOlJlcG9zaXRvcnkyMjg4NzA5NA==-flat-tablefind.cpp,tesseract-MDEwOlJlcG9zaXRvcnkyMjg4NzA5NA==-flat-tablefind.cpp,1011,1014,3,1255,1258,3
272,https://htmlpreview.github.io/?https://github.com/Christina96/boilerplate-sample-matches/blob/main/Cpp/notepad-plus-plus-MDEwOlJlcG9zaXRvcnkzMzAxNDgxMQ==-flat-LexBash.cxx-notepad-plus-plus-MDEwOlJlcG9zaXRvcnkzMzAxNDgxMQ==-flat-LexBash.cxx.html,15,notepad-plus-plus-MDEwOlJlcG9zaXRvcnkzMzAxNDgxMQ==-flat-LexBash.cxx,notepad-plus-plus-MDEwOlJlcG9zaXRvcnkzMzAxNDgxMQ==-flat-LexBash.cxx,801,803,2,801,803,2
273,https://htmlpreview.github.io/?https://github.com/Christina96/boilerplate-sample-matches/blob/main/Cpp/snap-MDEwOlJlcG9zaXRvcnk0Mjg4MzU3-flat-bowbs.h-snap-MDEwOlJlcG9zaXRvcnk0Mjg4MzU3-flat-wmine.h.html,22,snap-MDEwOlJlcG9zaXRvcnk0Mjg4MzU3-flat-bowbs.h,snap-MDEwOlJlcG9zaXRvcnk0Mjg4MzU3-flat-wmine.h,353,355,2,13,15,2
274,https://htmlpreview.github.io/?https://github.com/Christina96/boilerplate-sample-matches/blob/main/Cpp/notepad-plus-plus-MDEwOlJlcG9zaXRvcnkzMzAxNDgxMQ==-flat-Notepad_plus.cpp-notepad-plus-plus-MDEwOlJlcG9zaXRvcnkzMzAxNDgxMQ==-flat-Notepad_plus.cpp.html,19,notepad-plus-plus-MDEwOlJlcG9zaXRvcnkzMzAxNDgxMQ==-flat-Notepad_plus.cpp,notepad-plus-plus-MDEwOlJlcG9zaXRvcnkzMzAxNDgxMQ==-flat-Notepad_plus.cpp,4375,4377,2,4375,4377,2
275,https://htmlpreview.github.io/?https://github.com/Christina96/boilerplate-sample-matches/blob/main/Cpp/snap-MDEwOlJlcG9zaXRvcnk0Mjg4MzU3-flat-hldoc.cpp-snap-MDEwOlJlcG9zaXRvcnk0Mjg4MzU3-flat-yahoobs.cpp.html,149,snap-MDEwOlJlcG9zaXRvcnk0Mjg4MzU3-flat-hldoc.cpp,snap-MDEwOlJlcG9zaXRvcnk0Mjg4MzU3-flat-yahoobs.cpp,393,416,23,735,757,22
276,https://htmlpreview.github.io/?https://github.com/Christina96/boilerplate-sample-matches/blob/main/Cpp/abseil-cpp-MDEwOlJlcG9zaXRvcnkxMDQyMzE1NDE=-flat-flag_8.h-abseil-cpp-MDEwOlJlcG9zaXRvcnkxMDQyMzE1NDE=-flat-flag_8.h.html,23,abseil-cpp-MDEwOlJlcG9zaXRvcnkxMDQyMzE1NDE=-flat-flag_8.h,abseil-cpp-MDEwOlJlcG9zaXRvcnkxMDQyMzE1NDE=-flat-flag_8.h,197,200,3,197,200,3
277,https://htmlpreview.github.io/?https://github.com/Christina96/boilerplate-sample-matches/blob/main/Cpp/subconverter-MDEwOlJlcG9zaXRvcnkyMTg2ODY3NjM=-flat-json.hpp-notepad-plus-plus-MDEwOlJlcG9zaXRvcnkzMzAxNDgxMQ==-flat-json.hpp.html,9423,subconverter-MDEwOlJlcG9zaXRvcnkyMTg2ODY3NjM=-flat-json.hpp,notepad-plus-plus-MDEwOlJlcG9zaXRvcnkzMzAxNDgxMQ==-flat-json.hpp,2057,2200,143,2225,2368,143
278,https://htmlpreview.github.io/?https://github.com/Christina96/boilerplate-sample-matches/blob/main/Cpp/glm-MDEwOlJlcG9zaXRvcnk4NDM2MzE=-flat-gtc_matrix_access.cpp-glm-MDEwOlJlcG9zaXRvcnk4NDM2MzE=-flat-gtx_random.cpp.html,18,glm-MDEwOlJlcG9zaXRvcnk4NDM2MzE=-flat-gtc_matrix_access.cpp,glm-MDEwOlJlcG9zaXRvcnk4NDM2MzE=-flat-gtx_random.cpp,260,263,3,71,74,3
279,https://htmlpreview.github.io/?https://github.com/Christina96/boilerplate-sample-matches/blob/main/Cpp/caffe-MDEwOlJlcG9zaXRvcnk2MTg3MDgwMw==-flat-caffe.cpp-caffe-MDEwOlJlcG9zaXRvcnk2MTg3MDgwMw==-flat-sample.cpp.html,38,caffe-MDEwOlJlcG9zaXRvcnk2MTg3MDgwMw==-flat-caffe.cpp,caffe-MDEwOlJlcG9zaXRvcnk2MTg3MDgwMw==-flat-sample.cpp,104,111,7,60,67,7
280,https://htmlpreview.github.io/?https://github.com/Christina96/boilerplate-sample-matches/blob/main/Cpp/snap-MDEwOlJlcG9zaXRvcnk0Mjg4MzU3-flat-appsrv.cpp-snap-MDEwOlJlcG9zaXRvcnk0Mjg4MzU3-flat-appsrv.cpp.html,14,snap-MDEwOlJlcG9zaXRvcnk0Mjg4MzU3-flat-appsrv.cpp,snap-MDEwOlJlcG9zaXRvcnk0Mjg4MzU3-flat-appsrv.cpp,200,203,3,200,203,3
281,https://htmlpreview.github.io/?https://github.com/Christina96/boilerplate-sample-matches/blob/main/Cpp/snap-MDEwOlJlcG9zaXRvcnk0Mjg4MzU3-flat-test.cpp-snap-MDEwOlJlcG9zaXRvcnk0Mjg4MzU3-flat-test.cpp.html,27,snap-MDEwOlJlcG9zaXRvcnk0Mjg4MzU3-flat-test.cpp,snap-MDEwOlJlcG9zaXRvcnk0Mjg4MzU3-flat-test.cpp,72,75,3,72,75,3
282,https://htmlpreview.github.io/?https://github.com/Christina96/boilerplate-sample-matches/blob/main/Cpp/Cpp_Primer_Answers-MDEwOlJlcG9zaXRvcnk0NzE3MDI2MQ==-flat-exercise14_45.cpp-Cpp_Primer_Answers-MDEwOlJlcG9zaXRvcnk0NzE3MDI2MQ==-flat-exercise14_2.cpp.html,89,Cpp_Primer_Answers-MDEwOlJlcG9zaXRvcnk0NzE3MDI2MQ==-flat-exercise14_45.cpp,Cpp_Primer_Answers-MDEwOlJlcG9zaXRvcnk0NzE3MDI2MQ==-flat-exercise14_2.cpp,19,33,14,19,32,13
283,https://htmlpreview.github.io/?https://github.com/Christina96/boilerplate-sample-matches/blob/main/Cpp/nano-node-MDEwOlJlcG9zaXRvcnkxOTM0NzM0MA==-flat-cl.h-nano-node-MDEwOlJlcG9zaXRvcnkxOTM0NzM0MA==-flat-cl.h.html,19,nano-node-MDEwOlJlcG9zaXRvcnkxOTM0NzM0MA==-flat-cl.h,nano-node-MDEwOlJlcG9zaXRvcnkxOTM0NzM0MA==-flat-cl.h,69,75,6,69,75,6
284,https://htmlpreview.github.io/?https://github.com/Christina96/boilerplate-sample-matches/blob/main/Cpp/snap-MDEwOlJlcG9zaXRvcnk0Mjg4MzU3-flat-netobj.cpp-snap-MDEwOlJlcG9zaXRvcnk0Mjg4MzU3-flat-websrv.cpp.html,26,snap-MDEwOlJlcG9zaXRvcnk0Mjg4MzU3-flat-netobj.cpp,snap-MDEwOlJlcG9zaXRvcnk0Mjg4MzU3-flat-websrv.cpp,118,121,3,34,37,3
285,https://htmlpreview.github.io/?https://github.com/Christina96/boilerplate-sample-matches/blob/main/Cpp/snap-MDEwOlJlcG9zaXRvcnk0Mjg4MzU3-flat-semspace.cpp-snap-MDEwOlJlcG9zaXRvcnk0Mjg4MzU3-flat-semspace.cpp.html,37,snap-MDEwOlJlcG9zaXRvcnk0Mjg4MzU3-flat-semspace.cpp,snap-MDEwOlJlcG9zaXRvcnk0Mjg4MzU3-flat-semspace.cpp,260,263,3,260,263,3
286,https://htmlpreview.github.io/?https://github.com/Christina96/boilerplate-sample-matches/blob/main/Cpp/snap-MDEwOlJlcG9zaXRvcnk0Mjg4MzU3-flat-flx.cpp-snap-MDEwOlJlcG9zaXRvcnk0Mjg4MzU3-flat-flx.cpp.html,17,snap-MDEwOlJlcG9zaXRvcnk0Mjg4MzU3-flat-flx.cpp,snap-MDEwOlJlcG9zaXRvcnk0Mjg4MzU3-flat-flx.cpp,138,139,1,138,139,1
287,https://htmlpreview.github.io/?https://github.com/Christina96/boilerplate-sample-matches/blob/main/Cpp/abseil-cpp-MDEwOlJlcG9zaXRvcnkxMDQyMzE1NDE=-flat-btree_test.cc-abseil-cpp-MDEwOlJlcG9zaXRvcnkxMDQyMzE1NDE=-flat-btree_test.cc.html,25,abseil-cpp-MDEwOlJlcG9zaXRvcnkxMDQyMzE1NDE=-flat-btree_test.cc,abseil-cpp-MDEwOlJlcG9zaXRvcnkxMDQyMzE1NDE=-flat-btree_test.cc,2144,2146,2,2141,2143,2
288,https://htmlpreview.github.io/?https://github.com/Christina96/boilerplate-sample-matches/blob/main/Cpp/tesseract-MDEwOlJlcG9zaXRvcnkyMjg4NzA5NA==-flat-cluster.cpp-tesseract-MDEwOlJlcG9zaXRvcnkyMjg4NzA5NA==-flat-cluster.cpp.html,14,tesseract-MDEwOlJlcG9zaXRvcnkyMjg4NzA5NA==-flat-cluster.cpp,tesseract-MDEwOlJlcG9zaXRvcnkyMjg4NzA5NA==-flat-cluster.cpp,1589,1593,4,1589,1593,4
289,https://htmlpreview.github.io/?https://github.com/Christina96/boilerplate-sample-matches/blob/main/Cpp/snap-MDEwOlJlcG9zaXRvcnk0Mjg4MzU3-flat-stopword.cpp-snap-MDEwOlJlcG9zaXRvcnk0Mjg4MzU3-flat-stopword.cpp.html,16,snap-MDEwOlJlcG9zaXRvcnk0Mjg4MzU3-flat-stopword.cpp,snap-MDEwOlJlcG9zaXRvcnk0Mjg4MzU3-flat-stopword.cpp,454,461,7,203,210,7
290,https://htmlpreview.github.io/?https://github.com/Christina96/boilerplate-sample-matches/blob/main/Cpp/notepad-plus-plus-MDEwOlJlcG9zaXRvcnkzMzAxNDgxMQ==-flat-LexCmake.cxx-notepad-plus-plus-MDEwOlJlcG9zaXRvcnkzMzAxNDgxMQ==-flat-LexNsis.cxx.html,68,notepad-plus-plus-MDEwOlJlcG9zaXRvcnkzMzAxNDgxMQ==-flat-LexCmake.cxx,notepad-plus-plus-MDEwOlJlcG9zaXRvcnkzMzAxNDgxMQ==-flat-LexNsis.cxx,348,362,14,506,520,14
291,https://htmlpreview.github.io/?https://github.com/Christina96/boilerplate-sample-matches/blob/main/Cpp/tesseract-MDEwOlJlcG9zaXRvcnkyMjg4NzA5NA==-flat-tospace.cpp-tesseract-MDEwOlJlcG9zaXRvcnkyMjg4NzA5NA==-flat-tospace.cpp.html,44,tesseract-MDEwOlJlcG9zaXRvcnkyMjg4NzA5NA==-flat-tospace.cpp,tesseract-MDEwOlJlcG9zaXRvcnkyMjg4NzA5NA==-flat-tospace.cpp,1079,1088,9,1048,1057,9
292,https://htmlpreview.github.io/?https://github.com/Christina96/boilerplate-sample-matches/blob/main/Cpp/nano-node-MDEwOlJlcG9zaXRvcnkxOTM0NzM0MA==-flat-tomlconfig.cpp-tesseract-MDEwOlJlcG9zaXRvcnkyMjg4NzA5NA==-flat-pageres.cpp.html,14,nano-node-MDEwOlJlcG9zaXRvcnkxOTM0NzM0MA==-flat-tomlconfig.cpp,tesseract-MDEwOlJlcG9zaXRvcnkyMjg4NzA5NA==-flat-pageres.cpp,88,90,2,570,572,2
293,https://htmlpreview.github.io/?https://github.com/Christina96/boilerplate-sample-matches/blob/main/Cpp/notepad-plus-plus-MDEwOlJlcG9zaXRvcnkzMzAxNDgxMQ==-flat-Editor.cxx-notepad-plus-plus-MDEwOlJlcG9zaXRvcnkzMzAxNDgxMQ==-flat-Editor.cxx.html,16,notepad-plus-plus-MDEwOlJlcG9zaXRvcnkzMzAxNDgxMQ==-flat-Editor.cxx,notepad-plus-plus-MDEwOlJlcG9zaXRvcnkzMzAxNDgxMQ==-flat-Editor.cxx,731,733,2,731,733,2
294,https://htmlpreview.github.io/?https://github.com/Christina96/boilerplate-sample-matches/blob/main/Cpp/snap-MDEwOlJlcG9zaXRvcnk0Mjg4MzU3-flat-btalarms.cpp-snap-MDEwOlJlcG9zaXRvcnk0Mjg4MzU3-flat-btalarms.cpp.html,23,snap-MDEwOlJlcG9zaXRvcnk0Mjg4MzU3-flat-btalarms.cpp,snap-MDEwOlJlcG9zaXRvcnk0Mjg4MzU3-flat-btalarms.cpp,1251,1253,2,1251,1253,2
295,https://htmlpreview.github.io/?https://github.com/Christina96/boilerplate-sample-matches/blob/main/Cpp/notepad-plus-plus-MDEwOlJlcG9zaXRvcnkzMzAxNDgxMQ==-flat-basic_regex.hpp-notepad-plus-plus-MDEwOlJlcG9zaXRvcnkzMzAxNDgxMQ==-flat-basic_regex.hpp.html,21,notepad-plus-plus-MDEwOlJlcG9zaXRvcnkzMzAxNDgxMQ==-flat-basic_regex.hpp,notepad-plus-plus-MDEwOlJlcG9zaXRvcnkzMzAxNDgxMQ==-flat-basic_regex.hpp,158,163,5,158,163,5
296,https://htmlpreview.github.io/?https://github.com/Christina96/boilerplate-sample-matches/blob/main/Cpp/nano-node-MDEwOlJlcG9zaXRvcnkxOTM0NzM0MA==-flat-versioning.hpp-nano-node-MDEwOlJlcG9zaXRvcnkxOTM0NzM0MA==-flat-messages.hpp.html,15,nano-node-MDEwOlJlcG9zaXRvcnkxOTM0NzM0MA==-flat-versioning.hpp,nano-node-MDEwOlJlcG9zaXRvcnkxOTM0NzM0MA==-flat-messages.hpp,43,45,2,173,175,2
297,https://htmlpreview.github.io/?https://github.com/Christina96/boilerplate-sample-matches/blob/main/Cpp/caffe-MDEwOlJlcG9zaXRvcnk2MTg3MDgwMw==-flat-test_image_data_layer.cpp-caffe-MDEwOlJlcG9zaXRvcnk2MTg3MDgwMw==-flat-test_image_data_layer.cpp.html,16,caffe-MDEwOlJlcG9zaXRvcnk2MTg3MDgwMw==-flat-test_image_data_layer.cpp,caffe-MDEwOlJlcG9zaXRvcnk2MTg3MDgwMw==-flat-test_image_data_layer.cpp,62,64,2,77,79,2
298,https://htmlpreview.github.io/?https://github.com/Christina96/boilerplate-sample-matches/blob/main/Cpp/abseil-cpp-MDEwOlJlcG9zaXRvcnkxMDQyMzE1NDE=-flat-numbers_test.cc-abseil-cpp-MDEwOlJlcG9zaXRvcnkxMDQyMzE1NDE=-flat-numbers_test.cc.html,164,abseil-cpp-MDEwOlJlcG9zaXRvcnkxMDQyMzE1NDE=-flat-numbers_test.cc,abseil-cpp-MDEwOlJlcG9zaXRvcnkxMDQyMzE1NDE=-flat-numbers_test.cc,1191,1211,20,1131,1151,20
299,https://htmlpreview.github.io/?https://github.com/Christina96/boilerplate-sample-matches/blob/main/Cpp/tesseract-MDEwOlJlcG9zaXRvcnkyMjg4NzA5NA==-flat-rejctmap.cpp-notepad-plus-plus-MDEwOlJlcG9zaXRvcnkzMzAxNDgxMQ==-flat-Parameters.h.html,18,tesseract-MDEwOlJlcG9zaXRvcnkyMjg4NzA5NA==-flat-rejctmap.cpp,notepad-plus-plus-MDEwOlJlcG9zaXRvcnkzMzAxNDgxMQ==-flat-Parameters.h,39,43,4,863,867,4
300,https://htmlpreview.github.io/?https://github.com/Christina96/boilerplate-sample-matches/blob/main/Cpp/snap-MDEwOlJlcG9zaXRvcnk0Mjg4MzU3-flat-util.cpp-snap-MDEwOlJlcG9zaXRvcnk0Mjg4MzU3-flat-util.cpp.html,26,snap-MDEwOlJlcG9zaXRvcnk0Mjg4MzU3-flat-util.cpp,snap-MDEwOlJlcG9zaXRvcnk0Mjg4MzU3-flat-util.cpp,103,108,5,103,108,5
301,https://htmlpreview.github.io/?https://github.com/Christina96/boilerplate-sample-matches/blob/main/Cpp/tesseract-MDEwOlJlcG9zaXRvcnkyMjg4NzA5NA==-flat-reversed.cpp-tesseract-MDEwOlJlcG9zaXRvcnkyMjg4NzA5NA==-flat-reversed.cpp.html,27,tesseract-MDEwOlJlcG9zaXRvcnkyMjg4NzA5NA==-flat-reversed.cpp,tesseract-MDEwOlJlcG9zaXRvcnkyMjg4NzA5NA==-flat-reversed.cpp,33,36,3,33,36,3
302,https://htmlpreview.github.io/?https://github.com/Christina96/boilerplate-sample-matches/blob/main/Cpp/abseil-cpp-MDEwOlJlcG9zaXRvcnkxMDQyMzE1NDE=-flat-unordered_map_constructor_test.h-abseil-cpp-MDEwOlJlcG9zaXRvcnkxMDQyMzE1NDE=-flat-unordered_set_constructor_test.h.html,248,abseil-cpp-MDEwOlJlcG9zaXRvcnkxMDQyMzE1NDE=-flat-unordered_map_constructor_test.h,abseil-cpp-MDEwOlJlcG9zaXRvcnkxMDQyMzE1NDE=-flat-unordered_set_constructor_test.h,379,412,33,384,417,33
303,https://htmlpreview.github.io/?https://github.com/Christina96/boilerplate-sample-matches/blob/main/Cpp/caffe-MDEwOlJlcG9zaXRvcnk2MTg3MDgwMw==-flat-mkldnn_convolution_layer.cpp-caffe-MDEwOlJlcG9zaXRvcnk2MTg3MDgwMw==-flat-mkldnn_convolution_layer.cpp.html,20,caffe-MDEwOlJlcG9zaXRvcnk2MTg3MDgwMw==-flat-mkldnn_convolution_layer.cpp,caffe-MDEwOlJlcG9zaXRvcnk2MTg3MDgwMw==-flat-mkldnn_convolution_layer.cpp,372,373,1,375,377,2
304,https://htmlpreview.github.io/?https://github.com/Christina96/boilerplate-sample-matches/blob/main/Cpp/notepad-plus-plus-MDEwOlJlcG9zaXRvcnkzMzAxNDgxMQ==-flat-TestLexers.cxx-notepad-plus-plus-MDEwOlJlcG9zaXRvcnkzMzAxNDgxMQ==-flat-TestLexers.cxx.html,24,notepad-plus-plus-MDEwOlJlcG9zaXRvcnkzMzAxNDgxMQ==-flat-TestLexers.cxx,notepad-plus-plus-MDEwOlJlcG9zaXRvcnkzMzAxNDgxMQ==-flat-TestLexers.cxx,721,724,3,724,727,3
305,https://htmlpreview.github.io/?https://github.com/Christina96/boilerplate-sample-matches/blob/main/Cpp/notepad-plus-plus-MDEwOlJlcG9zaXRvcnkzMzAxNDgxMQ==-flat-tinyxmlparserA.cpp-notepad-plus-plus-MDEwOlJlcG9zaXRvcnkzMzAxNDgxMQ==-flat-tinyxmlparserA.cpp.html,24,notepad-plus-plus-MDEwOlJlcG9zaXRvcnkzMzAxNDgxMQ==-flat-tinyxmlparserA.cpp,notepad-plus-plus-MDEwOlJlcG9zaXRvcnkzMzAxNDgxMQ==-flat-tinyxmlparserA.cpp,751,755,4,757,762,5
306,https://htmlpreview.github.io/?https://github.com/Christina96/boilerplate-sample-matches/blob/main/Cpp/snap-MDEwOlJlcG9zaXRvcnk0Mjg4MzU3-flat-euproj.cpp-snap-MDEwOlJlcG9zaXRvcnk0Mjg4MzU3-flat-euproj.cpp.html,25,snap-MDEwOlJlcG9zaXRvcnk0Mjg4MzU3-flat-euproj.cpp,snap-MDEwOlJlcG9zaXRvcnk0Mjg4MzU3-flat-euproj.cpp,706,708,2,691,693,2
307,https://htmlpreview.github.io/?https://github.com/Christina96/boilerplate-sample-matches/blob/main/Cpp/snap-MDEwOlJlcG9zaXRvcnk0Mjg4MzU3-flat-btaserver.cpp-snap-MDEwOlJlcG9zaXRvcnk0Mjg4MzU3-flat-btaserver.cpp.html,27,snap-MDEwOlJlcG9zaXRvcnk0Mjg4MzU3-flat-btaserver.cpp,snap-MDEwOlJlcG9zaXRvcnk0Mjg4MzU3-flat-btaserver.cpp,586,591,5,586,591,5
308,https://htmlpreview.github.io/?https://github.com/Christina96/boilerplate-sample-matches/blob/main/Cpp/tesseract-MDEwOlJlcG9zaXRvcnkyMjg4NzA5NA==-flat-clst.h-tesseract-MDEwOlJlcG9zaXRvcnkyMjg4NzA5NA==-flat-clst.h.html,67,tesseract-MDEwOlJlcG9zaXRvcnkyMjg4NzA5NA==-flat-clst.h,tesseract-MDEwOlJlcG9zaXRvcnkyMjg4NzA5NA==-flat-clst.h,50,63,13,50,63,13
309,https://htmlpreview.github.io/?https://github.com/Christina96/boilerplate-sample-matches/blob/main/Cpp/nano-node-MDEwOlJlcG9zaXRvcnkxOTM0NzM0MA==-flat-ed25519-donna-64bit-x86.h-nano-node-MDEwOlJlcG9zaXRvcnkxOTM0NzM0MA==-flat-ed25519-donna-64bit-x86.h.html,83,nano-node-MDEwOlJlcG9zaXRvcnkxOTM0NzM0MA==-flat-ed25519-donna-64bit-x86.h,nano-node-MDEwOlJlcG9zaXRvcnkxOTM0NzM0MA==-flat-ed25519-donna-64bit-x86.h,299,311,12,299,311,12
310,https://htmlpreview.github.io/?https://github.com/Christina96/boilerplate-sample-matches/blob/main/Cpp/notepad-plus-plus-MDEwOlJlcG9zaXRvcnkzMzAxNDgxMQ==-flat-tinystr.cpp-notepad-plus-plus-MDEwOlJlcG9zaXRvcnkzMzAxNDgxMQ==-flat-tinystr.cpp.html,18,notepad-plus-plus-MDEwOlJlcG9zaXRvcnkzMzAxNDgxMQ==-flat-tinystr.cpp,notepad-plus-plus-MDEwOlJlcG9zaXRvcnkzMzAxNDgxMQ==-flat-tinystr.cpp,132,137,5,132,137,5
311,https://htmlpreview.github.io/?https://github.com/Christina96/boilerplate-sample-matches/blob/main/Cpp/tesseract-MDEwOlJlcG9zaXRvcnkyMjg4NzA5NA==-flat-normalis.cpp-tesseract-MDEwOlJlcG9zaXRvcnkyMjg4NzA5NA==-flat-normalis.cpp.html,14,tesseract-MDEwOlJlcG9zaXRvcnkyMjg4NzA5NA==-flat-normalis.cpp,tesseract-MDEwOlJlcG9zaXRvcnkyMjg4NzA5NA==-flat-normalis.cpp,245,247,2,170,172,2
312,https://htmlpreview.github.io/?https://github.com/Christina96/boilerplate-sample-matches/blob/main/Cpp/snap-MDEwOlJlcG9zaXRvcnk0Mjg4MzU3-flat-nlpwinlf.cpp-snap-MDEwOlJlcG9zaXRvcnk0Mjg4MzU3-flat-table.h.html,15,snap-MDEwOlJlcG9zaXRvcnk0Mjg4MzU3-flat-nlpwinlf.cpp,snap-MDEwOlJlcG9zaXRvcnk0Mjg4MzU3-flat-table.h,112,114,2,1032,1034,2
313,https://htmlpreview.github.io/?https://github.com/Christina96/boilerplate-sample-matches/blob/main/Cpp/Cpp_Primer_Answers-MDEwOlJlcG9zaXRvcnk0NzE3MDI2MQ==-flat-exercise3_20.cpp-Cpp_Primer_Answers-MDEwOlJlcG9zaXRvcnk0NzE3MDI2MQ==-flat-exercise3_20.cpp.html,18,Cpp_Primer_Answers-MDEwOlJlcG9zaXRvcnk0NzE3MDI2MQ==-flat-exercise3_20.cpp,Cpp_Primer_Answers-MDEwOlJlcG9zaXRvcnk0NzE3MDI2MQ==-flat-exercise3_20.cpp,13,18,5,13,18,5
314,https://htmlpreview.github.io/?https://github.com/Christina96/boilerplate-sample-matches/blob/main/Cpp/notepad-plus-plus-MDEwOlJlcG9zaXRvcnkzMzAxNDgxMQ==-flat-LexCOBOL.cxx-notepad-plus-plus-MDEwOlJlcG9zaXRvcnkzMzAxNDgxMQ==-flat-LexScriptol.cxx.html,15,notepad-plus-plus-MDEwOlJlcG9zaXRvcnkzMzAxNDgxMQ==-flat-LexCOBOL.cxx,notepad-plus-plus-MDEwOlJlcG9zaXRvcnkzMzAxNDgxMQ==-flat-LexScriptol.cxx,161,163,2,134,136,2
315,https://htmlpreview.github.io/?https://github.com/Christina96/boilerplate-sample-matches/blob/main/Cpp/abseil-cpp-MDEwOlJlcG9zaXRvcnkxMDQyMzE1NDE=-flat-raw_hash_map.h-abseil-cpp-MDEwOlJlcG9zaXRvcnkxMDQyMzE1NDE=-flat-raw_hash_map.h.html,19,abseil-cpp-MDEwOlJlcG9zaXRvcnkxMDQyMzE1NDE=-flat-raw_hash_map.h,abseil-cpp-MDEwOlJlcG9zaXRvcnkxMDQyMzE1NDE=-flat-raw_hash_map.h,104,109,5,114,119,5
316,https://htmlpreview.github.io/?https://github.com/Christina96/boilerplate-sample-matches/blob/main/Cpp/subconverter-MDEwOlJlcG9zaXRvcnkyMTg2ODY3NjM=-flat-quickjspp.hpp-notepad-plus-plus-MDEwOlJlcG9zaXRvcnkzMzAxNDgxMQ==-flat-ScintillaGTK.cxx.html,14,subconverter-MDEwOlJlcG9zaXRvcnkyMTg2ODY3NjM=-flat-quickjspp.hpp,notepad-plus-plus-MDEwOlJlcG9zaXRvcnkzMzAxNDgxMQ==-flat-ScintillaGTK.cxx,528,530,2,486,488,2
317,https://htmlpreview.github.io/?https://github.com/Christina96/boilerplate-sample-matches/blob/main/Cpp/notepad-plus-plus-MDEwOlJlcG9zaXRvcnkzMzAxNDgxMQ==-flat-ScintillaGTKAccessible.cxx-notepad-plus-plus-MDEwOlJlcG9zaXRvcnkzMzAxNDgxMQ==-flat-BabyGrid.cpp.html,27,notepad-plus-plus-MDEwOlJlcG9zaXRvcnkzMzAxNDgxMQ==-flat-ScintillaGTKAccessible.cxx,notepad-plus-plus-MDEwOlJlcG9zaXRvcnkzMzAxNDgxMQ==-flat-BabyGrid.cpp,814,818,4,521,525,4
318,https://htmlpreview.github.io/?https://github.com/Christina96/boilerplate-sample-matches/blob/main/Cpp/snap-MDEwOlJlcG9zaXRvcnk0Mjg4MzU3-flat-agmfit.cpp-snap-MDEwOlJlcG9zaXRvcnk0Mjg4MzU3-flat-agmfit.cpp.html,36,snap-MDEwOlJlcG9zaXRvcnk0Mjg4MzU3-flat-agmfit.cpp,snap-MDEwOlJlcG9zaXRvcnk0Mjg4MzU3-flat-agmfit.cpp,282,284,2,282,284,2
319,https://htmlpreview.github.io/?https://github.com/Christina96/boilerplate-sample-matches/blob/main/Cpp/snap-MDEwOlJlcG9zaXRvcnk0Mjg4MzU3-flat-bowfl.cpp-snap-MDEwOlJlcG9zaXRvcnk0Mjg4MzU3-flat-bowfl.cpp.html,15,snap-MDEwOlJlcG9zaXRvcnk0Mjg4MzU3-flat-bowfl.cpp,snap-MDEwOlJlcG9zaXRvcnk0Mjg4MzU3-flat-bowfl.cpp,720,723,3,720,723,3
320,https://htmlpreview.github.io/?https://github.com/Christina96/boilerplate-sample-matches/blob/main/Cpp/caffe-MDEwOlJlcG9zaXRvcnk2MTg3MDgwMw==-flat-gtest.cc-caffe-MDEwOlJlcG9zaXRvcnk2MTg3MDgwMw==-flat-gtest.cc.html,17,caffe-MDEwOlJlcG9zaXRvcnk2MTg3MDgwMw==-flat-gtest.cc,caffe-MDEwOlJlcG9zaXRvcnk2MTg3MDgwMw==-flat-gtest.cc,2641,2642,1,1493,1494,1
321,https://htmlpreview.github.io/?https://github.com/Christina96/boilerplate-sample-matches/blob/main/Cpp/nano-node-MDEwOlJlcG9zaXRvcnkxOTM0NzM0MA==-flat-memory_pool.cpp-nano-node-MDEwOlJlcG9zaXRvcnkxOTM0NzM0MA==-flat-memory_pool.cpp.html,22,nano-node-MDEwOlJlcG9zaXRvcnkxOTM0NzM0MA==-flat-memory_pool.cpp,nano-node-MDEwOlJlcG9zaXRvcnkxOTM0NzM0MA==-flat-memory_pool.cpp,56,58,2,53,55,2
322,https://htmlpreview.github.io/?https://github.com/Christina96/boilerplate-sample-matches/blob/main/Cpp/notepad-plus-plus-MDEwOlJlcG9zaXRvcnkzMzAxNDgxMQ==-flat-PlatQt.cpp-notepad-plus-plus-MDEwOlJlcG9zaXRvcnkzMzAxNDgxMQ==-flat-PlatQt.cpp.html,39,notepad-plus-plus-MDEwOlJlcG9zaXRvcnkzMzAxNDgxMQ==-flat-PlatQt.cpp,notepad-plus-plus-MDEwOlJlcG9zaXRvcnkzMzAxNDgxMQ==-flat-PlatQt.cpp,348,352,4,348,352,4
323,https://htmlpreview.github.io/?https://github.com/Christina96/boilerplate-sample-matches/blob/main/Cpp/nano-node-MDEwOlJlcG9zaXRvcnkxOTM0NzM0MA==-flat-entry.cpp-nano-node-MDEwOlJlcG9zaXRvcnkxOTM0NzM0MA==-flat-entry.cpp.html,26,nano-node-MDEwOlJlcG9zaXRvcnkxOTM0NzM0MA==-flat-entry.cpp,nano-node-MDEwOlJlcG9zaXRvcnkxOTM0NzM0MA==-flat-entry.cpp,413,417,4,413,417,4
324,https://htmlpreview.github.io/?https://github.com/Christina96/boilerplate-sample-matches/blob/main/Cpp/tesseract-MDEwOlJlcG9zaXRvcnkyMjg4NzA5NA==-flat-pgedit.cpp-notepad-plus-plus-MDEwOlJlcG9zaXRvcnkzMzAxNDgxMQ==-flat-preferenceDlg.cpp.html,15,tesseract-MDEwOlJlcG9zaXRvcnkyMjg4NzA5NA==-flat-pgedit.cpp,notepad-plus-plus-MDEwOlJlcG9zaXRvcnkzMzAxNDgxMQ==-flat-preferenceDlg.cpp,708,711,3,1210,1213,3
325,https://htmlpreview.github.io/?https://github.com/Christina96/boilerplate-sample-matches/blob/main/Cpp/tesseract-MDEwOlJlcG9zaXRvcnkyMjg4NzA5NA==-flat-trie.cpp-tesseract-MDEwOlJlcG9zaXRvcnkyMjg4NzA5NA==-flat-trie.cpp.html,42,tesseract-MDEwOlJlcG9zaXRvcnkyMjg4NzA5NA==-flat-trie.cpp,tesseract-MDEwOlJlcG9zaXRvcnkyMjg4NzA5NA==-flat-trie.cpp,193,198,5,193,198,5
326,https://htmlpreview.github.io/?https://github.com/Christina96/boilerplate-sample-matches/blob/main/Cpp/MMKV-MDEwOlJlcG9zaXRvcnkxNDkxMTE4MTM=-flat-MMKV_IO.cpp-MMKV-MDEwOlJlcG9zaXRvcnkxNDkxMTE4MTM=-flat-MMKV_IO.cpp.html,84,MMKV-MDEwOlJlcG9zaXRvcnkxNDkxMTE4MTM=-flat-MMKV_IO.cpp,MMKV-MDEwOlJlcG9zaXRvcnkxNDkxMTE4MTM=-flat-MMKV_IO.cpp,1137,1147,10,1137,1147,10
327,https://htmlpreview.github.io/?https://github.com/Christina96/boilerplate-sample-matches/blob/main/Cpp/tesseract-MDEwOlJlcG9zaXRvcnkyMjg4NzA5NA==-flat-thresholder.cpp-tesseract-MDEwOlJlcG9zaXRvcnkyMjg4NzA5NA==-flat-thresholder.cpp.html,21,tesseract-MDEwOlJlcG9zaXRvcnkyMjg4NzA5NA==-flat-thresholder.cpp,tesseract-MDEwOlJlcG9zaXRvcnkyMjg4NzA5NA==-flat-thresholder.cpp,111,115,4,212,216,4
328,https://htmlpreview.github.io/?https://github.com/Christina96/boilerplate-sample-matches/blob/main/Cpp/notepad-plus-plus-MDEwOlJlcG9zaXRvcnkzMzAxNDgxMQ==-flat-CellBuffer.cxx-notepad-plus-plus-MDEwOlJlcG9zaXRvcnkzMzAxNDgxMQ==-flat-CellBuffer.cxx.html,19,notepad-plus-plus-MDEwOlJlcG9zaXRvcnkzMzAxNDgxMQ==-flat-CellBuffer.cxx,notepad-plus-plus-MDEwOlJlcG9zaXRvcnkzMzAxNDgxMQ==-flat-CellBuffer.cxx,407,410,3,384,387,3
329,https://htmlpreview.github.io/?https://github.com/Christina96/boilerplate-sample-matches/blob/main/Cpp/snap-MDEwOlJlcG9zaXRvcnk0Mjg4MzU3-flat-yahoodm.cpp-snap-MDEwOlJlcG9zaXRvcnk0Mjg4MzU3-flat-dmoz.cpp.html,18,snap-MDEwOlJlcG9zaXRvcnk0Mjg4MzU3-flat-yahoodm.cpp,snap-MDEwOlJlcG9zaXRvcnk0Mjg4MzU3-flat-dmoz.cpp,205,210,5,26,32,6
330,https://htmlpreview.github.io/?https://github.com/Christina96/boilerplate-sample-matches/blob/main/Cpp/abseil-cpp-MDEwOlJlcG9zaXRvcnkxMDQyMzE1NDE=-flat-int128.cc-abseil-cpp-MDEwOlJlcG9zaXRvcnkxMDQyMzE1NDE=-flat-int128.cc.html,33,abseil-cpp-MDEwOlJlcG9zaXRvcnkxMDQyMzE1NDE=-flat-int128.cc,abseil-cpp-MDEwOlJlcG9zaXRvcnkxMDQyMzE1NDE=-flat-int128.cc,295,298,3,295,298,3
331,https://htmlpreview.github.io/?https://github.com/Christina96/boilerplate-sample-matches/blob/main/Cpp/snap-MDEwOlJlcG9zaXRvcnk0Mjg4MzU3-flat-rand-construct-exp.cpp-snap-MDEwOlJlcG9zaXRvcnk0Mjg4MzU3-flat-delete-exp.cpp.html,22,snap-MDEwOlJlcG9zaXRvcnk0Mjg4MzU3-flat-rand-construct-exp.cpp,snap-MDEwOlJlcG9zaXRvcnk0Mjg4MzU3-flat-delete-exp.cpp,18,20,2,24,26,2
332,https://htmlpreview.github.io/?https://github.com/Christina96/boilerplate-sample-matches/blob/main/Cpp/subconverter-MDEwOlJlcG9zaXRvcnkyMTg2ODY3NjM=-flat-webget.cpp-subconverter-MDEwOlJlcG9zaXRvcnkyMTg2ODY3NjM=-flat-webget.cpp.html,22,subconverter-MDEwOlJlcG9zaXRvcnkyMTg2ODY3NjM=-flat-webget.cpp,subconverter-MDEwOlJlcG9zaXRvcnkyMTg2ODY3NjM=-flat-webget.cpp,353,356,3,346,349,3
333,https://htmlpreview.github.io/?https://github.com/Christina96/boilerplate-sample-matches/blob/main/Cpp/notepad-plus-plus-MDEwOlJlcG9zaXRvcnkzMzAxNDgxMQ==-flat-w32_regex_traits.hpp-notepad-plus-plus-MDEwOlJlcG9zaXRvcnkzMzAxNDgxMQ==-flat-w32_regex_traits.hpp.html,79,notepad-plus-plus-MDEwOlJlcG9zaXRvcnkzMzAxNDgxMQ==-flat-w32_regex_traits.hpp,notepad-plus-plus-MDEwOlJlcG9zaXRvcnkzMzAxNDgxMQ==-flat-w32_regex_traits.hpp,229,243,14,421,435,14
334,https://htmlpreview.github.io/?https://github.com/Christina96/boilerplate-sample-matches/blob/main/Cpp/tesseract-MDEwOlJlcG9zaXRvcnkyMjg4NzA5NA==-flat-params_model.cpp-tesseract-MDEwOlJlcG9zaXRvcnkyMjg4NzA5NA==-flat-params_model.cpp.html,14,tesseract-MDEwOlJlcG9zaXRvcnkyMjg4NzA5NA==-flat-params_model.cpp,tesseract-MDEwOlJlcG9zaXRvcnkyMjg4NzA5NA==-flat-params_model.cpp,10,12,2,11,13,2
335,https://htmlpreview.github.io/?https://github.com/Christina96/boilerplate-sample-matches/blob/main/Cpp/Cpp_Primer_Answers-MDEwOlJlcG9zaXRvcnk0NzE3MDI2MQ==-flat-exercise10_27.cpp-Cpp_Primer_Answers-MDEwOlJlcG9zaXRvcnk0NzE3MDI2MQ==-flat-exercise10_28.cpp.html,27,Cpp_Primer_Answers-MDEwOlJlcG9zaXRvcnk0NzE3MDI2MQ==-flat-exercise10_27.cpp,Cpp_Primer_Answers-MDEwOlJlcG9zaXRvcnk0NzE3MDI2MQ==-flat-exercise10_28.cpp,8,9,1,16,17,1
336,https://htmlpreview.github.io/?https://github.com/Christina96/boilerplate-sample-matches/blob/main/Cpp/snap-MDEwOlJlcG9zaXRvcnk0Mjg4MzU3-flat-yahoobs.h-snap-MDEwOlJlcG9zaXRvcnk0Mjg4MzU3-flat-logreg.h.html,20,snap-MDEwOlJlcG9zaXRvcnk0Mjg4MzU3-flat-yahoobs.h,snap-MDEwOlJlcG9zaXRvcnk0Mjg4MzU3-flat-logreg.h,140,144,4,37,41,4
337,https://htmlpreview.github.io/?https://github.com/Christina96/boilerplate-sample-matches/blob/main/Cpp/snap-MDEwOlJlcG9zaXRvcnk0Mjg4MzU3-flat-nmobj.cpp-subconverter-MDEwOlJlcG9zaXRvcnkyMTg2ODY3NjM=-flat-inja.hpp.html,16,snap-MDEwOlJlcG9zaXRvcnk0Mjg4MzU3-flat-nmobj.cpp,subconverter-MDEwOlJlcG9zaXRvcnkyMTg2ODY3NjM=-flat-inja.hpp,904,907,3,2509,2512,3
338,https://htmlpreview.github.io/?https://github.com/Christina96/boilerplate-sample-matches/blob/main/Cpp/notepad-plus-plus-MDEwOlJlcG9zaXRvcnkzMzAxNDgxMQ==-flat-Notepad_plus.cpp-notepad-plus-plus-MDEwOlJlcG9zaXRvcnkzMzAxNDgxMQ==-flat-Notepad_plus.cpp.html,48,notepad-plus-plus-MDEwOlJlcG9zaXRvcnkzMzAxNDgxMQ==-flat-Notepad_plus.cpp,notepad-plus-plus-MDEwOlJlcG9zaXRvcnkzMzAxNDgxMQ==-flat-Notepad_plus.cpp,3541,3545,4,3549,3553,4
339,https://htmlpreview.github.io/?https://github.com/Christina96/boilerplate-sample-matches/blob/main/Cpp/nano-node-MDEwOlJlcG9zaXRvcnkxOTM0NzM0MA==-flat-ledger.cpp-nano-node-MDEwOlJlcG9zaXRvcnkxOTM0NzM0MA==-flat-ledger.cpp.html,21,nano-node-MDEwOlJlcG9zaXRvcnkxOTM0NzM0MA==-flat-ledger.cpp,nano-node-MDEwOlJlcG9zaXRvcnkxOTM0NzM0MA==-flat-ledger.cpp,4341,4344,3,4348,4351,3
340,https://htmlpreview.github.io/?https://github.com/Christina96/boilerplate-sample-matches/blob/main/Cpp/snap-MDEwOlJlcG9zaXRvcnk0Mjg4MzU3-flat-lsionto.cpp-snap-MDEwOlJlcG9zaXRvcnk0Mjg4MzU3-flat-bowclust.cpp.html,20,snap-MDEwOlJlcG9zaXRvcnk0Mjg4MzU3-flat-lsionto.cpp,snap-MDEwOlJlcG9zaXRvcnk0Mjg4MzU3-flat-bowclust.cpp,285,286,1,614,615,1
341,https://htmlpreview.github.io/?https://github.com/Christina96/boilerplate-sample-matches/blob/main/Cpp/snap-MDEwOlJlcG9zaXRvcnk0Mjg4MzU3-flat-rinetmatch.h-snap-MDEwOlJlcG9zaXRvcnk0Mjg4MzU3-flat-rinetmatch.h.html,85,snap-MDEwOlJlcG9zaXRvcnk0Mjg4MzU3-flat-rinetmatch.h,snap-MDEwOlJlcG9zaXRvcnk0Mjg4MzU3-flat-rinetmatch.h,484,499,15,484,499,15
342,https://htmlpreview.github.io/?https://github.com/Christina96/boilerplate-sample-matches/blob/main/Cpp/tesseract-MDEwOlJlcG9zaXRvcnkyMjg4NzA5NA==-flat-reject.cpp-tesseract-MDEwOlJlcG9zaXRvcnkyMjg4NzA5NA==-flat-reject.cpp.html,43,tesseract-MDEwOlJlcG9zaXRvcnkyMjg4NzA5NA==-flat-reject.cpp,tesseract-MDEwOlJlcG9zaXRvcnkyMjg4NzA5NA==-flat-reject.cpp,422,427,5,422,427,5
343,https://htmlpreview.github.io/?https://github.com/Christina96/boilerplate-sample-matches/blob/main/Cpp/abseil-cpp-MDEwOlJlcG9zaXRvcnkxMDQyMzE1NDE=-flat-raw_hash_set_benchmark.cc-abseil-cpp-MDEwOlJlcG9zaXRvcnkxMDQyMzE1NDE=-flat-raw_hash_set_test.cc.html,175,abseil-cpp-MDEwOlJlcG9zaXRvcnkxMDQyMzE1NDE=-flat-raw_hash_set_benchmark.cc,abseil-cpp-MDEwOlJlcG9zaXRvcnkxMDQyMzE1NDE=-flat-raw_hash_set_test.cc,75,95,20,314,334,20
344,https://htmlpreview.github.io/?https://github.com/Christina96/boilerplate-sample-matches/blob/main/Cpp/caffe-MDEwOlJlcG9zaXRvcnk2MTg3MDgwMw==-flat-gtest-internal.h-caffe-MDEwOlJlcG9zaXRvcnk2MTg3MDgwMw==-flat-gtest-internal.h.html,16,caffe-MDEwOlJlcG9zaXRvcnk2MTg3MDgwMw==-flat-gtest-internal.h,caffe-MDEwOlJlcG9zaXRvcnk2MTg3MDgwMw==-flat-gtest-internal.h,218,220,2,218,220,2
345,https://htmlpreview.github.io/?https://github.com/Christina96/boilerplate-sample-matches/blob/main/Cpp/notepad-plus-plus-MDEwOlJlcG9zaXRvcnkzMzAxNDgxMQ==-flat-catch_14.hpp-notepad-plus-plus-MDEwOlJlcG9zaXRvcnkzMzAxNDgxMQ==-flat-catch.hpp.html,7719,notepad-plus-plus-MDEwOlJlcG9zaXRvcnkzMzAxNDgxMQ==-flat-catch_14.hpp,notepad-plus-plus-MDEwOlJlcG9zaXRvcnkzMzAxNDgxMQ==-flat-catch.hpp,12839,13690,851,12839,13690,851
346,https://htmlpreview.github.io/?https://github.com/Christina96/boilerplate-sample-matches/blob/main/Cpp/snap-MDEwOlJlcG9zaXRvcnk0Mjg4MzU3-flat-yahoodm.h-snap-MDEwOlJlcG9zaXRvcnk0Mjg4MzU3-flat-yahoodm.h.html,20,snap-MDEwOlJlcG9zaXRvcnk0Mjg4MzU3-flat-yahoodm.h,snap-MDEwOlJlcG9zaXRvcnk0Mjg4MzU3-flat-yahoodm.h,216,218,2,216,218,2
347,https://htmlpreview.github.io/?https://github.com/Christina96/boilerplate-sample-matches/blob/main/Cpp/caffe-MDEwOlJlcG9zaXRvcnk2MTg3MDgwMw==-flat-gmock-generated-actions.h-caffe-MDEwOlJlcG9zaXRvcnk2MTg3MDgwMw==-flat-gmock-generated-actions.h.html,29,caffe-MDEwOlJlcG9zaXRvcnk2MTg3MDgwMw==-flat-gmock-generated-actions.h,caffe-MDEwOlJlcG9zaXRvcnk2MTg3MDgwMw==-flat-gmock-generated-actions.h,99,104,5,99,104,5
348,https://htmlpreview.github.io/?https://github.com/Christina96/boilerplate-sample-matches/blob/main/Cpp/snap-MDEwOlJlcG9zaXRvcnk0Mjg4MzU3-flat-dt.h-snap-MDEwOlJlcG9zaXRvcnk0Mjg4MzU3-flat-dt.h.html,18,snap-MDEwOlJlcG9zaXRvcnk0Mjg4MzU3-flat-dt.h,snap-MDEwOlJlcG9zaXRvcnk0Mjg4MzU3-flat-dt.h,64,67,3,172,175,3
349,https://htmlpreview.github.io/?https://github.com/Christina96/boilerplate-sample-matches/blob/main/Cpp/snap-MDEwOlJlcG9zaXRvcnk0Mjg4MzU3-flat-nlpwinlf.cpp-notepad-plus-plus-MDEwOlJlcG9zaXRvcnkzMzAxNDgxMQ==-flat-LexCOBOL.cxx.html,14,snap-MDEwOlJlcG9zaXRvcnk0Mjg4MzU3-flat-nlpwinlf.cpp,notepad-plus-plus-MDEwOlJlcG9zaXRvcnkzMzAxNDgxMQ==-flat-LexCOBOL.cxx,78,81,3,226,229,3
350,https://htmlpreview.github.io/?https://github.com/Christina96/boilerplate-sample-matches/blob/main/Cpp/notepad-plus-plus-MDEwOlJlcG9zaXRvcnkzMzAxNDgxMQ==-flat-preferenceDlg.cpp-notepad-plus-plus-MDEwOlJlcG9zaXRvcnkzMzAxNDgxMQ==-flat-preferenceDlg.cpp.html,15,notepad-plus-plus-MDEwOlJlcG9zaXRvcnkzMzAxNDgxMQ==-flat-preferenceDlg.cpp,notepad-plus-plus-MDEwOlJlcG9zaXRvcnkzMzAxNDgxMQ==-flat-preferenceDlg.cpp,1924,1928,4,1924,1928,4
351,https://htmlpreview.github.io/?https://github.com/Christina96/boilerplate-sample-matches/blob/main/Cpp/tesseract-MDEwOlJlcG9zaXRvcnkyMjg4NzA5NA==-flat-paragraphs.cpp-tesseract-MDEwOlJlcG9zaXRvcnkyMjg4NzA5NA==-flat-paragraphs.cpp.html,25,tesseract-MDEwOlJlcG9zaXRvcnkyMjg4NzA5NA==-flat-paragraphs.cpp,tesseract-MDEwOlJlcG9zaXRvcnkyMjg4NzA5NA==-flat-paragraphs.cpp,1717,1719,2,1717,1719,2
352,https://htmlpreview.github.io/?https://github.com/Christina96/boilerplate-sample-matches/blob/main/Cpp/caffe-MDEwOlJlcG9zaXRvcnk2MTg3MDgwMw==-flat-net.hpp-caffe-MDEwOlJlcG9zaXRvcnk2MTg3MDgwMw==-flat-net.hpp.html,16,caffe-MDEwOlJlcG9zaXRvcnk2MTg3MDgwMw==-flat-net.hpp,caffe-MDEwOlJlcG9zaXRvcnk2MTg3MDgwMw==-flat-net.hpp,53,54,1,53,54,1
353,https://htmlpreview.github.io/?https://github.com/Christina96/boilerplate-sample-matches/blob/main/Cpp/notepad-plus-plus-MDEwOlJlcG9zaXRvcnkzMzAxNDgxMQ==-flat-catch.hpp-notepad-plus-plus-MDEwOlJlcG9zaXRvcnkzMzAxNDgxMQ==-flat-catch_14.hpp.html,74239,notepad-plus-plus-MDEwOlJlcG9zaXRvcnkzMzAxNDgxMQ==-flat-catch.hpp,notepad-plus-plus-MDEwOlJlcG9zaXRvcnkzMzAxNDgxMQ==-flat-catch_14.hpp,3110,13690,10580,3110,13690,10580
354,https://htmlpreview.github.io/?https://github.com/Christina96/boilerplate-sample-matches/blob/main/Cpp/snap-MDEwOlJlcG9zaXRvcnk0Mjg4MzU3-flat-corrgr.cpp-snap-MDEwOlJlcG9zaXRvcnk0Mjg4MzU3-flat-corrgr.cpp.html,18,snap-MDEwOlJlcG9zaXRvcnk0Mjg4MzU3-flat-corrgr.cpp,snap-MDEwOlJlcG9zaXRvcnk0Mjg4MzU3-flat-corrgr.cpp,204,205,1,10,11,1
355,https://htmlpreview.github.io/?https://github.com/Christina96/boilerplate-sample-matches/blob/main/Cpp/abseil-cpp-MDEwOlJlcG9zaXRvcnkxMDQyMzE1NDE=-flat-time_zone_info.cc-abseil-cpp-MDEwOlJlcG9zaXRvcnkxMDQyMzE1NDE=-flat-time_zone_info.cc.html,14,abseil-cpp-MDEwOlJlcG9zaXRvcnkxMDQyMzE1NDE=-flat-time_zone_info.cc,abseil-cpp-MDEwOlJlcG9zaXRvcnkxMDQyMzE1NDE=-flat-time_zone_info.cc,534,536,2,534,536,2
356,https://htmlpreview.github.io/?https://github.com/Christina96/boilerplate-sample-matches/blob/main/Cpp/snap-MDEwOlJlcG9zaXRvcnk0Mjg4MzU3-flat-agmfast.cpp-snap-MDEwOlJlcG9zaXRvcnk0Mjg4MzU3-flat-agmfast.cpp.html,22,snap-MDEwOlJlcG9zaXRvcnk0Mjg4MzU3-flat-agmfast.cpp,snap-MDEwOlJlcG9zaXRvcnk0Mjg4MzU3-flat-agmfast.cpp,712,714,2,712,714,2
357,https://htmlpreview.github.io/?https://github.com/Christina96/boilerplate-sample-matches/blob/main/Cpp/nano-node-MDEwOlJlcG9zaXRvcnkxOTM0NzM0MA==-flat-openclapi.cpp-nano-node-MDEwOlJlcG9zaXRvcnkxOTM0NzM0MA==-flat-openclapi.cpp.html,54,nano-node-MDEwOlJlcG9zaXRvcnkxOTM0NzM0MA==-flat-openclapi.cpp,nano-node-MDEwOlJlcG9zaXRvcnkxOTM0NzM0MA==-flat-openclapi.cpp,69,84,15,69,84,15
358,https://htmlpreview.github.io/?https://github.com/Christina96/boilerplate-sample-matches/blob/main/Cpp/tesseract-MDEwOlJlcG9zaXRvcnkyMjg4NzA5NA==-flat-resultiterator_test.cc-tesseract-MDEwOlJlcG9zaXRvcnkyMjg4NzA5NA==-flat-layout_test.cc.html,15,tesseract-MDEwOlJlcG9zaXRvcnkyMjg4NzA5NA==-flat-resultiterator_test.cc,tesseract-MDEwOlJlcG9zaXRvcnkyMjg4NzA5NA==-flat-layout_test.cc,167,171,4,142,146,4
359,https://htmlpreview.github.io/?https://github.com/Christina96/boilerplate-sample-matches/blob/main/Cpp/notepad-plus-plus-MDEwOlJlcG9zaXRvcnkzMzAxNDgxMQ==-flat-LexCIL.cxx-notepad-plus-plus-MDEwOlJlcG9zaXRvcnkzMzAxNDgxMQ==-flat-LexBash.cxx.html,19,notepad-plus-plus-MDEwOlJlcG9zaXRvcnkzMzAxNDgxMQ==-flat-LexCIL.cxx,notepad-plus-plus-MDEwOlJlcG9zaXRvcnkzMzAxNDgxMQ==-flat-LexBash.cxx,114,115,1,385,386,1
360,https://htmlpreview.github.io/?https://github.com/Christina96/boilerplate-sample-matches/blob/main/Cpp/abseil-cpp-MDEwOlJlcG9zaXRvcnkxMDQyMzE1NDE=-flat-int128_test.cc-abseil-cpp-MDEwOlJlcG9zaXRvcnkxMDQyMzE1NDE=-flat-int128_test.cc.html,20,abseil-cpp-MDEwOlJlcG9zaXRvcnkxMDQyMzE1NDE=-flat-int128_test.cc,abseil-cpp-MDEwOlJlcG9zaXRvcnkxMDQyMzE1NDE=-flat-int128_test.cc,38,40,2,461,463,2
361,https://htmlpreview.github.io/?https://github.com/Christina96/boilerplate-sample-matches/blob/main/Cpp/notepad-plus-plus-MDEwOlJlcG9zaXRvcnkzMzAxNDgxMQ==-flat-catch.hpp-notepad-plus-plus-MDEwOlJlcG9zaXRvcnkzMzAxNDgxMQ==-flat-catch_14.hpp.html,58687,notepad-plus-plus-MDEwOlJlcG9zaXRvcnkzMzAxNDgxMQ==-flat-catch.hpp,notepad-plus-plus-MDEwOlJlcG9zaXRvcnkzMzAxNDgxMQ==-flat-catch_14.hpp,5360,13690,8330,5360,13690,8330
362,https://htmlpreview.github.io/?https://github.com/Christina96/boilerplate-sample-matches/blob/main/Cpp/abseil-cpp-MDEwOlJlcG9zaXRvcnkxMDQyMzE1NDE=-flat-blocking_counter_benchmark.cc-abseil-cpp-MDEwOlJlcG9zaXRvcnkxMDQyMzE1NDE=-flat-blocking_counter_benchmark.cc.html,16,abseil-cpp-MDEwOlJlcG9zaXRvcnkxMDQyMzE1NDE=-flat-blocking_counter_benchmark.cc,abseil-cpp-MDEwOlJlcG9zaXRvcnkxMDQyMzE1NDE=-flat-blocking_counter_benchmark.cc,40,42,2,40,42,2
363,https://htmlpreview.github.io/?https://github.com/Christina96/boilerplate-sample-matches/blob/main/Cpp/notepad-plus-plus-MDEwOlJlcG9zaXRvcnkzMzAxNDgxMQ==-flat-perl_matcher_non_recursive.hpp-notepad-plus-plus-MDEwOlJlcG9zaXRvcnkzMzAxNDgxMQ==-flat-perl_matcher_non_recursive.hpp.html,17,notepad-plus-plus-MDEwOlJlcG9zaXRvcnkzMzAxNDgxMQ==-flat-perl_matcher_non_recursive.hpp,notepad-plus-plus-MDEwOlJlcG9zaXRvcnkzMzAxNDgxMQ==-flat-perl_matcher_non_recursive.hpp,545,547,2,545,547,2
364,https://htmlpreview.github.io/?https://github.com/Christina96/boilerplate-sample-matches/blob/main/Cpp/snap-MDEwOlJlcG9zaXRvcnk0Mjg4MzU3-flat-unicode.cpp-snap-MDEwOlJlcG9zaXRvcnk0Mjg4MzU3-flat-unicode.cpp.html,33,snap-MDEwOlJlcG9zaXRvcnk0Mjg4MzU3-flat-unicode.cpp,snap-MDEwOlJlcG9zaXRvcnk0Mjg4MzU3-flat-unicode.cpp,1283,1284,1,1283,1284,1
365,https://htmlpreview.github.io/?https://github.com/Christina96/boilerplate-sample-matches/blob/main/Cpp/abseil-cpp-MDEwOlJlcG9zaXRvcnkxMDQyMzE1NDE=-flat-variant_benchmark.cc-abseil-cpp-MDEwOlJlcG9zaXRvcnkxMDQyMzE1NDE=-flat-variant_benchmark.cc.html,14,abseil-cpp-MDEwOlJlcG9zaXRvcnkxMDQyMzE1NDE=-flat-variant_benchmark.cc,abseil-cpp-MDEwOlJlcG9zaXRvcnkxMDQyMzE1NDE=-flat-variant_benchmark.cc,144,145,1,144,145,1
366,https://htmlpreview.github.io/?https://github.com/Christina96/boilerplate-sample-matches/blob/main/Cpp/caffe-MDEwOlJlcG9zaXRvcnk2MTg3MDgwMw==-flat-mkl_dnn_cppwrapper.h-caffe-MDEwOlJlcG9zaXRvcnk2MTg3MDgwMw==-flat-mkl_dnn_cppwrapper.h.html,30,caffe-MDEwOlJlcG9zaXRvcnk2MTg3MDgwMw==-flat-mkl_dnn_cppwrapper.h,caffe-MDEwOlJlcG9zaXRvcnk2MTg3MDgwMw==-flat-mkl_dnn_cppwrapper.h,123,127,4,123,127,4
367,https://htmlpreview.github.io/?https://github.com/Christina96/boilerplate-sample-matches/blob/main/Cpp/notepad-plus-plus-MDEwOlJlcG9zaXRvcnkzMzAxNDgxMQ==-flat-tinyxmlparserA.cpp-notepad-plus-plus-MDEwOlJlcG9zaXRvcnkzMzAxNDgxMQ==-flat-tinyxmlparserA.cpp.html,45,notepad-plus-plus-MDEwOlJlcG9zaXRvcnkzMzAxNDgxMQ==-flat-tinyxmlparserA.cpp,notepad-plus-plus-MDEwOlJlcG9zaXRvcnkzMzAxNDgxMQ==-flat-tinyxmlparserA.cpp,508,516,8,508,516,8
368,https://htmlpreview.github.io/?https://github.com/Christina96/boilerplate-sample-matches/blob/main/Cpp/tesseract-MDEwOlJlcG9zaXRvcnkyMjg4NzA5NA==-flat-matrix.h-tesseract-MDEwOlJlcG9zaXRvcnkyMjg4NzA5NA==-flat-matrix.h.html,24,tesseract-MDEwOlJlcG9zaXRvcnkyMjg4NzA5NA==-flat-matrix.h,tesseract-MDEwOlJlcG9zaXRvcnkyMjg4NzA5NA==-flat-matrix.h,285,290,5,299,304,5
369,https://htmlpreview.github.io/?https://github.com/Christina96/boilerplate-sample-matches/blob/main/Cpp/notepad-plus-plus-MDEwOlJlcG9zaXRvcnkzMzAxNDgxMQ==-flat-catch_14.hpp-notepad-plus-plus-MDEwOlJlcG9zaXRvcnkzMzAxNDgxMQ==-flat-catch_14.hpp.html,63976,notepad-plus-plus-MDEwOlJlcG9zaXRvcnkzMzAxNDgxMQ==-flat-catch_14.hpp,notepad-plus-plus-MDEwOlJlcG9zaXRvcnkzMzAxNDgxMQ==-flat-catch_14.hpp,4702,13690,8988,4702,13690,8988
370,https://htmlpreview.github.io/?https://github.com/Christina96/boilerplate-sample-matches/blob/main/Cpp/abseil-cpp-MDEwOlJlcG9zaXRvcnkxMDQyMzE1NDE=-flat-numbers_test.cc-abseil-cpp-MDEwOlJlcG9zaXRvcnkxMDQyMzE1NDE=-flat-numbers_test.cc.html,411,abseil-cpp-MDEwOlJlcG9zaXRvcnkxMDQyMzE1NDE=-flat-numbers_test.cc,abseil-cpp-MDEwOlJlcG9zaXRvcnkxMDQyMzE1NDE=-flat-numbers_test.cc,1162,1211,49,1102,1151,49
371,https://htmlpreview.github.io/?https://github.com/Christina96/boilerplate-sample-matches/blob/main/Cpp/abseil-cpp-MDEwOlJlcG9zaXRvcnkxMDQyMzE1NDE=-flat-conformance_testing.h-abseil-cpp-MDEwOlJlcG9zaXRvcnkxMDQyMzE1NDE=-flat-raw_hash_set_allocator_test.cc.html,15,abseil-cpp-MDEwOlJlcG9zaXRvcnkxMDQyMzE1NDE=-flat-conformance_testing.h,abseil-cpp-MDEwOlJlcG9zaXRvcnkxMDQyMzE1NDE=-flat-raw_hash_set_allocator_test.cc,735,738,3,34,37,3
372,https://htmlpreview.github.io/?https://github.com/Christina96/boilerplate-sample-matches/blob/main/Cpp/tesseract-MDEwOlJlcG9zaXRvcnkyMjg4NzA5NA==-flat-tordmain.cpp-tesseract-MDEwOlJlcG9zaXRvcnkyMjg4NzA5NA==-flat-colpartitionset.cpp.html,17,tesseract-MDEwOlJlcG9zaXRvcnkyMjg4NzA5NA==-flat-tordmain.cpp,tesseract-MDEwOlJlcG9zaXRvcnkyMjg4NzA5NA==-flat-colpartitionset.cpp,279,282,3,401,404,3
373,https://htmlpreview.github.io/?https://github.com/Christina96/boilerplate-sample-matches/blob/main/Cpp/abseil-cpp-MDEwOlJlcG9zaXRvcnkxMDQyMzE1NDE=-flat-cycleclock.cc-abseil-cpp-MDEwOlJlcG9zaXRvcnkxMDQyMzE1NDE=-flat-cycleclock.h.html,29,abseil-cpp-MDEwOlJlcG9zaXRvcnkxMDQyMzE1NDE=-flat-cycleclock.cc,abseil-cpp-MDEwOlJlcG9zaXRvcnkxMDQyMzE1NDE=-flat-cycleclock.h,23,29,6,45,51,6
374,https://htmlpreview.github.io/?https://github.com/Christina96/boilerplate-sample-matches/blob/main/Cpp/MMKV-MDEwOlJlcG9zaXRvcnkxNDkxMTE4MTM=-flat-MiniPBCoder.cpp-MMKV-MDEwOlJlcG9zaXRvcnkxNDkxMTE4MTM=-flat-MiniPBCoder.cpp.html,16,MMKV-MDEwOlJlcG9zaXRvcnkxNDkxMTE4MTM=-flat-MiniPBCoder.cpp,MMKV-MDEwOlJlcG9zaXRvcnkxNDkxMTE4MTM=-flat-MiniPBCoder.cpp,58,61,3,58,61,3
375,https://htmlpreview.github.io/?https://github.com/Christina96/boilerplate-sample-matches/blob/main/Cpp/abseil-cpp-MDEwOlJlcG9zaXRvcnkxMDQyMzE1NDE=-flat-civil_time_test.cc-abseil-cpp-MDEwOlJlcG9zaXRvcnkxMDQyMzE1NDE=-flat-civil_time_test.cc.html,80,abseil-cpp-MDEwOlJlcG9zaXRvcnkxMDQyMzE1NDE=-flat-civil_time_test.cc,abseil-cpp-MDEwOlJlcG9zaXRvcnkxMDQyMzE1NDE=-flat-civil_time_test.cc,372,378,6,362,368,6
376,https://htmlpreview.github.io/?https://github.com/Christina96/boilerplate-sample-matches/blob/main/Cpp/abseil-cpp-MDEwOlJlcG9zaXRvcnkxMDQyMzE1NDE=-flat-time.cc-abseil-cpp-MDEwOlJlcG9zaXRvcnkxMDQyMzE1NDE=-flat-time.cc.html,22,abseil-cpp-MDEwOlJlcG9zaXRvcnkxMDQyMzE1NDE=-flat-time.cc,abseil-cpp-MDEwOlJlcG9zaXRvcnkxMDQyMzE1NDE=-flat-time.cc,144,146,2,144,146,2
377,https://htmlpreview.github.io/?https://github.com/Christina96/boilerplate-sample-matches/blob/main/Cpp/notepad-plus-plus-MDEwOlJlcG9zaXRvcnkzMzAxNDgxMQ==-flat-catch_14.hpp-notepad-plus-plus-MDEwOlJlcG9zaXRvcnkzMzAxNDgxMQ==-flat-catch.hpp.html,6571,notepad-plus-plus-MDEwOlJlcG9zaXRvcnkzMzAxNDgxMQ==-flat-catch_14.hpp,notepad-plus-plus-MDEwOlJlcG9zaXRvcnkzMzAxNDgxMQ==-flat-catch.hpp,12982,13690,708,12982,13690,708
378,https://htmlpreview.github.io/?https://github.com/Christina96/boilerplate-sample-matches/blob/main/Cpp/abseil-cpp-MDEwOlJlcG9zaXRvcnkxMDQyMzE1NDE=-flat-escaping.cc-abseil-cpp-MDEwOlJlcG9zaXRvcnkxMDQyMzE1NDE=-flat-escaping.cc.html,36,abseil-cpp-MDEwOlJlcG9zaXRvcnkxMDQyMzE1NDE=-flat-escaping.cc,abseil-cpp-MDEwOlJlcG9zaXRvcnkxMDQyMzE1NDE=-flat-escaping.cc,398,402,4,452,456,4
379,https://htmlpreview.github.io/?https://github.com/Christina96/boilerplate-sample-matches/blob/main/Cpp/caffe-MDEwOlJlcG9zaXRvcnk2MTg3MDgwMw==-flat-test_image_data_layer.cpp-caffe-MDEwOlJlcG9zaXRvcnk2MTg3MDgwMw==-flat-test_image_data_layer.cpp.html,20,caffe-MDEwOlJlcG9zaXRvcnk2MTg3MDgwMw==-flat-test_image_data_layer.cpp,caffe-MDEwOlJlcG9zaXRvcnk2MTg3MDgwMw==-flat-test_image_data_layer.cpp,232,234,2,232,234,2
380,https://htmlpreview.github.io/?https://github.com/Christina96/boilerplate-sample-matches/blob/main/Cpp/caffe-MDEwOlJlcG9zaXRvcnk2MTg3MDgwMw==-flat-test_convolution_layer.cpp-caffe-MDEwOlJlcG9zaXRvcnk2MTg3MDgwMw==-flat-test_mkldnn_convolution_layer.cpp.html,14,caffe-MDEwOlJlcG9zaXRvcnk2MTg3MDgwMw==-flat-test_convolution_layer.cpp,caffe-MDEwOlJlcG9zaXRvcnk2MTg3MDgwMw==-flat-test_mkldnn_convolution_layer.cpp,617,618,1,776,777,1
381,https://htmlpreview.github.io/?https://github.com/Christina96/boilerplate-sample-matches/blob/main/Cpp/snap-MDEwOlJlcG9zaXRvcnk0Mjg4MzU3-flat-wikinet.cpp-snap-MDEwOlJlcG9zaXRvcnk0Mjg4MzU3-flat-wix.cpp.html,27,snap-MDEwOlJlcG9zaXRvcnk0Mjg4MzU3-flat-wikinet.cpp,snap-MDEwOlJlcG9zaXRvcnk0Mjg4MzU3-flat-wix.cpp,1611,1613,2,626,629,3
382,https://htmlpreview.github.io/?https://github.com/Christina96/boilerplate-sample-matches/blob/main/Cpp/abseil-cpp-MDEwOlJlcG9zaXRvcnkxMDQyMzE1NDE=-flat-flat_hash_set_test.cc-abseil-cpp-MDEwOlJlcG9zaXRvcnkxMDQyMzE1NDE=-flat-flat_hash_set_test.cc.html,245,abseil-cpp-MDEwOlJlcG9zaXRvcnkxMDQyMzE1NDE=-flat-flat_hash_set_test.cc,abseil-cpp-MDEwOlJlcG9zaXRvcnkxMDQyMzE1NDE=-flat-flat_hash_set_test.cc,108,135,27,108,135,27
383,https://htmlpreview.github.io/?https://github.com/Christina96/boilerplate-sample-matches/blob/main/Cpp/abseil-cpp-MDEwOlJlcG9zaXRvcnkxMDQyMzE1NDE=-flat-conformance_testing.h-abseil-cpp-MDEwOlJlcG9zaXRvcnkxMDQyMzE1NDE=-flat-conformance_testing.h.html,52,abseil-cpp-MDEwOlJlcG9zaXRvcnkxMDQyMzE1NDE=-flat-conformance_testing.h,abseil-cpp-MDEwOlJlcG9zaXRvcnkxMDQyMzE1NDE=-flat-conformance_testing.h,122,138,16,97,112,15
