ID,Link,Tokens,File 1,File 2,Start 1,End 1,Detected Lines 1,Start 2,End 2,Detected Lines 2
0,https://htmlpreview.github.io/?https://github.com/Christina96/boilerplate-sample-matches/blob/main/cpp/nano-node-MDEwOlJlcG9zaXRvcnkxOTM0NzM0MA==-flat-work.hpp-nano-node-MDEwOlJlcG9zaXRvcnkxOTM0NzM0MA==-flat-buckets.hpp-0.html,15,nano-node-MDEwOlJlcG9zaXRvcnkxOTM0NzM0MA==-flat-work.hpp,nano-node-MDEwOlJlcG9zaXRvcnkxOTM0NzM0MA==-flat-buckets.hpp,40,41,1,31,32,1
1,https://htmlpreview.github.io/?https://github.com/Christina96/boilerplate-sample-matches/blob/main/cpp/caffe-MDEwOlJlcG9zaXRvcnk2MTg3MDgwMw==-flat-gtest-type-util.h-caffe-MDEwOlJlcG9zaXRvcnk2MTg3MDgwMw==-flat-gtest-type-util.h-1.html,34,caffe-MDEwOlJlcG9zaXRvcnk2MTg3MDgwMw==-flat-gtest-type-util.h,caffe-MDEwOlJlcG9zaXRvcnk2MTg3MDgwMw==-flat-gtest-type-util.h,2593,2595,2,2574,2576,2
2,https://htmlpreview.github.io/?https://github.com/Christina96/boilerplate-sample-matches/blob/main/cpp/nano-node-MDEwOlJlcG9zaXRvcnkxOTM0NzM0MA==-flat-valgrind.h-nano-node-MDEwOlJlcG9zaXRvcnkxOTM0NzM0MA==-flat-valgrind.h-2.html,91,nano-node-MDEwOlJlcG9zaXRvcnkxOTM0NzM0MA==-flat-valgrind.h,nano-node-MDEwOlJlcG9zaXRvcnkxOTM0NzM0MA==-flat-valgrind.h,568,582,14,592,606,14
3,https://htmlpreview.github.io/?https://github.com/Christina96/boilerplate-sample-matches/blob/main/cpp/tesseract-MDEwOlJlcG9zaXRvcnkyMjg4NzA5NA==-flat-trainingsample.cpp-tesseract-MDEwOlJlcG9zaXRvcnkyMjg4NzA5NA==-flat-trainingsample.cpp-3.html,59,tesseract-MDEwOlJlcG9zaXRvcnkyMjg4NzA5NA==-flat-trainingsample.cpp,tesseract-MDEwOlJlcG9zaXRvcnkyMjg4NzA5NA==-flat-trainingsample.cpp,46,57,11,107,118,11
4,https://htmlpreview.github.io/?https://github.com/Christina96/boilerplate-sample-matches/blob/main/cpp/notepad-plus-plus-MDEwOlJlcG9zaXRvcnkzMzAxNDgxMQ==-flat-Parameters.cpp-notepad-plus-plus-MDEwOlJlcG9zaXRvcnkzMzAxNDgxMQ==-flat-Common.cpp-4.html,16,notepad-plus-plus-MDEwOlJlcG9zaXRvcnkzMzAxNDgxMQ==-flat-Parameters.cpp,notepad-plus-plus-MDEwOlJlcG9zaXRvcnkzMzAxNDgxMQ==-flat-Common.cpp,1602,1603,1,544,546,2
5,https://htmlpreview.github.io/?https://github.com/Christina96/boilerplate-sample-matches/blob/main/cpp/notepad-plus-plus-MDEwOlJlcG9zaXRvcnkzMzAxNDgxMQ==-flat-catch_14.hpp-notepad-plus-plus-MDEwOlJlcG9zaXRvcnkzMzAxNDgxMQ==-flat-catch.hpp-5.html,8445,notepad-plus-plus-MDEwOlJlcG9zaXRvcnkzMzAxNDgxMQ==-flat-catch_14.hpp,notepad-plus-plus-MDEwOlJlcG9zaXRvcnkzMzAxNDgxMQ==-flat-catch.hpp,12736,13690,954,12736,13690,954
6,https://htmlpreview.github.io/?https://github.com/Christina96/boilerplate-sample-matches/blob/main/cpp/abseil-cpp-MDEwOlJlcG9zaXRvcnkxMDQyMzE1NDE=-flat-time_test.cc-abseil-cpp-MDEwOlJlcG9zaXRvcnkxMDQyMzE1NDE=-flat-time_test.cc-6.html,48,abseil-cpp-MDEwOlJlcG9zaXRvcnkxMDQyMzE1NDE=-flat-time_test.cc,abseil-cpp-MDEwOlJlcG9zaXRvcnkxMDQyMzE1NDE=-flat-time_test.cc,192,194,2,194,196,2
7,https://htmlpreview.github.io/?https://github.com/Christina96/boilerplate-sample-matches/blob/main/cpp/snap-MDEwOlJlcG9zaXRvcnk0Mjg4MzU3-flat-test-multimodal.cpp-snap-MDEwOlJlcG9zaXRvcnk0Mjg4MzU3-flat-test-multimodal.cpp-7.html,25,snap-MDEwOlJlcG9zaXRvcnk0Mjg4MzU3-flat-test-multimodal.cpp,snap-MDEwOlJlcG9zaXRvcnk0Mjg4MzU3-flat-test-multimodal.cpp,189,193,4,637,641,4
8,https://htmlpreview.github.io/?https://github.com/Christina96/boilerplate-sample-matches/blob/main/cpp/notepad-plus-plus-MDEwOlJlcG9zaXRvcnkzMzAxNDgxMQ==-flat-ShortcutMapper.cpp-notepad-plus-plus-MDEwOlJlcG9zaXRvcnkzMzAxNDgxMQ==-flat-ShortcutMapper.cpp-8.html,23,notepad-plus-plus-MDEwOlJlcG9zaXRvcnkzMzAxNDgxMQ==-flat-ShortcutMapper.cpp,notepad-plus-plus-MDEwOlJlcG9zaXRvcnkzMzAxNDgxMQ==-flat-ShortcutMapper.cpp,283,288,5,310,315,5
9,https://htmlpreview.github.io/?https://github.com/Christina96/boilerplate-sample-matches/blob/main/cpp/abseil-cpp-MDEwOlJlcG9zaXRvcnkxMDQyMzE1NDE=-flat-civil_time_test_17.cc-abseil-cpp-MDEwOlJlcG9zaXRvcnkxMDQyMzE1NDE=-flat-civil_time_test_17.cc-9.html,30,abseil-cpp-MDEwOlJlcG9zaXRvcnkxMDQyMzE1NDE=-flat-civil_time_test_17.cc,abseil-cpp-MDEwOlJlcG9zaXRvcnkxMDQyMzE1NDE=-flat-civil_time_test_17.cc,809,811,2,806,808,2
10,https://htmlpreview.github.io/?https://github.com/Christina96/boilerplate-sample-matches/blob/main/cpp/tesseract-MDEwOlJlcG9zaXRvcnkyMjg4NzA5NA==-flat-pageres.cpp-tesseract-MDEwOlJlcG9zaXRvcnkyMjg4NzA5NA==-flat-colpartitionset.cpp-10.html,15,tesseract-MDEwOlJlcG9zaXRvcnkyMjg4NzA5NA==-flat-pageres.cpp,tesseract-MDEwOlJlcG9zaXRvcnkyMjg4NzA5NA==-flat-colpartitionset.cpp,42,45,3,497,500,3
11,https://htmlpreview.github.io/?https://github.com/Christina96/boilerplate-sample-matches/blob/main/cpp/tesseract-MDEwOlJlcG9zaXRvcnkyMjg4NzA5NA==-flat-colpartition.cpp-tesseract-MDEwOlJlcG9zaXRvcnkyMjg4NzA5NA==-flat-colpartition.cpp-11.html,23,tesseract-MDEwOlJlcG9zaXRvcnkyMjg4NzA5NA==-flat-colpartition.cpp,tesseract-MDEwOlJlcG9zaXRvcnkyMjg4NzA5NA==-flat-colpartition.cpp,2047,2050,3,1983,1986,3
12,https://htmlpreview.github.io/?https://github.com/Christina96/boilerplate-sample-matches/blob/main/cpp/subconverter-MDEwOlJlcG9zaXRvcnkyMTg2ODY3NjM=-flat-json.hpp-notepad-plus-plus-MDEwOlJlcG9zaXRvcnkzMzAxNDgxMQ==-flat-json.hpp-12.html,3095,subconverter-MDEwOlJlcG9zaXRvcnkyMTg2ODY3NjM=-flat-json.hpp,notepad-plus-plus-MDEwOlJlcG9zaXRvcnkzMzAxNDgxMQ==-flat-json.hpp,11104,11509,405,12413,12818,405
13,https://htmlpreview.github.io/?https://github.com/Christina96/boilerplate-sample-matches/blob/main/cpp/tesseract-MDEwOlJlcG9zaXRvcnkyMjg4NzA5NA==-flat-serialis.cpp-tesseract-MDEwOlJlcG9zaXRvcnkyMjg4NzA5NA==-flat-serialis.cpp-13.html,16,tesseract-MDEwOlJlcG9zaXRvcnkyMjg4NzA5NA==-flat-serialis.cpp,tesseract-MDEwOlJlcG9zaXRvcnkyMjg4NzA5NA==-flat-serialis.cpp,162,163,1,172,173,1
14,https://htmlpreview.github.io/?https://github.com/Christina96/boilerplate-sample-matches/blob/main/cpp/notepad-plus-plus-MDEwOlJlcG9zaXRvcnkzMzAxNDgxMQ==-flat-LexPascal.cxx-notepad-plus-plus-MDEwOlJlcG9zaXRvcnkzMzAxNDgxMQ==-flat-LexDataflex.cxx-14.html,14,notepad-plus-plus-MDEwOlJlcG9zaXRvcnkzMzAxNDgxMQ==-flat-LexPascal.cxx,notepad-plus-plus-MDEwOlJlcG9zaXRvcnkzMzAxNDgxMQ==-flat-LexDataflex.cxx,249,252,3,278,281,3
15,https://htmlpreview.github.io/?https://github.com/Christina96/boilerplate-sample-matches/blob/main/cpp/notepad-plus-plus-MDEwOlJlcG9zaXRvcnkzMzAxNDgxMQ==-flat-LexAPDL.cxx-notepad-plus-plus-MDEwOlJlcG9zaXRvcnkzMzAxNDgxMQ==-flat-LexGAP.cxx-15.html,19,notepad-plus-plus-MDEwOlJlcG9zaXRvcnkzMzAxNDgxMQ==-flat-LexAPDL.cxx,notepad-plus-plus-MDEwOlJlcG9zaXRvcnkzMzAxNDgxMQ==-flat-LexGAP.cxx,27,31,4,25,29,4
16,https://htmlpreview.github.io/?https://github.com/Christina96/boilerplate-sample-matches/blob/main/cpp/snap-MDEwOlJlcG9zaXRvcnk0Mjg4MzU3-flat-benchmark-util.cpp-snap-MDEwOlJlcG9zaXRvcnk0Mjg4MzU3-flat-benchmark-util.cpp-16.html,22,snap-MDEwOlJlcG9zaXRvcnk0Mjg4MzU3-flat-benchmark-util.cpp,snap-MDEwOlJlcG9zaXRvcnk0Mjg4MzU3-flat-benchmark-util.cpp,349,352,3,177,180,3
17,https://htmlpreview.github.io/?https://github.com/Christina96/boilerplate-sample-matches/blob/main/cpp/snap-MDEwOlJlcG9zaXRvcnk0Mjg4MzU3-flat-flow.cpp-tesseract-MDEwOlJlcG9zaXRvcnkyMjg4NzA5NA==-flat-intfeaturedist.cpp-17.html,14,snap-MDEwOlJlcG9zaXRvcnk0Mjg4MzU3-flat-flow.cpp,tesseract-MDEwOlJlcG9zaXRvcnkyMjg4NzA5NA==-flat-intfeaturedist.cpp,198,200,2,77,79,2
18,https://htmlpreview.github.io/?https://github.com/Christina96/boilerplate-sample-matches/blob/main/cpp/snap-MDEwOlJlcG9zaXRvcnk0Mjg4MzU3-flat-fl.cpp-snap-MDEwOlJlcG9zaXRvcnk0Mjg4MzU3-flat-zipfl.cpp-18.html,15,snap-MDEwOlJlcG9zaXRvcnk0Mjg4MzU3-flat-fl.cpp,snap-MDEwOlJlcG9zaXRvcnk0Mjg4MzU3-flat-zipfl.cpp,235,236,1,103,104,1
19,https://htmlpreview.github.io/?https://github.com/Christina96/boilerplate-sample-matches/blob/main/cpp/snap-MDEwOlJlcG9zaXRvcnk0Mjg4MzU3-flat-test-alg.cpp-snap-MDEwOlJlcG9zaXRvcnk0Mjg4MzU3-flat-test-alg.cpp-19.html,14,snap-MDEwOlJlcG9zaXRvcnk0Mjg4MzU3-flat-test-alg.cpp,snap-MDEwOlJlcG9zaXRvcnk0Mjg4MzU3-flat-test-alg.cpp,1406,1407,1,1411,1412,1
20,https://htmlpreview.github.io/?https://github.com/Christina96/boilerplate-sample-matches/blob/main/cpp/notepad-plus-plus-MDEwOlJlcG9zaXRvcnkzMzAxNDgxMQ==-flat-Editor.cxx-notepad-plus-plus-MDEwOlJlcG9zaXRvcnkzMzAxNDgxMQ==-flat-PositionCache.cxx-20.html,14,notepad-plus-plus-MDEwOlJlcG9zaXRvcnkzMzAxNDgxMQ==-flat-Editor.cxx,notepad-plus-plus-MDEwOlJlcG9zaXRvcnkzMzAxNDgxMQ==-flat-PositionCache.cxx,776,779,3,70,73,3
21,https://htmlpreview.github.io/?https://github.com/Christina96/boilerplate-sample-matches/blob/main/cpp/abseil-cpp-MDEwOlJlcG9zaXRvcnkxMDQyMzE1NDE=-flat-sem_waiter.cc-abseil-cpp-MDEwOlJlcG9zaXRvcnkxMDQyMzE1NDE=-flat-stdcpp_waiter.cc-21.html,17,abseil-cpp-MDEwOlJlcG9zaXRvcnkxMDQyMzE1NDE=-flat-sem_waiter.cc,abseil-cpp-MDEwOlJlcG9zaXRvcnkxMDQyMzE1NDE=-flat-stdcpp_waiter.cc,14,19,5,12,17,5
22,https://htmlpreview.github.io/?https://github.com/Christina96/boilerplate-sample-matches/blob/main/cpp/snap-MDEwOlJlcG9zaXRvcnk0Mjg4MzU3-flat-gridvcl.cpp-snap-MDEwOlJlcG9zaXRvcnk0Mjg4MzU3-flat-gridvcl.cpp-22.html,17,snap-MDEwOlJlcG9zaXRvcnk0Mjg4MzU3-flat-gridvcl.cpp,snap-MDEwOlJlcG9zaXRvcnk0Mjg4MzU3-flat-gridvcl.cpp,523,525,2,530,532,2
23,https://htmlpreview.github.io/?https://github.com/Christina96/boilerplate-sample-matches/blob/main/cpp/snap-MDEwOlJlcG9zaXRvcnk0Mjg4MzU3-flat-nyta.h-snap-MDEwOlJlcG9zaXRvcnk0Mjg4MzU3-flat-dmoz.h-23.html,22,snap-MDEwOlJlcG9zaXRvcnk0Mjg4MzU3-flat-nyta.h,snap-MDEwOlJlcG9zaXRvcnk0Mjg4MzU3-flat-dmoz.h,66,68,2,64,66,2
24,https://htmlpreview.github.io/?https://github.com/Christina96/boilerplate-sample-matches/blob/main/cpp/nano-node-MDEwOlJlcG9zaXRvcnkxOTM0NzM0MA==-flat-rocksdb_iterator.hpp-nano-node-MDEwOlJlcG9zaXRvcnkxOTM0NzM0MA==-flat-rocksdb.hpp-24.html,25,nano-node-MDEwOlJlcG9zaXRvcnkxOTM0NzM0MA==-flat-rocksdb_iterator.hpp,nano-node-MDEwOlJlcG9zaXRvcnkxOTM0NzM0MA==-flat-rocksdb.hpp,170,172,2,87,89,2
25,https://htmlpreview.github.io/?https://github.com/Christina96/boilerplate-sample-matches/blob/main/cpp/notepad-plus-plus-MDEwOlJlcG9zaXRvcnkzMzAxNDgxMQ==-flat-regbase.hpp-notepad-plus-plus-MDEwOlJlcG9zaXRvcnkzMzAxNDgxMQ==-flat-CharacterSet.h-25.html,17,notepad-plus-plus-MDEwOlJlcG9zaXRvcnkzMzAxNDgxMQ==-flat-regbase.hpp,notepad-plus-plus-MDEwOlJlcG9zaXRvcnkzMzAxNDgxMQ==-flat-CharacterSet.h,6,12,6,8,13,5
26,https://htmlpreview.github.io/?https://github.com/Christina96/boilerplate-sample-matches/blob/main/cpp/abseil-cpp-MDEwOlJlcG9zaXRvcnkxMDQyMzE1NDE=-flat-time_zone_format.cc-abseil-cpp-MDEwOlJlcG9zaXRvcnkxMDQyMzE1NDE=-flat-time_zone_format.cc-26.html,33,abseil-cpp-MDEwOlJlcG9zaXRvcnkxMDQyMzE1NDE=-flat-time_zone_format.cc,abseil-cpp-MDEwOlJlcG9zaXRvcnkxMDQyMzE1NDE=-flat-time_zone_format.cc,459,461,2,463,465,2
27,https://htmlpreview.github.io/?https://github.com/Christina96/boilerplate-sample-matches/blob/main/cpp/snap-MDEwOlJlcG9zaXRvcnk0Mjg4MzU3-flat-ultra.cpp-snap-MDEwOlJlcG9zaXRvcnk0Mjg4MzU3-flat-ultra.cpp-27.html,33,snap-MDEwOlJlcG9zaXRvcnk0Mjg4MzU3-flat-ultra.cpp,snap-MDEwOlJlcG9zaXRvcnk0Mjg4MzU3-flat-ultra.cpp,1265,1268,3,1267,1270,3
28,https://htmlpreview.github.io/?https://github.com/Christina96/boilerplate-sample-matches/blob/main/cpp/subconverter-MDEwOlJlcG9zaXRvcnkyMTg2ODY3NjM=-flat-inja.hpp-subconverter-MDEwOlJlcG9zaXRvcnkyMTg2ODY3NjM=-flat-inja.hpp-28.html,16,subconverter-MDEwOlJlcG9zaXRvcnkyMTg2ODY3NjM=-flat-inja.hpp,subconverter-MDEwOlJlcG9zaXRvcnkyMTg2ODY3NjM=-flat-inja.hpp,3304,3307,3,3309,3312,3
29,https://htmlpreview.github.io/?https://github.com/Christina96/boilerplate-sample-matches/blob/main/cpp/snap-MDEwOlJlcG9zaXRvcnk0Mjg4MzU3-flat-ss.h-snap-MDEwOlJlcG9zaXRvcnk0Mjg4MzU3-flat-ssmp.h-29.html,286,snap-MDEwOlJlcG9zaXRvcnk0Mjg4MzU3-flat-ss.h,snap-MDEwOlJlcG9zaXRvcnk0Mjg4MzU3-flat-ssmp.h,72,85,13,27,41,14
30,https://htmlpreview.github.io/?https://github.com/Christina96/boilerplate-sample-matches/blob/main/cpp/abseil-cpp-MDEwOlJlcG9zaXRvcnkxMDQyMzE1NDE=-flat-conformance_testing_test.cc-abseil-cpp-MDEwOlJlcG9zaXRvcnkxMDQyMzE1NDE=-flat-conformance_testing_test.cc-30.html,114,abseil-cpp-MDEwOlJlcG9zaXRvcnkxMDQyMzE1NDE=-flat-conformance_testing_test.cc,abseil-cpp-MDEwOlJlcG9zaXRvcnkxMDQyMzE1NDE=-flat-conformance_testing_test.cc,1077,1099,22,1105,1127,22
31,https://htmlpreview.github.io/?https://github.com/Christina96/boilerplate-sample-matches/blob/main/cpp/notepad-plus-plus-MDEwOlJlcG9zaXRvcnkzMzAxNDgxMQ==-flat-testPerLine.cxx-notepad-plus-plus-MDEwOlJlcG9zaXRvcnkzMzAxNDgxMQ==-flat-testPerLine.cxx-31.html,30,notepad-plus-plus-MDEwOlJlcG9zaXRvcnkzMzAxNDgxMQ==-flat-testPerLine.cxx,notepad-plus-plus-MDEwOlJlcG9zaXRvcnkzMzAxNDgxMQ==-flat-testPerLine.cxx,51,54,3,54,57,3
32,https://htmlpreview.github.io/?https://github.com/Christina96/boilerplate-sample-matches/blob/main/cpp/notepad-plus-plus-MDEwOlJlcG9zaXRvcnkzMzAxNDgxMQ==-flat-LexHTML.cxx-caffe-MDEwOlJlcG9zaXRvcnk2MTg3MDgwMw==-flat-im_transforms.cpp-32.html,14,notepad-plus-plus-MDEwOlJlcG9zaXRvcnkzMzAxNDgxMQ==-flat-LexHTML.cxx,caffe-MDEwOlJlcG9zaXRvcnk2MTg3MDgwMw==-flat-im_transforms.cpp,1057,1059,2,168,170,2
33,https://htmlpreview.github.io/?https://github.com/Christina96/boilerplate-sample-matches/blob/main/cpp/notepad-plus-plus-MDEwOlJlcG9zaXRvcnkzMzAxNDgxMQ==-flat-LexMetapost.cxx-notepad-plus-plus-MDEwOlJlcG9zaXRvcnkzMzAxNDgxMQ==-flat-LexTeX.cxx-33.html,44,notepad-plus-plus-MDEwOlJlcG9zaXRvcnkzMzAxNDgxMQ==-flat-LexMetapost.cxx,notepad-plus-plus-MDEwOlJlcG9zaXRvcnkzMzAxNDgxMQ==-flat-LexTeX.cxx,95,102,7,102,109,7
34,https://htmlpreview.github.io/?https://github.com/Christina96/boilerplate-sample-matches/blob/main/cpp/tesseract-MDEwOlJlcG9zaXRvcnkyMjg4NzA5NA==-flat-normstrngs.cpp-tesseract-MDEwOlJlcG9zaXRvcnkyMjg4NzA5NA==-flat-par_control.cpp-34.html,18,tesseract-MDEwOlJlcG9zaXRvcnkyMjg4NzA5NA==-flat-normstrngs.cpp,tesseract-MDEwOlJlcG9zaXRvcnkyMjg4NzA5NA==-flat-par_control.cpp,141,143,2,17,19,2
35,https://htmlpreview.github.io/?https://github.com/Christina96/boilerplate-sample-matches/blob/main/cpp/abseil-cpp-MDEwOlJlcG9zaXRvcnkxMDQyMzE1NDE=-flat-btree.h-abseil-cpp-MDEwOlJlcG9zaXRvcnkxMDQyMzE1NDE=-flat-btree.h-35.html,17,abseil-cpp-MDEwOlJlcG9zaXRvcnkxMDQyMzE1NDE=-flat-btree.h,abseil-cpp-MDEwOlJlcG9zaXRvcnkxMDQyMzE1NDE=-flat-btree.h,687,688,1,688,689,1
36,https://htmlpreview.github.io/?https://github.com/Christina96/boilerplate-sample-matches/blob/main/cpp/notepad-plus-plus-MDEwOlJlcG9zaXRvcnkzMzAxNDgxMQ==-flat-perl_matcher.hpp-notepad-plus-plus-MDEwOlJlcG9zaXRvcnkzMzAxNDgxMQ==-flat-perl_matcher.hpp-36.html,18,notepad-plus-plus-MDEwOlJlcG9zaXRvcnkzMzAxNDgxMQ==-flat-perl_matcher.hpp,notepad-plus-plus-MDEwOlJlcG9zaXRvcnkzMzAxNDgxMQ==-flat-perl_matcher.hpp,114,115,1,126,127,1
37,https://htmlpreview.github.io/?https://github.com/Christina96/boilerplate-sample-matches/blob/main/cpp/caffe-MDEwOlJlcG9zaXRvcnk2MTg3MDgwMw==-flat-test_tile_layer.cpp-caffe-MDEwOlJlcG9zaXRvcnk2MTg3MDgwMw==-flat-test_tile_layer.cpp-37.html,20,caffe-MDEwOlJlcG9zaXRvcnk2MTg3MDgwMw==-flat-test_tile_layer.cpp,caffe-MDEwOlJlcG9zaXRvcnk2MTg3MDgwMw==-flat-test_tile_layer.cpp,38,41,3,92,95,3
38,https://htmlpreview.github.io/?https://github.com/Christina96/boilerplate-sample-matches/blob/main/cpp/snap-MDEwOlJlcG9zaXRvcnk0Mjg4MzU3-flat-unicode.cpp-snap-MDEwOlJlcG9zaXRvcnk0Mjg4MzU3-flat-unicode.cpp-38.html,24,snap-MDEwOlJlcG9zaXRvcnk0Mjg4MzU3-flat-unicode.cpp,snap-MDEwOlJlcG9zaXRvcnk0Mjg4MzU3-flat-unicode.cpp,638,640,2,635,637,2
39,https://htmlpreview.github.io/?https://github.com/Christina96/boilerplate-sample-matches/blob/main/cpp/snap-MDEwOlJlcG9zaXRvcnk0Mjg4MzU3-flat-rinetmatch.h-snap-MDEwOlJlcG9zaXRvcnk0Mjg4MzU3-flat-rids.h-39.html,19,snap-MDEwOlJlcG9zaXRvcnk0Mjg4MzU3-flat-rinetmatch.h,snap-MDEwOlJlcG9zaXRvcnk0Mjg4MzU3-flat-rids.h,91,96,5,381,386,5
40,https://htmlpreview.github.io/?https://github.com/Christina96/boilerplate-sample-matches/blob/main/cpp/snap-MDEwOlJlcG9zaXRvcnk0Mjg4MzU3-flat-mmnet.cpp-snap-MDEwOlJlcG9zaXRvcnk0Mjg4MzU3-flat-mmnet.cpp-40.html,38,snap-MDEwOlJlcG9zaXRvcnk0Mjg4MzU3-flat-mmnet.cpp,snap-MDEwOlJlcG9zaXRvcnk0Mjg4MzU3-flat-mmnet.cpp,1164,1168,4,1171,1175,4
41,https://htmlpreview.github.io/?https://github.com/Christina96/boilerplate-sample-matches/blob/main/cpp/tesseract-MDEwOlJlcG9zaXRvcnkyMjg4NzA5NA==-flat-openclwrapper.cpp-tesseract-MDEwOlJlcG9zaXRvcnkyMjg4NzA5NA==-flat-openclwrapper.cpp-41.html,37,tesseract-MDEwOlJlcG9zaXRvcnkyMjg4NzA5NA==-flat-openclwrapper.cpp,tesseract-MDEwOlJlcG9zaXRvcnkyMjg4NzA5NA==-flat-openclwrapper.cpp,1196,1200,4,1311,1315,4
42,https://htmlpreview.github.io/?https://github.com/Christina96/boilerplate-sample-matches/blob/main/cpp/snap-MDEwOlJlcG9zaXRvcnk0Mjg4MzU3-flat-bix.cpp-snap-MDEwOlJlcG9zaXRvcnk0Mjg4MzU3-flat-txtbs.cpp-42.html,26,snap-MDEwOlJlcG9zaXRvcnk0Mjg4MzU3-flat-bix.cpp,snap-MDEwOlJlcG9zaXRvcnk0Mjg4MzU3-flat-txtbs.cpp,204,208,4,17,21,4
43,https://htmlpreview.github.io/?https://github.com/Christina96/boilerplate-sample-matches/blob/main/cpp/notepad-plus-plus-MDEwOlJlcG9zaXRvcnkzMzAxNDgxMQ==-flat-Parameters.cpp-notepad-plus-plus-MDEwOlJlcG9zaXRvcnkzMzAxNDgxMQ==-flat-Parameters.cpp-43.html,18,notepad-plus-plus-MDEwOlJlcG9zaXRvcnkzMzAxNDgxMQ==-flat-Parameters.cpp,notepad-plus-plus-MDEwOlJlcG9zaXRvcnkzMzAxNDgxMQ==-flat-Parameters.cpp,3707,3708,1,3704,3705,1
44,https://htmlpreview.github.io/?https://github.com/Christina96/boilerplate-sample-matches/blob/main/cpp/notepad-plus-plus-MDEwOlJlcG9zaXRvcnkzMzAxNDgxMQ==-flat-VerticalFileSwitcherListView.cpp-notepad-plus-plus-MDEwOlJlcG9zaXRvcnkzMzAxNDgxMQ==-flat-VerticalFileSwitcherListView.cpp-44.html,22,notepad-plus-plus-MDEwOlJlcG9zaXRvcnkzMzAxNDgxMQ==-flat-VerticalFileSwitcherListView.cpp,notepad-plus-plus-MDEwOlJlcG9zaXRvcnkzMzAxNDgxMQ==-flat-VerticalFileSwitcherListView.cpp,151,154,3,233,236,3
45,https://htmlpreview.github.io/?https://github.com/Christina96/boilerplate-sample-matches/blob/main/cpp/caffe-MDEwOlJlcG9zaXRvcnk2MTg3MDgwMw==-flat-im2col.cpp-caffe-MDEwOlJlcG9zaXRvcnk2MTg3MDgwMw==-flat-im2col.cpp-45.html,35,caffe-MDEwOlJlcG9zaXRvcnk2MTg3MDgwMw==-flat-im2col.cpp,caffe-MDEwOlJlcG9zaXRvcnk2MTg3MDgwMw==-flat-im2col.cpp,59,62,3,279,282,3
46,https://htmlpreview.github.io/?https://github.com/Christina96/boilerplate-sample-matches/blob/main/cpp/notepad-plus-plus-MDEwOlJlcG9zaXRvcnkzMzAxNDgxMQ==-flat-concepts.hpp-notepad-plus-plus-MDEwOlJlcG9zaXRvcnkzMzAxNDgxMQ==-flat-regex_token_iterator.hpp-46.html,16,notepad-plus-plus-MDEwOlJlcG9zaXRvcnkzMzAxNDgxMQ==-flat-concepts.hpp,notepad-plus-plus-MDEwOlJlcG9zaXRvcnkzMzAxNDgxMQ==-flat-regex_token_iterator.hpp,616,621,5,13,18,5
47,https://htmlpreview.github.io/?https://github.com/Christina96/boilerplate-sample-matches/blob/main/cpp/notepad-plus-plus-MDEwOlJlcG9zaXRvcnkzMzAxNDgxMQ==-flat-catch_14.hpp-notepad-plus-plus-MDEwOlJlcG9zaXRvcnkzMzAxNDgxMQ==-flat-catch.hpp-47.html,34351,notepad-plus-plus-MDEwOlJlcG9zaXRvcnkzMzAxNDgxMQ==-flat-catch_14.hpp,notepad-plus-plus-MDEwOlJlcG9zaXRvcnkzMzAxNDgxMQ==-flat-catch.hpp,8839,13690,4851,8839,13690,4851
48,https://htmlpreview.github.io/?https://github.com/Christina96/boilerplate-sample-matches/blob/main/cpp/snap-MDEwOlJlcG9zaXRvcnk0Mjg4MzU3-flat-cyc.cpp-snap-MDEwOlJlcG9zaXRvcnk0Mjg4MzU3-flat-cyc.cpp-48.html,24,snap-MDEwOlJlcG9zaXRvcnk0Mjg4MzU3-flat-cyc.cpp,snap-MDEwOlJlcG9zaXRvcnk0Mjg4MzU3-flat-cyc.cpp,180,182,2,275,277,2
49,https://htmlpreview.github.io/?https://github.com/Christina96/boilerplate-sample-matches/blob/main/cpp/notepad-plus-plus-MDEwOlJlcG9zaXRvcnkzMzAxNDgxMQ==-flat-LexillaAccess.cxx-notepad-plus-plus-MDEwOlJlcG9zaXRvcnkzMzAxNDgxMQ==-flat-catch.hpp-49.html,14,notepad-plus-plus-MDEwOlJlcG9zaXRvcnkzMzAxNDgxMQ==-flat-LexillaAccess.cxx,notepad-plus-plus-MDEwOlJlcG9zaXRvcnkzMzAxNDgxMQ==-flat-catch.hpp,110,113,3,9596,9599,3
50,https://htmlpreview.github.io/?https://github.com/Christina96/boilerplate-sample-matches/blob/main/cpp/notepad-plus-plus-MDEwOlJlcG9zaXRvcnkzMzAxNDgxMQ==-flat-catch_14.hpp-notepad-plus-plus-MDEwOlJlcG9zaXRvcnkzMzAxNDgxMQ==-flat-catch.hpp-50.html,96690,notepad-plus-plus-MDEwOlJlcG9zaXRvcnkzMzAxNDgxMQ==-flat-catch_14.hpp,notepad-plus-plus-MDEwOlJlcG9zaXRvcnkzMzAxNDgxMQ==-flat-catch.hpp,322,13690,13368,322,13690,13368
51,https://htmlpreview.github.io/?https://github.com/Christina96/boilerplate-sample-matches/blob/main/cpp/nano-node-MDEwOlJlcG9zaXRvcnkxOTM0NzM0MA==-flat-blockbuilders.cpp-nano-node-MDEwOlJlcG9zaXRvcnkxOTM0NzM0MA==-flat-blockbuilders.cpp-51.html,25,nano-node-MDEwOlJlcG9zaXRvcnkxOTM0NzM0MA==-flat-blockbuilders.cpp,nano-node-MDEwOlJlcG9zaXRvcnkxOTM0NzM0MA==-flat-blockbuilders.cpp,411,416,5,467,472,5
52,https://htmlpreview.github.io/?https://github.com/Christina96/boilerplate-sample-matches/blob/main/cpp/abseil-cpp-MDEwOlJlcG9zaXRvcnkxMDQyMzE1NDE=-flat-any_invocable_test.cc-abseil-cpp-MDEwOlJlcG9zaXRvcnkxMDQyMzE1NDE=-flat-any_invocable_test.cc-52.html,31,abseil-cpp-MDEwOlJlcG9zaXRvcnkxMDQyMzE1NDE=-flat-any_invocable_test.cc,abseil-cpp-MDEwOlJlcG9zaXRvcnkxMDQyMzE1NDE=-flat-any_invocable_test.cc,896,899,3,956,959,3
53,https://htmlpreview.github.io/?https://github.com/Christina96/boilerplate-sample-matches/blob/main/cpp/tesseract-MDEwOlJlcG9zaXRvcnkyMjg4NzA5NA==-flat-pdblock.cpp-tesseract-MDEwOlJlcG9zaXRvcnkyMjg4NzA5NA==-flat-polyblk.cpp-53.html,15,tesseract-MDEwOlJlcG9zaXRvcnkyMjg4NzA5NA==-flat-pdblock.cpp,tesseract-MDEwOlJlcG9zaXRvcnkyMjg4NzA5NA==-flat-polyblk.cpp,108,112,4,64,68,4
54,https://htmlpreview.github.io/?https://github.com/Christina96/boilerplate-sample-matches/blob/main/cpp/snap-MDEwOlJlcG9zaXRvcnk0Mjg4MzU3-flat-flx.h-snap-MDEwOlJlcG9zaXRvcnk0Mjg4MzU3-flat-fl.h-54.html,26,snap-MDEwOlJlcG9zaXRvcnk0Mjg4MzU3-flat-flx.h,snap-MDEwOlJlcG9zaXRvcnk0Mjg4MzU3-flat-fl.h,295,300,5,359,364,5
55,https://htmlpreview.github.io/?https://github.com/Christina96/boilerplate-sample-matches/blob/main/cpp/abseil-cpp-MDEwOlJlcG9zaXRvcnkxMDQyMzE1NDE=-flat-cordz_test.cc-abseil-cpp-MDEwOlJlcG9zaXRvcnkxMDQyMzE1NDE=-flat-cordz_test.cc-55.html,189,abseil-cpp-MDEwOlJlcG9zaXRvcnkxMDQyMzE1NDE=-flat-cordz_test.cc,abseil-cpp-MDEwOlJlcG9zaXRvcnkxMDQyMzE1NDE=-flat-cordz_test.cc,263,283,20,306,326,20
56,https://htmlpreview.github.io/?https://github.com/Christina96/boilerplate-sample-matches/blob/main/cpp/nano-node-MDEwOlJlcG9zaXRvcnkxOTM0NzM0MA==-flat-qt_94.cpp-nano-node-MDEwOlJlcG9zaXRvcnkxOTM0NzM0MA==-flat-qt_94.cpp-56.html,24,nano-node-MDEwOlJlcG9zaXRvcnkxOTM0NzM0MA==-flat-qt_94.cpp,nano-node-MDEwOlJlcG9zaXRvcnkxOTM0NzM0MA==-flat-qt_94.cpp,485,486,1,520,521,1
57,https://htmlpreview.github.io/?https://github.com/Christina96/boilerplate-sample-matches/blob/main/cpp/nano-node-MDEwOlJlcG9zaXRvcnkxOTM0NzM0MA==-flat-node.cpp-nano-node-MDEwOlJlcG9zaXRvcnkxOTM0NzM0MA==-flat-node_6.cpp-57.html,34,nano-node-MDEwOlJlcG9zaXRvcnkxOTM0NzM0MA==-flat-node.cpp,nano-node-MDEwOlJlcG9zaXRvcnkxOTM0NzM0MA==-flat-node_6.cpp,305,307,2,84,86,2
58,https://htmlpreview.github.io/?https://github.com/Christina96/boilerplate-sample-matches/blob/main/cpp/tesseract-MDEwOlJlcG9zaXRvcnkyMjg4NzA5NA==-flat-rect.h-tesseract-MDEwOlJlcG9zaXRvcnkyMjg4NzA5NA==-flat-rect.h-58.html,39,tesseract-MDEwOlJlcG9zaXRvcnkyMjg4NzA5NA==-flat-rect.h,tesseract-MDEwOlJlcG9zaXRvcnkyMjg4NzA5NA==-flat-rect.h,261,265,4,274,278,4
59,https://htmlpreview.github.io/?https://github.com/Christina96/boilerplate-sample-matches/blob/main/cpp/snap-MDEwOlJlcG9zaXRvcnk0Mjg4MzU3-flat-wikinet.cpp-snap-MDEwOlJlcG9zaXRvcnk0Mjg4MzU3-flat-wikinet.cpp-59.html,59,snap-MDEwOlJlcG9zaXRvcnk0Mjg4MzU3-flat-wikinet.cpp,snap-MDEwOlJlcG9zaXRvcnk0Mjg4MzU3-flat-wikinet.cpp,941,945,4,1007,1011,4
60,https://htmlpreview.github.io/?https://github.com/Christina96/boilerplate-sample-matches/blob/main/cpp/tesseract-MDEwOlJlcG9zaXRvcnkyMjg4NzA5NA==-flat-makerow.cpp-tesseract-MDEwOlJlcG9zaXRvcnkyMjg4NzA5NA==-flat-makerow.cpp-60.html,24,tesseract-MDEwOlJlcG9zaXRvcnkyMjg4NzA5NA==-flat-makerow.cpp,tesseract-MDEwOlJlcG9zaXRvcnkyMjg4NzA5NA==-flat-makerow.cpp,1527,1529,2,1954,1957,3
61,https://htmlpreview.github.io/?https://github.com/Christina96/boilerplate-sample-matches/blob/main/cpp/notepad-plus-plus-MDEwOlJlcG9zaXRvcnkzMzAxNDgxMQ==-flat-LexPerl.cxx-notepad-plus-plus-MDEwOlJlcG9zaXRvcnkzMzAxNDgxMQ==-flat-LexPerl.cxx-61.html,25,notepad-plus-plus-MDEwOlJlcG9zaXRvcnkzMzAxNDgxMQ==-flat-LexPerl.cxx,notepad-plus-plus-MDEwOlJlcG9zaXRvcnkzMzAxNDgxMQ==-flat-LexPerl.cxx,197,202,5,203,209,6
62,https://htmlpreview.github.io/?https://github.com/Christina96/boilerplate-sample-matches/blob/main/cpp/abseil-cpp-MDEwOlJlcG9zaXRvcnkxMDQyMzE1NDE=-flat-numbers_test.cc-abseil-cpp-MDEwOlJlcG9zaXRvcnkxMDQyMzE1NDE=-flat-numbers_test.cc-62.html,16,abseil-cpp-MDEwOlJlcG9zaXRvcnkxMDQyMzE1NDE=-flat-numbers_test.cc,abseil-cpp-MDEwOlJlcG9zaXRvcnkxMDQyMzE1NDE=-flat-numbers_test.cc,186,188,2,183,185,2
63,https://htmlpreview.github.io/?https://github.com/Christina96/boilerplate-sample-matches/blob/main/cpp/snap-MDEwOlJlcG9zaXRvcnk0Mjg4MzU3-flat-benchmark.cpp-snap-MDEwOlJlcG9zaXRvcnk0Mjg4MzU3-flat-benchmark.cpp-63.html,20,snap-MDEwOlJlcG9zaXRvcnk0Mjg4MzU3-flat-benchmark.cpp,snap-MDEwOlJlcG9zaXRvcnk0Mjg4MzU3-flat-benchmark.cpp,63,65,2,26,28,2
64,https://htmlpreview.github.io/?https://github.com/Christina96/boilerplate-sample-matches/blob/main/cpp/tesseract-MDEwOlJlcG9zaXRvcnkyMjg4NzA5NA==-flat-elst2.h-tesseract-MDEwOlJlcG9zaXRvcnkyMjg4NzA5NA==-flat-clst.h-64.html,16,tesseract-MDEwOlJlcG9zaXRvcnkyMjg4NzA5NA==-flat-elst2.h,tesseract-MDEwOlJlcG9zaXRvcnkyMjg4NzA5NA==-flat-clst.h,16,19,3,16,19,3
65,https://htmlpreview.github.io/?https://github.com/Christina96/boilerplate-sample-matches/blob/main/cpp/subconverter-MDEwOlJlcG9zaXRvcnkyMTg2ODY3NjM=-flat-json.hpp-notepad-plus-plus-MDEwOlJlcG9zaXRvcnkzMzAxNDgxMQ==-flat-json.hpp-65.html,41,subconverter-MDEwOlJlcG9zaXRvcnkyMTg2ODY3NjM=-flat-json.hpp,notepad-plus-plus-MDEwOlJlcG9zaXRvcnkzMzAxNDgxMQ==-flat-json.hpp,7817,7826,9,8787,8796,9
66,https://htmlpreview.github.io/?https://github.com/Christina96/boilerplate-sample-matches/blob/main/cpp/abseil-cpp-MDEwOlJlcG9zaXRvcnkxMDQyMzE1NDE=-flat-unordered_map_constructor_test.h-abseil-cpp-MDEwOlJlcG9zaXRvcnkxMDQyMzE1NDE=-flat-unordered_set_constructor_test.h-66.html,22,abseil-cpp-MDEwOlJlcG9zaXRvcnkxMDQyMzE1NDE=-flat-unordered_map_constructor_test.h,abseil-cpp-MDEwOlJlcG9zaXRvcnkxMDQyMzE1NDE=-flat-unordered_set_constructor_test.h,207,210,3,100,103,3
67,https://htmlpreview.github.io/?https://github.com/Christina96/boilerplate-sample-matches/blob/main/cpp/snap-MDEwOlJlcG9zaXRvcnk0Mjg4MzU3-flat-bowbs.cpp-snap-MDEwOlJlcG9zaXRvcnk0Mjg4MzU3-flat-bowbs.cpp-67.html,57,snap-MDEwOlJlcG9zaXRvcnk0Mjg4MzU3-flat-bowbs.cpp,snap-MDEwOlJlcG9zaXRvcnk0Mjg4MzU3-flat-bowbs.cpp,1190,1197,7,1222,1229,7
68,https://htmlpreview.github.io/?https://github.com/Christina96/boilerplate-sample-matches/blob/main/cpp/nano-node-MDEwOlJlcG9zaXRvcnkxOTM0NzM0MA==-flat-request_aggregator_62.cpp-nano-node-MDEwOlJlcG9zaXRvcnkxOTM0NzM0MA==-flat-node_46.cpp-68.html,22,nano-node-MDEwOlJlcG9zaXRvcnkxOTM0NzM0MA==-flat-request_aggregator_62.cpp,nano-node-MDEwOlJlcG9zaXRvcnkxOTM0NzM0MA==-flat-node_46.cpp,279,280,1,90,91,1
69,https://htmlpreview.github.io/?https://github.com/Christina96/boilerplate-sample-matches/blob/main/cpp/notepad-plus-plus-MDEwOlJlcG9zaXRvcnkzMzAxNDgxMQ==-flat-LexTADS3.cxx-notepad-plus-plus-MDEwOlJlcG9zaXRvcnkzMzAxNDgxMQ==-flat-ScintillaEditView.cpp-69.html,17,notepad-plus-plus-MDEwOlJlcG9zaXRvcnkzMzAxNDgxMQ==-flat-LexTADS3.cxx,notepad-plus-plus-MDEwOlJlcG9zaXRvcnkzMzAxNDgxMQ==-flat-ScintillaEditView.cpp,307,310,3,830,833,3
70,https://htmlpreview.github.io/?https://github.com/Christina96/boilerplate-sample-matches/blob/main/cpp/notepad-plus-plus-MDEwOlJlcG9zaXRvcnkzMzAxNDgxMQ==-flat-Editor.cxx-notepad-plus-plus-MDEwOlJlcG9zaXRvcnkzMzAxNDgxMQ==-flat-Editor.cxx-70.html,16,notepad-plus-plus-MDEwOlJlcG9zaXRvcnkzMzAxNDgxMQ==-flat-Editor.cxx,notepad-plus-plus-MDEwOlJlcG9zaXRvcnkzMzAxNDgxMQ==-flat-Editor.cxx,2005,2007,2,2013,2015,2
71,https://htmlpreview.github.io/?https://github.com/Christina96/boilerplate-sample-matches/blob/main/cpp/tesseract-MDEwOlJlcG9zaXRvcnkyMjg4NzA5NA==-flat-adaptive.h-tesseract-MDEwOlJlcG9zaXRvcnkyMjg4NzA5NA==-flat-adaptive.h-71.html,22,tesseract-MDEwOlJlcG9zaXRvcnkyMjg4NzA5NA==-flat-adaptive.h,tesseract-MDEwOlJlcG9zaXRvcnkyMjg4NzA5NA==-flat-adaptive.h,60,62,2,61,63,2
72,https://htmlpreview.github.io/?https://github.com/Christina96/boilerplate-sample-matches/blob/main/cpp/snap-MDEwOlJlcG9zaXRvcnk0Mjg4MzU3-flat-wikipedia.cpp-snap-MDEwOlJlcG9zaXRvcnk0Mjg4MzU3-flat-cpdoc.cpp-72.html,15,snap-MDEwOlJlcG9zaXRvcnk0Mjg4MzU3-flat-wikipedia.cpp,snap-MDEwOlJlcG9zaXRvcnk0Mjg4MzU3-flat-cpdoc.cpp,5,8,3,37,40,3
73,https://htmlpreview.github.io/?https://github.com/Christina96/boilerplate-sample-matches/blob/main/cpp/abseil-cpp-MDEwOlJlcG9zaXRvcnkxMDQyMzE1NDE=-flat-if_constexpr.h-abseil-cpp-MDEwOlJlcG9zaXRvcnkxMDQyMzE1NDE=-flat-container_memory.h-73.html,14,abseil-cpp-MDEwOlJlcG9zaXRvcnkxMDQyMzE1NDE=-flat-if_constexpr.h,abseil-cpp-MDEwOlJlcG9zaXRvcnkxMDQyMzE1NDE=-flat-container_memory.h,20,23,3,257,260,3
74,https://htmlpreview.github.io/?https://github.com/Christina96/boilerplate-sample-matches/blob/main/cpp/snap-MDEwOlJlcG9zaXRvcnk0Mjg4MzU3-flat-subgraph-exp.cpp-snap-MDEwOlJlcG9zaXRvcnk0Mjg4MzU3-flat-TableIndexTest.cpp-74.html,31,snap-MDEwOlJlcG9zaXRvcnk0Mjg4MzU3-flat-subgraph-exp.cpp,snap-MDEwOlJlcG9zaXRvcnk0Mjg4MzU3-flat-TableIndexTest.cpp,21,23,2,121,123,2
75,https://htmlpreview.github.io/?https://github.com/Christina96/boilerplate-sample-matches/blob/main/cpp/abseil-cpp-MDEwOlJlcG9zaXRvcnkxMDQyMzE1NDE=-flat-type_traits_test.cc-abseil-cpp-MDEwOlJlcG9zaXRvcnkxMDQyMzE1NDE=-flat-type_traits_test.cc-75.html,36,abseil-cpp-MDEwOlJlcG9zaXRvcnkxMDQyMzE1NDE=-flat-type_traits_test.cc,abseil-cpp-MDEwOlJlcG9zaXRvcnkxMDQyMzE1NDE=-flat-type_traits_test.cc,227,236,9,247,256,9
76,https://htmlpreview.github.io/?https://github.com/Christina96/boilerplate-sample-matches/blob/main/cpp/abseil-cpp-MDEwOlJlcG9zaXRvcnkxMDQyMzE1NDE=-flat-inlined_vector_benchmark.cc-abseil-cpp-MDEwOlJlcG9zaXRvcnkxMDQyMzE1NDE=-flat-inlined_vector_benchmark.cc-76.html,46,abseil-cpp-MDEwOlJlcG9zaXRvcnkxMDQyMzE1NDE=-flat-inlined_vector_benchmark.cc,abseil-cpp-MDEwOlJlcG9zaXRvcnkxMDQyMzE1NDE=-flat-inlined_vector_benchmark.cc,72,78,6,86,92,6
77,https://htmlpreview.github.io/?https://github.com/Christina96/boilerplate-sample-matches/blob/main/cpp/notepad-plus-plus-MDEwOlJlcG9zaXRvcnkzMzAxNDgxMQ==-flat-Common.cpp-notepad-plus-plus-MDEwOlJlcG9zaXRvcnkzMzAxNDgxMQ==-flat-EncodingMapper.cpp-77.html,41,notepad-plus-plus-MDEwOlJlcG9zaXRvcnkzMzAxNDgxMQ==-flat-Common.cpp,notepad-plus-plus-MDEwOlJlcG9zaXRvcnkzMzAxNDgxMQ==-flat-EncodingMapper.cpp,201,211,10,68,78,10
78,https://htmlpreview.github.io/?https://github.com/Christina96/boilerplate-sample-matches/blob/main/cpp/nano-node-MDEwOlJlcG9zaXRvcnkxOTM0NzM0MA==-flat-testutil.hpp-nano-node-MDEwOlJlcG9zaXRvcnkxOTM0NzM0MA==-flat-bootstrap_server.cpp-78.html,30,nano-node-MDEwOlJlcG9zaXRvcnkxOTM0NzM0MA==-flat-testutil.hpp,nano-node-MDEwOlJlcG9zaXRvcnkxOTM0NzM0MA==-flat-bootstrap_server.cpp,112,118,6,22,28,6
79,https://htmlpreview.github.io/?https://github.com/Christina96/boilerplate-sample-matches/blob/main/cpp/abseil-cpp-MDEwOlJlcG9zaXRvcnkxMDQyMzE1NDE=-flat-variant_test.cc-abseil-cpp-MDEwOlJlcG9zaXRvcnkxMDQyMzE1NDE=-flat-variant_test.cc-79.html,17,abseil-cpp-MDEwOlJlcG9zaXRvcnkxMDQyMzE1NDE=-flat-variant_test.cc,abseil-cpp-MDEwOlJlcG9zaXRvcnkxMDQyMzE1NDE=-flat-variant_test.cc,961,962,1,1050,1051,1
80,https://htmlpreview.github.io/?https://github.com/Christina96/boilerplate-sample-matches/blob/main/cpp/nano-node-MDEwOlJlcG9zaXRvcnkxOTM0NzM0MA==-flat-nodeconfig.cpp-nano-node-MDEwOlJlcG9zaXRvcnkxOTM0NzM0MA==-flat-rpcconfig.cpp-80.html,14,nano-node-MDEwOlJlcG9zaXRvcnkxOTM0NzM0MA==-flat-nodeconfig.cpp,nano-node-MDEwOlJlcG9zaXRvcnkxOTM0NzM0MA==-flat-rpcconfig.cpp,184,185,1,25,26,1
81,https://htmlpreview.github.io/?https://github.com/Christina96/boilerplate-sample-matches/blob/main/cpp/abseil-cpp-MDEwOlJlcG9zaXRvcnkxMDQyMzE1NDE=-flat-variant_test.cc-abseil-cpp-MDEwOlJlcG9zaXRvcnkxMDQyMzE1NDE=-flat-variant_test.cc-81.html,82,abseil-cpp-MDEwOlJlcG9zaXRvcnkxMDQyMzE1NDE=-flat-variant_test.cc,abseil-cpp-MDEwOlJlcG9zaXRvcnkxMDQyMzE1NDE=-flat-variant_test.cc,238,247,9,322,331,9
82,https://htmlpreview.github.io/?https://github.com/Christina96/boilerplate-sample-matches/blob/main/cpp/notepad-plus-plus-MDEwOlJlcG9zaXRvcnkzMzAxNDgxMQ==-flat-testSplitVector.cxx-notepad-plus-plus-MDEwOlJlcG9zaXRvcnkzMzAxNDgxMQ==-flat-testSplitVector.cxx-82.html,20,notepad-plus-plus-MDEwOlJlcG9zaXRvcnkzMzAxNDgxMQ==-flat-testSplitVector.cxx,notepad-plus-plus-MDEwOlJlcG9zaXRvcnkzMzAxNDgxMQ==-flat-testSplitVector.cxx,75,77,2,91,93,2
83,https://htmlpreview.github.io/?https://github.com/Christina96/boilerplate-sample-matches/blob/main/cpp/snap-MDEwOlJlcG9zaXRvcnk0Mjg4MzU3-flat-ssch.cpp-snap-MDEwOlJlcG9zaXRvcnk0Mjg4MzU3-flat-sch.cpp-83.html,21,snap-MDEwOlJlcG9zaXRvcnk0Mjg4MzU3-flat-ssch.cpp,snap-MDEwOlJlcG9zaXRvcnk0Mjg4MzU3-flat-sch.cpp,126,128,2,205,207,2
84,https://htmlpreview.github.io/?https://github.com/Christina96/boilerplate-sample-matches/blob/main/cpp/snap-MDEwOlJlcG9zaXRvcnk0Mjg4MzU3-flat-gstat.cpp-snap-MDEwOlJlcG9zaXRvcnk0Mjg4MzU3-flat-gstat.cpp-84.html,47,snap-MDEwOlJlcG9zaXRvcnk0Mjg4MzU3-flat-gstat.cpp,snap-MDEwOlJlcG9zaXRvcnk0Mjg4MzU3-flat-gstat.cpp,394,400,6,401,407,6
85,https://htmlpreview.github.io/?https://github.com/Christina96/boilerplate-sample-matches/blob/main/cpp/Cpp_Primer_Answers-MDEwOlJlcG9zaXRvcnk0NzE3MDI2MQ==-flat-exercise13_39.h-Cpp_Primer_Answers-MDEwOlJlcG9zaXRvcnk0NzE3MDI2MQ==-flat-exercise14_23.h-85.html,26,Cpp_Primer_Answers-MDEwOlJlcG9zaXRvcnk0NzE3MDI2MQ==-flat-exercise13_39.h,Cpp_Primer_Answers-MDEwOlJlcG9zaXRvcnk0NzE3MDI2MQ==-flat-exercise14_23.h,16,18,2,31,33,2
86,https://htmlpreview.github.io/?https://github.com/Christina96/boilerplate-sample-matches/blob/main/cpp/caffe-MDEwOlJlcG9zaXRvcnk2MTg3MDgwMw==-flat-solver.cpp-caffe-MDEwOlJlcG9zaXRvcnk2MTg3MDgwMw==-flat-caffe.cpp-86.html,223,caffe-MDEwOlJlcG9zaXRvcnk2MTg3MDgwMw==-flat-solver.cpp,caffe-MDEwOlJlcG9zaXRvcnk2MTg3MDgwMw==-flat-caffe.cpp,478,499,21,288,309,21
87,https://htmlpreview.github.io/?https://github.com/Christina96/boilerplate-sample-matches/blob/main/cpp/snap-MDEwOlJlcG9zaXRvcnk0Mjg4MzU3-flat-agmdirected.cpp-snap-MDEwOlJlcG9zaXRvcnk0Mjg4MzU3-flat-agmfast.cpp-87.html,14,snap-MDEwOlJlcG9zaXRvcnk0Mjg4MzU3-flat-agmdirected.cpp,snap-MDEwOlJlcG9zaXRvcnk0Mjg4MzU3-flat-agmfast.cpp,331,332,1,468,469,1
88,https://htmlpreview.github.io/?https://github.com/Christina96/boilerplate-sample-matches/blob/main/cpp/tesseract-MDEwOlJlcG9zaXRvcnkyMjg4NzA5NA==-flat-functions.h-tesseract-MDEwOlJlcG9zaXRvcnkyMjg4NzA5NA==-flat-functions.h-88.html,14,tesseract-MDEwOlJlcG9zaXRvcnkyMjg4NzA5NA==-flat-functions.h,tesseract-MDEwOlJlcG9zaXRvcnkyMjg4NzA5NA==-flat-functions.h,45,47,2,79,81,2
89,https://htmlpreview.github.io/?https://github.com/Christina96/boilerplate-sample-matches/blob/main/cpp/snap-MDEwOlJlcG9zaXRvcnk0Mjg4MzU3-flat-cordis.cpp-abseil-cpp-MDEwOlJlcG9zaXRvcnkxMDQyMzE1NDE=-flat-graphcycles.cc-89.html,16,snap-MDEwOlJlcG9zaXRvcnk0Mjg4MzU3-flat-cordis.cpp,abseil-cpp-MDEwOlJlcG9zaXRvcnkxMDQyMzE1NDE=-flat-graphcycles.cc,125,126,1,446,447,1
90,https://htmlpreview.github.io/?https://github.com/Christina96/boilerplate-sample-matches/blob/main/cpp/abseil-cpp-MDEwOlJlcG9zaXRvcnkxMDQyMzE1NDE=-flat-hash_benchmark.cc-abseil-cpp-MDEwOlJlcG9zaXRvcnkxMDQyMzE1NDE=-flat-hash_benchmark.cc-90.html,93,abseil-cpp-MDEwOlJlcG9zaXRvcnkxMDQyMzE1NDE=-flat-hash_benchmark.cc,abseil-cpp-MDEwOlJlcG9zaXRvcnkxMDQyMzE1NDE=-flat-hash_benchmark.cc,132,138,6,182,189,7
91,https://htmlpreview.github.io/?https://github.com/Christina96/boilerplate-sample-matches/blob/main/cpp/subconverter-MDEwOlJlcG9zaXRvcnkyMTg2ODY3NjM=-flat-interfaces.cpp-subconverter-MDEwOlJlcG9zaXRvcnkyMTg2ODY3NjM=-flat-interfaces.cpp-91.html,15,subconverter-MDEwOlJlcG9zaXRvcnkyMTg2ODY3NjM=-flat-interfaces.cpp,subconverter-MDEwOlJlcG9zaXRvcnkyMTg2ODY3NjM=-flat-interfaces.cpp,436,438,2,441,443,2
92,https://htmlpreview.github.io/?https://github.com/Christina96/boilerplate-sample-matches/blob/main/cpp/notepad-plus-plus-MDEwOlJlcG9zaXRvcnkzMzAxNDgxMQ==-flat-BabyGridWrapper.h-notepad-plus-plus-MDEwOlJlcG9zaXRvcnkzMzAxNDgxMQ==-flat-FindReplaceDlg.cpp-92.html,25,notepad-plus-plus-MDEwOlJlcG9zaXRvcnkzMzAxNDgxMQ==-flat-BabyGridWrapper.h,notepad-plus-plus-MDEwOlJlcG9zaXRvcnkzMzAxNDgxMQ==-flat-FindReplaceDlg.cpp,41,43,2,847,849,2
93,https://htmlpreview.github.io/?https://github.com/Christina96/boilerplate-sample-matches/blob/main/cpp/nano-node-MDEwOlJlcG9zaXRvcnkxOTM0NzM0MA==-flat-cl2.hpp-nano-node-MDEwOlJlcG9zaXRvcnkxOTM0NzM0MA==-flat-cl2.hpp-93.html,24,nano-node-MDEwOlJlcG9zaXRvcnkxOTM0NzM0MA==-flat-cl2.hpp,nano-node-MDEwOlJlcG9zaXRvcnkxOTM0NzM0MA==-flat-cl2.hpp,3327,3333,6,4394,4400,6
94,https://htmlpreview.github.io/?https://github.com/Christina96/boilerplate-sample-matches/blob/main/cpp/notepad-plus-plus-MDEwOlJlcG9zaXRvcnkzMzAxNDgxMQ==-flat-UserDefineDialog.cpp-notepad-plus-plus-MDEwOlJlcG9zaXRvcnkzMzAxNDgxMQ==-flat-UserDefineDialog.cpp-94.html,27,notepad-plus-plus-MDEwOlJlcG9zaXRvcnkzMzAxNDgxMQ==-flat-UserDefineDialog.cpp,notepad-plus-plus-MDEwOlJlcG9zaXRvcnkzMzAxNDgxMQ==-flat-UserDefineDialog.cpp,565,569,4,746,750,4
95,https://htmlpreview.github.io/?https://github.com/Christina96/boilerplate-sample-matches/blob/main/cpp/nano-node-MDEwOlJlcG9zaXRvcnkxOTM0NzM0MA==-flat-rpcconfig.cpp-nano-node-MDEwOlJlcG9zaXRvcnkxOTM0NzM0MA==-flat-entry_11.cpp-95.html,19,nano-node-MDEwOlJlcG9zaXRvcnkxOTM0NzM0MA==-flat-rpcconfig.cpp,nano-node-MDEwOlJlcG9zaXRvcnkxOTM0NzM0MA==-flat-entry_11.cpp,129,131,2,633,635,2
96,https://htmlpreview.github.io/?https://github.com/Christina96/boilerplate-sample-matches/blob/main/cpp/snap-MDEwOlJlcG9zaXRvcnk0Mjg4MzU3-flat-ccar.cpp-tesseract-MDEwOlJlcG9zaXRvcnkyMjg4NzA5NA==-flat-paragraphs.cpp-96.html,15,snap-MDEwOlJlcG9zaXRvcnk0Mjg4MzU3-flat-ccar.cpp,tesseract-MDEwOlJlcG9zaXRvcnkyMjg4NzA5NA==-flat-paragraphs.cpp,21,22,1,1503,1504,1
97,https://htmlpreview.github.io/?https://github.com/Christina96/boilerplate-sample-matches/blob/main/cpp/tesseract-MDEwOlJlcG9zaXRvcnkyMjg4NzA5NA==-flat-pdblock.cpp-tesseract-MDEwOlJlcG9zaXRvcnkyMjg4NzA5NA==-flat-pdblock.cpp-97.html,50,tesseract-MDEwOlJlcG9zaXRvcnkyMjg4NzA5NA==-flat-pdblock.cpp,tesseract-MDEwOlJlcG9zaXRvcnkyMjg4NzA5NA==-flat-pdblock.cpp,219,224,5,225,230,5
98,https://htmlpreview.github.io/?https://github.com/Christina96/boilerplate-sample-matches/blob/main/cpp/glm-MDEwOlJlcG9zaXRvcnk4NDM2MzE=-flat-quaternion.hpp-glm-MDEwOlJlcG9zaXRvcnk4NDM2MzE=-flat-quaternion.hpp-98.html,21,glm-MDEwOlJlcG9zaXRvcnk4NDM2MzE=-flat-quaternion.hpp,glm-MDEwOlJlcG9zaXRvcnk4NDM2MzE=-flat-quaternion.hpp,30,33,3,32,35,3
99,https://htmlpreview.github.io/?https://github.com/Christina96/boilerplate-sample-matches/blob/main/cpp/snap-MDEwOlJlcG9zaXRvcnk0Mjg4MzU3-flat-util.cpp-snap-MDEwOlJlcG9zaXRvcnk0Mjg4MzU3-flat-util.cpp-99.html,51,snap-MDEwOlJlcG9zaXRvcnk0Mjg4MzU3-flat-util.cpp,snap-MDEwOlJlcG9zaXRvcnk0Mjg4MzU3-flat-util.cpp,418,424,6,429,435,6
100,https://htmlpreview.github.io/?https://github.com/Christina96/boilerplate-sample-matches/blob/main/cpp/snap-MDEwOlJlcG9zaXRvcnk0Mjg4MzU3-flat-tql.cpp-snap-MDEwOlJlcG9zaXRvcnk0Mjg4MzU3-flat-wixexp.cpp-100.html,16,snap-MDEwOlJlcG9zaXRvcnk0Mjg4MzU3-flat-tql.cpp,snap-MDEwOlJlcG9zaXRvcnk0Mjg4MzU3-flat-wixexp.cpp,190,193,3,171,174,3
101,https://htmlpreview.github.io/?https://github.com/Christina96/boilerplate-sample-matches/blob/main/cpp/notepad-plus-plus-MDEwOlJlcG9zaXRvcnkzMzAxNDgxMQ==-flat-catch_14.hpp-notepad-plus-plus-MDEwOlJlcG9zaXRvcnkzMzAxNDgxMQ==-flat-catch.hpp-101.html,35263,notepad-plus-plus-MDEwOlJlcG9zaXRvcnkzMzAxNDgxMQ==-flat-catch_14.hpp,notepad-plus-plus-MDEwOlJlcG9zaXRvcnkzMzAxNDgxMQ==-flat-catch.hpp,8725,13690,4965,8725,13690,4965
102,https://htmlpreview.github.io/?https://github.com/Christina96/boilerplate-sample-matches/blob/main/cpp/snap-MDEwOlJlcG9zaXRvcnk0Mjg4MzU3-flat-sqlitedb.h-snap-MDEwOlJlcG9zaXRvcnk0Mjg4MzU3-flat-sqlitedb.h-102.html,16,snap-MDEwOlJlcG9zaXRvcnk0Mjg4MzU3-flat-sqlitedb.h,snap-MDEwOlJlcG9zaXRvcnk0Mjg4MzU3-flat-sqlitedb.h,45,47,2,44,46,2
103,https://htmlpreview.github.io/?https://github.com/Christina96/boilerplate-sample-matches/blob/main/cpp/snap-MDEwOlJlcG9zaXRvcnk0Mjg4MzU3-flat-tbhc.h-snap-MDEwOlJlcG9zaXRvcnk0Mjg4MzU3-flat-yahoodm.h-103.html,15,snap-MDEwOlJlcG9zaXRvcnk0Mjg4MzU3-flat-tbhc.h,snap-MDEwOlJlcG9zaXRvcnk0Mjg4MzU3-flat-yahoodm.h,54,56,2,62,64,2
104,https://htmlpreview.github.io/?https://github.com/Christina96/boilerplate-sample-matches/blob/main/cpp/caffe-MDEwOlJlcG9zaXRvcnk2MTg3MDgwMw==-flat-mkl_deconvolution_layer.cpp-caffe-MDEwOlJlcG9zaXRvcnk2MTg3MDgwMw==-flat-mkl_convolution_layer.cpp-104.html,61,caffe-MDEwOlJlcG9zaXRvcnk2MTg3MDgwMw==-flat-mkl_deconvolution_layer.cpp,caffe-MDEwOlJlcG9zaXRvcnk2MTg3MDgwMw==-flat-mkl_convolution_layer.cpp,206,216,10,160,170,10
105,https://htmlpreview.github.io/?https://github.com/Christina96/boilerplate-sample-matches/blob/main/cpp/snap-MDEwOlJlcG9zaXRvcnk0Mjg4MzU3-flat-term.h-snap-MDEwOlJlcG9zaXRvcnk0Mjg4MzU3-flat-dzs.h-105.html,17,snap-MDEwOlJlcG9zaXRvcnk0Mjg4MzU3-flat-term.h,snap-MDEwOlJlcG9zaXRvcnk0Mjg4MzU3-flat-dzs.h,78,84,6,138,144,6
106,https://htmlpreview.github.io/?https://github.com/Christina96/boilerplate-sample-matches/blob/main/cpp/nano-node-MDEwOlJlcG9zaXRvcnkxOTM0NzM0MA==-flat-cl.hpp-nano-node-MDEwOlJlcG9zaXRvcnkxOTM0NzM0MA==-flat-cl2.hpp-106.html,28,nano-node-MDEwOlJlcG9zaXRvcnkxOTM0NzM0MA==-flat-cl.hpp,nano-node-MDEwOlJlcG9zaXRvcnkxOTM0NzM0MA==-flat-cl2.hpp,1708,1714,6,1664,1670,6
107,https://htmlpreview.github.io/?https://github.com/Christina96/boilerplate-sample-matches/blob/main/cpp/notepad-plus-plus-MDEwOlJlcG9zaXRvcnkzMzAxNDgxMQ==-flat-LexOpal.cxx-notepad-plus-plus-MDEwOlJlcG9zaXRvcnkzMzAxNDgxMQ==-flat-LexOpal.cxx-107.html,29,notepad-plus-plus-MDEwOlJlcG9zaXRvcnkzMzAxNDgxMQ==-flat-LexOpal.cxx,notepad-plus-plus-MDEwOlJlcG9zaXRvcnkzMzAxNDgxMQ==-flat-LexOpal.cxx,229,236,7,327,334,7
108,https://htmlpreview.github.io/?https://github.com/Christina96/boilerplate-sample-matches/blob/main/cpp/snap-MDEwOlJlcG9zaXRvcnk0Mjg4MzU3-flat-sock.cpp-notepad-plus-plus-MDEwOlJlcG9zaXRvcnkzMzAxNDgxMQ==-flat-Gripper.cpp-108.html,27,snap-MDEwOlJlcG9zaXRvcnk0Mjg4MzU3-flat-sock.cpp,notepad-plus-plus-MDEwOlJlcG9zaXRvcnkzMzAxNDgxMQ==-flat-Gripper.cpp,290,295,5,55,60,5
109,https://htmlpreview.github.io/?https://github.com/Christina96/boilerplate-sample-matches/blob/main/cpp/abseil-cpp-MDEwOlJlcG9zaXRvcnkxMDQyMzE1NDE=-flat-str_replace_test.cc-abseil-cpp-MDEwOlJlcG9zaXRvcnkxMDQyMzE1NDE=-flat-str_replace_test.cc-109.html,28,abseil-cpp-MDEwOlJlcG9zaXRvcnkxMDQyMzE1NDE=-flat-str_replace_test.cc,abseil-cpp-MDEwOlJlcG9zaXRvcnkxMDQyMzE1NDE=-flat-str_replace_test.cc,86,89,3,148,151,3
110,https://htmlpreview.github.io/?https://github.com/Christina96/boilerplate-sample-matches/blob/main/cpp/snap-MDEwOlJlcG9zaXRvcnk0Mjg4MzU3-flat-svmmodels.cpp-snap-MDEwOlJlcG9zaXRvcnk0Mjg4MzU3-flat-vizmapgks.cpp-110.html,31,snap-MDEwOlJlcG9zaXRvcnk0Mjg4MzU3-flat-svmmodels.cpp,snap-MDEwOlJlcG9zaXRvcnk0Mjg4MzU3-flat-vizmapgks.cpp,1296,1298,2,477,479,2
111,https://htmlpreview.github.io/?https://github.com/Christina96/boilerplate-sample-matches/blob/main/cpp/caffe-MDEwOlJlcG9zaXRvcnk2MTg3MDgwMw==-flat-gtest-internal.h-caffe-MDEwOlJlcG9zaXRvcnk2MTg3MDgwMw==-flat-gtest-internal.h-111.html,19,caffe-MDEwOlJlcG9zaXRvcnk2MTg3MDgwMw==-flat-gtest-internal.h,caffe-MDEwOlJlcG9zaXRvcnk2MTg3MDgwMw==-flat-gtest-internal.h,333,335,2,339,341,2
112,https://htmlpreview.github.io/?https://github.com/Christina96/boilerplate-sample-matches/blob/main/cpp/abseil-cpp-MDEwOlJlcG9zaXRvcnkxMDQyMzE1NDE=-flat-inlined_vector_test.cc-abseil-cpp-MDEwOlJlcG9zaXRvcnkxMDQyMzE1NDE=-flat-span_test.cc-112.html,24,abseil-cpp-MDEwOlJlcG9zaXRvcnkxMDQyMzE1NDE=-flat-inlined_vector_test.cc,abseil-cpp-MDEwOlJlcG9zaXRvcnkxMDQyMzE1NDE=-flat-span_test.cc,150,154,4,191,195,4
113,https://htmlpreview.github.io/?https://github.com/Christina96/boilerplate-sample-matches/blob/main/cpp/caffe-MDEwOlJlcG9zaXRvcnk2MTg3MDgwMw==-flat-mkl_batch_norm_layer.cpp-caffe-MDEwOlJlcG9zaXRvcnk2MTg3MDgwMw==-flat-mkldnn_batch_norm_layer.cpp-113.html,36,caffe-MDEwOlJlcG9zaXRvcnk2MTg3MDgwMw==-flat-mkl_batch_norm_layer.cpp,caffe-MDEwOlJlcG9zaXRvcnk2MTg3MDgwMw==-flat-mkldnn_batch_norm_layer.cpp,32,35,3,30,33,3
114,https://htmlpreview.github.io/?https://github.com/Christina96/boilerplate-sample-matches/blob/main/cpp/abseil-cpp-MDEwOlJlcG9zaXRvcnkxMDQyMzE1NDE=-flat-mutex_test.cc-abseil-cpp-MDEwOlJlcG9zaXRvcnkxMDQyMzE1NDE=-flat-mutex_test.cc-114.html,16,abseil-cpp-MDEwOlJlcG9zaXRvcnkxMDQyMzE1NDE=-flat-mutex_test.cc,abseil-cpp-MDEwOlJlcG9zaXRvcnkxMDQyMzE1NDE=-flat-mutex_test.cc,501,504,3,810,813,3
115,https://htmlpreview.github.io/?https://github.com/Christina96/boilerplate-sample-matches/blob/main/cpp/notepad-plus-plus-MDEwOlJlcG9zaXRvcnkzMzAxNDgxMQ==-flat-NppDarkMode.cpp-notepad-plus-plus-MDEwOlJlcG9zaXRvcnkzMzAxNDgxMQ==-flat-NppDarkMode.cpp-115.html,143,notepad-plus-plus-MDEwOlJlcG9zaXRvcnkzMzAxNDgxMQ==-flat-NppDarkMode.cpp,notepad-plus-plus-MDEwOlJlcG9zaXRvcnkzMzAxNDgxMQ==-flat-NppDarkMode.cpp,931,967,36,1070,1106,36
116,https://htmlpreview.github.io/?https://github.com/Christina96/boilerplate-sample-matches/blob/main/cpp/caffe-MDEwOlJlcG9zaXRvcnk2MTg3MDgwMw==-flat-test_data_layer.cpp-caffe-MDEwOlJlcG9zaXRvcnk2MTg3MDgwMw==-flat-test_annotated_data_layer.cpp-116.html,39,caffe-MDEwOlJlcG9zaXRvcnk2MTg3MDgwMw==-flat-test_data_layer.cpp,caffe-MDEwOlJlcG9zaXRvcnk2MTg3MDgwMw==-flat-test_annotated_data_layer.cpp,26,32,6,52,58,6
117,https://htmlpreview.github.io/?https://github.com/Christina96/boilerplate-sample-matches/blob/main/cpp/notepad-plus-plus-MDEwOlJlcG9zaXRvcnkzMzAxNDgxMQ==-flat-match_results.hpp-notepad-plus-plus-MDEwOlJlcG9zaXRvcnkzMzAxNDgxMQ==-flat-match_results.hpp-117.html,35,notepad-plus-plus-MDEwOlJlcG9zaXRvcnkzMzAxNDgxMQ==-flat-match_results.hpp,notepad-plus-plus-MDEwOlJlcG9zaXRvcnkzMzAxNDgxMQ==-flat-match_results.hpp,182,184,2,203,205,2
118,https://htmlpreview.github.io/?https://github.com/Christina96/boilerplate-sample-matches/blob/main/cpp/abseil-cpp-MDEwOlJlcG9zaXRvcnkxMDQyMzE1NDE=-flat-distribution_test_util_test.cc-abseil-cpp-MDEwOlJlcG9zaXRvcnkxMDQyMzE1NDE=-flat-distribution_test_util_test.cc-118.html,30,abseil-cpp-MDEwOlJlcG9zaXRvcnkxMDQyMzE1NDE=-flat-distribution_test_util_test.cc,abseil-cpp-MDEwOlJlcG9zaXRvcnkxMDQyMzE1NDE=-flat-distribution_test_util_test.cc,131,134,3,116,119,3
119,https://htmlpreview.github.io/?https://github.com/Christina96/boilerplate-sample-matches/blob/main/cpp/notepad-plus-plus-MDEwOlJlcG9zaXRvcnkzMzAxNDgxMQ==-flat-catch_14.hpp-notepad-plus-plus-MDEwOlJlcG9zaXRvcnkzMzAxNDgxMQ==-flat-catch.hpp-119.html,14008,notepad-plus-plus-MDEwOlJlcG9zaXRvcnkzMzAxNDgxMQ==-flat-catch_14.hpp,notepad-plus-plus-MDEwOlJlcG9zaXRvcnkzMzAxNDgxMQ==-flat-catch.hpp,11887,13690,1803,11887,13690,1803
120,https://htmlpreview.github.io/?https://github.com/Christina96/boilerplate-sample-matches/blob/main/cpp/caffe-MDEwOlJlcG9zaXRvcnk2MTg3MDgwMw==-flat-test_mkldnn_convolution_layer.cpp-notepad-plus-plus-MDEwOlJlcG9zaXRvcnkzMzAxNDgxMQ==-flat-ColourPicker.cpp-120.html,14,caffe-MDEwOlJlcG9zaXRvcnk2MTg3MDgwMw==-flat-test_mkldnn_convolution_layer.cpp,notepad-plus-plus-MDEwOlJlcG9zaXRvcnkzMzAxNDgxMQ==-flat-ColourPicker.cpp,616,618,2,93,95,2
121,https://htmlpreview.github.io/?https://github.com/Christina96/boilerplate-sample-matches/blob/main/cpp/snap-MDEwOlJlcG9zaXRvcnk0Mjg4MzU3-flat-json.cpp-snap-MDEwOlJlcG9zaXRvcnk0Mjg4MzU3-flat-json.cpp-121.html,17,snap-MDEwOlJlcG9zaXRvcnk0Mjg4MzU3-flat-json.cpp,snap-MDEwOlJlcG9zaXRvcnk0Mjg4MzU3-flat-json.cpp,67,70,3,72,75,3
122,https://htmlpreview.github.io/?https://github.com/Christina96/boilerplate-sample-matches/blob/main/cpp/snap-MDEwOlJlcG9zaXRvcnk0Mjg4MzU3-flat-webnetobj.h-abseil-cpp-MDEwOlJlcG9zaXRvcnkxMDQyMzE1NDE=-flat-statusor_internal.h-122.html,19,snap-MDEwOlJlcG9zaXRvcnk0Mjg4MzU3-flat-webnetobj.h,abseil-cpp-MDEwOlJlcG9zaXRvcnkxMDQyMzE1NDE=-flat-statusor_internal.h,69,71,2,173,176,3
123,https://htmlpreview.github.io/?https://github.com/Christina96/boilerplate-sample-matches/blob/main/cpp/tesseract-MDEwOlJlcG9zaXRvcnkyMjg4NzA5NA==-flat-lstmtrainer.h-tesseract-MDEwOlJlcG9zaXRvcnkyMjg4NzA5NA==-flat-trainingsample.h-123.html,22,tesseract-MDEwOlJlcG9zaXRvcnkyMjg4NzA5NA==-flat-lstmtrainer.h,tesseract-MDEwOlJlcG9zaXRvcnkyMjg4NzA5NA==-flat-trainingsample.h,86,92,6,55,61,6
124,https://htmlpreview.github.io/?https://github.com/Christina96/boilerplate-sample-matches/blob/main/cpp/snap-MDEwOlJlcG9zaXRvcnk0Mjg4MzU3-flat-yahoobs.cpp-snap-MDEwOlJlcG9zaXRvcnk0Mjg4MzU3-flat-hldoc.cpp-124.html,56,snap-MDEwOlJlcG9zaXRvcnk0Mjg4MzU3-flat-yahoobs.cpp,snap-MDEwOlJlcG9zaXRvcnk0Mjg4MzU3-flat-hldoc.cpp,472,486,14,343,357,14
125,https://htmlpreview.github.io/?https://github.com/Christina96/boilerplate-sample-matches/blob/main/cpp/snap-MDEwOlJlcG9zaXRvcnk0Mjg4MzU3-flat-valds.h-snap-MDEwOlJlcG9zaXRvcnk0Mjg4MzU3-flat-xml.h-125.html,15,snap-MDEwOlJlcG9zaXRvcnk0Mjg4MzU3-flat-valds.h,snap-MDEwOlJlcG9zaXRvcnk0Mjg4MzU3-flat-xml.h,38,39,1,295,296,1
126,https://htmlpreview.github.io/?https://github.com/Christina96/boilerplate-sample-matches/blob/main/cpp/abseil-cpp-MDEwOlJlcG9zaXRvcnkxMDQyMzE1NDE=-flat-benchmarks.cc-abseil-cpp-MDEwOlJlcG9zaXRvcnkxMDQyMzE1NDE=-flat-benchmarks.cc-126.html,25,abseil-cpp-MDEwOlJlcG9zaXRvcnkxMDQyMzE1NDE=-flat-benchmarks.cc,abseil-cpp-MDEwOlJlcG9zaXRvcnkxMDQyMzE1NDE=-flat-benchmarks.cc,225,228,3,199,202,3
127,https://htmlpreview.github.io/?https://github.com/Christina96/boilerplate-sample-matches/blob/main/cpp/caffe-MDEwOlJlcG9zaXRvcnk2MTg3MDgwMw==-flat-test_math_functions.cpp-caffe-MDEwOlJlcG9zaXRvcnk2MTg3MDgwMw==-flat-test_math_functions.cpp-127.html,39,caffe-MDEwOlJlcG9zaXRvcnk2MTg3MDgwMw==-flat-test_math_functions.cpp,caffe-MDEwOlJlcG9zaXRvcnk2MTg3MDgwMw==-flat-test_math_functions.cpp,67,72,5,133,138,5
128,https://htmlpreview.github.io/?https://github.com/Christina96/boilerplate-sample-matches/blob/main/cpp/tesseract-MDEwOlJlcG9zaXRvcnkyMjg4NzA5NA==-flat-trainingsampleset.cpp-nano-node-MDEwOlJlcG9zaXRvcnkxOTM0NzM0MA==-flat-active_transactions.cpp-128.html,16,tesseract-MDEwOlJlcG9zaXRvcnkyMjg4NzA5NA==-flat-trainingsampleset.cpp,nano-node-MDEwOlJlcG9zaXRvcnkxOTM0NzM0MA==-flat-active_transactions.cpp,563,565,2,257,259,2
129,https://htmlpreview.github.io/?https://github.com/Christina96/boilerplate-sample-matches/blob/main/cpp/snap-MDEwOlJlcG9zaXRvcnk0Mjg4MzU3-flat-agmattr.cpp-tesseract-MDEwOlJlcG9zaXRvcnkyMjg4NzA5NA==-flat-functions.h-129.html,15,snap-MDEwOlJlcG9zaXRvcnk0Mjg4MzU3-flat-agmattr.cpp,tesseract-MDEwOlJlcG9zaXRvcnkyMjg4NzA5NA==-flat-functions.h,215,218,3,158,161,3
130,https://htmlpreview.github.io/?https://github.com/Christina96/boilerplate-sample-matches/blob/main/cpp/abseil-cpp-MDEwOlJlcG9zaXRvcnkxMDQyMzE1NDE=-flat-civil_time_test_17.cc-abseil-cpp-MDEwOlJlcG9zaXRvcnkxMDQyMzE1NDE=-flat-civil_time_test.cc-130.html,24,abseil-cpp-MDEwOlJlcG9zaXRvcnkxMDQyMzE1NDE=-flat-civil_time_test_17.cc,abseil-cpp-MDEwOlJlcG9zaXRvcnkxMDQyMzE1NDE=-flat-civil_time_test.cc,482,485,3,305,308,3
131,https://htmlpreview.github.io/?https://github.com/Christina96/boilerplate-sample-matches/blob/main/cpp/snap-MDEwOlJlcG9zaXRvcnk0Mjg4MzU3-flat-benchmark-util.cpp-snap-MDEwOlJlcG9zaXRvcnk0Mjg4MzU3-flat-benchmark-util.cpp-131.html,14,snap-MDEwOlJlcG9zaXRvcnk0Mjg4MzU3-flat-benchmark-util.cpp,snap-MDEwOlJlcG9zaXRvcnk0Mjg4MzU3-flat-benchmark-util.cpp,200,201,1,295,296,1
132,https://htmlpreview.github.io/?https://github.com/Christina96/boilerplate-sample-matches/blob/main/cpp/snap-MDEwOlJlcG9zaXRvcnk0Mjg4MzU3-flat-bowfl.cpp-snap-MDEwOlJlcG9zaXRvcnk0Mjg4MzU3-flat-bowflx.cpp-132.html,264,snap-MDEwOlJlcG9zaXRvcnk0Mjg4MzU3-flat-bowfl.cpp,snap-MDEwOlJlcG9zaXRvcnk0Mjg4MzU3-flat-bowflx.cpp,345,373,28,329,357,28
133,https://htmlpreview.github.io/?https://github.com/Christina96/boilerplate-sample-matches/blob/main/cpp/glm-MDEwOlJlcG9zaXRvcnk4NDM2MzE=-flat-gtx_simd_mat4.cpp-glm-MDEwOlJlcG9zaXRvcnk4NDM2MzE=-flat-gtx_simd_mat4.cpp-133.html,35,glm-MDEwOlJlcG9zaXRvcnk4NDM2MzE=-flat-gtx_simd_mat4.cpp,glm-MDEwOlJlcG9zaXRvcnk4NDM2MzE=-flat-gtx_simd_mat4.cpp,106,111,5,91,96,5
134,https://htmlpreview.github.io/?https://github.com/Christina96/boilerplate-sample-matches/blob/main/cpp/notepad-plus-plus-MDEwOlJlcG9zaXRvcnkzMzAxNDgxMQ==-flat-catch_14.hpp-notepad-plus-plus-MDEwOlJlcG9zaXRvcnkzMzAxNDgxMQ==-flat-catch.hpp-134.html,73161,notepad-plus-plus-MDEwOlJlcG9zaXRvcnkzMzAxNDgxMQ==-flat-catch_14.hpp,notepad-plus-plus-MDEwOlJlcG9zaXRvcnkzMzAxNDgxMQ==-flat-catch.hpp,3264,13690,10426,3264,13690,10426
135,https://htmlpreview.github.io/?https://github.com/Christina96/boilerplate-sample-matches/blob/main/cpp/tesseract-MDEwOlJlcG9zaXRvcnkyMjg4NzA5NA==-flat-superscript.cpp-tesseract-MDEwOlJlcG9zaXRvcnkyMjg4NzA5NA==-flat-superscript.cpp-135.html,72,tesseract-MDEwOlJlcG9zaXRvcnkyMjg4NzA5NA==-flat-superscript.cpp,tesseract-MDEwOlJlcG9zaXRvcnkyMjg4NzA5NA==-flat-superscript.cpp,276,288,12,294,306,12
136,https://htmlpreview.github.io/?https://github.com/Christina96/boilerplate-sample-matches/blob/main/cpp/snap-MDEwOlJlcG9zaXRvcnk0Mjg4MzU3-flat-network.cpp-snap-MDEwOlJlcG9zaXRvcnk0Mjg4MzU3-flat-network.cpp-136.html,135,snap-MDEwOlJlcG9zaXRvcnk0Mjg4MzU3-flat-network.cpp,snap-MDEwOlJlcG9zaXRvcnk0Mjg4MzU3-flat-network.cpp,350,365,15,321,336,15
137,https://htmlpreview.github.io/?https://github.com/Christina96/boilerplate-sample-matches/blob/main/cpp/snap-MDEwOlJlcG9zaXRvcnk0Mjg4MzU3-flat-sch.cpp-snap-MDEwOlJlcG9zaXRvcnk0Mjg4MzU3-flat-sch.cpp-137.html,19,snap-MDEwOlJlcG9zaXRvcnk0Mjg4MzU3-flat-sch.cpp,snap-MDEwOlJlcG9zaXRvcnk0Mjg4MzU3-flat-sch.cpp,328,331,3,304,307,3
138,https://htmlpreview.github.io/?https://github.com/Christina96/boilerplate-sample-matches/blob/main/cpp/tesseract-MDEwOlJlcG9zaXRvcnkyMjg4NzA5NA==-flat-makerow.cpp-tesseract-MDEwOlJlcG9zaXRvcnkyMjg4NzA5NA==-flat-makerow.cpp-138.html,14,tesseract-MDEwOlJlcG9zaXRvcnkyMjg4NzA5NA==-flat-makerow.cpp,tesseract-MDEwOlJlcG9zaXRvcnkyMjg4NzA5NA==-flat-makerow.cpp,645,646,1,1412,1413,1
139,https://htmlpreview.github.io/?https://github.com/Christina96/boilerplate-sample-matches/blob/main/cpp/snap-MDEwOlJlcG9zaXRvcnk0Mjg4MzU3-flat-ds.h-snap-MDEwOlJlcG9zaXRvcnk0Mjg4MzU3-flat-xmlser.h-139.html,17,snap-MDEwOlJlcG9zaXRvcnk0Mjg4MzU3-flat-ds.h,snap-MDEwOlJlcG9zaXRvcnk0Mjg4MzU3-flat-xmlser.h,2203,2205,2,3,5,2
140,https://htmlpreview.github.io/?https://github.com/Christina96/boilerplate-sample-matches/blob/main/cpp/abseil-cpp-MDEwOlJlcG9zaXRvcnkxMDQyMzE1NDE=-flat-usage_6.cc-notepad-plus-plus-MDEwOlJlcG9zaXRvcnkzMzAxNDgxMQ==-flat-BoostRegExSearch.cxx-140.html,22,abseil-cpp-MDEwOlJlcG9zaXRvcnkxMDQyMzE1NDE=-flat-usage_6.cc,notepad-plus-plus-MDEwOlJlcG9zaXRvcnkzMzAxNDgxMQ==-flat-BoostRegExSearch.cxx,154,156,2,337,339,2
141,https://htmlpreview.github.io/?https://github.com/Christina96/boilerplate-sample-matches/blob/main/cpp/subconverter-MDEwOlJlcG9zaXRvcnkyMTg2ODY3NjM=-flat-settings.cpp-subconverter-MDEwOlJlcG9zaXRvcnkyMTg2ODY3NjM=-flat-settings.cpp-141.html,23,subconverter-MDEwOlJlcG9zaXRvcnkyMTg2ODY3NjM=-flat-settings.cpp,subconverter-MDEwOlJlcG9zaXRvcnkyMTg2ODY3NjM=-flat-settings.cpp,57,59,2,98,100,2
142,https://htmlpreview.github.io/?https://github.com/Christina96/boilerplate-sample-matches/blob/main/cpp/nano-node-MDEwOlJlcG9zaXRvcnkxOTM0NzM0MA==-flat-json_handler.cpp-snap-MDEwOlJlcG9zaXRvcnk0Mjg4MzU3-flat-vizmap.cpp-142.html,14,nano-node-MDEwOlJlcG9zaXRvcnkxOTM0NzM0MA==-flat-json_handler.cpp,snap-MDEwOlJlcG9zaXRvcnk0Mjg4MzU3-flat-vizmap.cpp,2467,2474,7,53,58,5
143,https://htmlpreview.github.io/?https://github.com/Christina96/boilerplate-sample-matches/blob/main/cpp/notepad-plus-plus-MDEwOlJlcG9zaXRvcnkzMzAxNDgxMQ==-flat-preferenceDlg.cpp-notepad-plus-plus-MDEwOlJlcG9zaXRvcnkzMzAxNDgxMQ==-flat-FindCharsInRange.cpp-143.html,14,notepad-plus-plus-MDEwOlJlcG9zaXRvcnkzMzAxNDgxMQ==-flat-preferenceDlg.cpp,notepad-plus-plus-MDEwOlJlcG9zaXRvcnkzMzAxNDgxMQ==-flat-FindCharsInRange.cpp,2627,2636,9,106,115,9
144,https://htmlpreview.github.io/?https://github.com/Christina96/boilerplate-sample-matches/blob/main/cpp/tesseract-MDEwOlJlcG9zaXRvcnkyMjg4NzA5NA==-flat-validate_javanese.cpp-tesseract-MDEwOlJlcG9zaXRvcnkyMjg4NzA5NA==-flat-validate_indic.cpp-144.html,133,tesseract-MDEwOlJlcG9zaXRvcnkyMjg4NzA5NA==-flat-validate_javanese.cpp,tesseract-MDEwOlJlcG9zaXRvcnkyMjg4NzA5NA==-flat-validate_indic.cpp,178,206,28,259,287,28
145,https://htmlpreview.github.io/?https://github.com/Christina96/boilerplate-sample-matches/blob/main/cpp/nano-node-MDEwOlJlcG9zaXRvcnkxOTM0NzM0MA==-flat-socket.cpp-nano-node-MDEwOlJlcG9zaXRvcnkxOTM0NzM0MA==-flat-socket.cpp-145.html,99,nano-node-MDEwOlJlcG9zaXRvcnkxOTM0NzM0MA==-flat-socket.cpp,nano-node-MDEwOlJlcG9zaXRvcnkxOTM0NzM0MA==-flat-socket.cpp,520,530,10,606,615,9
146,https://htmlpreview.github.io/?https://github.com/Christina96/boilerplate-sample-matches/blob/main/cpp/caffe-MDEwOlJlcG9zaXRvcnk2MTg3MDgwMw==-flat-detection_output_layer.cpp-caffe-MDEwOlJlcG9zaXRvcnk2MTg3MDgwMw==-flat-detection_output_layer.cpp-146.html,59,caffe-MDEwOlJlcG9zaXRvcnk2MTg3MDgwMw==-flat-detection_output_layer.cpp,caffe-MDEwOlJlcG9zaXRvcnk2MTg3MDgwMw==-flat-detection_output_layer.cpp,395,400,5,409,414,5
147,https://htmlpreview.github.io/?https://github.com/Christina96/boilerplate-sample-matches/blob/main/cpp/snap-MDEwOlJlcG9zaXRvcnk0Mjg4MzU3-flat-graphcounter.cpp-snap-MDEwOlJlcG9zaXRvcnk0Mjg4MzU3-flat-graphcounter.cpp-147.html,20,snap-MDEwOlJlcG9zaXRvcnk0Mjg4MzU3-flat-graphcounter.cpp,snap-MDEwOlJlcG9zaXRvcnk0Mjg4MzU3-flat-graphcounter.cpp,78,80,2,98,100,2
148,https://htmlpreview.github.io/?https://github.com/Christina96/boilerplate-sample-matches/blob/main/cpp/tesseract-MDEwOlJlcG9zaXRvcnkyMjg4NzA5NA==-flat-makerow.cpp-tesseract-MDEwOlJlcG9zaXRvcnkyMjg4NzA5NA==-flat-topitch.cpp-148.html,14,tesseract-MDEwOlJlcG9zaXRvcnkyMjg4NzA5NA==-flat-makerow.cpp,tesseract-MDEwOlJlcG9zaXRvcnkyMjg4NzA5NA==-flat-topitch.cpp,1704,1706,2,1255,1257,2
149,https://htmlpreview.github.io/?https://github.com/Christina96/boilerplate-sample-matches/blob/main/cpp/caffe-MDEwOlJlcG9zaXRvcnk2MTg3MDgwMw==-flat-gtest-port.cc-caffe-MDEwOlJlcG9zaXRvcnk2MTg3MDgwMw==-flat-gtest-port.cc-149.html,16,caffe-MDEwOlJlcG9zaXRvcnk2MTg3MDgwMw==-flat-gtest-port.cc,caffe-MDEwOlJlcG9zaXRvcnk2MTg3MDgwMw==-flat-gtest-port.cc,396,399,3,399,402,3
150,https://htmlpreview.github.io/?https://github.com/Christina96/boilerplate-sample-matches/blob/main/cpp/nano-node-MDEwOlJlcG9zaXRvcnkxOTM0NzM0MA==-flat-node.cpp-nano-node-MDEwOlJlcG9zaXRvcnkxOTM0NzM0MA==-flat-active_transactions.cpp-150.html,18,nano-node-MDEwOlJlcG9zaXRvcnkxOTM0NzM0MA==-flat-node.cpp,nano-node-MDEwOlJlcG9zaXRvcnkxOTM0NzM0MA==-flat-active_transactions.cpp,3523,3524,1,947,948,1
151,https://htmlpreview.github.io/?https://github.com/Christina96/boilerplate-sample-matches/blob/main/cpp/notepad-plus-plus-MDEwOlJlcG9zaXRvcnkzMzAxNDgxMQ==-flat-w32_regex_traits.hpp-notepad-plus-plus-MDEwOlJlcG9zaXRvcnkzMzAxNDgxMQ==-flat-cpp_regex_traits.hpp-151.html,39,notepad-plus-plus-MDEwOlJlcG9zaXRvcnkzMzAxNDgxMQ==-flat-w32_regex_traits.hpp,notepad-plus-plus-MDEwOlJlcG9zaXRvcnkzMzAxNDgxMQ==-flat-cpp_regex_traits.hpp,715,725,10,823,833,10
152,https://htmlpreview.github.io/?https://github.com/Christina96/boilerplate-sample-matches/blob/main/cpp/abseil-cpp-MDEwOlJlcG9zaXRvcnkxMDQyMzE1NDE=-flat-parser_test.cc-abseil-cpp-MDEwOlJlcG9zaXRvcnkxMDQyMzE1NDE=-flat-parser_test.cc-152.html,18,abseil-cpp-MDEwOlJlcG9zaXRvcnkxMDQyMzE1NDE=-flat-parser_test.cc,abseil-cpp-MDEwOlJlcG9zaXRvcnkxMDQyMzE1NDE=-flat-parser_test.cc,309,311,2,314,316,2
153,https://htmlpreview.github.io/?https://github.com/Christina96/boilerplate-sample-matches/blob/main/cpp/abseil-cpp-MDEwOlJlcG9zaXRvcnkxMDQyMzE1NDE=-flat-mutex_test.cc-abseil-cpp-MDEwOlJlcG9zaXRvcnkxMDQyMzE1NDE=-flat-mutex_benchmark.cc-153.html,16,abseil-cpp-MDEwOlJlcG9zaXRvcnkxMDQyMzE1NDE=-flat-mutex_test.cc,abseil-cpp-MDEwOlJlcG9zaXRvcnkxMDQyMzE1NDE=-flat-mutex_benchmark.cc,1298,1302,4,196,200,4
154,https://htmlpreview.github.io/?https://github.com/Christina96/boilerplate-sample-matches/blob/main/cpp/snap-MDEwOlJlcG9zaXRvcnk0Mjg4MzU3-flat-bowbs.cpp-snap-MDEwOlJlcG9zaXRvcnk0Mjg4MzU3-flat-bowclust.cpp-154.html,20,snap-MDEwOlJlcG9zaXRvcnk0Mjg4MzU3-flat-bowbs.cpp,snap-MDEwOlJlcG9zaXRvcnk0Mjg4MzU3-flat-bowclust.cpp,906,908,2,490,492,2
155,https://htmlpreview.github.io/?https://github.com/Christina96/boilerplate-sample-matches/blob/main/cpp/abseil-cpp-MDEwOlJlcG9zaXRvcnkxMDQyMzE1NDE=-flat-statusor_test.cc-abseil-cpp-MDEwOlJlcG9zaXRvcnkxMDQyMzE1NDE=-flat-utility_test.cc-155.html,16,abseil-cpp-MDEwOlJlcG9zaXRvcnkxMDQyMzE1NDE=-flat-statusor_test.cc,abseil-cpp-MDEwOlJlcG9zaXRvcnkxMDQyMzE1NDE=-flat-utility_test.cc,190,193,3,258,261,3
156,https://htmlpreview.github.io/?https://github.com/Christina96/boilerplate-sample-matches/blob/main/cpp/tesseract-MDEwOlJlcG9zaXRvcnkyMjg4NzA5NA==-flat-oclkernels.h-tesseract-MDEwOlJlcG9zaXRvcnkyMjg4NzA5NA==-flat-oclkernels.h-156.html,16,tesseract-MDEwOlJlcG9zaXRvcnkyMjg4NzA5NA==-flat-oclkernels.h,tesseract-MDEwOlJlcG9zaXRvcnkyMjg4NzA5NA==-flat-oclkernels.h,201,204,3,424,427,3
157,https://htmlpreview.github.io/?https://github.com/Christina96/boilerplate-sample-matches/blob/main/cpp/abseil-cpp-MDEwOlJlcG9zaXRvcnkxMDQyMzE1NDE=-flat-crc_internal.h-abseil-cpp-MDEwOlJlcG9zaXRvcnkxMDQyMzE1NDE=-flat-crc_internal.h-157.html,14,abseil-cpp-MDEwOlJlcG9zaXRvcnkxMDQyMzE1NDE=-flat-crc_internal.h,abseil-cpp-MDEwOlJlcG9zaXRvcnkxMDQyMzE1NDE=-flat-crc_internal.h,21,23,2,34,36,2
158,https://htmlpreview.github.io/?https://github.com/Christina96/boilerplate-sample-matches/blob/main/cpp/nano-node-MDEwOlJlcG9zaXRvcnkxOTM0NzM0MA==-flat-rpc.cpp-nano-node-MDEwOlJlcG9zaXRvcnkxOTM0NzM0MA==-flat-rpc.cpp-158.html,47,nano-node-MDEwOlJlcG9zaXRvcnkxOTM0NzM0MA==-flat-rpc.cpp,nano-node-MDEwOlJlcG9zaXRvcnkxOTM0NzM0MA==-flat-rpc.cpp,4827,4829,2,4857,4859,2
159,https://htmlpreview.github.io/?https://github.com/Christina96/boilerplate-sample-matches/blob/main/cpp/tesseract-MDEwOlJlcG9zaXRvcnkyMjg4NzA5NA==-flat-nthitem_test.cc-tesseract-MDEwOlJlcG9zaXRvcnkyMjg4NzA5NA==-flat-nthitem_test.cc-159.html,43,tesseract-MDEwOlJlcG9zaXRvcnkyMjg4NzA5NA==-flat-nthitem_test.cc,tesseract-MDEwOlJlcG9zaXRvcnkyMjg4NzA5NA==-flat-nthitem_test.cc,40,43,3,43,46,3
160,https://htmlpreview.github.io/?https://github.com/Christina96/boilerplate-sample-matches/blob/main/cpp/tesseract-MDEwOlJlcG9zaXRvcnkyMjg4NzA5NA==-flat-elst.cpp-tesseract-MDEwOlJlcG9zaXRvcnkyMjg4NzA5NA==-flat-elst2.cpp-160.html,46,tesseract-MDEwOlJlcG9zaXRvcnkyMjg4NzA5NA==-flat-elst.cpp,tesseract-MDEwOlJlcG9zaXRvcnkyMjg4NzA5NA==-flat-elst2.cpp,161,167,6,180,186,6
161,https://htmlpreview.github.io/?https://github.com/Christina96/boilerplate-sample-matches/blob/main/cpp/snap-MDEwOlJlcG9zaXRvcnk0Mjg4MzU3-flat-spinn3r.h-snap-MDEwOlJlcG9zaXRvcnk0Mjg4MzU3-flat-spinn3r.h-161.html,14,snap-MDEwOlJlcG9zaXRvcnk0Mjg4MzU3-flat-spinn3r.h,snap-MDEwOlJlcG9zaXRvcnk0Mjg4MzU3-flat-spinn3r.h,10,13,3,44,47,3
162,https://htmlpreview.github.io/?https://github.com/Christina96/boilerplate-sample-matches/blob/main/cpp/notepad-plus-plus-MDEwOlJlcG9zaXRvcnkzMzAxNDgxMQ==-flat-ImageListSet.cpp-notepad-plus-plus-MDEwOlJlcG9zaXRvcnkzMzAxNDgxMQ==-flat-ImageListSet.cpp-162.html,24,notepad-plus-plus-MDEwOlJlcG9zaXRvcnkzMzAxNDgxMQ==-flat-ImageListSet.cpp,notepad-plus-plus-MDEwOlJlcG9zaXRvcnkzMzAxNDgxMQ==-flat-ImageListSet.cpp,83,85,2,82,84,2
163,https://htmlpreview.github.io/?https://github.com/Christina96/boilerplate-sample-matches/blob/main/cpp/notepad-plus-plus-MDEwOlJlcG9zaXRvcnkzMzAxNDgxMQ==-flat-c_regex_traits.hpp-notepad-plus-plus-MDEwOlJlcG9zaXRvcnkzMzAxNDgxMQ==-flat-cpp_regex_traits.hpp-163.html,48,notepad-plus-plus-MDEwOlJlcG9zaXRvcnkzMzAxNDgxMQ==-flat-c_regex_traits.hpp,notepad-plus-plus-MDEwOlJlcG9zaXRvcnkzMzAxNDgxMQ==-flat-cpp_regex_traits.hpp,363,369,6,457,463,6
164,https://htmlpreview.github.io/?https://github.com/Christina96/boilerplate-sample-matches/blob/main/cpp/notepad-plus-plus-MDEwOlJlcG9zaXRvcnkzMzAxNDgxMQ==-flat-catch_14.hpp-notepad-plus-plus-MDEwOlJlcG9zaXRvcnkzMzAxNDgxMQ==-flat-catch.hpp-164.html,87030,notepad-plus-plus-MDEwOlJlcG9zaXRvcnkzMzAxNDgxMQ==-flat-catch_14.hpp,notepad-plus-plus-MDEwOlJlcG9zaXRvcnkzMzAxNDgxMQ==-flat-catch.hpp,1351,13690,12339,1351,13690,12339
165,https://htmlpreview.github.io/?https://github.com/Christina96/boilerplate-sample-matches/blob/main/cpp/caffe-MDEwOlJlcG9zaXRvcnk2MTg3MDgwMw==-flat-upgrade_net_proto_binary.cpp-caffe-MDEwOlJlcG9zaXRvcnk2MTg3MDgwMw==-flat-upgrade_solver_proto_text.cpp-165.html,70,caffe-MDEwOlJlcG9zaXRvcnk2MTg3MDgwMw==-flat-upgrade_net_proto_binary.cpp,caffe-MDEwOlJlcG9zaXRvcnk2MTg3MDgwMw==-flat-upgrade_solver_proto_text.cpp,27,39,12,27,39,12
166,https://htmlpreview.github.io/?https://github.com/Christina96/boilerplate-sample-matches/blob/main/cpp/notepad-plus-plus-MDEwOlJlcG9zaXRvcnkzMzAxNDgxMQ==-flat-LexJulia.cxx-notepad-plus-plus-MDEwOlJlcG9zaXRvcnkzMzAxNDgxMQ==-flat-LexJulia.cxx-166.html,21,notepad-plus-plus-MDEwOlJlcG9zaXRvcnkzMzAxNDgxMQ==-flat-LexJulia.cxx,notepad-plus-plus-MDEwOlJlcG9zaXRvcnkzMzAxNDgxMQ==-flat-LexJulia.cxx,969,974,5,976,981,5
167,https://htmlpreview.github.io/?https://github.com/Christina96/boilerplate-sample-matches/blob/main/cpp/caffe-MDEwOlJlcG9zaXRvcnk2MTg3MDgwMw==-flat-convert_imageset.cpp-caffe-MDEwOlJlcG9zaXRvcnk2MTg3MDgwMw==-flat-image_data_layer.cpp-167.html,67,caffe-MDEwOlJlcG9zaXRvcnk2MTg3MDgwMw==-flat-convert_imageset.cpp,caffe-MDEwOlJlcG9zaXRvcnk2MTg3MDgwMw==-flat-image_data_layer.cpp,56,63,7,40,47,7
168,https://htmlpreview.github.io/?https://github.com/Christina96/boilerplate-sample-matches/blob/main/cpp/notepad-plus-plus-MDEwOlJlcG9zaXRvcnkzMzAxNDgxMQ==-flat-ListView.cpp-snap-MDEwOlJlcG9zaXRvcnk0Mjg4MzU3-flat-table.cpp-168.html,14,notepad-plus-plus-MDEwOlJlcG9zaXRvcnkzMzAxNDgxMQ==-flat-ListView.cpp,snap-MDEwOlJlcG9zaXRvcnk0Mjg4MzU3-flat-table.cpp,73,75,2,2703,2704,1
169,https://htmlpreview.github.io/?https://github.com/Christina96/boilerplate-sample-matches/blob/main/cpp/caffe-MDEwOlJlcG9zaXRvcnk2MTg3MDgwMw==-flat-test_detection.cpp-caffe-MDEwOlJlcG9zaXRvcnk2MTg3MDgwMw==-flat-caffe.cpp-169.html,35,caffe-MDEwOlJlcG9zaXRvcnk2MTg3MDgwMw==-flat-test_detection.cpp,caffe-MDEwOlJlcG9zaXRvcnk2MTg3MDgwMw==-flat-caffe.cpp,48,54,6,126,132,6
170,https://htmlpreview.github.io/?https://github.com/Christina96/boilerplate-sample-matches/blob/main/cpp/notepad-plus-plus-MDEwOlJlcG9zaXRvcnkzMzAxNDgxMQ==-flat-json.hpp-notepad-plus-plus-MDEwOlJlcG9zaXRvcnkzMzAxNDgxMQ==-flat-json.hpp-170.html,44,notepad-plus-plus-MDEwOlJlcG9zaXRvcnkzMzAxNDgxMQ==-flat-json.hpp,notepad-plus-plus-MDEwOlJlcG9zaXRvcnkzMzAxNDgxMQ==-flat-json.hpp,4340,4345,5,4351,4356,5
171,https://htmlpreview.github.io/?https://github.com/Christina96/boilerplate-sample-matches/blob/main/cpp/subconverter-MDEwOlJlcG9zaXRvcnkyMTg2ODY3NjM=-flat-inja.hpp-subconverter-MDEwOlJlcG9zaXRvcnkyMTg2ODY3NjM=-flat-inja.hpp-171.html,15,subconverter-MDEwOlJlcG9zaXRvcnkyMTg2ODY3NjM=-flat-inja.hpp,subconverter-MDEwOlJlcG9zaXRvcnkyMTg2ODY3NjM=-flat-inja.hpp,465,467,2,460,462,2
172,https://htmlpreview.github.io/?https://github.com/Christina96/boilerplate-sample-matches/blob/main/cpp/abseil-cpp-MDEwOlJlcG9zaXRvcnkxMDQyMzE1NDE=-flat-flat_hash_set.h-abseil-cpp-MDEwOlJlcG9zaXRvcnkxMDQyMzE1NDE=-flat-node_hash_set.h-172.html,295,abseil-cpp-MDEwOlJlcG9zaXRvcnkxMDQyMzE1NDE=-flat-flat_hash_set.h,abseil-cpp-MDEwOlJlcG9zaXRvcnkxMDQyMzE1NDE=-flat-node_hash_set.h,17,63,46,16,63,47
173,https://htmlpreview.github.io/?https://github.com/Christina96/boilerplate-sample-matches/blob/main/cpp/notepad-plus-plus-MDEwOlJlcG9zaXRvcnkzMzAxNDgxMQ==-flat-DockingManager.cpp-notepad-plus-plus-MDEwOlJlcG9zaXRvcnkzMzAxNDgxMQ==-flat-DockingManager.cpp-173.html,14,notepad-plus-plus-MDEwOlJlcG9zaXRvcnkzMzAxNDgxMQ==-flat-DockingManager.cpp,notepad-plus-plus-MDEwOlJlcG9zaXRvcnkzMzAxNDgxMQ==-flat-DockingManager.cpp,262,265,3,284,287,3
174,https://htmlpreview.github.io/?https://github.com/Christina96/boilerplate-sample-matches/blob/main/cpp/notepad-plus-plus-MDEwOlJlcG9zaXRvcnkzMzAxNDgxMQ==-flat-LexHTML.cxx-notepad-plus-plus-MDEwOlJlcG9zaXRvcnkzMzAxNDgxMQ==-flat-LexUser.cxx-174.html,20,notepad-plus-plus-MDEwOlJlcG9zaXRvcnkzMzAxNDgxMQ==-flat-LexHTML.cxx,notepad-plus-plus-MDEwOlJlcG9zaXRvcnkzMzAxNDgxMQ==-flat-LexUser.cxx,1773,1778,5,1841,1847,6
175,https://htmlpreview.github.io/?https://github.com/Christina96/boilerplate-sample-matches/blob/main/cpp/snap-MDEwOlJlcG9zaXRvcnk0Mjg4MzU3-flat-ghash.cpp-snap-MDEwOlJlcG9zaXRvcnk0Mjg4MzU3-flat-ghash.cpp-175.html,35,snap-MDEwOlJlcG9zaXRvcnk0Mjg4MzU3-flat-ghash.cpp,snap-MDEwOlJlcG9zaXRvcnk0Mjg4MzU3-flat-ghash.cpp,297,300,3,335,338,3
176,https://htmlpreview.github.io/?https://github.com/Christina96/boilerplate-sample-matches/blob/main/cpp/snap-MDEwOlJlcG9zaXRvcnk0Mjg4MzU3-flat-test-shmio.cpp-snap-MDEwOlJlcG9zaXRvcnk0Mjg4MzU3-flat-test-shmio.cpp-176.html,38,snap-MDEwOlJlcG9zaXRvcnk0Mjg4MzU3-flat-test-shmio.cpp,snap-MDEwOlJlcG9zaXRvcnk0Mjg4MzU3-flat-test-shmio.cpp,189,195,6,216,222,6
177,https://htmlpreview.github.io/?https://github.com/Christina96/boilerplate-sample-matches/blob/main/cpp/snap-MDEwOlJlcG9zaXRvcnk0Mjg4MzU3-flat-sqlitedb.h-snap-MDEwOlJlcG9zaXRvcnk0Mjg4MzU3-flat-sqlitedb.h-177.html,45,snap-MDEwOlJlcG9zaXRvcnk0Mjg4MzU3-flat-sqlitedb.h,snap-MDEwOlJlcG9zaXRvcnk0Mjg4MzU3-flat-sqlitedb.h,60,70,10,68,78,10
178,https://htmlpreview.github.io/?https://github.com/Christina96/boilerplate-sample-matches/blob/main/cpp/notepad-plus-plus-MDEwOlJlcG9zaXRvcnkzMzAxNDgxMQ==-flat-catch.hpp-notepad-plus-plus-MDEwOlJlcG9zaXRvcnkzMzAxNDgxMQ==-flat-catch_14.hpp-178.html,16,notepad-plus-plus-MDEwOlJlcG9zaXRvcnkzMzAxNDgxMQ==-flat-catch.hpp,notepad-plus-plus-MDEwOlJlcG9zaXRvcnkzMzAxNDgxMQ==-flat-catch_14.hpp,354,355,1,354,355,1
179,https://htmlpreview.github.io/?https://github.com/Christina96/boilerplate-sample-matches/blob/main/cpp/nano-node-MDEwOlJlcG9zaXRvcnkxOTM0NzM0MA==-flat-valgrind.h-nano-node-MDEwOlJlcG9zaXRvcnkxOTM0NzM0MA==-flat-valgrind.h-179.html,17,nano-node-MDEwOlJlcG9zaXRvcnkxOTM0NzM0MA==-flat-valgrind.h,nano-node-MDEwOlJlcG9zaXRvcnkxOTM0NzM0MA==-flat-valgrind.h,1350,1353,3,1416,1419,3
180,https://htmlpreview.github.io/?https://github.com/Christina96/boilerplate-sample-matches/blob/main/cpp/notepad-plus-plus-MDEwOlJlcG9zaXRvcnkzMzAxNDgxMQ==-flat-json.hpp-subconverter-MDEwOlJlcG9zaXRvcnkyMTg2ODY3NjM=-flat-json.hpp-180.html,17,notepad-plus-plus-MDEwOlJlcG9zaXRvcnkzMzAxNDgxMQ==-flat-json.hpp,subconverter-MDEwOlJlcG9zaXRvcnkyMTg2ODY3NjM=-flat-json.hpp,14517,14519,2,14309,14311,2
181,https://htmlpreview.github.io/?https://github.com/Christina96/boilerplate-sample-matches/blob/main/cpp/tesseract-MDEwOlJlcG9zaXRvcnkyMjg4NzA5NA==-flat-validate_indic_test.cc-tesseract-MDEwOlJlcG9zaXRvcnkyMjg4NzA5NA==-flat-validate_indic_test.cc-181.html,17,tesseract-MDEwOlJlcG9zaXRvcnkyMjg4NzA5NA==-flat-validate_indic_test.cc,tesseract-MDEwOlJlcG9zaXRvcnkyMjg4NzA5NA==-flat-validate_indic_test.cc,87,89,2,125,127,2
182,https://htmlpreview.github.io/?https://github.com/Christina96/boilerplate-sample-matches/blob/main/cpp/nano-node-MDEwOlJlcG9zaXRvcnkxOTM0NzM0MA==-flat-node_6.cpp-nano-node-MDEwOlJlcG9zaXRvcnkxOTM0NzM0MA==-flat-node_6.cpp-182.html,21,nano-node-MDEwOlJlcG9zaXRvcnkxOTM0NzM0MA==-flat-node_6.cpp,nano-node-MDEwOlJlcG9zaXRvcnkxOTM0NzM0MA==-flat-node_6.cpp,35,37,2,75,77,2
183,https://htmlpreview.github.io/?https://github.com/Christina96/boilerplate-sample-matches/blob/main/cpp/snap-MDEwOlJlcG9zaXRvcnk0Mjg4MzU3-flat-demo-TNodeEdgeNet.cpp-notepad-plus-plus-MDEwOlJlcG9zaXRvcnkzMzAxNDgxMQ==-flat-Document.h-183.html,15,snap-MDEwOlJlcG9zaXRvcnk0Mjg4MzU3-flat-demo-TNodeEdgeNet.cpp,notepad-plus-plus-MDEwOlJlcG9zaXRvcnkzMzAxNDgxMQ==-flat-Document.h,187,192,5,195,200,5
184,https://htmlpreview.github.io/?https://github.com/Christina96/boilerplate-sample-matches/blob/main/cpp/caffe-MDEwOlJlcG9zaXRvcnk2MTg3MDgwMw==-flat-mkl_batch_norm_layer.cpp-caffe-MDEwOlJlcG9zaXRvcnk2MTg3MDgwMw==-flat-mkl_lrn_layer.cpp-184.html,15,caffe-MDEwOlJlcG9zaXRvcnk2MTg3MDgwMw==-flat-mkl_batch_norm_layer.cpp,caffe-MDEwOlJlcG9zaXRvcnk2MTg3MDgwMw==-flat-mkl_lrn_layer.cpp,252,254,2,139,141,2
185,https://htmlpreview.github.io/?https://github.com/Christina96/boilerplate-sample-matches/blob/main/cpp/notepad-plus-plus-MDEwOlJlcG9zaXRvcnkzMzAxNDgxMQ==-flat-source_location.hpp-notepad-plus-plus-MDEwOlJlcG9zaXRvcnkzMzAxNDgxMQ==-flat-source_location.hpp-185.html,14,notepad-plus-plus-MDEwOlJlcG9zaXRvcnkzMzAxNDgxMQ==-flat-source_location.hpp,notepad-plus-plus-MDEwOlJlcG9zaXRvcnkzMzAxNDgxMQ==-flat-source_location.hpp,43,47,4,47,51,4
186,https://htmlpreview.github.io/?https://github.com/Christina96/boilerplate-sample-matches/blob/main/cpp/notepad-plus-plus-MDEwOlJlcG9zaXRvcnkzMzAxNDgxMQ==-flat-LexBash.cxx-notepad-plus-plus-MDEwOlJlcG9zaXRvcnkzMzAxNDgxMQ==-flat-LexPerl.cxx-186.html,23,notepad-plus-plus-MDEwOlJlcG9zaXRvcnkzMzAxNDgxMQ==-flat-LexBash.cxx,notepad-plus-plus-MDEwOlJlcG9zaXRvcnkzMzAxNDgxMQ==-flat-LexPerl.cxx,649,652,3,738,741,3
187,https://htmlpreview.github.io/?https://github.com/Christina96/boilerplate-sample-matches/blob/main/cpp/caffe-MDEwOlJlcG9zaXRvcnk2MTg3MDgwMw==-flat-common.cpp-caffe-MDEwOlJlcG9zaXRvcnk2MTg3MDgwMw==-flat-common.cpp-187.html,38,caffe-MDEwOlJlcG9zaXRvcnk2MTg3MDgwMw==-flat-common.cpp,caffe-MDEwOlJlcG9zaXRvcnk2MTg3MDgwMw==-flat-common.cpp,79,81,2,202,204,2
188,https://htmlpreview.github.io/?https://github.com/Christina96/boilerplate-sample-matches/blob/main/cpp/abseil-cpp-MDEwOlJlcG9zaXRvcnkxMDQyMzE1NDE=-flat-container.h-abseil-cpp-MDEwOlJlcG9zaXRvcnkxMDQyMzE1NDE=-flat-container.h-188.html,17,abseil-cpp-MDEwOlJlcG9zaXRvcnkxMDQyMzE1NDE=-flat-container.h,abseil-cpp-MDEwOlJlcG9zaXRvcnkxMDQyMzE1NDE=-flat-container.h,112,114,2,298,299,1
189,https://htmlpreview.github.io/?https://github.com/Christina96/boilerplate-sample-matches/blob/main/cpp/notepad-plus-plus-MDEwOlJlcG9zaXRvcnkzMzAxNDgxMQ==-flat-PlatQt.cpp-notepad-plus-plus-MDEwOlJlcG9zaXRvcnkzMzAxNDgxMQ==-flat-ScintillaEditBase.cpp-189.html,16,notepad-plus-plus-MDEwOlJlcG9zaXRvcnkzMzAxNDgxMQ==-flat-PlatQt.cpp,notepad-plus-plus-MDEwOlJlcG9zaXRvcnkzMzAxNDgxMQ==-flat-ScintillaEditBase.cpp,1050,1052,2,304,306,2
190,https://htmlpreview.github.io/?https://github.com/Christina96/boilerplate-sample-matches/blob/main/cpp/abseil-cpp-MDEwOlJlcG9zaXRvcnkxMDQyMzE1NDE=-flat-btree_test.cc-abseil-cpp-MDEwOlJlcG9zaXRvcnkxMDQyMzE1NDE=-flat-btree_test.cc-190.html,30,abseil-cpp-MDEwOlJlcG9zaXRvcnkxMDQyMzE1NDE=-flat-btree_test.cc,abseil-cpp-MDEwOlJlcG9zaXRvcnkxMDQyMzE1NDE=-flat-btree_test.cc,101,108,7,111,118,7
191,https://htmlpreview.github.io/?https://github.com/Christina96/boilerplate-sample-matches/blob/main/cpp/tesseract-MDEwOlJlcG9zaXRvcnkyMjg4NzA5NA==-flat-picofeat.cpp-tesseract-MDEwOlJlcG9zaXRvcnkyMjg4NzA5NA==-flat-outfeat.cpp-191.html,27,tesseract-MDEwOlJlcG9zaXRvcnkyMjg4NzA5NA==-flat-picofeat.cpp,tesseract-MDEwOlJlcG9zaXRvcnkyMjg4NzA5NA==-flat-outfeat.cpp,87,91,4,72,76,4
192,https://htmlpreview.github.io/?https://github.com/Christina96/boilerplate-sample-matches/blob/main/cpp/snap-MDEwOlJlcG9zaXRvcnk0Mjg4MzU3-flat-bde.cpp-snap-MDEwOlJlcG9zaXRvcnk0Mjg4MzU3-flat-bde.cpp-192.html,17,snap-MDEwOlJlcG9zaXRvcnk0Mjg4MzU3-flat-bde.cpp,snap-MDEwOlJlcG9zaXRvcnk0Mjg4MzU3-flat-bde.cpp,133,137,4,18,21,3
193,https://htmlpreview.github.io/?https://github.com/Christina96/boilerplate-sample-matches/blob/main/cpp/glm-MDEwOlJlcG9zaXRvcnk4NDM2MzE=-flat-type_vec3.hpp-glm-MDEwOlJlcG9zaXRvcnk4NDM2MzE=-flat-type_vec4.hpp-193.html,253,glm-MDEwOlJlcG9zaXRvcnk4NDM2MzE=-flat-type_vec3.hpp,glm-MDEwOlJlcG9zaXRvcnk4NDM2MzE=-flat-type_vec4.hpp,134,155,21,175,196,21
194,https://htmlpreview.github.io/?https://github.com/Christina96/boilerplate-sample-matches/blob/main/cpp/abseil-cpp-MDEwOlJlcG9zaXRvcnkxMDQyMzE1NDE=-flat-numbers_test.cc-abseil-cpp-MDEwOlJlcG9zaXRvcnkxMDQyMzE1NDE=-flat-numbers_test.cc-194.html,40,abseil-cpp-MDEwOlJlcG9zaXRvcnkxMDQyMzE1NDE=-flat-numbers_test.cc,abseil-cpp-MDEwOlJlcG9zaXRvcnkxMDQyMzE1NDE=-flat-numbers_test.cc,1136,1139,3,1196,1199,3
195,https://htmlpreview.github.io/?https://github.com/Christina96/boilerplate-sample-matches/blob/main/cpp/notepad-plus-plus-MDEwOlJlcG9zaXRvcnkzMzAxNDgxMQ==-flat-documentMap.cpp-notepad-plus-plus-MDEwOlJlcG9zaXRvcnkzMzAxNDgxMQ==-flat-ProjectPanel.cpp-195.html,14,notepad-plus-plus-MDEwOlJlcG9zaXRvcnkzMzAxNDgxMQ==-flat-documentMap.cpp,notepad-plus-plus-MDEwOlJlcG9zaXRvcnkzMzAxNDgxMQ==-flat-ProjectPanel.cpp,244,248,4,126,130,4
196,https://htmlpreview.github.io/?https://github.com/Christina96/boilerplate-sample-matches/blob/main/cpp/caffe-MDEwOlJlcG9zaXRvcnk2MTg3MDgwMw==-flat-batch_classification.cpp-caffe-MDEwOlJlcG9zaXRvcnk2MTg3MDgwMw==-flat-classification.cpp-196.html,61,caffe-MDEwOlJlcG9zaXRvcnk2MTg3MDgwMw==-flat-batch_classification.cpp,caffe-MDEwOlJlcG9zaXRvcnk2MTg3MDgwMw==-flat-classification.cpp,234,244,10,149,159,10
197,https://htmlpreview.github.io/?https://github.com/Christina96/boilerplate-sample-matches/blob/main/cpp/nano-node-MDEwOlJlcG9zaXRvcnkxOTM0NzM0MA==-flat-stats.hpp-nano-node-MDEwOlJlcG9zaXRvcnkxOTM0NzM0MA==-flat-stats.hpp-197.html,28,nano-node-MDEwOlJlcG9zaXRvcnkxOTM0NzM0MA==-flat-stats.hpp,nano-node-MDEwOlJlcG9zaXRvcnkxOTM0NzM0MA==-flat-stats.hpp,46,49,3,63,66,3
198,https://htmlpreview.github.io/?https://github.com/Christina96/boilerplate-sample-matches/blob/main/cpp/caffe-MDEwOlJlcG9zaXRvcnk2MTg3MDgwMw==-flat-mkldnn_batch_norm_layer.cpp-snap-MDEwOlJlcG9zaXRvcnk0Mjg4MzU3-flat-test-TStrPool.cpp-198.html,16,caffe-MDEwOlJlcG9zaXRvcnk2MTg3MDgwMw==-flat-mkldnn_batch_norm_layer.cpp,snap-MDEwOlJlcG9zaXRvcnk0Mjg4MzU3-flat-test-TStrPool.cpp,412,414,2,28,30,2
199,https://htmlpreview.github.io/?https://github.com/Christina96/boilerplate-sample-matches/blob/main/cpp/abseil-cpp-MDEwOlJlcG9zaXRvcnkxMDQyMzE1NDE=-flat-cord_rep_btree_test.cc-abseil-cpp-MDEwOlJlcG9zaXRvcnkxMDQyMzE1NDE=-flat-cord_rep_btree_test.cc-199.html,51,abseil-cpp-MDEwOlJlcG9zaXRvcnkxMDQyMzE1NDE=-flat-cord_rep_btree_test.cc,abseil-cpp-MDEwOlJlcG9zaXRvcnkxMDQyMzE1NDE=-flat-cord_rep_btree_test.cc,701,705,4,748,752,4
200,https://htmlpreview.github.io/?https://github.com/Christina96/boilerplate-sample-matches/blob/main/cpp/snap-MDEwOlJlcG9zaXRvcnk0Mjg4MzU3-flat-bde.cpp-snap-MDEwOlJlcG9zaXRvcnk0Mjg4MzU3-flat-adox.cpp-200.html,63,snap-MDEwOlJlcG9zaXRvcnk0Mjg4MzU3-flat-bde.cpp,snap-MDEwOlJlcG9zaXRvcnk0Mjg4MzU3-flat-adox.cpp,152,161,9,45,54,9
201,https://htmlpreview.github.io/?https://github.com/Christina96/boilerplate-sample-matches/blob/main/cpp/snap-MDEwOlJlcG9zaXRvcnk0Mjg4MzU3-flat-term.cpp-snap-MDEwOlJlcG9zaXRvcnk0Mjg4MzU3-flat-term.cpp-201.html,20,snap-MDEwOlJlcG9zaXRvcnk0Mjg4MzU3-flat-term.cpp,snap-MDEwOlJlcG9zaXRvcnk0Mjg4MzU3-flat-term.cpp,186,188,2,72,74,2
202,https://htmlpreview.github.io/?https://github.com/Christina96/boilerplate-sample-matches/blob/main/cpp/notepad-plus-plus-MDEwOlJlcG9zaXRvcnkzMzAxNDgxMQ==-flat-catch_14.hpp-notepad-plus-plus-MDEwOlJlcG9zaXRvcnkzMzAxNDgxMQ==-flat-catch.hpp-202.html,64681,notepad-plus-plus-MDEwOlJlcG9zaXRvcnkzMzAxNDgxMQ==-flat-catch_14.hpp,notepad-plus-plus-MDEwOlJlcG9zaXRvcnkzMzAxNDgxMQ==-flat-catch.hpp,4601,13690,9089,4601,13690,9089
203,https://htmlpreview.github.io/?https://github.com/Christina96/boilerplate-sample-matches/blob/main/cpp/notepad-plus-plus-MDEwOlJlcG9zaXRvcnkzMzAxNDgxMQ==-flat-LexBash.cxx-notepad-plus-plus-MDEwOlJlcG9zaXRvcnkzMzAxNDgxMQ==-flat-LexBash.cxx-203.html,22,notepad-plus-plus-MDEwOlJlcG9zaXRvcnkzMzAxNDgxMQ==-flat-LexBash.cxx,notepad-plus-plus-MDEwOlJlcG9zaXRvcnkzMzAxNDgxMQ==-flat-LexBash.cxx,43,52,9,48,57,9
204,https://htmlpreview.github.io/?https://github.com/Christina96/boilerplate-sample-matches/blob/main/cpp/notepad-plus-plus-MDEwOlJlcG9zaXRvcnkzMzAxNDgxMQ==-flat-ColourPopup.cpp-notepad-plus-plus-MDEwOlJlcG9zaXRvcnkzMzAxNDgxMQ==-flat-FindReplaceDlg.cpp-204.html,17,notepad-plus-plus-MDEwOlJlcG9zaXRvcnkzMzAxNDgxMQ==-flat-ColourPopup.cpp,notepad-plus-plus-MDEwOlJlcG9zaXRvcnkzMzAxNDgxMQ==-flat-FindReplaceDlg.cpp,76,79,3,4635,4638,3
205,https://htmlpreview.github.io/?https://github.com/Christina96/boilerplate-sample-matches/blob/main/cpp/notepad-plus-plus-MDEwOlJlcG9zaXRvcnkzMzAxNDgxMQ==-flat-tinyxmlparser.cpp-notepad-plus-plus-MDEwOlJlcG9zaXRvcnkzMzAxNDgxMQ==-flat-tinyxmlparserA.cpp-205.html,22,notepad-plus-plus-MDEwOlJlcG9zaXRvcnkzMzAxNDgxMQ==-flat-tinyxmlparser.cpp,notepad-plus-plus-MDEwOlJlcG9zaXRvcnkzMzAxNDgxMQ==-flat-tinyxmlparserA.cpp,362,365,3,374,377,3
206,https://htmlpreview.github.io/?https://github.com/Christina96/boilerplate-sample-matches/blob/main/cpp/MMKV-MDEwOlJlcG9zaXRvcnkxNDkxMTE4MTM=-flat-CodedInputDataCrypt.cpp-MMKV-MDEwOlJlcG9zaXRvcnkxNDkxMTE4MTM=-flat-CodedInputDataCrypt_OSX.cpp-206.html,61,MMKV-MDEwOlJlcG9zaXRvcnkxNDkxMTE4MTM=-flat-CodedInputDataCrypt.cpp,MMKV-MDEwOlJlcG9zaXRvcnkxNDkxMTE4MTM=-flat-CodedInputDataCrypt_OSX.cpp,174,182,8,12,20,8
207,https://htmlpreview.github.io/?https://github.com/Christina96/boilerplate-sample-matches/blob/main/cpp/snap-MDEwOlJlcG9zaXRvcnk0Mjg4MzU3-flat-rinetmatch.h-snap-MDEwOlJlcG9zaXRvcnk0Mjg4MzU3-flat-rids.h-207.html,23,snap-MDEwOlJlcG9zaXRvcnk0Mjg4MzU3-flat-rinetmatch.h,snap-MDEwOlJlcG9zaXRvcnk0Mjg4MzU3-flat-rids.h,90,96,6,380,386,6
208,https://htmlpreview.github.io/?https://github.com/Christina96/boilerplate-sample-matches/blob/main/cpp/nano-node-MDEwOlJlcG9zaXRvcnkxOTM0NzM0MA==-flat-block_store.cpp-nano-node-MDEwOlJlcG9zaXRvcnkxOTM0NzM0MA==-flat-block_store.cpp-208.html,21,nano-node-MDEwOlJlcG9zaXRvcnkxOTM0NzM0MA==-flat-block_store.cpp,nano-node-MDEwOlJlcG9zaXRvcnkxOTM0NzM0MA==-flat-block_store.cpp,2065,2067,2,477,479,2
209,https://htmlpreview.github.io/?https://github.com/Christina96/boilerplate-sample-matches/blob/main/cpp/caffe-MDEwOlJlcG9zaXRvcnk2MTg3MDgwMw==-flat-device_alternate.hpp-caffe-MDEwOlJlcG9zaXRvcnk2MTg3MDgwMw==-flat-device_alternate.hpp-209.html,14,caffe-MDEwOlJlcG9zaXRvcnk2MTg3MDgwMw==-flat-device_alternate.hpp,caffe-MDEwOlJlcG9zaXRvcnk2MTg3MDgwMw==-flat-device_alternate.hpp,45,47,2,51,53,2
210,https://htmlpreview.github.io/?https://github.com/Christina96/boilerplate-sample-matches/blob/main/cpp/tesseract-MDEwOlJlcG9zaXRvcnkyMjg4NzA5NA==-flat-clst.h-tesseract-MDEwOlJlcG9zaXRvcnkyMjg4NzA5NA==-flat-elst.h-210.html,21,tesseract-MDEwOlJlcG9zaXRvcnkyMjg4NzA5NA==-flat-clst.h,tesseract-MDEwOlJlcG9zaXRvcnkyMjg4NzA5NA==-flat-elst.h,157,161,4,250,254,4
211,https://htmlpreview.github.io/?https://github.com/Christina96/boilerplate-sample-matches/blob/main/cpp/snap-MDEwOlJlcG9zaXRvcnk0Mjg4MzU3-flat-prologparser.cpp-snap-MDEwOlJlcG9zaXRvcnk0Mjg4MzU3-flat-prologparser.cpp-211.html,23,snap-MDEwOlJlcG9zaXRvcnk0Mjg4MzU3-flat-prologparser.cpp,snap-MDEwOlJlcG9zaXRvcnk0Mjg4MzU3-flat-prologparser.cpp,406,412,6,386,392,6
212,https://htmlpreview.github.io/?https://github.com/Christina96/boilerplate-sample-matches/blob/main/cpp/abseil-cpp-MDEwOlJlcG9zaXRvcnkxMDQyMzE1NDE=-flat-parse_test.cc-abseil-cpp-MDEwOlJlcG9zaXRvcnkxMDQyMzE1NDE=-flat-parse_test.cc-212.html,21,abseil-cpp-MDEwOlJlcG9zaXRvcnkxMDQyMzE1NDE=-flat-parse_test.cc,abseil-cpp-MDEwOlJlcG9zaXRvcnkxMDQyMzE1NDE=-flat-parse_test.cc,248,251,3,302,305,3
213,https://htmlpreview.github.io/?https://github.com/Christina96/boilerplate-sample-matches/blob/main/cpp/tesseract-MDEwOlJlcG9zaXRvcnkyMjg4NzA5NA==-flat-helpers.h-notepad-plus-plus-MDEwOlJlcG9zaXRvcnkzMzAxNDgxMQ==-flat-NppIO.cpp-213.html,15,tesseract-MDEwOlJlcG9zaXRvcnkyMjg4NzA5NA==-flat-helpers.h,notepad-plus-plus-MDEwOlJlcG9zaXRvcnkzMzAxNDgxMQ==-flat-NppIO.cpp,68,73,5,152,158,6
214,https://htmlpreview.github.io/?https://github.com/Christina96/boilerplate-sample-matches/blob/main/cpp/subconverter-MDEwOlJlcG9zaXRvcnkyMTg2ODY3NjM=-flat-json.hpp-notepad-plus-plus-MDEwOlJlcG9zaXRvcnkzMzAxNDgxMQ==-flat-json.hpp-214.html,50,subconverter-MDEwOlJlcG9zaXRvcnkyMTg2ODY3NjM=-flat-json.hpp,notepad-plus-plus-MDEwOlJlcG9zaXRvcnkzMzAxNDgxMQ==-flat-json.hpp,10135,10140,5,11275,11280,5
215,https://htmlpreview.github.io/?https://github.com/Christina96/boilerplate-sample-matches/blob/main/cpp/snap-MDEwOlJlcG9zaXRvcnk0Mjg4MzU3-flat-crawler.cpp-snap-MDEwOlJlcG9zaXRvcnk0Mjg4MzU3-flat-crawler.cpp-215.html,29,snap-MDEwOlJlcG9zaXRvcnk0Mjg4MzU3-flat-crawler.cpp,snap-MDEwOlJlcG9zaXRvcnk0Mjg4MzU3-flat-crawler.cpp,344,347,3,380,383,3
216,https://htmlpreview.github.io/?https://github.com/Christina96/boilerplate-sample-matches/blob/main/cpp/caffe-MDEwOlJlcG9zaXRvcnk2MTg3MDgwMw==-flat-cudnn.hpp-caffe-MDEwOlJlcG9zaXRvcnk2MTg3MDgwMw==-flat-cudnn.hpp-216.html,31,caffe-MDEwOlJlcG9zaXRvcnk2MTg3MDgwMw==-flat-cudnn.hpp,caffe-MDEwOlJlcG9zaXRvcnk2MTg3MDgwMw==-flat-cudnn.hpp,58,63,5,91,96,5
217,https://htmlpreview.github.io/?https://github.com/Christina96/boilerplate-sample-matches/blob/main/cpp/caffe-MDEwOlJlcG9zaXRvcnk2MTg3MDgwMw==-flat-test_annotated_data_layer.cpp-caffe-MDEwOlJlcG9zaXRvcnk2MTg3MDgwMw==-flat-test_data_layer.cpp-217.html,27,caffe-MDEwOlJlcG9zaXRvcnk2MTg3MDgwMw==-flat-test_annotated_data_layer.cpp,caffe-MDEwOlJlcG9zaXRvcnk2MTg3MDgwMw==-flat-test_data_layer.cpp,197,199,2,36,38,2
218,https://htmlpreview.github.io/?https://github.com/Christina96/boilerplate-sample-matches/blob/main/cpp/nano-node-MDEwOlJlcG9zaXRvcnkxOTM0NzM0MA==-flat-curve25519-donna-64bit.h-nano-node-MDEwOlJlcG9zaXRvcnkxOTM0NzM0MA==-flat-curve25519-donna-64bit.h-218.html,217,nano-node-MDEwOlJlcG9zaXRvcnkxOTM0NzM0MA==-flat-curve25519-donna-64bit.h,nano-node-MDEwOlJlcG9zaXRvcnkxOTM0NzM0MA==-flat-curve25519-donna-64bit.h,124,138,14,223,237,14
219,https://htmlpreview.github.io/?https://github.com/Christina96/boilerplate-sample-matches/blob/main/cpp/notepad-plus-plus-MDEwOlJlcG9zaXRvcnkzMzAxNDgxMQ==-flat-LexHollywood.cxx-notepad-plus-plus-MDEwOlJlcG9zaXRvcnkzMzAxNDgxMQ==-flat-LexBasic.cxx-219.html,83,notepad-plus-plus-MDEwOlJlcG9zaXRvcnkzMzAxNDgxMQ==-flat-LexHollywood.cxx,notepad-plus-plus-MDEwOlJlcG9zaXRvcnkzMzAxNDgxMQ==-flat-LexBasic.cxx,270,286,16,244,260,16
220,https://htmlpreview.github.io/?https://github.com/Christina96/boilerplate-sample-matches/blob/main/cpp/caffe-MDEwOlJlcG9zaXRvcnk2MTg3MDgwMw==-flat-test_convolution_layer.cpp-caffe-MDEwOlJlcG9zaXRvcnk2MTg3MDgwMw==-flat-test_mkldnn_convolution_layer.cpp-220.html,91,caffe-MDEwOlJlcG9zaXRvcnk2MTg3MDgwMw==-flat-test_convolution_layer.cpp,caffe-MDEwOlJlcG9zaXRvcnk2MTg3MDgwMw==-flat-test_mkldnn_convolution_layer.cpp,327,338,11,422,433,11
221,https://htmlpreview.github.io/?https://github.com/Christina96/boilerplate-sample-matches/blob/main/cpp/tesseract-MDEwOlJlcG9zaXRvcnkyMjg4NzA5NA==-flat-denorm_test.cc-tesseract-MDEwOlJlcG9zaXRvcnkyMjg4NzA5NA==-flat-denorm_test.cc-221.html,30,tesseract-MDEwOlJlcG9zaXRvcnkyMjg4NzA5NA==-flat-denorm_test.cc,tesseract-MDEwOlJlcG9zaXRvcnkyMjg4NzA5NA==-flat-denorm_test.cc,37,40,3,68,71,3
222,https://htmlpreview.github.io/?https://github.com/Christina96/boilerplate-sample-matches/blob/main/cpp/snap-MDEwOlJlcG9zaXRvcnk0Mjg4MzU3-flat-network.cpp-snap-MDEwOlJlcG9zaXRvcnk0Mjg4MzU3-flat-graph_2.cpp-222.html,282,snap-MDEwOlJlcG9zaXRvcnk0Mjg4MzU3-flat-network.cpp,snap-MDEwOlJlcG9zaXRvcnk0Mjg4MzU3-flat-graph_2.cpp,1933,1964,31,57,88,31
223,https://htmlpreview.github.io/?https://github.com/Christina96/boilerplate-sample-matches/blob/main/cpp/notepad-plus-plus-MDEwOlJlcG9zaXRvcnkzMzAxNDgxMQ==-flat-Buffer.cpp-notepad-plus-plus-MDEwOlJlcG9zaXRvcnkzMzAxNDgxMQ==-flat-Buffer.cpp-223.html,16,notepad-plus-plus-MDEwOlJlcG9zaXRvcnkzMzAxNDgxMQ==-flat-Buffer.cpp,notepad-plus-plus-MDEwOlJlcG9zaXRvcnkzMzAxNDgxMQ==-flat-Buffer.cpp,773,776,3,888,891,3
224,https://htmlpreview.github.io/?https://github.com/Christina96/boilerplate-sample-matches/blob/main/cpp/nano-node-MDEwOlJlcG9zaXRvcnkxOTM0NzM0MA==-flat-conflicts.cpp-nano-node-MDEwOlJlcG9zaXRvcnkxOTM0NzM0MA==-flat-wallets.cpp-224.html,20,nano-node-MDEwOlJlcG9zaXRvcnkxOTM0NzM0MA==-flat-conflicts.cpp,nano-node-MDEwOlJlcG9zaXRvcnkxOTM0NzM0MA==-flat-wallets.cpp,187,191,4,17,21,4
225,https://htmlpreview.github.io/?https://github.com/Christina96/boilerplate-sample-matches/blob/main/cpp/notepad-plus-plus-MDEwOlJlcG9zaXRvcnkzMzAxNDgxMQ==-flat-LexObjC.cxx-snap-MDEwOlJlcG9zaXRvcnk0Mjg4MzU3-flat-shash.h-225.html,14,notepad-plus-plus-MDEwOlJlcG9zaXRvcnkzMzAxNDgxMQ==-flat-LexObjC.cxx,snap-MDEwOlJlcG9zaXRvcnk0Mjg4MzU3-flat-shash.h,474,475,1,539,540,1
226,https://htmlpreview.github.io/?https://github.com/Christina96/boilerplate-sample-matches/blob/main/cpp/notepad-plus-plus-MDEwOlJlcG9zaXRvcnkzMzAxNDgxMQ==-flat-PlatQt.cpp-notepad-plus-plus-MDEwOlJlcG9zaXRvcnkzMzAxNDgxMQ==-flat-PlatQt.cpp-226.html,16,notepad-plus-plus-MDEwOlJlcG9zaXRvcnkzMzAxNDgxMQ==-flat-PlatQt.cpp,notepad-plus-plus-MDEwOlJlcG9zaXRvcnkzMzAxNDgxMQ==-flat-PlatQt.cpp,445,447,2,550,552,2
227,https://htmlpreview.github.io/?https://github.com/Christina96/boilerplate-sample-matches/blob/main/cpp/snap-MDEwOlJlcG9zaXRvcnk0Mjg4MzU3-flat-google.cpp-snap-MDEwOlJlcG9zaXRvcnk0Mjg4MzU3-flat-googlex.cpp-227.html,14,snap-MDEwOlJlcG9zaXRvcnk0Mjg4MzU3-flat-google.cpp,snap-MDEwOlJlcG9zaXRvcnk0Mjg4MzU3-flat-googlex.cpp,549,550,1,533,534,1
228,https://htmlpreview.github.io/?https://github.com/Christina96/boilerplate-sample-matches/blob/main/cpp/notepad-plus-plus-MDEwOlJlcG9zaXRvcnkzMzAxNDgxMQ==-flat-catch_14.hpp-notepad-plus-plus-MDEwOlJlcG9zaXRvcnkzMzAxNDgxMQ==-flat-catch.hpp-228.html,46720,notepad-plus-plus-MDEwOlJlcG9zaXRvcnkzMzAxNDgxMQ==-flat-catch_14.hpp,notepad-plus-plus-MDEwOlJlcG9zaXRvcnkzMzAxNDgxMQ==-flat-catch.hpp,7053,13690,6637,7053,13690,6637
229,https://htmlpreview.github.io/?https://github.com/Christina96/boilerplate-sample-matches/blob/main/cpp/snap-MDEwOlJlcG9zaXRvcnk0Mjg4MzU3-flat-network.cpp-snap-MDEwOlJlcG9zaXRvcnk0Mjg4MzU3-flat-network.cpp-229.html,442,snap-MDEwOlJlcG9zaXRvcnk0Mjg4MzU3-flat-network.cpp,snap-MDEwOlJlcG9zaXRvcnk0Mjg4MzU3-flat-network.cpp,939,988,49,1128,1177,49
230,https://htmlpreview.github.io/?https://github.com/Christina96/boilerplate-sample-matches/blob/main/cpp/abseil-cpp-MDEwOlJlcG9zaXRvcnkxMDQyMzE1NDE=-flat-container_test.cc-snap-MDEwOlJlcG9zaXRvcnk0Mjg4MzU3-flat-test-alg.cpp-230.html,14,abseil-cpp-MDEwOlJlcG9zaXRvcnkxMDQyMzE1NDE=-flat-container_test.cc,snap-MDEwOlJlcG9zaXRvcnk0Mjg4MzU3-flat-test-alg.cpp,920,922,2,1194,1196,2
231,https://htmlpreview.github.io/?https://github.com/Christina96/boilerplate-sample-matches/blob/main/cpp/snap-MDEwOlJlcG9zaXRvcnk0Mjg4MzU3-flat-memes.cpp-snap-MDEwOlJlcG9zaXRvcnk0Mjg4MzU3-flat-http.cpp-231.html,28,snap-MDEwOlJlcG9zaXRvcnk0Mjg4MzU3-flat-memes.cpp,snap-MDEwOlJlcG9zaXRvcnk0Mjg4MzU3-flat-http.cpp,392,396,4,692,694,2
232,https://htmlpreview.github.io/?https://github.com/Christina96/boilerplate-sample-matches/blob/main/cpp/abseil-cpp-MDEwOlJlcG9zaXRvcnkxMDQyMzE1NDE=-flat-distributions_test.cc-abseil-cpp-MDEwOlJlcG9zaXRvcnkxMDQyMzE1NDE=-flat-distributions_test.cc-232.html,24,abseil-cpp-MDEwOlJlcG9zaXRvcnkxMDQyMzE1NDE=-flat-distributions_test.cc,abseil-cpp-MDEwOlJlcG9zaXRvcnkxMDQyMzE1NDE=-flat-distributions_test.cc,154,155,1,168,169,1
233,https://htmlpreview.github.io/?https://github.com/Christina96/boilerplate-sample-matches/blob/main/cpp/abseil-cpp-MDEwOlJlcG9zaXRvcnkxMDQyMzE1NDE=-flat-layout_test.cc-abseil-cpp-MDEwOlJlcG9zaXRvcnkxMDQyMzE1NDE=-flat-layout_test.cc-233.html,20,abseil-cpp-MDEwOlJlcG9zaXRvcnkxMDQyMzE1NDE=-flat-layout_test.cc,abseil-cpp-MDEwOlJlcG9zaXRvcnkxMDQyMzE1NDE=-flat-layout_test.cc,1452,1453,1,1451,1452,1
234,https://htmlpreview.github.io/?https://github.com/Christina96/boilerplate-sample-matches/blob/main/cpp/notepad-plus-plus-MDEwOlJlcG9zaXRvcnkzMzAxNDgxMQ==-flat-catch_14.hpp-notepad-plus-plus-MDEwOlJlcG9zaXRvcnkzMzAxNDgxMQ==-flat-catch.hpp-234.html,86409,notepad-plus-plus-MDEwOlJlcG9zaXRvcnkzMzAxNDgxMQ==-flat-catch_14.hpp,notepad-plus-plus-MDEwOlJlcG9zaXRvcnkzMzAxNDgxMQ==-flat-catch.hpp,1455,13690,12235,1455,13690,12235
235,https://htmlpreview.github.io/?https://github.com/Christina96/boilerplate-sample-matches/blob/main/cpp/notepad-plus-plus-MDEwOlJlcG9zaXRvcnkzMzAxNDgxMQ==-flat-catch_14.hpp-notepad-plus-plus-MDEwOlJlcG9zaXRvcnkzMzAxNDgxMQ==-flat-catch.hpp-235.html,29543,notepad-plus-plus-MDEwOlJlcG9zaXRvcnkzMzAxNDgxMQ==-flat-catch_14.hpp,notepad-plus-plus-MDEwOlJlcG9zaXRvcnkzMzAxNDgxMQ==-flat-catch.hpp,9580,13690,4110,9580,13690,4110
236,https://htmlpreview.github.io/?https://github.com/Christina96/boilerplate-sample-matches/blob/main/cpp/snap-MDEwOlJlcG9zaXRvcnk0Mjg4MzU3-flat-bd.h-snap-MDEwOlJlcG9zaXRvcnk0Mjg4MzU3-flat-bd.h-236.html,14,snap-MDEwOlJlcG9zaXRvcnk0Mjg4MzU3-flat-bd.h,snap-MDEwOlJlcG9zaXRvcnk0Mjg4MzU3-flat-bd.h,111,114,3,119,122,3
237,https://htmlpreview.github.io/?https://github.com/Christina96/boilerplate-sample-matches/blob/main/cpp/notepad-plus-plus-MDEwOlJlcG9zaXRvcnkzMzAxNDgxMQ==-flat-TabBar.cpp-notepad-plus-plus-MDEwOlJlcG9zaXRvcnkzMzAxNDgxMQ==-flat-DockingCont.cpp-237.html,16,notepad-plus-plus-MDEwOlJlcG9zaXRvcnkzMzAxNDgxMQ==-flat-TabBar.cpp,notepad-plus-plus-MDEwOlJlcG9zaXRvcnkzMzAxNDgxMQ==-flat-DockingCont.cpp,849,851,2,809,811,2
238,https://htmlpreview.github.io/?https://github.com/Christina96/boilerplate-sample-matches/blob/main/cpp/subconverter-MDEwOlJlcG9zaXRvcnkyMTg2ODY3NjM=-flat-infoparser.cpp-subconverter-MDEwOlJlcG9zaXRvcnkyMTg2ODY3NjM=-flat-infoparser.cpp-238.html,73,subconverter-MDEwOlJlcG9zaXRvcnkyMTg2ODY3NjM=-flat-infoparser.cpp,subconverter-MDEwOlJlcG9zaXRvcnkyMTg2ODY3NjM=-flat-infoparser.cpp,84,102,18,102,120,18
239,https://htmlpreview.github.io/?https://github.com/Christina96/boilerplate-sample-matches/blob/main/cpp/notepad-plus-plus-MDEwOlJlcG9zaXRvcnkzMzAxNDgxMQ==-flat-DocTabView.cpp-notepad-plus-plus-MDEwOlJlcG9zaXRvcnkzMzAxNDgxMQ==-flat-ListView.cpp-239.html,17,notepad-plus-plus-MDEwOlJlcG9zaXRvcnkzMzAxNDgxMQ==-flat-DocTabView.cpp,notepad-plus-plus-MDEwOlJlcG9zaXRvcnkzMzAxNDgxMQ==-flat-ListView.cpp,20,21,1,61,62,1
240,https://htmlpreview.github.io/?https://github.com/Christina96/boilerplate-sample-matches/blob/main/cpp/snap-MDEwOlJlcG9zaXRvcnk0Mjg4MzU3-flat-dmoz.h-snap-MDEwOlJlcG9zaXRvcnk0Mjg4MzU3-flat-dmoz.h-240.html,31,snap-MDEwOlJlcG9zaXRvcnk0Mjg4MzU3-flat-dmoz.h,snap-MDEwOlJlcG9zaXRvcnk0Mjg4MzU3-flat-dmoz.h,88,91,3,91,94,3
241,https://htmlpreview.github.io/?https://github.com/Christina96/boilerplate-sample-matches/blob/main/cpp/snap-MDEwOlJlcG9zaXRvcnk0Mjg4MzU3-flat-gstat.h-snap-MDEwOlJlcG9zaXRvcnk0Mjg4MzU3-flat-mmgraph-exp.h-241.html,14,snap-MDEwOlJlcG9zaXRvcnk0Mjg4MzU3-flat-gstat.h,snap-MDEwOlJlcG9zaXRvcnk0Mjg4MzU3-flat-mmgraph-exp.h,180,183,3,451,454,3
242,https://htmlpreview.github.io/?https://github.com/Christina96/boilerplate-sample-matches/blob/main/cpp/notepad-plus-plus-MDEwOlJlcG9zaXRvcnkzMzAxNDgxMQ==-flat-catch_14.hpp-notepad-plus-plus-MDEwOlJlcG9zaXRvcnkzMzAxNDgxMQ==-flat-catch.hpp-242.html,58143,notepad-plus-plus-MDEwOlJlcG9zaXRvcnkzMzAxNDgxMQ==-flat-catch_14.hpp,notepad-plus-plus-MDEwOlJlcG9zaXRvcnkzMzAxNDgxMQ==-flat-catch.hpp,5426,13690,8264,5426,13690,8264
243,https://htmlpreview.github.io/?https://github.com/Christina96/boilerplate-sample-matches/blob/main/cpp/notepad-plus-plus-MDEwOlJlcG9zaXRvcnkzMzAxNDgxMQ==-flat-tinystrA.cpp-notepad-plus-plus-MDEwOlJlcG9zaXRvcnkzMzAxNDgxMQ==-flat-tinystr.cpp-243.html,14,notepad-plus-plus-MDEwOlJlcG9zaXRvcnkzMzAxNDgxMQ==-flat-tinystrA.cpp,notepad-plus-plus-MDEwOlJlcG9zaXRvcnkzMzAxNDgxMQ==-flat-tinystr.cpp,126,130,4,125,129,4
244,https://htmlpreview.github.io/?https://github.com/Christina96/boilerplate-sample-matches/blob/main/cpp/notepad-plus-plus-MDEwOlJlcG9zaXRvcnkzMzAxNDgxMQ==-flat-catch_14.hpp-notepad-plus-plus-MDEwOlJlcG9zaXRvcnkzMzAxNDgxMQ==-flat-catch.hpp-244.html,51845,notepad-plus-plus-MDEwOlJlcG9zaXRvcnkzMzAxNDgxMQ==-flat-catch_14.hpp,notepad-plus-plus-MDEwOlJlcG9zaXRvcnkzMzAxNDgxMQ==-flat-catch.hpp,6339,13690,7351,6339,13690,7351
245,https://htmlpreview.github.io/?https://github.com/Christina96/boilerplate-sample-matches/blob/main/cpp/abseil-cpp-MDEwOlJlcG9zaXRvcnkxMDQyMzE1NDE=-flat-reflection_test.cc-abseil-cpp-MDEwOlJlcG9zaXRvcnkxMDQyMzE1NDE=-flat-reflection_test.cc-245.html,16,abseil-cpp-MDEwOlJlcG9zaXRvcnkxMDQyMzE1NDE=-flat-reflection_test.cc,abseil-cpp-MDEwOlJlcG9zaXRvcnkxMDQyMzE1NDE=-flat-reflection_test.cc,27,29,2,29,31,2
246,https://htmlpreview.github.io/?https://github.com/Christina96/boilerplate-sample-matches/blob/main/cpp/caffe-MDEwOlJlcG9zaXRvcnk2MTg3MDgwMw==-flat-prelu_layer.cpp-caffe-MDEwOlJlcG9zaXRvcnk2MTg3MDgwMw==-flat-normalize_layer.cpp-246.html,100,caffe-MDEwOlJlcG9zaXRvcnk2MTg3MDgwMw==-flat-prelu_layer.cpp,caffe-MDEwOlJlcG9zaXRvcnk2MTg3MDgwMw==-flat-normalize_layer.cpp,30,43,13,45,58,13
247,https://htmlpreview.github.io/?https://github.com/Christina96/boilerplate-sample-matches/blob/main/cpp/snap-MDEwOlJlcG9zaXRvcnk0Mjg4MzU3-flat-blobbs.h-snap-MDEwOlJlcG9zaXRvcnk0Mjg4MzU3-flat-cascdynetinf.h-247.html,15,snap-MDEwOlJlcG9zaXRvcnk0Mjg4MzU3-flat-blobbs.h,snap-MDEwOlJlcG9zaXRvcnk0Mjg4MzU3-flat-cascdynetinf.h,6,10,4,127,131,4
248,https://htmlpreview.github.io/?https://github.com/Christina96/boilerplate-sample-matches/blob/main/cpp/notepad-plus-plus-MDEwOlJlcG9zaXRvcnkzMzAxNDgxMQ==-flat-ScintillaQt.cpp-notepad-plus-plus-MDEwOlJlcG9zaXRvcnkzMzAxNDgxMQ==-flat-ScintillaQt.cpp-248.html,19,notepad-plus-plus-MDEwOlJlcG9zaXRvcnkzMzAxNDgxMQ==-flat-ScintillaQt.cpp,notepad-plus-plus-MDEwOlJlcG9zaXRvcnkzMzAxNDgxMQ==-flat-ScintillaQt.cpp,648,651,3,654,657,3
249,https://htmlpreview.github.io/?https://github.com/Christina96/boilerplate-sample-matches/blob/main/cpp/notepad-plus-plus-MDEwOlJlcG9zaXRvcnkzMzAxNDgxMQ==-flat-NppNotification.cpp-notepad-plus-plus-MDEwOlJlcG9zaXRvcnkzMzAxNDgxMQ==-flat-winmain.cpp-249.html,45,notepad-plus-plus-MDEwOlJlcG9zaXRvcnkzMzAxNDgxMQ==-flat-NppNotification.cpp,notepad-plus-plus-MDEwOlJlcG9zaXRvcnkzMzAxNDgxMQ==-flat-winmain.cpp,213,216,3,465,468,3
250,https://htmlpreview.github.io/?https://github.com/Christina96/boilerplate-sample-matches/blob/main/cpp/tesseract-MDEwOlJlcG9zaXRvcnkyMjg4NzA5NA==-flat-recodebeam_test.cc-tesseract-MDEwOlJlcG9zaXRvcnkyMjg4NzA5NA==-flat-equationdetect.cpp-250.html,14,tesseract-MDEwOlJlcG9zaXRvcnkyMjg4NzA5NA==-flat-recodebeam_test.cc,tesseract-MDEwOlJlcG9zaXRvcnkyMjg4NzA5NA==-flat-equationdetect.cpp,67,68,1,115,116,1
251,https://htmlpreview.github.io/?https://github.com/Christina96/boilerplate-sample-matches/blob/main/cpp/tesseract-MDEwOlJlcG9zaXRvcnkyMjg4NzA5NA==-flat-pageiterator.h-nano-node-MDEwOlJlcG9zaXRvcnkxOTM0NzM0MA==-flat-stats.hpp-251.html,15,tesseract-MDEwOlJlcG9zaXRvcnkyMjg4NzA5NA==-flat-pageiterator.h,nano-node-MDEwOlJlcG9zaXRvcnkxOTM0NzM0MA==-flat-stats.hpp,11,16,5,15,21,6
252,https://htmlpreview.github.io/?https://github.com/Christina96/boilerplate-sample-matches/blob/main/cpp/tesseract-MDEwOlJlcG9zaXRvcnkyMjg4NzA5NA==-flat-fontinfo.cpp-tesseract-MDEwOlJlcG9zaXRvcnkyMjg4NzA5NA==-flat-matrix.h-252.html,21,tesseract-MDEwOlJlcG9zaXRvcnkyMjg4NzA5NA==-flat-fontinfo.cpp,tesseract-MDEwOlJlcG9zaXRvcnkyMjg4NzA5NA==-flat-matrix.h,117,121,4,416,420,4
253,https://htmlpreview.github.io/?https://github.com/Christina96/boilerplate-sample-matches/blob/main/cpp/snap-MDEwOlJlcG9zaXRvcnk0Mjg4MzU3-flat-google.cpp-snap-MDEwOlJlcG9zaXRvcnk0Mjg4MzU3-flat-tnt.cpp-253.html,15,snap-MDEwOlJlcG9zaXRvcnk0Mjg4MzU3-flat-google.cpp,snap-MDEwOlJlcG9zaXRvcnk0Mjg4MzU3-flat-tnt.cpp,759,761,2,234,235,1
254,https://htmlpreview.github.io/?https://github.com/Christina96/boilerplate-sample-matches/blob/main/cpp/notepad-plus-plus-MDEwOlJlcG9zaXRvcnkzMzAxNDgxMQ==-flat-LexNsis.cxx-notepad-plus-plus-MDEwOlJlcG9zaXRvcnkzMzAxNDgxMQ==-flat-LexNsis.cxx-254.html,17,notepad-plus-plus-MDEwOlJlcG9zaXRvcnkzMzAxNDgxMQ==-flat-LexNsis.cxx,notepad-plus-plus-MDEwOlJlcG9zaXRvcnkzMzAxNDgxMQ==-flat-LexNsis.cxx,90,93,3,123,126,3
255,https://htmlpreview.github.io/?https://github.com/Christina96/boilerplate-sample-matches/blob/main/cpp/subconverter-MDEwOlJlcG9zaXRvcnkyMTg2ODY3NjM=-flat-string.cpp-subconverter-MDEwOlJlcG9zaXRvcnkyMTg2ODY3NjM=-flat-string.cpp-255.html,18,subconverter-MDEwOlJlcG9zaXRvcnkyMTg2ODY3NjM=-flat-string.cpp,subconverter-MDEwOlJlcG9zaXRvcnkyMTg2ODY3NjM=-flat-string.cpp,104,109,5,126,131,5
256,https://htmlpreview.github.io/?https://github.com/Christina96/boilerplate-sample-matches/blob/main/cpp/notepad-plus-plus-MDEwOlJlcG9zaXRvcnkzMzAxNDgxMQ==-flat-perl_matcher_non_recursive.hpp-notepad-plus-plus-MDEwOlJlcG9zaXRvcnkzMzAxNDgxMQ==-flat-perl_matcher_non_recursive.hpp-256.html,123,notepad-plus-plus-MDEwOlJlcG9zaXRvcnkzMzAxNDgxMQ==-flat-perl_matcher_non_recursive.hpp,notepad-plus-plus-MDEwOlJlcG9zaXRvcnkzMzAxNDgxMQ==-flat-perl_matcher_non_recursive.hpp,735,747,12,799,811,12
257,https://htmlpreview.github.io/?https://github.com/Christina96/boilerplate-sample-matches/blob/main/cpp/tesseract-MDEwOlJlcG9zaXRvcnkyMjg4NzA5NA==-flat-paragraphs.cpp-tesseract-MDEwOlJlcG9zaXRvcnkyMjg4NzA5NA==-flat-paragraphs.cpp-257.html,34,tesseract-MDEwOlJlcG9zaXRvcnkyMjg4NzA5NA==-flat-paragraphs.cpp,tesseract-MDEwOlJlcG9zaXRvcnkyMjg4NzA5NA==-flat-paragraphs.cpp,660,664,4,671,675,4
258,https://htmlpreview.github.io/?https://github.com/Christina96/boilerplate-sample-matches/blob/main/cpp/abseil-cpp-MDEwOlJlcG9zaXRvcnkxMDQyMzE1NDE=-flat-poisson_distribution_test.cc-abseil-cpp-MDEwOlJlcG9zaXRvcnkxMDQyMzE1NDE=-flat-log_uniform_int_distribution_test.cc-258.html,31,abseil-cpp-MDEwOlJlcG9zaXRvcnkxMDQyMzE1NDE=-flat-poisson_distribution_test.cc,abseil-cpp-MDEwOlJlcG9zaXRvcnkxMDQyMzE1NDE=-flat-log_uniform_int_distribution_test.cc,316,321,5,176,181,5
259,https://htmlpreview.github.io/?https://github.com/Christina96/boilerplate-sample-matches/blob/main/cpp/notepad-plus-plus-MDEwOlJlcG9zaXRvcnkzMzAxNDgxMQ==-flat-catch_14.hpp-notepad-plus-plus-MDEwOlJlcG9zaXRvcnkzMzAxNDgxMQ==-flat-catch.hpp-259.html,31488,notepad-plus-plus-MDEwOlJlcG9zaXRvcnkzMzAxNDgxMQ==-flat-catch_14.hpp,notepad-plus-plus-MDEwOlJlcG9zaXRvcnkzMzAxNDgxMQ==-flat-catch.hpp,9296,13690,4394,9296,13690,4394
260,https://htmlpreview.github.io/?https://github.com/Christina96/boilerplate-sample-matches/blob/main/cpp/tesseract-MDEwOlJlcG9zaXRvcnkyMjg4NzA5NA==-flat-openclwrapper.cpp-caffe-MDEwOlJlcG9zaXRvcnk2MTg3MDgwMw==-flat-gmock-spec-builders.h-260.html,14,tesseract-MDEwOlJlcG9zaXRvcnkyMjg4NzA5NA==-flat-openclwrapper.cpp,caffe-MDEwOlJlcG9zaXRvcnk2MTg3MDgwMw==-flat-gmock-spec-builders.h,1299,1302,3,558,561,3
261,https://htmlpreview.github.io/?https://github.com/Christina96/boilerplate-sample-matches/blob/main/cpp/snap-MDEwOlJlcG9zaXRvcnk0Mjg4MzU3-flat-sgraph.cpp-snap-MDEwOlJlcG9zaXRvcnk0Mjg4MzU3-flat-euproj.cpp-261.html,52,snap-MDEwOlJlcG9zaXRvcnk0Mjg4MzU3-flat-sgraph.cpp,snap-MDEwOlJlcG9zaXRvcnk0Mjg4MzU3-flat-euproj.cpp,252,256,4,173,177,4
262,https://htmlpreview.github.io/?https://github.com/Christina96/boilerplate-sample-matches/blob/main/cpp/abseil-cpp-MDEwOlJlcG9zaXRvcnkxMDQyMzE1NDE=-flat-distributions_test.cc-abseil-cpp-MDEwOlJlcG9zaXRvcnkxMDQyMzE1NDE=-flat-distributions_test.cc-262.html,17,abseil-cpp-MDEwOlJlcG9zaXRvcnkxMDQyMzE1NDE=-flat-distributions_test.cc,abseil-cpp-MDEwOlJlcG9zaXRvcnkxMDQyMzE1NDE=-flat-distributions_test.cc,55,57,2,19,21,2
263,https://htmlpreview.github.io/?https://github.com/Christina96/boilerplate-sample-matches/blob/main/cpp/glm-MDEwOlJlcG9zaXRvcnk4NDM2MzE=-flat-core_type_half.cpp-glm-MDEwOlJlcG9zaXRvcnk4NDM2MzE=-flat-core_func_matrix.cpp-263.html,15,glm-MDEwOlJlcG9zaXRvcnk4NDM2MzE=-flat-core_type_half.cpp,glm-MDEwOlJlcG9zaXRvcnk4NDM2MzE=-flat-core_func_matrix.cpp,113,114,1,133,134,1
264,https://htmlpreview.github.io/?https://github.com/Christina96/boilerplate-sample-matches/blob/main/cpp/snap-MDEwOlJlcG9zaXRvcnk0Mjg4MzU3-flat-casc.cpp-snap-MDEwOlJlcG9zaXRvcnk0Mjg4MzU3-flat-casc.cpp-264.html,61,snap-MDEwOlJlcG9zaXRvcnk0Mjg4MzU3-flat-casc.cpp,snap-MDEwOlJlcG9zaXRvcnk0Mjg4MzU3-flat-casc.cpp,150,160,10,217,227,10
265,https://htmlpreview.github.io/?https://github.com/Christina96/boilerplate-sample-matches/blob/main/cpp/abseil-cpp-MDEwOlJlcG9zaXRvcnkxMDQyMzE1NDE=-flat-str_cat_test.cc-notepad-plus-plus-MDEwOlJlcG9zaXRvcnkzMzAxNDgxMQ==-flat-concepts.hpp-265.html,16,abseil-cpp-MDEwOlJlcG9zaXRvcnkxMDQyMzE1NDE=-flat-str_cat_test.cc,notepad-plus-plus-MDEwOlJlcG9zaXRvcnkzMzAxNDgxMQ==-flat-concepts.hpp,172,174,2,68,70,2
266,https://htmlpreview.github.io/?https://github.com/Christina96/boilerplate-sample-matches/blob/main/cpp/notepad-plus-plus-MDEwOlJlcG9zaXRvcnkzMzAxNDgxMQ==-flat-ScintillaWin.cxx-notepad-plus-plus-MDEwOlJlcG9zaXRvcnkzMzAxNDgxMQ==-flat-ScintillaWin.cxx-266.html,14,notepad-plus-plus-MDEwOlJlcG9zaXRvcnkzMzAxNDgxMQ==-flat-ScintillaWin.cxx,notepad-plus-plus-MDEwOlJlcG9zaXRvcnkzMzAxNDgxMQ==-flat-ScintillaWin.cxx,409,410,1,404,405,1
267,https://htmlpreview.github.io/?https://github.com/Christina96/boilerplate-sample-matches/blob/main/cpp/abseil-cpp-MDEwOlJlcG9zaXRvcnkxMDQyMzE1NDE=-flat-cord_rep_btree_test.cc-abseil-cpp-MDEwOlJlcG9zaXRvcnkxMDQyMzE1NDE=-flat-cord_rep_btree_test.cc-267.html,54,abseil-cpp-MDEwOlJlcG9zaXRvcnkxMDQyMzE1NDE=-flat-cord_rep_btree_test.cc,abseil-cpp-MDEwOlJlcG9zaXRvcnkxMDQyMzE1NDE=-flat-cord_rep_btree_test.cc,700,705,5,747,752,5
268,https://htmlpreview.github.io/?https://github.com/Christina96/boilerplate-sample-matches/blob/main/cpp/abseil-cpp-MDEwOlJlcG9zaXRvcnkxMDQyMzE1NDE=-flat-numbers_benchmark.cc-nano-node-MDEwOlJlcG9zaXRvcnkxOTM0NzM0MA==-flat-peer_container.cpp-268.html,14,abseil-cpp-MDEwOlJlcG9zaXRvcnkxMDQyMzE1NDE=-flat-numbers_benchmark.cc,nano-node-MDEwOlJlcG9zaXRvcnkxOTM0NzM0MA==-flat-peer_container.cpp,239,240,1,55,56,1
269,https://htmlpreview.github.io/?https://github.com/Christina96/boilerplate-sample-matches/blob/main/cpp/snap-MDEwOlJlcG9zaXRvcnk0Mjg4MzU3-flat-euproj.cpp-snap-MDEwOlJlcG9zaXRvcnk0Mjg4MzU3-flat-euproj.cpp-269.html,61,snap-MDEwOlJlcG9zaXRvcnk0Mjg4MzU3-flat-euproj.cpp,snap-MDEwOlJlcG9zaXRvcnk0Mjg4MzU3-flat-euproj.cpp,1310,1316,6,1459,1465,6
270,https://htmlpreview.github.io/?https://github.com/Christina96/boilerplate-sample-matches/blob/main/cpp/notepad-plus-plus-MDEwOlJlcG9zaXRvcnkzMzAxNDgxMQ==-flat-ScintillaGTK.cxx-notepad-plus-plus-MDEwOlJlcG9zaXRvcnkzMzAxNDgxMQ==-flat-ScintillaQt.cpp-270.html,16,notepad-plus-plus-MDEwOlJlcG9zaXRvcnkzMzAxNDgxMQ==-flat-ScintillaGTK.cxx,notepad-plus-plus-MDEwOlJlcG9zaXRvcnkzMzAxNDgxMQ==-flat-ScintillaQt.cpp,2283,2285,2,646,648,2
271,https://htmlpreview.github.io/?https://github.com/Christina96/boilerplate-sample-matches/blob/main/cpp/Cpp_Primer_Answers-MDEwOlJlcG9zaXRvcnk0NzE3MDI2MQ==-flat-exercise13_18.h-Cpp_Primer_Answers-MDEwOlJlcG9zaXRvcnk0NzE3MDI2MQ==-flat-exercise13_19.h-271.html,17,Cpp_Primer_Answers-MDEwOlJlcG9zaXRvcnk0NzE3MDI2MQ==-flat-exercise13_18.h,Cpp_Primer_Answers-MDEwOlJlcG9zaXRvcnk0NzE3MDI2MQ==-flat-exercise13_19.h,5,10,5,5,10,5
272,https://htmlpreview.github.io/?https://github.com/Christina96/boilerplate-sample-matches/blob/main/cpp/snap-MDEwOlJlcG9zaXRvcnk0Mjg4MzU3-flat-demo-hashvec-benchmark.cpp-snap-MDEwOlJlcG9zaXRvcnk0Mjg4MzU3-flat-demo-hashvec-benchmark.cpp-272.html,32,snap-MDEwOlJlcG9zaXRvcnk0Mjg4MzU3-flat-demo-hashvec-benchmark.cpp,snap-MDEwOlJlcG9zaXRvcnk0Mjg4MzU3-flat-demo-hashvec-benchmark.cpp,163,170,7,60,67,7
273,https://htmlpreview.github.io/?https://github.com/Christina96/boilerplate-sample-matches/blob/main/cpp/abseil-cpp-MDEwOlJlcG9zaXRvcnkxMDQyMzE1NDE=-flat-duration_test.cc-abseil-cpp-MDEwOlJlcG9zaXRvcnkxMDQyMzE1NDE=-flat-duration_test.cc-273.html,18,abseil-cpp-MDEwOlJlcG9zaXRvcnkxMDQyMzE1NDE=-flat-duration_test.cc,abseil-cpp-MDEwOlJlcG9zaXRvcnkxMDQyMzE1NDE=-flat-duration_test.cc,411,412,1,419,420,1
274,https://htmlpreview.github.io/?https://github.com/Christina96/boilerplate-sample-matches/blob/main/cpp/notepad-plus-plus-MDEwOlJlcG9zaXRvcnkzMzAxNDgxMQ==-flat-catch_14.hpp-notepad-plus-plus-MDEwOlJlcG9zaXRvcnkzMzAxNDgxMQ==-flat-catch.hpp-274.html,89322,notepad-plus-plus-MDEwOlJlcG9zaXRvcnkzMzAxNDgxMQ==-flat-catch_14.hpp,notepad-plus-plus-MDEwOlJlcG9zaXRvcnkzMzAxNDgxMQ==-flat-catch.hpp,987,13690,12703,987,13690,12703
275,https://htmlpreview.github.io/?https://github.com/Christina96/boilerplate-sample-matches/blob/main/cpp/abseil-cpp-MDEwOlJlcG9zaXRvcnkxMDQyMzE1NDE=-flat-int128_test.cc-abseil-cpp-MDEwOlJlcG9zaXRvcnkxMDQyMzE1NDE=-flat-int128_test.cc-275.html,14,abseil-cpp-MDEwOlJlcG9zaXRvcnkxMDQyMzE1NDE=-flat-int128_test.cc,abseil-cpp-MDEwOlJlcG9zaXRvcnkxMDQyMzE1NDE=-flat-int128_test.cc,659,660,1,846,847,1
276,https://htmlpreview.github.io/?https://github.com/Christina96/boilerplate-sample-matches/blob/main/cpp/caffe-MDEwOlJlcG9zaXRvcnk2MTg3MDgwMw==-flat-test_scale_layer.cpp-caffe-MDEwOlJlcG9zaXRvcnk2MTg3MDgwMw==-flat-test_bias_layer.cpp-276.html,15,caffe-MDEwOlJlcG9zaXRvcnk2MTg3MDgwMw==-flat-test_scale_layer.cpp,caffe-MDEwOlJlcG9zaXRvcnk2MTg3MDgwMw==-flat-test_bias_layer.cpp,108,109,1,102,103,1
277,https://htmlpreview.github.io/?https://github.com/Christina96/boilerplate-sample-matches/blob/main/cpp/tesseract-MDEwOlJlcG9zaXRvcnkyMjg4NzA5NA==-flat-blobbox.h-caffe-MDEwOlJlcG9zaXRvcnk2MTg3MDgwMw==-flat-region_loss_layer.hpp-277.html,15,tesseract-MDEwOlJlcG9zaXRvcnkyMjg4NzA5NA==-flat-blobbox.h,caffe-MDEwOlJlcG9zaXRvcnk2MTg3MDgwMw==-flat-region_loss_layer.hpp,529,534,5,55,60,5
278,https://htmlpreview.github.io/?https://github.com/Christina96/boilerplate-sample-matches/blob/main/cpp/notepad-plus-plus-MDEwOlJlcG9zaXRvcnkzMzAxNDgxMQ==-flat-LexAbaqus.cxx-notepad-plus-plus-MDEwOlJlcG9zaXRvcnkzMzAxNDgxMQ==-flat-LexAbaqus.cxx-278.html,94,notepad-plus-plus-MDEwOlJlcG9zaXRvcnkzMzAxNDgxMQ==-flat-LexAbaqus.cxx,notepad-plus-plus-MDEwOlJlcG9zaXRvcnkzMzAxNDgxMQ==-flat-LexAbaqus.cxx,362,377,15,408,423,15
279,https://htmlpreview.github.io/?https://github.com/Christina96/boilerplate-sample-matches/blob/main/cpp/notepad-plus-plus-MDEwOlJlcG9zaXRvcnkzMzAxNDgxMQ==-flat-ScintillaEditBase.cpp-nano-node-MDEwOlJlcG9zaXRvcnkxOTM0NzM0MA==-flat-qt_94.cpp-279.html,14,notepad-plus-plus-MDEwOlJlcG9zaXRvcnkzMzAxNDgxMQ==-flat-ScintillaEditBase.cpp,nano-node-MDEwOlJlcG9zaXRvcnkxOTM0NzM0MA==-flat-qt_94.cpp,444,446,2,448,450,2
280,https://htmlpreview.github.io/?https://github.com/Christina96/boilerplate-sample-matches/blob/main/cpp/caffe-MDEwOlJlcG9zaXRvcnk2MTg3MDgwMw==-flat-data_layer.hpp-caffe-MDEwOlJlcG9zaXRvcnk2MTg3MDgwMw==-flat-box_data_layer.hpp-280.html,15,caffe-MDEwOlJlcG9zaXRvcnk2MTg3MDgwMw==-flat-data_layer.hpp,caffe-MDEwOlJlcG9zaXRvcnk2MTg3MDgwMw==-flat-box_data_layer.hpp,26,28,2,27,29,2
281,https://htmlpreview.github.io/?https://github.com/Christina96/boilerplate-sample-matches/blob/main/cpp/notepad-plus-plus-MDEwOlJlcG9zaXRvcnkzMzAxNDgxMQ==-flat-catch_14.hpp-notepad-plus-plus-MDEwOlJlcG9zaXRvcnkzMzAxNDgxMQ==-flat-catch.hpp-281.html,29383,notepad-plus-plus-MDEwOlJlcG9zaXRvcnkzMzAxNDgxMQ==-flat-catch_14.hpp,notepad-plus-plus-MDEwOlJlcG9zaXRvcnkzMzAxNDgxMQ==-flat-catch.hpp,9602,13690,4088,9602,13690,4088
282,https://htmlpreview.github.io/?https://github.com/Christina96/boilerplate-sample-matches/blob/main/cpp/subconverter-MDEwOlJlcG9zaXRvcnkyMTg2ODY3NjM=-flat-json.hpp-notepad-plus-plus-MDEwOlJlcG9zaXRvcnkzMzAxNDgxMQ==-flat-json.hpp-282.html,805,subconverter-MDEwOlJlcG9zaXRvcnkyMTg2ODY3NjM=-flat-json.hpp,notepad-plus-plus-MDEwOlJlcG9zaXRvcnkzMzAxNDgxMQ==-flat-json.hpp,4251,4364,113,4851,4964,113
283,https://htmlpreview.github.io/?https://github.com/Christina96/boilerplate-sample-matches/blob/main/cpp/tesseract-MDEwOlJlcG9zaXRvcnkyMjg4NzA5NA==-flat-unicharmap.cpp-tesseract-MDEwOlJlcG9zaXRvcnkyMjg4NzA5NA==-flat-unicharset.cpp-283.html,16,tesseract-MDEwOlJlcG9zaXRvcnkyMjg4NzA5NA==-flat-unicharmap.cpp,tesseract-MDEwOlJlcG9zaXRvcnkyMjg4NzA5NA==-flat-unicharset.cpp,9,10,1,129,131,2
284,https://htmlpreview.github.io/?https://github.com/Christina96/boilerplate-sample-matches/blob/main/cpp/caffe-MDEwOlJlcG9zaXRvcnk2MTg3MDgwMw==-flat-test_net_2.cpp-caffe-MDEwOlJlcG9zaXRvcnk2MTg3MDgwMw==-flat-test_net_2.cpp-284.html,27,caffe-MDEwOlJlcG9zaXRvcnk2MTg3MDgwMw==-flat-test_net_2.cpp,caffe-MDEwOlJlcG9zaXRvcnk2MTg3MDgwMw==-flat-test_net_2.cpp,315,326,11,341,353,12
285,https://htmlpreview.github.io/?https://github.com/Christina96/boilerplate-sample-matches/blob/main/cpp/Cpp_Primer_Answers-MDEwOlJlcG9zaXRvcnk0NzE3MDI2MQ==-flat-main.cpp-Cpp_Primer_Answers-MDEwOlJlcG9zaXRvcnk0NzE3MDI2MQ==-flat-main.cpp-285.html,30,Cpp_Primer_Answers-MDEwOlJlcG9zaXRvcnk0NzE3MDI2MQ==-flat-main.cpp,Cpp_Primer_Answers-MDEwOlJlcG9zaXRvcnk0NzE3MDI2MQ==-flat-main.cpp,15,17,2,17,19,2
286,https://htmlpreview.github.io/?https://github.com/Christina96/boilerplate-sample-matches/blob/main/cpp/abseil-cpp-MDEwOlJlcG9zaXRvcnkxMDQyMzE1NDE=-flat-hash_12.h-abseil-cpp-MDEwOlJlcG9zaXRvcnkxMDQyMzE1NDE=-flat-hash_12.h-286.html,71,abseil-cpp-MDEwOlJlcG9zaXRvcnkxMDQyMzE1NDE=-flat-hash_12.h,abseil-cpp-MDEwOlJlcG9zaXRvcnkxMDQyMzE1NDE=-flat-hash_12.h,336,342,6,344,351,7
287,https://htmlpreview.github.io/?https://github.com/Christina96/boilerplate-sample-matches/blob/main/cpp/caffe-MDEwOlJlcG9zaXRvcnk2MTg3MDgwMw==-flat-test_data_layer.cpp-caffe-MDEwOlJlcG9zaXRvcnk2MTg3MDgwMw==-flat-test_annotated_data_layer.cpp-287.html,14,caffe-MDEwOlJlcG9zaXRvcnk2MTg3MDgwMw==-flat-test_data_layer.cpp,caffe-MDEwOlJlcG9zaXRvcnk2MTg3MDgwMw==-flat-test_annotated_data_layer.cpp,206,208,2,435,437,2
288,https://htmlpreview.github.io/?https://github.com/Christina96/boilerplate-sample-matches/blob/main/cpp/tesseract-MDEwOlJlcG9zaXRvcnkyMjg4NzA5NA==-flat-lstm.cpp-tesseract-MDEwOlJlcG9zaXRvcnkyMjg4NzA5NA==-flat-plumbing.cpp-288.html,22,tesseract-MDEwOlJlcG9zaXRvcnkyMjg4NzA5NA==-flat-lstm.cpp,tesseract-MDEwOlJlcG9zaXRvcnkyMjg4NzA5NA==-flat-plumbing.cpp,121,125,4,13,17,4
289,https://htmlpreview.github.io/?https://github.com/Christina96/boilerplate-sample-matches/blob/main/cpp/notepad-plus-plus-MDEwOlJlcG9zaXRvcnkzMzAxNDgxMQ==-flat-preferenceDlg.cpp-notepad-plus-plus-MDEwOlJlcG9zaXRvcnkzMzAxNDgxMQ==-flat-preferenceDlg.cpp-289.html,16,notepad-plus-plus-MDEwOlJlcG9zaXRvcnkzMzAxNDgxMQ==-flat-preferenceDlg.cpp,notepad-plus-plus-MDEwOlJlcG9zaXRvcnkzMzAxNDgxMQ==-flat-preferenceDlg.cpp,1864,1868,4,1859,1863,4
290,https://htmlpreview.github.io/?https://github.com/Christina96/boilerplate-sample-matches/blob/main/cpp/notepad-plus-plus-MDEwOlJlcG9zaXRvcnkzMzAxNDgxMQ==-flat-ProjectPanel.cpp-notepad-plus-plus-MDEwOlJlcG9zaXRvcnkzMzAxNDgxMQ==-flat-RunDlg.cpp-290.html,14,notepad-plus-plus-MDEwOlJlcG9zaXRvcnkzMzAxNDgxMQ==-flat-ProjectPanel.cpp,notepad-plus-plus-MDEwOlJlcG9zaXRvcnkzMzAxNDgxMQ==-flat-RunDlg.cpp,714,716,2,152,154,2
291,https://htmlpreview.github.io/?https://github.com/Christina96/boilerplate-sample-matches/blob/main/cpp/caffe-MDEwOlJlcG9zaXRvcnk2MTg3MDgwMw==-flat-net.cpp-caffe-MDEwOlJlcG9zaXRvcnk2MTg3MDgwMw==-flat-test_mkl_deconvolution_layer.cpp-291.html,20,caffe-MDEwOlJlcG9zaXRvcnk2MTg3MDgwMw==-flat-net.cpp,caffe-MDEwOlJlcG9zaXRvcnk2MTg3MDgwMw==-flat-test_mkl_deconvolution_layer.cpp,1622,1623,1,168,169,1
292,https://htmlpreview.github.io/?https://github.com/Christina96/boilerplate-sample-matches/blob/main/cpp/tesseract-MDEwOlJlcG9zaXRvcnkyMjg4NzA5NA==-flat-makerow.h-tesseract-MDEwOlJlcG9zaXRvcnkyMjg4NzA5NA==-flat-topitch.h-292.html,14,tesseract-MDEwOlJlcG9zaXRvcnkyMjg4NzA5NA==-flat-makerow.h,tesseract-MDEwOlJlcG9zaXRvcnkyMjg4NzA5NA==-flat-topitch.h,176,179,3,17,21,4
293,https://htmlpreview.github.io/?https://github.com/Christina96/boilerplate-sample-matches/blob/main/cpp/snap-MDEwOlJlcG9zaXRvcnk0Mjg4MzU3-flat-triad.h-snap-MDEwOlJlcG9zaXRvcnk0Mjg4MzU3-flat-triad.h-293.html,39,snap-MDEwOlJlcG9zaXRvcnk0Mjg4MzU3-flat-triad.h,snap-MDEwOlJlcG9zaXRvcnk0Mjg4MzU3-flat-triad.h,144,149,5,186,191,5
294,https://htmlpreview.github.io/?https://github.com/Christina96/boilerplate-sample-matches/blob/main/cpp/notepad-plus-plus-MDEwOlJlcG9zaXRvcnkzMzAxNDgxMQ==-flat-FindReplaceDlg.cpp-notepad-plus-plus-MDEwOlJlcG9zaXRvcnkzMzAxNDgxMQ==-flat-NppNotification.cpp-294.html,15,notepad-plus-plus-MDEwOlJlcG9zaXRvcnkzMzAxNDgxMQ==-flat-FindReplaceDlg.cpp,notepad-plus-plus-MDEwOlJlcG9zaXRvcnkzMzAxNDgxMQ==-flat-NppNotification.cpp,1144,1145,1,463,464,1
295,https://htmlpreview.github.io/?https://github.com/Christina96/boilerplate-sample-matches/blob/main/cpp/tesseract-MDEwOlJlcG9zaXRvcnkyMjg4NzA5NA==-flat-unicharset_training_utils.cpp-tesseract-MDEwOlJlcG9zaXRvcnkyMjg4NzA5NA==-flat-unicharset_training_utils.cpp-295.html,18,tesseract-MDEwOlJlcG9zaXRvcnkyMjg4NzA5NA==-flat-unicharset_training_utils.cpp,tesseract-MDEwOlJlcG9zaXRvcnkyMjg4NzA5NA==-flat-unicharset_training_utils.cpp,41,46,5,32,37,5
296,https://htmlpreview.github.io/?https://github.com/Christina96/boilerplate-sample-matches/blob/main/cpp/notepad-plus-plus-MDEwOlJlcG9zaXRvcnkzMzAxNDgxMQ==-flat-LexFlagship.cxx-notepad-plus-plus-MDEwOlJlcG9zaXRvcnkzMzAxNDgxMQ==-flat-LexFlagship.cxx-296.html,22,notepad-plus-plus-MDEwOlJlcG9zaXRvcnkzMzAxNDgxMQ==-flat-LexFlagship.cxx,notepad-plus-plus-MDEwOlJlcG9zaXRvcnkzMzAxNDgxMQ==-flat-LexFlagship.cxx,99,105,6,116,122,6
297,https://htmlpreview.github.io/?https://github.com/Christina96/boilerplate-sample-matches/blob/main/cpp/notepad-plus-plus-MDEwOlJlcG9zaXRvcnkzMzAxNDgxMQ==-flat-LexHTML.cxx-notepad-plus-plus-MDEwOlJlcG9zaXRvcnkzMzAxNDgxMQ==-flat-LexEDIFACT.cxx-297.html,25,notepad-plus-plus-MDEwOlJlcG9zaXRvcnkzMzAxNDgxMQ==-flat-LexHTML.cxx,notepad-plus-plus-MDEwOlJlcG9zaXRvcnkzMzAxNDgxMQ==-flat-LexEDIFACT.cxx,1462,1465,3,162,166,4
298,https://htmlpreview.github.io/?https://github.com/Christina96/boilerplate-sample-matches/blob/main/cpp/caffe-MDEwOlJlcG9zaXRvcnk2MTg3MDgwMw==-flat-mpi.h-caffe-MDEwOlJlcG9zaXRvcnk2MTg3MDgwMw==-flat-mpi.h-298.html,3826,caffe-MDEwOlJlcG9zaXRvcnk2MTg3MDgwMw==-flat-mpi.h,caffe-MDEwOlJlcG9zaXRvcnk2MTg3MDgwMw==-flat-mpi.h,811,1150,339,1408,1749,341
299,https://htmlpreview.github.io/?https://github.com/Christina96/boilerplate-sample-matches/blob/main/cpp/abseil-cpp-MDEwOlJlcG9zaXRvcnkxMDQyMzE1NDE=-flat-inlined_vector_benchmark.cc-abseil-cpp-MDEwOlJlcG9zaXRvcnkxMDQyMzE1NDE=-flat-inlined_vector_benchmark.cc-299.html,23,abseil-cpp-MDEwOlJlcG9zaXRvcnkxMDQyMzE1NDE=-flat-inlined_vector_benchmark.cc,abseil-cpp-MDEwOlJlcG9zaXRvcnkxMDQyMzE1NDE=-flat-inlined_vector_benchmark.cc,99,101,2,171,173,2
300,https://htmlpreview.github.io/?https://github.com/Christina96/boilerplate-sample-matches/blob/main/cpp/subconverter-MDEwOlJlcG9zaXRvcnkyMTg2ODY3NjM=-flat-inja.hpp-subconverter-MDEwOlJlcG9zaXRvcnkyMTg2ODY3NjM=-flat-inja.hpp-300.html,18,subconverter-MDEwOlJlcG9zaXRvcnkyMTg2ODY3NjM=-flat-inja.hpp,subconverter-MDEwOlJlcG9zaXRvcnkyMTg2ODY3NjM=-flat-inja.hpp,2407,2409,2,2443,2445,2
301,https://htmlpreview.github.io/?https://github.com/Christina96/boilerplate-sample-matches/blob/main/cpp/notepad-plus-plus-MDEwOlJlcG9zaXRvcnkzMzAxNDgxMQ==-flat-LexMagik.cxx-notepad-plus-plus-MDEwOlJlcG9zaXRvcnkzMzAxNDgxMQ==-flat-LexMagik.cxx-301.html,33,notepad-plus-plus-MDEwOlJlcG9zaXRvcnkzMzAxNDgxMQ==-flat-LexMagik.cxx,notepad-plus-plus-MDEwOlJlcG9zaXRvcnkzMzAxNDgxMQ==-flat-LexMagik.cxx,98,101,3,115,118,3
302,https://htmlpreview.github.io/?https://github.com/Christina96/boilerplate-sample-matches/blob/main/cpp/glm-MDEwOlJlcG9zaXRvcnk4NDM2MzE=-flat-type_vec3.hpp-glm-MDEwOlJlcG9zaXRvcnk4NDM2MzE=-flat-type_vec4.hpp-302.html,18,glm-MDEwOlJlcG9zaXRvcnk4NDM2MzE=-flat-type_vec3.hpp,glm-MDEwOlJlcG9zaXRvcnk4NDM2MzE=-flat-type_vec4.hpp,81,82,1,140,141,1
303,https://htmlpreview.github.io/?https://github.com/Christina96/boilerplate-sample-matches/blob/main/cpp/snap-MDEwOlJlcG9zaXRvcnk0Mjg4MzU3-flat-dt.cpp-snap-MDEwOlJlcG9zaXRvcnk0Mjg4MzU3-flat-dt.cpp-303.html,38,snap-MDEwOlJlcG9zaXRvcnk0Mjg4MzU3-flat-dt.cpp,snap-MDEwOlJlcG9zaXRvcnk0Mjg4MzU3-flat-dt.cpp,1383,1387,4,1436,1440,4
304,https://htmlpreview.github.io/?https://github.com/Christina96/boilerplate-sample-matches/blob/main/cpp/snap-MDEwOlJlcG9zaXRvcnk0Mjg4MzU3-flat-tm.cpp-notepad-plus-plus-MDEwOlJlcG9zaXRvcnkzMzAxNDgxMQ==-flat-ScintillaQt.cpp-304.html,19,snap-MDEwOlJlcG9zaXRvcnk0Mjg4MzU3-flat-tm.cpp,notepad-plus-plus-MDEwOlJlcG9zaXRvcnkzMzAxNDgxMQ==-flat-ScintillaQt.cpp,370,372,2,430,433,3
305,https://htmlpreview.github.io/?https://github.com/Christina96/boilerplate-sample-matches/blob/main/cpp/notepad-plus-plus-MDEwOlJlcG9zaXRvcnkzMzAxNDgxMQ==-flat-ScintillaBase.cxx-notepad-plus-plus-MDEwOlJlcG9zaXRvcnkzMzAxNDgxMQ==-flat-Editor.cxx-305.html,19,notepad-plus-plus-MDEwOlJlcG9zaXRvcnkzMzAxNDgxMQ==-flat-ScintillaBase.cxx,notepad-plus-plus-MDEwOlJlcG9zaXRvcnkzMzAxNDgxMQ==-flat-Editor.cxx,779,782,3,5786,5789,3
306,https://htmlpreview.github.io/?https://github.com/Christina96/boilerplate-sample-matches/blob/main/cpp/abseil-cpp-MDEwOlJlcG9zaXRvcnkxMDQyMzE1NDE=-flat-strip_test.cc-abseil-cpp-MDEwOlJlcG9zaXRvcnkxMDQyMzE1NDE=-flat-parse_test.cc-306.html,22,abseil-cpp-MDEwOlJlcG9zaXRvcnkxMDQyMzE1NDE=-flat-strip_test.cc,abseil-cpp-MDEwOlJlcG9zaXRvcnkxMDQyMzE1NDE=-flat-parse_test.cc,78,86,8,592,596,4
307,https://htmlpreview.github.io/?https://github.com/Christina96/boilerplate-sample-matches/blob/main/cpp/tesseract-MDEwOlJlcG9zaXRvcnkyMjg4NzA5NA==-flat-linefind.cpp-tesseract-MDEwOlJlcG9zaXRvcnkyMjg4NzA5NA==-flat-linefind.cpp-307.html,16,tesseract-MDEwOlJlcG9zaXRvcnkyMjg4NzA5NA==-flat-linefind.cpp,tesseract-MDEwOlJlcG9zaXRvcnkyMjg4NzA5NA==-flat-linefind.cpp,429,431,2,159,161,2
308,https://htmlpreview.github.io/?https://github.com/Christina96/boilerplate-sample-matches/blob/main/cpp/caffe-MDEwOlJlcG9zaXRvcnk2MTg3MDgwMw==-flat-test_bbox_util.cpp-caffe-MDEwOlJlcG9zaXRvcnk2MTg3MDgwMw==-flat-test_bbox_util.cpp-308.html,20,caffe-MDEwOlJlcG9zaXRvcnk2MTg3MDgwMw==-flat-test_bbox_util.cpp,caffe-MDEwOlJlcG9zaXRvcnk2MTg3MDgwMw==-flat-test_bbox_util.cpp,516,518,2,1637,1639,2
309,https://htmlpreview.github.io/?https://github.com/Christina96/boilerplate-sample-matches/blob/main/cpp/tesseract-MDEwOlJlcG9zaXRvcnkyMjg4NzA5NA==-flat-dotproductfma.cpp-tesseract-MDEwOlJlcG9zaXRvcnkyMjg4NzA5NA==-flat-dotproductfma.cpp-309.html,14,tesseract-MDEwOlJlcG9zaXRvcnkyMjg4NzA5NA==-flat-dotproductfma.cpp,tesseract-MDEwOlJlcG9zaXRvcnkyMjg4NzA5NA==-flat-dotproductfma.cpp,53,56,3,26,29,3
310,https://htmlpreview.github.io/?https://github.com/Christina96/boilerplate-sample-matches/blob/main/cpp/snap-MDEwOlJlcG9zaXRvcnk0Mjg4MzU3-flat-flx.h-snap-MDEwOlJlcG9zaXRvcnk0Mjg4MzU3-flat-graph.h-310.html,33,snap-MDEwOlJlcG9zaXRvcnk0Mjg4MzU3-flat-flx.h,snap-MDEwOlJlcG9zaXRvcnk0Mjg4MzU3-flat-graph.h,181,184,3,73,76,3
311,https://htmlpreview.github.io/?https://github.com/Christina96/boilerplate-sample-matches/blob/main/cpp/notepad-plus-plus-MDEwOlJlcG9zaXRvcnkzMzAxNDgxMQ==-flat-LexHex.cxx-notepad-plus-plus-MDEwOlJlcG9zaXRvcnkzMzAxNDgxMQ==-flat-LexRust.cxx-311.html,17,notepad-plus-plus-MDEwOlJlcG9zaXRvcnkzMzAxNDgxMQ==-flat-LexHex.cxx,notepad-plus-plus-MDEwOlJlcG9zaXRvcnkzMzAxNDgxMQ==-flat-LexRust.cxx,581,583,2,657,659,2
312,https://htmlpreview.github.io/?https://github.com/Christina96/boilerplate-sample-matches/blob/main/cpp/notepad-plus-plus-MDEwOlJlcG9zaXRvcnkzMzAxNDgxMQ==-flat-Editor.cxx-notepad-plus-plus-MDEwOlJlcG9zaXRvcnkzMzAxNDgxMQ==-flat-Editor.cxx-312.html,21,notepad-plus-plus-MDEwOlJlcG9zaXRvcnkzMzAxNDgxMQ==-flat-Editor.cxx,notepad-plus-plus-MDEwOlJlcG9zaXRvcnkzMzAxNDgxMQ==-flat-Editor.cxx,6225,6229,4,6403,6407,4
313,https://htmlpreview.github.io/?https://github.com/Christina96/boilerplate-sample-matches/blob/main/cpp/notepad-plus-plus-MDEwOlJlcG9zaXRvcnkzMzAxNDgxMQ==-flat-catch_14.hpp-notepad-plus-plus-MDEwOlJlcG9zaXRvcnkzMzAxNDgxMQ==-flat-catch.hpp-313.html,86013,notepad-plus-plus-MDEwOlJlcG9zaXRvcnkzMzAxNDgxMQ==-flat-catch_14.hpp,notepad-plus-plus-MDEwOlJlcG9zaXRvcnkzMzAxNDgxMQ==-flat-catch.hpp,1528,13690,12162,1528,13690,12162
314,https://htmlpreview.github.io/?https://github.com/Christina96/boilerplate-sample-matches/blob/main/cpp/tesseract-MDEwOlJlcG9zaXRvcnkyMjg4NzA5NA==-flat-pageres.cpp-tesseract-MDEwOlJlcG9zaXRvcnkyMjg4NzA5NA==-flat-pageres.cpp-314.html,24,tesseract-MDEwOlJlcG9zaXRvcnkyMjg4NzA5NA==-flat-pageres.cpp,tesseract-MDEwOlJlcG9zaXRvcnkyMjg4NzA5NA==-flat-pageres.cpp,1228,1231,3,1239,1242,3
315,https://htmlpreview.github.io/?https://github.com/Christina96/boilerplate-sample-matches/blob/main/cpp/notepad-plus-plus-MDEwOlJlcG9zaXRvcnkzMzAxNDgxMQ==-flat-ScintillaBase.cxx-notepad-plus-plus-MDEwOlJlcG9zaXRvcnkzMzAxNDgxMQ==-flat-ScintillaBase.cxx-315.html,28,notepad-plus-plus-MDEwOlJlcG9zaXRvcnkzMzAxNDgxMQ==-flat-ScintillaBase.cxx,notepad-plus-plus-MDEwOlJlcG9zaXRvcnkzMzAxNDgxMQ==-flat-ScintillaBase.cxx,605,611,6,611,617,6
316,https://htmlpreview.github.io/?https://github.com/Christina96/boilerplate-sample-matches/blob/main/cpp/snap-MDEwOlJlcG9zaXRvcnk0Mjg4MzU3-flat-kronecker.cpp-snap-MDEwOlJlcG9zaXRvcnk0Mjg4MzU3-flat-kronecker.cpp-316.html,25,snap-MDEwOlJlcG9zaXRvcnk0Mjg4MzU3-flat-kronecker.cpp,snap-MDEwOlJlcG9zaXRvcnk0Mjg4MzU3-flat-kronecker.cpp,1109,1112,3,1441,1444,3
317,https://htmlpreview.github.io/?https://github.com/Christina96/boilerplate-sample-matches/blob/main/cpp/abseil-cpp-MDEwOlJlcG9zaXRvcnkxMDQyMzE1NDE=-flat-time_zone_if.h-tesseract-MDEwOlJlcG9zaXRvcnkyMjg4NzA5NA==-flat-clst.h-317.html,15,abseil-cpp-MDEwOlJlcG9zaXRvcnkxMDQyMzE1NDE=-flat-time_zone_if.h,tesseract-MDEwOlJlcG9zaXRvcnkyMjg4NzA5NA==-flat-clst.h,29,31,2,423,425,2
318,https://htmlpreview.github.io/?https://github.com/Christina96/boilerplate-sample-matches/blob/main/cpp/notepad-plus-plus-MDEwOlJlcG9zaXRvcnkzMzAxNDgxMQ==-flat-LexMarkdown.cxx-notepad-plus-plus-MDEwOlJlcG9zaXRvcnkzMzAxNDgxMQ==-flat-LexTxt2tags.cxx-318.html,55,notepad-plus-plus-MDEwOlJlcG9zaXRvcnkzMzAxNDgxMQ==-flat-LexMarkdown.cxx,notepad-plus-plus-MDEwOlJlcG9zaXRvcnkzMzAxNDgxMQ==-flat-LexTxt2tags.cxx,100,112,12,63,75,12
319,https://htmlpreview.github.io/?https://github.com/Christina96/boilerplate-sample-matches/blob/main/cpp/nano-node-MDEwOlJlcG9zaXRvcnkxOTM0NzM0MA==-flat-cl_platform.h-nano-node-MDEwOlJlcG9zaXRvcnkxOTM0NzM0MA==-flat-cl_platform.h-319.html,20,nano-node-MDEwOlJlcG9zaXRvcnkxOTM0NzM0MA==-flat-cl_platform.h,nano-node-MDEwOlJlcG9zaXRvcnkxOTM0NzM0MA==-flat-cl_platform.h,482,484,2,416,418,2
320,https://htmlpreview.github.io/?https://github.com/Christina96/boilerplate-sample-matches/blob/main/cpp/notepad-plus-plus-MDEwOlJlcG9zaXRvcnkzMzAxNDgxMQ==-flat-perl_matcher_non_recursive.hpp-notepad-plus-plus-MDEwOlJlcG9zaXRvcnkzMzAxNDgxMQ==-flat-perl_matcher_non_recursive.hpp-320.html,14,notepad-plus-plus-MDEwOlJlcG9zaXRvcnkzMzAxNDgxMQ==-flat-perl_matcher_non_recursive.hpp,notepad-plus-plus-MDEwOlJlcG9zaXRvcnkzMzAxNDgxMQ==-flat-perl_matcher_non_recursive.hpp,1161,1163,2,1082,1084,2
321,https://htmlpreview.github.io/?https://github.com/Christina96/boilerplate-sample-matches/blob/main/cpp/nano-node-MDEwOlJlcG9zaXRvcnkxOTM0NzM0MA==-flat-ipc_access_config.cpp-nano-node-MDEwOlJlcG9zaXRvcnkxOTM0NzM0MA==-flat-ipc_access_config.cpp-321.html,15,nano-node-MDEwOlJlcG9zaXRvcnkxOTM0NzM0MA==-flat-ipc_access_config.cpp,nano-node-MDEwOlJlcG9zaXRvcnkxOTM0NzM0MA==-flat-ipc_access_config.cpp,10,12,2,32,34,2
322,https://htmlpreview.github.io/?https://github.com/Christina96/boilerplate-sample-matches/blob/main/cpp/MMKV-MDEwOlJlcG9zaXRvcnkxNDkxMTE4MTM=-flat-native-bridge.cpp-MMKV-MDEwOlJlcG9zaXRvcnkxNDkxMTE4MTM=-flat-native-bridge.cpp-322.html,15,MMKV-MDEwOlJlcG9zaXRvcnkxNDkxMTE4MTM=-flat-native-bridge.cpp,MMKV-MDEwOlJlcG9zaXRvcnkxNDkxMTE4MTM=-flat-native-bridge.cpp,624,625,1,735,736,1
323,https://htmlpreview.github.io/?https://github.com/Christina96/boilerplate-sample-matches/blob/main/cpp/tesseract-MDEwOlJlcG9zaXRvcnkyMjg4NzA5NA==-flat-strokewidth.cpp-tesseract-MDEwOlJlcG9zaXRvcnkyMjg4NzA5NA==-flat-tablefind.cpp-323.html,15,tesseract-MDEwOlJlcG9zaXRvcnkyMjg4NzA5NA==-flat-strokewidth.cpp,tesseract-MDEwOlJlcG9zaXRvcnkyMjg4NzA5NA==-flat-tablefind.cpp,165,168,3,145,148,3
324,https://htmlpreview.github.io/?https://github.com/Christina96/boilerplate-sample-matches/blob/main/cpp/snap-MDEwOlJlcG9zaXRvcnk0Mjg4MzU3-flat-ultra.cpp-snap-MDEwOlJlcG9zaXRvcnk0Mjg4MzU3-flat-ultra.cpp-324.html,57,snap-MDEwOlJlcG9zaXRvcnk0Mjg4MzU3-flat-ultra.cpp,snap-MDEwOlJlcG9zaXRvcnk0Mjg4MzU3-flat-ultra.cpp,617,621,4,654,658,4
325,https://htmlpreview.github.io/?https://github.com/Christina96/boilerplate-sample-matches/blob/main/cpp/nano-node-MDEwOlJlcG9zaXRvcnkxOTM0NzM0MA==-flat-tomlconfig.hpp-nano-node-MDEwOlJlcG9zaXRvcnkxOTM0NzM0MA==-flat-relaxed_atomic.hpp-325.html,20,nano-node-MDEwOlJlcG9zaXRvcnkxOTM0NzM0MA==-flat-tomlconfig.hpp,nano-node-MDEwOlJlcG9zaXRvcnkxOTM0NzM0MA==-flat-relaxed_atomic.hpp,135,136,1,6,7,1
326,https://htmlpreview.github.io/?https://github.com/Christina96/boilerplate-sample-matches/blob/main/cpp/notepad-plus-plus-MDEwOlJlcG9zaXRvcnkzMzAxNDgxMQ==-flat-Splitter.cpp-notepad-plus-plus-MDEwOlJlcG9zaXRvcnkzMzAxNDgxMQ==-flat-Splitter.cpp-326.html,17,notepad-plus-plus-MDEwOlJlcG9zaXRvcnkzMzAxNDgxMQ==-flat-Splitter.cpp,notepad-plus-plus-MDEwOlJlcG9zaXRvcnkzMzAxNDgxMQ==-flat-Splitter.cpp,232,237,5,253,258,5
327,https://htmlpreview.github.io/?https://github.com/Christina96/boilerplate-sample-matches/blob/main/cpp/abseil-cpp-MDEwOlJlcG9zaXRvcnkxMDQyMzE1NDE=-flat-civil_time_test_17.cc-abseil-cpp-MDEwOlJlcG9zaXRvcnkxMDQyMzE1NDE=-flat-civil_time_test_17.cc-327.html,65,abseil-cpp-MDEwOlJlcG9zaXRvcnkxMDQyMzE1NDE=-flat-civil_time_test_17.cc,abseil-cpp-MDEwOlJlcG9zaXRvcnkxMDQyMzE1NDE=-flat-civil_time_test_17.cc,336,342,6,348,354,6
328,https://htmlpreview.github.io/?https://github.com/Christina96/boilerplate-sample-matches/blob/main/cpp/abseil-cpp-MDEwOlJlcG9zaXRvcnkxMDQyMzE1NDE=-flat-cord_rep_ring.cc-abseil-cpp-MDEwOlJlcG9zaXRvcnkxMDQyMzE1NDE=-flat-cord_rep_ring.cc-328.html,27,abseil-cpp-MDEwOlJlcG9zaXRvcnkxMDQyMzE1NDE=-flat-cord_rep_ring.cc,abseil-cpp-MDEwOlJlcG9zaXRvcnkxMDQyMzE1NDE=-flat-cord_rep_ring.cc,415,417,2,442,444,2
329,https://htmlpreview.github.io/?https://github.com/Christina96/boilerplate-sample-matches/blob/main/cpp/snap-MDEwOlJlcG9zaXRvcnk0Mjg4MzU3-flat-bowfl.cpp-snap-MDEwOlJlcG9zaXRvcnk0Mjg4MzU3-flat-bowflx.cpp-329.html,15,snap-MDEwOlJlcG9zaXRvcnk0Mjg4MzU3-flat-bowfl.cpp,snap-MDEwOlJlcG9zaXRvcnk0Mjg4MzU3-flat-bowflx.cpp,248,250,2,170,172,2
330,https://htmlpreview.github.io/?https://github.com/Christina96/boilerplate-sample-matches/blob/main/cpp/tesseract-MDEwOlJlcG9zaXRvcnkyMjg4NzA5NA==-flat-adaptive.cpp-tesseract-MDEwOlJlcG9zaXRvcnkyMjg4NzA5NA==-flat-adaptive.cpp-330.html,19,tesseract-MDEwOlJlcG9zaXRvcnkyMjg4NzA5NA==-flat-adaptive.cpp,tesseract-MDEwOlJlcG9zaXRvcnkyMjg4NzA5NA==-flat-adaptive.cpp,156,157,1,157,158,1
331,https://htmlpreview.github.io/?https://github.com/Christina96/boilerplate-sample-matches/blob/main/cpp/abseil-cpp-MDEwOlJlcG9zaXRvcnkxMDQyMzE1NDE=-flat-duration.cc-abseil-cpp-MDEwOlJlcG9zaXRvcnkxMDQyMzE1NDE=-flat-duration.cc-331.html,22,abseil-cpp-MDEwOlJlcG9zaXRvcnkxMDQyMzE1NDE=-flat-duration.cc,abseil-cpp-MDEwOlJlcG9zaXRvcnkxMDQyMzE1NDE=-flat-duration.cc,642,647,5,646,651,5
332,https://htmlpreview.github.io/?https://github.com/Christina96/boilerplate-sample-matches/blob/main/cpp/snap-MDEwOlJlcG9zaXRvcnk0Mjg4MzU3-flat-graph.cpp-snap-MDEwOlJlcG9zaXRvcnk0Mjg4MzU3-flat-graph.cpp-332.html,25,snap-MDEwOlJlcG9zaXRvcnk0Mjg4MzU3-flat-graph.cpp,snap-MDEwOlJlcG9zaXRvcnk0Mjg4MzU3-flat-graph.cpp,372,375,3,646,649,3
333,https://htmlpreview.github.io/?https://github.com/Christina96/boilerplate-sample-matches/blob/main/cpp/tesseract-MDEwOlJlcG9zaXRvcnkyMjg4NzA5NA==-flat-pitsync1.cpp-tesseract-MDEwOlJlcG9zaXRvcnkyMjg4NzA5NA==-flat-pithsync.cpp-333.html,16,tesseract-MDEwOlJlcG9zaXRvcnkyMjg4NzA5NA==-flat-pitsync1.cpp,tesseract-MDEwOlJlcG9zaXRvcnkyMjg4NzA5NA==-flat-pithsync.cpp,69,71,2,218,220,2
334,https://htmlpreview.github.io/?https://github.com/Christina96/boilerplate-sample-matches/blob/main/cpp/snap-MDEwOlJlcG9zaXRvcnk0Mjg4MzU3-flat-ssch.cpp-snap-MDEwOlJlcG9zaXRvcnk0Mjg4MzU3-flat-sch.cpp-334.html,25,snap-MDEwOlJlcG9zaXRvcnk0Mjg4MzU3-flat-ssch.cpp,snap-MDEwOlJlcG9zaXRvcnk0Mjg4MzU3-flat-sch.cpp,89,94,5,124,130,6
335,https://htmlpreview.github.io/?https://github.com/Christina96/boilerplate-sample-matches/blob/main/cpp/notepad-plus-plus-MDEwOlJlcG9zaXRvcnkzMzAxNDgxMQ==-flat-tinyxmlA.h-notepad-plus-plus-MDEwOlJlcG9zaXRvcnkzMzAxNDgxMQ==-flat-tinyxmlA.h-335.html,17,notepad-plus-plus-MDEwOlJlcG9zaXRvcnkzMzAxNDgxMQ==-flat-tinyxmlA.h,notepad-plus-plus-MDEwOlJlcG9zaXRvcnkzMzAxNDgxMQ==-flat-tinyxmlA.h,397,399,2,467,470,3
336,https://htmlpreview.github.io/?https://github.com/Christina96/boilerplate-sample-matches/blob/main/cpp/notepad-plus-plus-MDEwOlJlcG9zaXRvcnkzMzAxNDgxMQ==-flat-catch_14.hpp-notepad-plus-plus-MDEwOlJlcG9zaXRvcnkzMzAxNDgxMQ==-flat-catch.hpp-336.html,87042,notepad-plus-plus-MDEwOlJlcG9zaXRvcnkzMzAxNDgxMQ==-flat-catch_14.hpp,notepad-plus-plus-MDEwOlJlcG9zaXRvcnkzMzAxNDgxMQ==-flat-catch.hpp,1350,13690,12340,1350,13690,12340
337,https://htmlpreview.github.io/?https://github.com/Christina96/boilerplate-sample-matches/blob/main/cpp/snap-MDEwOlJlcG9zaXRvcnk0Mjg4MzU3-flat-nmobj.cpp-snap-MDEwOlJlcG9zaXRvcnk0Mjg4MzU3-flat-nmobj.cpp-337.html,26,snap-MDEwOlJlcG9zaXRvcnk0Mjg4MzU3-flat-nmobj.cpp,snap-MDEwOlJlcG9zaXRvcnk0Mjg4MzU3-flat-nmobj.cpp,768,771,3,820,823,3
338,https://htmlpreview.github.io/?https://github.com/Christina96/boilerplate-sample-matches/blob/main/cpp/abseil-cpp-MDEwOlJlcG9zaXRvcnkxMDQyMzE1NDE=-flat-numbers_test.cc-abseil-cpp-MDEwOlJlcG9zaXRvcnkxMDQyMzE1NDE=-flat-numbers_test.cc-338.html,28,abseil-cpp-MDEwOlJlcG9zaXRvcnkxMDQyMzE1NDE=-flat-numbers_test.cc,abseil-cpp-MDEwOlJlcG9zaXRvcnkxMDQyMzE1NDE=-flat-numbers_test.cc,258,260,2,226,228,2
339,https://htmlpreview.github.io/?https://github.com/Christina96/boilerplate-sample-matches/blob/main/cpp/tesseract-MDEwOlJlcG9zaXRvcnkyMjg4NzA5NA==-flat-colpartition.cpp-tesseract-MDEwOlJlcG9zaXRvcnkyMjg4NzA5NA==-flat-colpartition.cpp-339.html,108,tesseract-MDEwOlJlcG9zaXRvcnkyMjg4NzA5NA==-flat-colpartition.cpp,tesseract-MDEwOlJlcG9zaXRvcnkyMjg4NzA5NA==-flat-colpartition.cpp,1971,1986,15,2043,2058,15
340,https://htmlpreview.github.io/?https://github.com/Christina96/boilerplate-sample-matches/blob/main/cpp/snap-MDEwOlJlcG9zaXRvcnk0Mjg4MzU3-flat-table.cpp-snap-MDEwOlJlcG9zaXRvcnk0Mjg4MzU3-flat-table.cpp-340.html,17,snap-MDEwOlJlcG9zaXRvcnk0Mjg4MzU3-flat-table.cpp,snap-MDEwOlJlcG9zaXRvcnk0Mjg4MzU3-flat-table.cpp,1722,1723,1,1723,1724,1
341,https://htmlpreview.github.io/?https://github.com/Christina96/boilerplate-sample-matches/blob/main/cpp/caffe-MDEwOlJlcG9zaXRvcnk2MTg3MDgwMw==-flat-test_bbox_util.cpp-caffe-MDEwOlJlcG9zaXRvcnk2MTg3MDgwMw==-flat-test_bbox_util.cpp-341.html,63,caffe-MDEwOlJlcG9zaXRvcnk2MTg3MDgwMw==-flat-test_bbox_util.cpp,caffe-MDEwOlJlcG9zaXRvcnk2MTg3MDgwMw==-flat-test_bbox_util.cpp,1326,1334,8,1343,1351,8
342,https://htmlpreview.github.io/?https://github.com/Christina96/boilerplate-sample-matches/blob/main/cpp/snap-MDEwOlJlcG9zaXRvcnk0Mjg4MzU3-flat-memes.cpp-snap-MDEwOlJlcG9zaXRvcnk0Mjg4MzU3-flat-memes.cpp-342.html,14,snap-MDEwOlJlcG9zaXRvcnk0Mjg4MzU3-flat-memes.cpp,snap-MDEwOlJlcG9zaXRvcnk0Mjg4MzU3-flat-memes.cpp,1331,1332,1,1337,1338,1
343,https://htmlpreview.github.io/?https://github.com/Christina96/boilerplate-sample-matches/blob/main/cpp/nano-node-MDEwOlJlcG9zaXRvcnkxOTM0NzM0MA==-flat-election_44.cpp-nano-node-MDEwOlJlcG9zaXRvcnkxOTM0NzM0MA==-flat-election_44.cpp-343.html,18,nano-node-MDEwOlJlcG9zaXRvcnkxOTM0NzM0MA==-flat-election_44.cpp,nano-node-MDEwOlJlcG9zaXRvcnkxOTM0NzM0MA==-flat-election_44.cpp,465,467,2,470,472,2
344,https://htmlpreview.github.io/?https://github.com/Christina96/boilerplate-sample-matches/blob/main/cpp/snap-MDEwOlJlcG9zaXRvcnk0Mjg4MzU3-flat-fa.h-snap-MDEwOlJlcG9zaXRvcnk0Mjg4MzU3-flat-fa.h-344.html,24,snap-MDEwOlJlcG9zaXRvcnk0Mjg4MzU3-flat-fa.h,snap-MDEwOlJlcG9zaXRvcnk0Mjg4MzU3-flat-fa.h,185,188,3,190,193,3
345,https://htmlpreview.github.io/?https://github.com/Christina96/boilerplate-sample-matches/blob/main/cpp/abseil-cpp-MDEwOlJlcG9zaXRvcnkxMDQyMzE1NDE=-flat-ascii_test.cc-abseil-cpp-MDEwOlJlcG9zaXRvcnkxMDQyMzE1NDE=-flat-ascii_test.cc-345.html,22,abseil-cpp-MDEwOlJlcG9zaXRvcnkxMDQyMzE1NDE=-flat-ascii_test.cc,abseil-cpp-MDEwOlJlcG9zaXRvcnkxMDQyMzE1NDE=-flat-ascii_test.cc,168,172,4,181,185,4
346,https://htmlpreview.github.io/?https://github.com/Christina96/boilerplate-sample-matches/blob/main/cpp/abseil-cpp-MDEwOlJlcG9zaXRvcnkxMDQyMzE1NDE=-flat-cord_rep_ring.cc-abseil-cpp-MDEwOlJlcG9zaXRvcnkxMDQyMzE1NDE=-flat-cord_rep_ring.cc-346.html,58,abseil-cpp-MDEwOlJlcG9zaXRvcnkxMDQyMzE1NDE=-flat-cord_rep_ring.cc,abseil-cpp-MDEwOlJlcG9zaXRvcnkxMDQyMzE1NDE=-flat-cord_rep_ring.cc,498,507,9,522,531,9
347,https://htmlpreview.github.io/?https://github.com/Christina96/boilerplate-sample-matches/blob/main/cpp/abseil-cpp-MDEwOlJlcG9zaXRvcnkxMDQyMzE1NDE=-flat-demangle.cc-abseil-cpp-MDEwOlJlcG9zaXRvcnkxMDQyMzE1NDE=-flat-demangle.cc-347.html,16,abseil-cpp-MDEwOlJlcG9zaXRvcnkxMDQyMzE1NDE=-flat-demangle.cc,abseil-cpp-MDEwOlJlcG9zaXRvcnkxMDQyMzE1NDE=-flat-demangle.cc,773,776,3,785,789,4
348,https://htmlpreview.github.io/?https://github.com/Christina96/boilerplate-sample-matches/blob/main/cpp/tesseract-MDEwOlJlcG9zaXRvcnkyMjg4NzA5NA==-flat-shapetable_test.cc-tesseract-MDEwOlJlcG9zaXRvcnkyMjg4NzA5NA==-flat-shapetable_test.cc-348.html,24,tesseract-MDEwOlJlcG9zaXRvcnkyMjg4NzA5NA==-flat-shapetable_test.cc,tesseract-MDEwOlJlcG9zaXRvcnkyMjg4NzA5NA==-flat-shapetable_test.cc,80,82,2,81,83,2
349,https://htmlpreview.github.io/?https://github.com/Christina96/boilerplate-sample-matches/blob/main/cpp/abseil-cpp-MDEwOlJlcG9zaXRvcnkxMDQyMzE1NDE=-flat-crc_memcpy_x86_64.cc-abseil-cpp-MDEwOlJlcG9zaXRvcnkxMDQyMzE1NDE=-flat-crc_memcpy_x86_64.cc-349.html,23,abseil-cpp-MDEwOlJlcG9zaXRvcnkxMDQyMzE1NDE=-flat-crc_memcpy_x86_64.cc,abseil-cpp-MDEwOlJlcG9zaXRvcnkxMDQyMzE1NDE=-flat-crc_memcpy_x86_64.cc,212,215,3,240,243,3
350,https://htmlpreview.github.io/?https://github.com/Christina96/boilerplate-sample-matches/blob/main/cpp/snap-MDEwOlJlcG9zaXRvcnk0Mjg4MzU3-flat-ontolight.cpp-snap-MDEwOlJlcG9zaXRvcnk0Mjg4MzU3-flat-test.cpp-350.html,19,snap-MDEwOlJlcG9zaXRvcnk0Mjg4MzU3-flat-ontolight.cpp,snap-MDEwOlJlcG9zaXRvcnk0Mjg4MzU3-flat-test.cpp,324,326,2,68,70,2
351,https://htmlpreview.github.io/?https://github.com/Christina96/boilerplate-sample-matches/blob/main/cpp/notepad-plus-plus-MDEwOlJlcG9zaXRvcnkzMzAxNDgxMQ==-flat-catch_14.hpp-notepad-plus-plus-MDEwOlJlcG9zaXRvcnkzMzAxNDgxMQ==-flat-catch.hpp-351.html,41507,notepad-plus-plus-MDEwOlJlcG9zaXRvcnkzMzAxNDgxMQ==-flat-catch_14.hpp,notepad-plus-plus-MDEwOlJlcG9zaXRvcnkzMzAxNDgxMQ==-flat-catch.hpp,7793,13690,5897,7793,13690,5897
352,https://htmlpreview.github.io/?https://github.com/Christina96/boilerplate-sample-matches/blob/main/cpp/abseil-cpp-MDEwOlJlcG9zaXRvcnkxMDQyMzE1NDE=-flat-btree_benchmark.cc-abseil-cpp-MDEwOlJlcG9zaXRvcnkxMDQyMzE1NDE=-flat-btree_benchmark.cc-352.html,20,abseil-cpp-MDEwOlJlcG9zaXRvcnkxMDQyMzE1NDE=-flat-btree_benchmark.cc,abseil-cpp-MDEwOlJlcG9zaXRvcnkxMDQyMzE1NDE=-flat-btree_benchmark.cc,496,498,2,500,502,2
353,https://htmlpreview.github.io/?https://github.com/Christina96/boilerplate-sample-matches/blob/main/cpp/notepad-plus-plus-MDEwOlJlcG9zaXRvcnkzMzAxNDgxMQ==-flat-LexMMIXAL.cxx-notepad-plus-plus-MDEwOlJlcG9zaXRvcnkzMzAxNDgxMQ==-flat-LexBullant.cxx-353.html,3,notepad-plus-plus-MDEwOlJlcG9zaXRvcnkzMzAxNDgxMQ==-flat-LexMMIXAL.cxx,notepad-plus-plus-MDEwOlJlcG9zaXRvcnkzMzAxNDgxMQ==-flat-LexBullant.cxx,153,155,2,195,197,2
354,https://htmlpreview.github.io/?https://github.com/Christina96/boilerplate-sample-matches/blob/main/cpp/snap-MDEwOlJlcG9zaXRvcnk0Mjg4MzU3-flat-gstat.cpp-abseil-cpp-MDEwOlJlcG9zaXRvcnkxMDQyMzE1NDE=-flat-counting_allocator.h-354.html,14,snap-MDEwOlJlcG9zaXRvcnk0Mjg4MzU3-flat-gstat.cpp,abseil-cpp-MDEwOlJlcG9zaXRvcnkxMDQyMzE1NDE=-flat-counting_allocator.h,454,456,2,37,39,2
355,https://htmlpreview.github.io/?https://github.com/Christina96/boilerplate-sample-matches/blob/main/cpp/abseil-cpp-MDEwOlJlcG9zaXRvcnkxMDQyMzE1NDE=-flat-randen_hwaes.h-abseil-cpp-MDEwOlJlcG9zaXRvcnkxMDQyMzE1NDE=-flat-randen_slow.h-355.html,14,abseil-cpp-MDEwOlJlcG9zaXRvcnkxMDQyMzE1NDE=-flat-randen_hwaes.h,abseil-cpp-MDEwOlJlcG9zaXRvcnkxMDQyMzE1NDE=-flat-randen_slow.h,9,10,1,10,11,1
356,https://htmlpreview.github.io/?https://github.com/Christina96/boilerplate-sample-matches/blob/main/cpp/snap-MDEwOlJlcG9zaXRvcnk0Mjg4MzU3-flat-euproj.cpp-snap-MDEwOlJlcG9zaXRvcnk0Mjg4MzU3-flat-skygrid.cpp-356.html,16,snap-MDEwOlJlcG9zaXRvcnk0Mjg4MzU3-flat-euproj.cpp,snap-MDEwOlJlcG9zaXRvcnk0Mjg4MzU3-flat-skygrid.cpp,1701,1702,1,274,275,1
357,https://htmlpreview.github.io/?https://github.com/Christina96/boilerplate-sample-matches/blob/main/cpp/snap-MDEwOlJlcG9zaXRvcnk0Mjg4MzU3-flat-zipfl.cpp-snap-MDEwOlJlcG9zaXRvcnk0Mjg4MzU3-flat-zipfl.cpp-357.html,38,snap-MDEwOlJlcG9zaXRvcnk0Mjg4MzU3-flat-zipfl.cpp,snap-MDEwOlJlcG9zaXRvcnk0Mjg4MzU3-flat-zipfl.cpp,208,210,2,273,276,3
358,https://htmlpreview.github.io/?https://github.com/Christina96/boilerplate-sample-matches/blob/main/cpp/nano-node-MDEwOlJlcG9zaXRvcnkxOTM0NzM0MA==-flat-blake2b-compress-avx2.h-nano-node-MDEwOlJlcG9zaXRvcnkxOTM0NzM0MA==-flat-blake2b-compress-avx2.h-358.html,19,nano-node-MDEwOlJlcG9zaXRvcnkxOTM0NzM0MA==-flat-blake2b-compress-avx2.h,nano-node-MDEwOlJlcG9zaXRvcnkxOTM0NzM0MA==-flat-blake2b-compress-avx2.h,55,56,1,56,57,1
359,https://htmlpreview.github.io/?https://github.com/Christina96/boilerplate-sample-matches/blob/main/cpp/caffe-MDEwOlJlcG9zaXRvcnk2MTg3MDgwMw==-flat-net.hpp-caffe-MDEwOlJlcG9zaXRvcnk2MTg3MDgwMw==-flat-net.hpp-359.html,15,caffe-MDEwOlJlcG9zaXRvcnk2MTg3MDgwMw==-flat-net.hpp,caffe-MDEwOlJlcG9zaXRvcnk2MTg3MDgwMw==-flat-net.hpp,153,154,1,154,155,1
360,https://htmlpreview.github.io/?https://github.com/Christina96/boilerplate-sample-matches/blob/main/cpp/abseil-cpp-MDEwOlJlcG9zaXRvcnkxMDQyMzE1NDE=-flat-randen_hwaes.cc-abseil-cpp-MDEwOlJlcG9zaXRvcnkxMDQyMzE1NDE=-flat-randen_hwaes.cc-360.html,16,abseil-cpp-MDEwOlJlcG9zaXRvcnkxMDQyMzE1NDE=-flat-randen_hwaes.cc,abseil-cpp-MDEwOlJlcG9zaXRvcnkxMDQyMzE1NDE=-flat-randen_hwaes.cc,239,241,2,296,298,2
361,https://htmlpreview.github.io/?https://github.com/Christina96/boilerplate-sample-matches/blob/main/cpp/snap-MDEwOlJlcG9zaXRvcnk0Mjg4MzU3-flat-demo-alg.cpp-snap-MDEwOlJlcG9zaXRvcnk0Mjg4MzU3-flat-demo-alg.cpp-361.html,16,snap-MDEwOlJlcG9zaXRvcnk0Mjg4MzU3-flat-demo-alg.cpp,snap-MDEwOlJlcG9zaXRvcnk0Mjg4MzU3-flat-demo-alg.cpp,121,123,2,103,105,2
362,https://htmlpreview.github.io/?https://github.com/Christina96/boilerplate-sample-matches/blob/main/cpp/abseil-cpp-MDEwOlJlcG9zaXRvcnkxMDQyMzE1NDE=-flat-cord.h-snap-MDEwOlJlcG9zaXRvcnk0Mjg4MzU3-flat-memes.cpp-362.html,15,abseil-cpp-MDEwOlJlcG9zaXRvcnkxMDQyMzE1NDE=-flat-cord.h,snap-MDEwOlJlcG9zaXRvcnk0Mjg4MzU3-flat-memes.cpp,492,493,1,2008,2009,1
363,https://htmlpreview.github.io/?https://github.com/Christina96/boilerplate-sample-matches/blob/main/cpp/abseil-cpp-MDEwOlJlcG9zaXRvcnkxMDQyMzE1NDE=-flat-hash_test.cc-abseil-cpp-MDEwOlJlcG9zaXRvcnkxMDQyMzE1NDE=-flat-cordz_info_test.cc-363.html,17,abseil-cpp-MDEwOlJlcG9zaXRvcnkxMDQyMzE1NDE=-flat-hash_test.cc,abseil-cpp-MDEwOlJlcG9zaXRvcnkxMDQyMzE1NDE=-flat-cordz_info_test.cc,117,118,1,33,34,1
364,https://htmlpreview.github.io/?https://github.com/Christina96/boilerplate-sample-matches/blob/main/cpp/tesseract-MDEwOlJlcG9zaXRvcnkyMjg4NzA5NA==-flat-bbgrid.cpp-tesseract-MDEwOlJlcG9zaXRvcnkyMjg4NzA5NA==-flat-bbgrid.h-364.html,17,tesseract-MDEwOlJlcG9zaXRvcnkyMjg4NzA5NA==-flat-bbgrid.cpp,tesseract-MDEwOlJlcG9zaXRvcnkyMjg4NzA5NA==-flat-bbgrid.h,148,149,1,11,12,1
365,https://htmlpreview.github.io/?https://github.com/Christina96/boilerplate-sample-matches/blob/main/cpp/abseil-cpp-MDEwOlJlcG9zaXRvcnkxMDQyMzE1NDE=-flat-btree_test.cc-abseil-cpp-MDEwOlJlcG9zaXRvcnkxMDQyMzE1NDE=-flat-btree_test.cc-365.html,24,abseil-cpp-MDEwOlJlcG9zaXRvcnkxMDQyMzE1NDE=-flat-btree_test.cc,abseil-cpp-MDEwOlJlcG9zaXRvcnkxMDQyMzE1NDE=-flat-btree_test.cc,309,312,3,347,350,3
366,https://htmlpreview.github.io/?https://github.com/Christina96/boilerplate-sample-matches/blob/main/cpp/nano-node-MDEwOlJlcG9zaXRvcnkxOTM0NzM0MA==-flat-final_vote_store_79.cpp-nano-node-MDEwOlJlcG9zaXRvcnkxOTM0NzM0MA==-flat-final_vote_store.cpp-366.html,756,nano-node-MDEwOlJlcG9zaXRvcnkxOTM0NzM0MA==-flat-final_vote_store_79.cpp,nano-node-MDEwOlJlcG9zaXRvcnkxOTM0NzM0MA==-flat-final_vote_store.cpp,5,77,72,5,77,72
367,https://htmlpreview.github.io/?https://github.com/Christina96/boilerplate-sample-matches/blob/main/cpp/abseil-cpp-MDEwOlJlcG9zaXRvcnkxMDQyMzE1NDE=-flat-bit_gen_ref.h-abseil-cpp-MDEwOlJlcG9zaXRvcnkxMDQyMzE1NDE=-flat-distribution_caller.h-367.html,15,abseil-cpp-MDEwOlJlcG9zaXRvcnkxMDQyMzE1NDE=-flat-bit_gen_ref.h,abseil-cpp-MDEwOlJlcG9zaXRvcnkxMDQyMzE1NDE=-flat-distribution_caller.h,44,45,1,24,25,1
368,https://htmlpreview.github.io/?https://github.com/Christina96/boilerplate-sample-matches/blob/main/cpp/snap-MDEwOlJlcG9zaXRvcnk0Mjg4MzU3-flat-euproj.cpp-snap-MDEwOlJlcG9zaXRvcnk0Mjg4MzU3-flat-euproj.cpp-368.html,28,snap-MDEwOlJlcG9zaXRvcnk0Mjg4MzU3-flat-euproj.cpp,snap-MDEwOlJlcG9zaXRvcnk0Mjg4MzU3-flat-euproj.cpp,1716,1720,4,1645,1649,4
369,https://htmlpreview.github.io/?https://github.com/Christina96/boilerplate-sample-matches/blob/main/cpp/tesseract-MDEwOlJlcG9zaXRvcnkyMjg4NzA5NA==-flat-paragraphs.cpp-tesseract-MDEwOlJlcG9zaXRvcnkyMjg4NzA5NA==-flat-paragraphs.cpp-369.html,14,tesseract-MDEwOlJlcG9zaXRvcnkyMjg4NzA5NA==-flat-paragraphs.cpp,tesseract-MDEwOlJlcG9zaXRvcnkyMjg4NzA5NA==-flat-paragraphs.cpp,892,893,1,894,895,1
370,https://htmlpreview.github.io/?https://github.com/Christina96/boilerplate-sample-matches/blob/main/cpp/glm-MDEwOlJlcG9zaXRvcnk4NDM2MzE=-flat-matrix_access.hpp-glm-MDEwOlJlcG9zaXRvcnk4NDM2MzE=-flat-matrix_access.hpp-370.html,20,glm-MDEwOlJlcG9zaXRvcnk4NDM2MzE=-flat-matrix_access.hpp,glm-MDEwOlJlcG9zaXRvcnk4NDM2MzE=-flat-matrix_access.hpp,14,18,4,23,27,4
371,https://htmlpreview.github.io/?https://github.com/Christina96/boilerplate-sample-matches/blob/main/cpp/caffe-MDEwOlJlcG9zaXRvcnk2MTg3MDgwMw==-flat-gmock-spec-builders.h-caffe-MDEwOlJlcG9zaXRvcnk2MTg3MDgwMw==-flat-gmock-spec-builders.h-371.html,20,caffe-MDEwOlJlcG9zaXRvcnk2MTg3MDgwMw==-flat-gmock-spec-builders.h,caffe-MDEwOlJlcG9zaXRvcnk2MTg3MDgwMw==-flat-gmock-spec-builders.h,523,526,3,528,531,3
372,https://htmlpreview.github.io/?https://github.com/Christina96/boilerplate-sample-matches/blob/main/cpp/snap-MDEwOlJlcG9zaXRvcnk0Mjg4MzU3-flat-rinetmatch.h-snap-MDEwOlJlcG9zaXRvcnk0Mjg4MzU3-flat-rinetmatch.h-372.html,26,snap-MDEwOlJlcG9zaXRvcnk0Mjg4MzU3-flat-rinetmatch.h,snap-MDEwOlJlcG9zaXRvcnk0Mjg4MzU3-flat-rinetmatch.h,685,692,7,679,686,7
373,https://htmlpreview.github.io/?https://github.com/Christina96/boilerplate-sample-matches/blob/main/cpp/snap-MDEwOlJlcG9zaXRvcnk0Mjg4MzU3-flat-graph_2.cpp-snap-MDEwOlJlcG9zaXRvcnk0Mjg4MzU3-flat-graphmp.cpp-373.html,178,snap-MDEwOlJlcG9zaXRvcnk0Mjg4MzU3-flat-graph_2.cpp,snap-MDEwOlJlcG9zaXRvcnk0Mjg4MzU3-flat-graphmp.cpp,225,243,18,38,56,18
374,https://htmlpreview.github.io/?https://github.com/Christina96/boilerplate-sample-matches/blob/main/cpp/snap-MDEwOlJlcG9zaXRvcnk0Mjg4MzU3-flat-webold.cpp-snap-MDEwOlJlcG9zaXRvcnk0Mjg4MzU3-flat-test-THash.cpp-374.html,15,snap-MDEwOlJlcG9zaXRvcnk0Mjg4MzU3-flat-webold.cpp,snap-MDEwOlJlcG9zaXRvcnk0Mjg4MzU3-flat-test-THash.cpp,55,60,5,204,209,5
375,https://htmlpreview.github.io/?https://github.com/Christina96/boilerplate-sample-matches/blob/main/cpp/snap-MDEwOlJlcG9zaXRvcnk0Mjg4MzU3-flat-yahoobs.cpp-snap-MDEwOlJlcG9zaXRvcnk0Mjg4MzU3-flat-hldoc.cpp-375.html,16,snap-MDEwOlJlcG9zaXRvcnk0Mjg4MzU3-flat-yahoobs.cpp,snap-MDEwOlJlcG9zaXRvcnk0Mjg4MzU3-flat-hldoc.cpp,3,4,1,176,177,1
376,https://htmlpreview.github.io/?https://github.com/Christina96/boilerplate-sample-matches/blob/main/cpp/abseil-cpp-MDEwOlJlcG9zaXRvcnkxMDQyMzE1NDE=-flat-randen_engine_test.cc-abseil-cpp-MDEwOlJlcG9zaXRvcnkxMDQyMzE1NDE=-flat-pcg_engine_test.cc-376.html,36,abseil-cpp-MDEwOlJlcG9zaXRvcnkxMDQyMzE1NDE=-flat-randen_engine_test.cc,abseil-cpp-MDEwOlJlcG9zaXRvcnkxMDQyMzE1NDE=-flat-pcg_engine_test.cc,112,117,5,110,115,5
377,https://htmlpreview.github.io/?https://github.com/Christina96/boilerplate-sample-matches/blob/main/cpp/snap-MDEwOlJlcG9zaXRvcnk0Mjg4MzU3-flat-lsionto.cpp-snap-MDEwOlJlcG9zaXRvcnk0Mjg4MzU3-flat-lsionto.cpp-377.html,40,snap-MDEwOlJlcG9zaXRvcnk0Mjg4MzU3-flat-lsionto.cpp,snap-MDEwOlJlcG9zaXRvcnk0Mjg4MzU3-flat-lsionto.cpp,1035,1039,4,1062,1066,4
378,https://htmlpreview.github.io/?https://github.com/Christina96/boilerplate-sample-matches/blob/main/cpp/abseil-cpp-MDEwOlJlcG9zaXRvcnkxMDQyMzE1NDE=-flat-mutex_test.cc-abseil-cpp-MDEwOlJlcG9zaXRvcnkxMDQyMzE1NDE=-flat-mutex_test.cc-378.html,50,abseil-cpp-MDEwOlJlcG9zaXRvcnkxMDQyMzE1NDE=-flat-mutex_test.cc,abseil-cpp-MDEwOlJlcG9zaXRvcnkxMDQyMzE1NDE=-flat-mutex_test.cc,368,374,6,393,399,6
379,https://htmlpreview.github.io/?https://github.com/Christina96/boilerplate-sample-matches/blob/main/cpp/caffe-MDEwOlJlcG9zaXRvcnk2MTg3MDgwMw==-flat-softmax_layer.cpp-caffe-MDEwOlJlcG9zaXRvcnk2MTg3MDgwMw==-flat-softmax_layer.cpp-379.html,14,caffe-MDEwOlJlcG9zaXRvcnk2MTg3MDgwMw==-flat-softmax_layer.cpp,caffe-MDEwOlJlcG9zaXRvcnk2MTg3MDgwMw==-flat-softmax_layer.cpp,30,31,1,33,34,1
380,https://htmlpreview.github.io/?https://github.com/Christina96/boilerplate-sample-matches/blob/main/cpp/notepad-plus-plus-MDEwOlJlcG9zaXRvcnkzMzAxNDgxMQ==-flat-Parameters.cpp-notepad-plus-plus-MDEwOlJlcG9zaXRvcnkzMzAxNDgxMQ==-flat-Parameters.cpp-380.html,17,notepad-plus-plus-MDEwOlJlcG9zaXRvcnkzMzAxNDgxMQ==-flat-Parameters.cpp,notepad-plus-plus-MDEwOlJlcG9zaXRvcnkzMzAxNDgxMQ==-flat-Parameters.cpp,2774,2775,1,2724,2725,1
381,https://htmlpreview.github.io/?https://github.com/Christina96/boilerplate-sample-matches/blob/main/cpp/notepad-plus-plus-MDEwOlJlcG9zaXRvcnkzMzAxNDgxMQ==-flat-LexPowerShell.cxx-notepad-plus-plus-MDEwOlJlcG9zaXRvcnkzMzAxNDgxMQ==-flat-LexAVE.cxx-381.html,15,notepad-plus-plus-MDEwOlJlcG9zaXRvcnkzMzAxNDgxMQ==-flat-LexPowerShell.cxx,notepad-plus-plus-MDEwOlJlcG9zaXRvcnkzMzAxNDgxMQ==-flat-LexAVE.cxx,164,169,5,122,127,5
382,https://htmlpreview.github.io/?https://github.com/Christina96/boilerplate-sample-matches/blob/main/cpp/nano-node-MDEwOlJlcG9zaXRvcnkxOTM0NzM0MA==-flat-openclwork.cpp-nano-node-MDEwOlJlcG9zaXRvcnkxOTM0NzM0MA==-flat-election_44.cpp-382.html,17,nano-node-MDEwOlJlcG9zaXRvcnkxOTM0NzM0MA==-flat-openclwork.cpp,nano-node-MDEwOlJlcG9zaXRvcnkxOTM0NzM0MA==-flat-election_44.cpp,147,150,3,307,310,3
383,https://htmlpreview.github.io/?https://github.com/Christina96/boilerplate-sample-matches/blob/main/cpp/notepad-plus-plus-MDEwOlJlcG9zaXRvcnkzMzAxNDgxMQ==-flat-LexPerl.cxx-notepad-plus-plus-MDEwOlJlcG9zaXRvcnkzMzAxNDgxMQ==-flat-LexEScript.cxx-383.html,22,notepad-plus-plus-MDEwOlJlcG9zaXRvcnkzMzAxNDgxMQ==-flat-LexPerl.cxx,notepad-plus-plus-MDEwOlJlcG9zaXRvcnkzMzAxNDgxMQ==-flat-LexEScript.cxx,1422,1425,3,135,138,3
