ID,Link,Tokens,File 1,File 2,Start 1,End 1,Detected Lines 1,Start 2,End 2,Detected Lines 2
0,https://htmlpreview.github.io/?https://github.com/Christina96/boilerplate-sample-matches/blob/main/Csharp/MudBlazor-MDEwOlJlcG9zaXRvcnkyODg0Mjg2NzY=-flat-PieChartTests.cs-MudBlazor-MDEwOlJlcG9zaXRvcnkyODg0Mjg2NzY=-flat-PieChartTests.cs.html,155,MudBlazor-MDEwOlJlcG9zaXRvcnkyODg0Mjg2NzY=-flat-PieChartTests.cs,MudBlazor-MDEwOlJlcG9zaXRvcnkyODg0Mjg2NzY=-flat-PieChartTests.cs,54,75,21,54,75,21
1,https://htmlpreview.github.io/?https://github.com/Christina96/boilerplate-sample-matches/blob/main/Csharp/dotween-MDEwOlJlcG9zaXRvcnkzMjQ3NTE2Mg==-flat-TweenManager_146.cs-dotween-MDEwOlJlcG9zaXRvcnkzMjQ3NTE2Mg==-flat-TweenManager_146.cs.html,14,dotween-MDEwOlJlcG9zaXRvcnkzMjQ3NTE2Mg==-flat-TweenManager_146.cs,dotween-MDEwOlJlcG9zaXRvcnkzMjQ3NTE2Mg==-flat-TweenManager_146.cs,850,852,2,846,848,2
2,https://htmlpreview.github.io/?https://github.com/Christina96/boilerplate-sample-matches/blob/main/Csharp/npgsql-MDEwOlJlcG9zaXRvcnkyODgzNTc0-flat-NpgsqlRange.cs-npgsql-MDEwOlJlcG9zaXRvcnkyODgzNTc0-flat-NpgsqlRange.cs.html,14,npgsql-MDEwOlJlcG9zaXRvcnkyODgzNTc0-flat-NpgsqlRange.cs,npgsql-MDEwOlJlcG9zaXRvcnkyODgzNTc0-flat-NpgsqlRange.cs,145,146,1,144,145,1
3,https://htmlpreview.github.io/?https://github.com/Christina96/boilerplate-sample-matches/blob/main/Csharp/Simple.Data-MDEwOlJlcG9zaXRvcnk4MTg3Njg=-flat-EagerLoadingEnumerable.cs-Simple.Data-MDEwOlJlcG9zaXRvcnk4MTg3Njg=-flat-EagerLoadingEnumerable.cs.html,13,Simple.Data-MDEwOlJlcG9zaXRvcnk4MTg3Njg=-flat-EagerLoadingEnumerable.cs,Simple.Data-MDEwOlJlcG9zaXRvcnk4MTg3Njg=-flat-EagerLoadingEnumerable.cs,9,11,2,9,11,2
4,https://htmlpreview.github.io/?https://github.com/Christina96/boilerplate-sample-matches/blob/main/Csharp/runner-MDEwOlJlcG9zaXRvcnkxODQyODY4NzU=-flat-TrackingConfig.cs-runner-MDEwOlJlcG9zaXRvcnkxODQyODY4NzU=-flat-TrackingConfig.cs.html,52,runner-MDEwOlJlcG9zaXRvcnkxODQyODY4NzU=-flat-TrackingConfig.cs,runner-MDEwOlJlcG9zaXRvcnkxODQyODY4NzU=-flat-TrackingConfig.cs,23,38,15,80,95,15
5,https://htmlpreview.github.io/?https://github.com/Christina96/boilerplate-sample-matches/blob/main/Csharp/dotween-MDEwOlJlcG9zaXRvcnkzMjQ3NTE2Mg==-flat-DOTweenComponentInspector.cs-dotween-MDEwOlJlcG9zaXRvcnkzMjQ3NTE2Mg==-flat-DOTweenComponentInspector.cs.html,14,dotween-MDEwOlJlcG9zaXRvcnkzMjQ3NTE2Mg==-flat-DOTweenComponentInspector.cs,dotween-MDEwOlJlcG9zaXRvcnkzMjQ3NTE2Mg==-flat-DOTweenComponentInspector.cs,58,59,1,58,59,1
6,https://htmlpreview.github.io/?https://github.com/Christina96/boilerplate-sample-matches/blob/main/Csharp/runner-MDEwOlJlcG9zaXRvcnkxODQyODY4NzU=-flat-CheckUtil.cs-runner-MDEwOlJlcG9zaXRvcnkxODQyODY4NzU=-flat-CheckUtil.cs.html,96,runner-MDEwOlJlcG9zaXRvcnkxODQyODY4NzU=-flat-CheckUtil.cs,runner-MDEwOlJlcG9zaXRvcnkxODQyODY4NzU=-flat-CheckUtil.cs,73,86,13,73,86,13
7,https://htmlpreview.github.io/?https://github.com/Christina96/boilerplate-sample-matches/blob/main/Csharp/MudBlazor-MDEwOlJlcG9zaXRvcnkyODg0Mjg2NzY=-flat-MoqExtensions.cs-MudBlazor-MDEwOlJlcG9zaXRvcnkyODg0Mjg2NzY=-flat-MoqExtensions.cs.html,68,MudBlazor-MDEwOlJlcG9zaXRvcnkyODg0Mjg2NzY=-flat-MoqExtensions.cs,MudBlazor-MDEwOlJlcG9zaXRvcnkyODg0Mjg2NzY=-flat-MoqExtensions.cs,16,21,5,29,34,5
8,https://htmlpreview.github.io/?https://github.com/Christina96/boilerplate-sample-matches/blob/main/Csharp/dotween-MDEwOlJlcG9zaXRvcnkzMjQ3NTE2Mg==-flat-LeanTween_56.cs-dotween-MDEwOlJlcG9zaXRvcnkzMjQ3NTE2Mg==-flat-LeanTween_56.cs.html,23,dotween-MDEwOlJlcG9zaXRvcnkzMjQ3NTE2Mg==-flat-LeanTween_56.cs,dotween-MDEwOlJlcG9zaXRvcnkzMjQ3NTE2Mg==-flat-LeanTween_56.cs,1980,1983,3,1906,1909,3
9,https://htmlpreview.github.io/?https://github.com/Christina96/boilerplate-sample-matches/blob/main/Csharp/EarTrumpet-MDEwOlJlcG9zaXRvcnkzODkxOTcwMg==-flat-FullWindowViewModel.cs-NetCoreServer-MDEwOlJlcG9zaXRvcnkxNjYxMjMxNjQ=-flat-Program_45.cs.html,12,EarTrumpet-MDEwOlJlcG9zaXRvcnkzODkxOTcwMg==-flat-FullWindowViewModel.cs,NetCoreServer-MDEwOlJlcG9zaXRvcnkxNjYxMjMxNjQ=-flat-Program_45.cs,63,65,2,109,111,2
10,https://htmlpreview.github.io/?https://github.com/Christina96/boilerplate-sample-matches/blob/main/Csharp/Security-MDEwOlJlcG9zaXRvcnkxNzcyMzY5OQ==-flat-Startup_14.cs-Security-MDEwOlJlcG9zaXRvcnkxNzcyMzY5OQ==-flat-Startup_14.cs.html,201,Security-MDEwOlJlcG9zaXRvcnkxNzcyMzY5OQ==-flat-Startup_14.cs,Security-MDEwOlJlcG9zaXRvcnkxNzcyMzY5OQ==-flat-Startup_14.cs,147,178,31,147,178,31
11,https://htmlpreview.github.io/?https://github.com/Christina96/boilerplate-sample-matches/blob/main/Csharp/Simple.Data-MDEwOlJlcG9zaXRvcnk4MTg3Njg=-flat-SqlTypeResolver.cs-Simple.Data-MDEwOlJlcG9zaXRvcnk4MTg3Njg=-flat-SqlTypeResolver.cs.html,349,Simple.Data-MDEwOlJlcG9zaXRvcnk4MTg3Njg=-flat-SqlTypeResolver.cs,Simple.Data-MDEwOlJlcG9zaXRvcnk4MTg3Njg=-flat-SqlTypeResolver.cs,3,47,44,3,47,44
12,https://htmlpreview.github.io/?https://github.com/Christina96/boilerplate-sample-matches/blob/main/Csharp/runner-MDEwOlJlcG9zaXRvcnkxODQyODY4NzU=-flat-TemplateReader.cs-runner-MDEwOlJlcG9zaXRvcnkxODQyODY4NzU=-flat-TemplateReader.cs.html,13,runner-MDEwOlJlcG9zaXRvcnkxODQyODY4NzU=-flat-TemplateReader.cs,runner-MDEwOlJlcG9zaXRvcnkxODQyODY4NzU=-flat-TemplateReader.cs,483,487,4,483,487,4
13,https://htmlpreview.github.io/?https://github.com/Christina96/boilerplate-sample-matches/blob/main/Csharp/npgsql-MDEwOlJlcG9zaXRvcnkyODgzNTc0-flat-TextHandler.cs-npgsql-MDEwOlJlcG9zaXRvcnkyODgzNTc0-flat-TextHandler.cs.html,17,npgsql-MDEwOlJlcG9zaXRvcnkyODgzNTc0-flat-TextHandler.cs,npgsql-MDEwOlJlcG9zaXRvcnkyODgzNTc0-flat-TextHandler.cs,216,218,2,219,221,2
14,https://htmlpreview.github.io/?https://github.com/Christina96/boilerplate-sample-matches/blob/main/Csharp/Security-MDEwOlJlcG9zaXRvcnkxNzcyMzY5OQ==-flat-OpenIdConnectHandler.cs-Security-MDEwOlJlcG9zaXRvcnkxNzcyMzY5OQ==-flat-OpenIdConnectHandler.cs.html,17,Security-MDEwOlJlcG9zaXRvcnkxNzcyMzY5OQ==-flat-OpenIdConnectHandler.cs,Security-MDEwOlJlcG9zaXRvcnkxNzcyMzY5OQ==-flat-OpenIdConnectHandler.cs,340,344,4,340,344,4
15,https://htmlpreview.github.io/?https://github.com/Christina96/boilerplate-sample-matches/blob/main/Csharp/MudBlazor-MDEwOlJlcG9zaXRvcnkyODg0Mjg2NzY=-flat-DataGridTests.cs-20486D-DevelopingASPNETMVCWebApplications-MDEwOlJlcG9zaXRvcnkxMTkzNTI2Mzc=-flat-ProductsController.cs.html,12,MudBlazor-MDEwOlJlcG9zaXRvcnkyODg0Mjg2NzY=-flat-DataGridTests.cs,20486D-DevelopingASPNETMVCWebApplications-MDEwOlJlcG9zaXRvcnkxMTkzNTI2Mzc=-flat-ProductsController.cs,1256,1258,2,55,57,2
16,https://htmlpreview.github.io/?https://github.com/Christina96/boilerplate-sample-matches/blob/main/Csharp/npgsql-MDEwOlJlcG9zaXRvcnkyODgzNTc0-flat-NpgsqlConnector.FrontendMessages.cs-npgsql-MDEwOlJlcG9zaXRvcnkyODgzNTc0-flat-NpgsqlConnector.FrontendMessages.cs.html,51,npgsql-MDEwOlJlcG9zaXRvcnkyODgzNTc0-flat-NpgsqlConnector.FrontendMessages.cs,npgsql-MDEwOlJlcG9zaXRvcnkyODgzNTc0-flat-NpgsqlConnector.FrontendMessages.cs,27,36,9,27,36,9
17,https://htmlpreview.github.io/?https://github.com/Christina96/boilerplate-sample-matches/blob/main/Csharp/20486D-DevelopingASPNETMVCWebApplications-MDEwOlJlcG9zaXRvcnkxMTkzNTI2Mzc=-flat-JobApplicationController.cs-20486D-DevelopingASPNETMVCWebApplications-MDEwOlJlcG9zaXRvcnkxMTkzNTI2Mzc=-flat-ReservationController.cs.html,16,20486D-DevelopingASPNETMVCWebApplications-MDEwOlJlcG9zaXRvcnkxMTkzNTI2Mzc=-flat-JobApplicationController.cs,20486D-DevelopingASPNETMVCWebApplications-MDEwOlJlcG9zaXRvcnkxMTkzNTI2Mzc=-flat-ReservationController.cs,32,35,3,47,50,3
18,https://htmlpreview.github.io/?https://github.com/Christina96/boilerplate-sample-matches/blob/main/Csharp/Security-MDEwOlJlcG9zaXRvcnkxNzcyMzY5OQ==-flat-MicrosoftAccountTests.cs-Security-MDEwOlJlcG9zaXRvcnkxNzcyMzY5OQ==-flat-GoogleTests.cs.html,14,Security-MDEwOlJlcG9zaXRvcnkxNzcyMzY5OQ==-flat-MicrosoftAccountTests.cs,Security-MDEwOlJlcG9zaXRvcnkxNzcyMzY5OQ==-flat-GoogleTests.cs,198,203,5,731,736,5
19,https://htmlpreview.github.io/?https://github.com/Christina96/boilerplate-sample-matches/blob/main/Csharp/runner-MDEwOlJlcG9zaXRvcnkxODQyODY4NzU=-flat-GitHubContext.cs-runner-MDEwOlJlcG9zaXRvcnkxODQyODY4NzU=-flat-RunnerContext.cs.html,13,runner-MDEwOlJlcG9zaXRvcnkxODQyODY4NzU=-flat-GitHubContext.cs,runner-MDEwOlJlcG9zaXRvcnkxODQyODY4NzU=-flat-RunnerContext.cs,48,50,2,8,10,2
20,https://htmlpreview.github.io/?https://github.com/Christina96/boilerplate-sample-matches/blob/main/Csharp/ZXing.Net.Mobile-MDEwOlJlcG9zaXRvcnk2MTYwNjcz-flat-HomePage.cs-ZXing.Net.Mobile-MDEwOlJlcG9zaXRvcnk2MTYwNjcz-flat-HomePage.cs.html,12,ZXing.Net.Mobile-MDEwOlJlcG9zaXRvcnk2MTYwNjcz-flat-HomePage.cs,ZXing.Net.Mobile-MDEwOlJlcG9zaXRvcnk2MTYwNjcz-flat-HomePage.cs,35,36,1,68,69,1
21,https://htmlpreview.github.io/?https://github.com/Christina96/boilerplate-sample-matches/blob/main/Csharp/npgsql-MDEwOlJlcG9zaXRvcnkyODgzNTc0-flat-NpgsqlCommand.cs-npgsql-MDEwOlJlcG9zaXRvcnkyODgzNTc0-flat-NpgsqlCommand.cs.html,18,npgsql-MDEwOlJlcG9zaXRvcnkyODgzNTc0-flat-NpgsqlCommand.cs,npgsql-MDEwOlJlcG9zaXRvcnkyODgzNTc0-flat-NpgsqlCommand.cs,488,491,3,488,491,3
22,https://htmlpreview.github.io/?https://github.com/Christina96/boilerplate-sample-matches/blob/main/Csharp/Security-MDEwOlJlcG9zaXRvcnkxNzcyMzY5OQ==-flat-ChunkingCookieManager_19.cs-Security-MDEwOlJlcG9zaXRvcnkxNzcyMzY5OQ==-flat-ChunkingCookieManager.cs.html,159,Security-MDEwOlJlcG9zaXRvcnkxNzcyMzY5OQ==-flat-ChunkingCookieManager_19.cs,Security-MDEwOlJlcG9zaXRvcnkxNzcyMzY5OQ==-flat-ChunkingCookieManager.cs,54,86,32,64,99,35
23,https://htmlpreview.github.io/?https://github.com/Christina96/boilerplate-sample-matches/blob/main/Csharp/dotween-MDEwOlJlcG9zaXRvcnkzMjQ3NTE2Mg==-flat-SafeMode_32.cs-dotween-MDEwOlJlcG9zaXRvcnkzMjQ3NTE2Mg==-flat-SafeMode_32.cs.html,82,dotween-MDEwOlJlcG9zaXRvcnkzMjQ3NTE2Mg==-flat-SafeMode_32.cs,dotween-MDEwOlJlcG9zaXRvcnkzMjQ3NTE2Mg==-flat-SafeMode_32.cs,8,18,10,8,18,10
24,https://htmlpreview.github.io/?https://github.com/Christina96/boilerplate-sample-matches/blob/main/Csharp/npgsql-MDEwOlJlcG9zaXRvcnkyODgzNTc0-flat-SqlQueryParser.cs-npgsql-MDEwOlJlcG9zaXRvcnkyODgzNTc0-flat-SqlQueryParser.cs.html,12,npgsql-MDEwOlJlcG9zaXRvcnkyODgzNTc0-flat-SqlQueryParser.cs,npgsql-MDEwOlJlcG9zaXRvcnkyODgzNTc0-flat-SqlQueryParser.cs,123,128,5,283,288,5
25,https://htmlpreview.github.io/?https://github.com/Christina96/boilerplate-sample-matches/blob/main/Csharp/ZXing.Net.Mobile-MDEwOlJlcG9zaXRvcnk2MTYwNjcz-flat-BitmapRenderer.ios.cs-ZXing.Net.Mobile-MDEwOlJlcG9zaXRvcnk2MTYwNjcz-flat-BitmapRenderer.macos.cs.html,16,ZXing.Net.Mobile-MDEwOlJlcG9zaXRvcnk2MTYwNjcz-flat-BitmapRenderer.ios.cs,ZXing.Net.Mobile-MDEwOlJlcG9zaXRvcnk2MTYwNjcz-flat-BitmapRenderer.macos.cs,5,10,5,5,10,5
26,https://htmlpreview.github.io/?https://github.com/Christina96/boilerplate-sample-matches/blob/main/Csharp/20486D-DevelopingASPNETMVCWebApplications-MDEwOlJlcG9zaXRvcnkxMTkzNTI2Mzc=-flat-Startup_201.cs-20486D-DevelopingASPNETMVCWebApplications-MDEwOlJlcG9zaXRvcnkxMTkzNTI2Mzc=-flat-Startup_210.cs.html,41,20486D-DevelopingASPNETMVCWebApplications-MDEwOlJlcG9zaXRvcnkxMTkzNTI2Mzc=-flat-Startup_201.cs,20486D-DevelopingASPNETMVCWebApplications-MDEwOlJlcG9zaXRvcnkxMTkzNTI2Mzc=-flat-Startup_210.cs,23,29,6,24,30,6
27,https://htmlpreview.github.io/?https://github.com/Christina96/boilerplate-sample-matches/blob/main/Csharp/ZXing.Net.Mobile-MDEwOlJlcG9zaXRvcnk2MTYwNjcz-flat-ScanPage.xaml.cs-ZXing.Net.Mobile-MDEwOlJlcG9zaXRvcnk2MTYwNjcz-flat-ScanPage.xaml.cs.html,24,ZXing.Net.Mobile-MDEwOlJlcG9zaXRvcnk2MTYwNjcz-flat-ScanPage.xaml.cs,ZXing.Net.Mobile-MDEwOlJlcG9zaXRvcnk2MTYwNjcz-flat-ScanPage.xaml.cs,76,84,8,81,89,8
28,https://htmlpreview.github.io/?https://github.com/Christina96/boilerplate-sample-matches/blob/main/Csharp/dotween-MDEwOlJlcG9zaXRvcnkzMjQ3NTE2Mg==-flat-GoKitTweenExtensions.cs-dotween-MDEwOlJlcG9zaXRvcnkzMjQ3NTE2Mg==-flat-GoKitTweenExtensions.cs.html,23,dotween-MDEwOlJlcG9zaXRvcnkzMjQ3NTE2Mg==-flat-GoKitTweenExtensions.cs,dotween-MDEwOlJlcG9zaXRvcnkzMjQ3NTE2Mg==-flat-GoKitTweenExtensions.cs,64,66,2,60,62,2
29,https://htmlpreview.github.io/?https://github.com/Christina96/boilerplate-sample-matches/blob/main/Csharp/runner-MDEwOlJlcG9zaXRvcnkxODQyODY4NzU=-flat-IOUtilL0.cs-runner-MDEwOlJlcG9zaXRvcnkxODQyODY4NzU=-flat-ContainerOperationProvider.cs.html,12,runner-MDEwOlJlcG9zaXRvcnkxODQyODY4NzU=-flat-IOUtilL0.cs,runner-MDEwOlJlcG9zaXRvcnkxODQyODY4NzU=-flat-ContainerOperationProvider.cs,184,186,2,416,418,2
30,https://htmlpreview.github.io/?https://github.com/Christina96/boilerplate-sample-matches/blob/main/Csharp/dotween-MDEwOlJlcG9zaXRvcnkzMjQ3NTE2Mg==-flat-DOTweenModuleUI_135.cs-dotween-MDEwOlJlcG9zaXRvcnkzMjQ3NTE2Mg==-flat-DOTweenModuleUI.cs.html,567,dotween-MDEwOlJlcG9zaXRvcnkzMjQ3NTE2Mg==-flat-DOTweenModuleUI_135.cs,dotween-MDEwOlJlcG9zaXRvcnkzMjQ3NTE2Mg==-flat-DOTweenModuleUI.cs,315,390,75,315,390,75
31,https://htmlpreview.github.io/?https://github.com/Christina96/boilerplate-sample-matches/blob/main/Csharp/dotween-MDEwOlJlcG9zaXRvcnkzMjQ3NTE2Mg==-flat-OnDestroyIssue.cs-dotween-MDEwOlJlcG9zaXRvcnkzMjQ3NTE2Mg==-flat-OnDestroyIssue.cs.html,18,dotween-MDEwOlJlcG9zaXRvcnkzMjQ3NTE2Mg==-flat-OnDestroyIssue.cs,dotween-MDEwOlJlcG9zaXRvcnkzMjQ3NTE2Mg==-flat-OnDestroyIssue.cs,20,23,3,32,35,3
32,https://htmlpreview.github.io/?https://github.com/Christina96/boilerplate-sample-matches/blob/main/Csharp/MudBlazor-MDEwOlJlcG9zaXRvcnkyODg0Mjg2NzY=-flat-NugetApiClient.cs-MudBlazor-MDEwOlJlcG9zaXRvcnkyODg0Mjg2NzY=-flat-NugetApiClient.cs.html,26,MudBlazor-MDEwOlJlcG9zaXRvcnkyODg0Mjg2NzY=-flat-NugetApiClient.cs,MudBlazor-MDEwOlJlcG9zaXRvcnkyODg0Mjg2NzY=-flat-NugetApiClient.cs,20,25,5,20,25,5
33,https://htmlpreview.github.io/?https://github.com/Christina96/boilerplate-sample-matches/blob/main/Csharp/npgsql-MDEwOlJlcG9zaXRvcnkyODgzNTc0-flat-CommonLogicalReplicationTests.cs-npgsql-MDEwOlJlcG9zaXRvcnkyODgzNTc0-flat-CommonReplicationTests.cs.html,15,npgsql-MDEwOlJlcG9zaXRvcnkyODgzNTc0-flat-CommonLogicalReplicationTests.cs,npgsql-MDEwOlJlcG9zaXRvcnkyODgzNTc0-flat-CommonReplicationTests.cs,229,231,2,113,115,2
34,https://htmlpreview.github.io/?https://github.com/Christina96/boilerplate-sample-matches/blob/main/Csharp/runner-MDEwOlJlcG9zaXRvcnkxODQyODY4NzU=-flat-VssCredentials.cs-runner-MDEwOlJlcG9zaXRvcnkxODQyODY4NzU=-flat-VssCredentials.cs.html,12,runner-MDEwOlJlcG9zaXRvcnkxODQyODY4NzU=-flat-VssCredentials.cs,runner-MDEwOlJlcG9zaXRvcnkxODQyODY4NzU=-flat-VssCredentials.cs,123,125,2,123,125,2
35,https://htmlpreview.github.io/?https://github.com/Christina96/boilerplate-sample-matches/blob/main/Csharp/dotween-MDEwOlJlcG9zaXRvcnkzMjQ3NTE2Mg==-flat-AbstractGoTweenCollection.cs-dotween-MDEwOlJlcG9zaXRvcnkzMjQ3NTE2Mg==-flat-AbstractGoTweenCollection.cs.html,784,dotween-MDEwOlJlcG9zaXRvcnkzMjQ3NTE2Mg==-flat-AbstractGoTweenCollection.cs,dotween-MDEwOlJlcG9zaXRvcnkzMjQ3NTE2Mg==-flat-AbstractGoTweenCollection.cs,177,322,145,177,322,145
36,https://htmlpreview.github.io/?https://github.com/Christina96/boilerplate-sample-matches/blob/main/Csharp/runner-MDEwOlJlcG9zaXRvcnkxODQyODY4NzU=-flat-PipelineContextData.cs-runner-MDEwOlJlcG9zaXRvcnkxODQyODY4NzU=-flat-IssuedTokenCredential.cs.html,12,runner-MDEwOlJlcG9zaXRvcnkxODQyODY4NzU=-flat-PipelineContextData.cs,runner-MDEwOlJlcG9zaXRvcnkxODQyODY4NzU=-flat-IssuedTokenCredential.cs,13,17,4,7,11,4
37,https://htmlpreview.github.io/?https://github.com/Christina96/boilerplate-sample-matches/blob/main/Csharp/Simple.Data-MDEwOlJlcG9zaXRvcnk4MTg3Njg=-flat-Adapter.cs-Simple.Data-MDEwOlJlcG9zaXRvcnk4MTg3Njg=-flat-Adapter.cs.html,14,Simple.Data-MDEwOlJlcG9zaXRvcnk4MTg3Njg=-flat-Adapter.cs,Simple.Data-MDEwOlJlcG9zaXRvcnk4MTg3Njg=-flat-Adapter.cs,245,248,3,226,229,3
38,https://htmlpreview.github.io/?https://github.com/Christina96/boilerplate-sample-matches/blob/main/Csharp/npgsql-MDEwOlJlcG9zaXRvcnkyODgzNTc0-flat-ReaderTests.cs-npgsql-MDEwOlJlcG9zaXRvcnkyODgzNTc0-flat-ReaderTests.cs.html,24,npgsql-MDEwOlJlcG9zaXRvcnkyODgzNTc0-flat-ReaderTests.cs,npgsql-MDEwOlJlcG9zaXRvcnkyODgzNTc0-flat-ReaderTests.cs,494,496,2,1225,1227,2
39,https://htmlpreview.github.io/?https://github.com/Christina96/boilerplate-sample-matches/blob/main/Csharp/ZXing.Net.Mobile-MDEwOlJlcG9zaXRvcnk2MTYwNjcz-flat-ZXingScannerPage.shared.cs-ZXing.Net.Mobile-MDEwOlJlcG9zaXRvcnk2MTYwNjcz-flat-ZXingBarcodeImageView.shared.cs.html,20,ZXing.Net.Mobile-MDEwOlJlcG9zaXRvcnk2MTYwNjcz-flat-ZXingScannerPage.shared.cs,ZXing.Net.Mobile-MDEwOlJlcG9zaXRvcnk2MTYwNjcz-flat-ZXingBarcodeImageView.shared.cs,138,141,3,16,19,3
40,https://htmlpreview.github.io/?https://github.com/Christina96/boilerplate-sample-matches/blob/main/Csharp/MudBlazor-MDEwOlJlcG9zaXRvcnkyODg0Mjg2NzY=-flat-AmericanStatesController_16.cs-MudBlazor-MDEwOlJlcG9zaXRvcnkyODg0Mjg2NzY=-flat-AmericanStatesController_16.cs.html,40,MudBlazor-MDEwOlJlcG9zaXRvcnkyODg0Mjg2NzY=-flat-AmericanStatesController_16.cs,MudBlazor-MDEwOlJlcG9zaXRvcnkyODg0Mjg2NzY=-flat-AmericanStatesController_16.cs,12,21,9,12,21,9
41,https://htmlpreview.github.io/?https://github.com/Christina96/boilerplate-sample-matches/blob/main/Csharp/runner-MDEwOlJlcG9zaXRvcnkxODQyODY4NzU=-flat-SelfUpdaterL0.cs-runner-MDEwOlJlcG9zaXRvcnkxODQyODY4NzU=-flat-SelfUpdaterL0.cs.html,13,runner-MDEwOlJlcG9zaXRvcnkxODQyODY4NzU=-flat-SelfUpdaterL0.cs,runner-MDEwOlJlcG9zaXRvcnkxODQyODY4NzU=-flat-SelfUpdaterL0.cs,450,451,1,686,687,1
42,https://htmlpreview.github.io/?https://github.com/Christina96/boilerplate-sample-matches/blob/main/Csharp/Simple.Data-MDEwOlJlcG9zaXRvcnk4MTg3Njg=-flat-FunctionReference.cs-Simple.Data-MDEwOlJlcG9zaXRvcnk4MTg3Njg=-flat-MathReference.cs.html,14,Simple.Data-MDEwOlJlcG9zaXRvcnk4MTg3Njg=-flat-FunctionReference.cs,Simple.Data-MDEwOlJlcG9zaXRvcnk4MTg3Njg=-flat-MathReference.cs,65,67,2,89,91,2
43,https://htmlpreview.github.io/?https://github.com/Christina96/boilerplate-sample-matches/blob/main/Csharp/dotween-MDEwOlJlcG9zaXRvcnkzMjQ3NTE2Mg==-flat-GoSplineCatmullRomSolver.cs-dotween-MDEwOlJlcG9zaXRvcnkzMjQ3NTE2Mg==-flat-GoSplineCatmullRomSolver.cs.html,340,dotween-MDEwOlJlcG9zaXRvcnkzMjQ3NTE2Mg==-flat-GoSplineCatmullRomSolver.cs,dotween-MDEwOlJlcG9zaXRvcnkzMjQ3NTE2Mg==-flat-GoSplineCatmullRomSolver.cs,20,54,34,20,54,34
44,https://htmlpreview.github.io/?https://github.com/Christina96/boilerplate-sample-matches/blob/main/Csharp/EarTrumpet-MDEwOlJlcG9zaXRvcnkzODkxOTcwMg==-flat-IAppItemViewModel.cs-EarTrumpet-MDEwOlJlcG9zaXRvcnkzODkxOTcwMg==-flat-IAudioDeviceSessionInternal.cs.html,15,EarTrumpet-MDEwOlJlcG9zaXRvcnkzODkxOTcwMg==-flat-IAppItemViewModel.cs,EarTrumpet-MDEwOlJlcG9zaXRvcnkzODkxOTcwMg==-flat-IAudioDeviceSessionInternal.cs,25,27,2,10,12,2
45,https://htmlpreview.github.io/?https://github.com/Christina96/boilerplate-sample-matches/blob/main/Csharp/runner-MDEwOlJlcG9zaXRvcnkxODQyODY4NzU=-flat-ActionRunner.cs-Security-MDEwOlJlcG9zaXRvcnkxNzcyMzY5OQ==-flat-JwtBearerHandler.cs.html,19,runner-MDEwOlJlcG9zaXRvcnkxODQyODY4NzU=-flat-ActionRunner.cs,Security-MDEwOlJlcG9zaXRvcnkxNzcyMzY5OQ==-flat-JwtBearerHandler.cs,172,175,3,219,222,3
46,https://htmlpreview.github.io/?https://github.com/Christina96/boilerplate-sample-matches/blob/main/Csharp/Security-MDEwOlJlcG9zaXRvcnkxNzcyMzY5OQ==-flat-TestExtensions_0.cs-Security-MDEwOlJlcG9zaXRvcnkxNzcyMzY5OQ==-flat-TestExtensions_0.cs.html,139,Security-MDEwOlJlcG9zaXRvcnkxNzcyMzY5OQ==-flat-TestExtensions_0.cs,Security-MDEwOlJlcG9zaXRvcnkxNzcyMzY5OQ==-flat-TestExtensions_0.cs,39,59,20,39,59,20
47,https://htmlpreview.github.io/?https://github.com/Christina96/boilerplate-sample-matches/blob/main/Csharp/runner-MDEwOlJlcG9zaXRvcnkxODQyODY4NzU=-flat-ActionManagerL0.cs-runner-MDEwOlJlcG9zaXRvcnkxODQyODY4NzU=-flat-ActionManagerL0.cs.html,19,runner-MDEwOlJlcG9zaXRvcnkxODQyODY4NzU=-flat-ActionManagerL0.cs,runner-MDEwOlJlcG9zaXRvcnkxODQyODY4NzU=-flat-ActionManagerL0.cs,347,348,1,278,279,1
48,https://htmlpreview.github.io/?https://github.com/Christina96/boilerplate-sample-matches/blob/main/Csharp/runner-MDEwOlJlcG9zaXRvcnkxODQyODY4NzU=-flat-TypeExtensionMethods.cs-runner-MDEwOlJlcG9zaXRvcnkxODQyODY4NzU=-flat-TypeExtensionMethods.cs.html,30,runner-MDEwOlJlcG9zaXRvcnkxODQyODY4NzU=-flat-TypeExtensionMethods.cs,runner-MDEwOlJlcG9zaXRvcnkxODQyODY4NzU=-flat-TypeExtensionMethods.cs,183,188,5,183,188,5
49,https://htmlpreview.github.io/?https://github.com/Christina96/boilerplate-sample-matches/blob/main/Csharp/runner-MDEwOlJlcG9zaXRvcnkxODQyODY4NzU=-flat-ContainerOperationProvider.cs-runner-MDEwOlJlcG9zaXRvcnkxODQyODY4NzU=-flat-ContainerOperationProvider.cs.html,40,runner-MDEwOlJlcG9zaXRvcnkxODQyODY4NzU=-flat-ContainerOperationProvider.cs,runner-MDEwOlJlcG9zaXRvcnkxODQyODY4NzU=-flat-ContainerOperationProvider.cs,292,299,7,285,292,7
50,https://htmlpreview.github.io/?https://github.com/Christina96/boilerplate-sample-matches/blob/main/Csharp/dotween-MDEwOlJlcG9zaXRvcnkzMjQ3NTE2Mg==-flat-LeanTween.cs-dotween-MDEwOlJlcG9zaXRvcnkzMjQ3NTE2Mg==-flat-LeanTween.cs.html,36,dotween-MDEwOlJlcG9zaXRvcnkzMjQ3NTE2Mg==-flat-LeanTween.cs,dotween-MDEwOlJlcG9zaXRvcnkzMjQ3NTE2Mg==-flat-LeanTween.cs,807,811,4,807,811,4
51,https://htmlpreview.github.io/?https://github.com/Christina96/boilerplate-sample-matches/blob/main/Csharp/dotween-MDEwOlJlcG9zaXRvcnkzMjQ3NTE2Mg==-flat-ShortcutExtensions43.cs-dotween-MDEwOlJlcG9zaXRvcnkzMjQ3NTE2Mg==-flat-ShortcutExtensions43.cs.html,54,dotween-MDEwOlJlcG9zaXRvcnkzMjQ3NTE2Mg==-flat-ShortcutExtensions43.cs,dotween-MDEwOlJlcG9zaXRvcnkzMjQ3NTE2Mg==-flat-ShortcutExtensions43.cs,34,40,6,16,22,6
52,https://htmlpreview.github.io/?https://github.com/Christina96/boilerplate-sample-matches/blob/main/Csharp/dotween-MDEwOlJlcG9zaXRvcnkzMjQ3NTE2Mg==-flat-MaterialColorTweenProperty.cs-dotween-MDEwOlJlcG9zaXRvcnkzMjQ3NTE2Mg==-flat-EulerAnglesTweenProperty_90.cs.html,14,dotween-MDEwOlJlcG9zaXRvcnkzMjQ3NTE2Mg==-flat-MaterialColorTweenProperty.cs,dotween-MDEwOlJlcG9zaXRvcnkzMjQ3NTE2Mg==-flat-EulerAnglesTweenProperty_90.cs,18,19,1,19,20,1
53,https://htmlpreview.github.io/?https://github.com/Christina96/boilerplate-sample-matches/blob/main/Csharp/dotween-MDEwOlJlcG9zaXRvcnkzMjQ3NTE2Mg==-flat-LeanTween.cs-dotween-MDEwOlJlcG9zaXRvcnkzMjQ3NTE2Mg==-flat-LeanTween.cs.html,14,dotween-MDEwOlJlcG9zaXRvcnkzMjQ3NTE2Mg==-flat-LeanTween.cs,dotween-MDEwOlJlcG9zaXRvcnkzMjQ3NTE2Mg==-flat-LeanTween.cs,305,306,1,305,306,1
54,https://htmlpreview.github.io/?https://github.com/Christina96/boilerplate-sample-matches/blob/main/Csharp/MudBlazor-MDEwOlJlcG9zaXRvcnkyODg0Mjg2NzY=-flat-SortingAssistentTests.cs-MudBlazor-MDEwOlJlcG9zaXRvcnkyODg0Mjg2NzY=-flat-SortingAssistentTests.cs.html,90,MudBlazor-MDEwOlJlcG9zaXRvcnkyODg0Mjg2NzY=-flat-SortingAssistentTests.cs,MudBlazor-MDEwOlJlcG9zaXRvcnkyODg0Mjg2NzY=-flat-SortingAssistentTests.cs,47,53,6,37,43,6
55,https://htmlpreview.github.io/?https://github.com/Christina96/boilerplate-sample-matches/blob/main/Csharp/npgsql-MDEwOlJlcG9zaXRvcnkyODgzNTc0-flat-ConnectionTests.cs-npgsql-MDEwOlJlcG9zaXRvcnkyODgzNTc0-flat-ConnectionTests.cs.html,19,npgsql-MDEwOlJlcG9zaXRvcnkyODgzNTc0-flat-ConnectionTests.cs,npgsql-MDEwOlJlcG9zaXRvcnkyODgzNTc0-flat-ConnectionTests.cs,765,768,3,765,768,3
56,https://htmlpreview.github.io/?https://github.com/Christina96/boilerplate-sample-matches/blob/main/Csharp/MudBlazor-MDEwOlJlcG9zaXRvcnkyODg0Mjg2NzY=-flat-IconsPage.razor.cs-MudBlazor-MDEwOlJlcG9zaXRvcnkyODg0Mjg2NzY=-flat-IconsPage.razor.cs.html,13,MudBlazor-MDEwOlJlcG9zaXRvcnkyODg0Mjg2NzY=-flat-IconsPage.razor.cs,MudBlazor-MDEwOlJlcG9zaXRvcnkyODg0Mjg2NzY=-flat-IconsPage.razor.cs,80,84,4,80,84,4
57,https://htmlpreview.github.io/?https://github.com/Christina96/boilerplate-sample-matches/blob/main/Csharp/dotween-MDEwOlJlcG9zaXRvcnkzMjQ3NTE2Mg==-flat-Go.cs-dotween-MDEwOlJlcG9zaXRvcnkzMjQ3NTE2Mg==-flat-Go.cs.html,1186,dotween-MDEwOlJlcG9zaXRvcnkzMjQ3NTE2Mg==-flat-Go.cs,dotween-MDEwOlJlcG9zaXRvcnkzMjQ3NTE2Mg==-flat-Go.cs,25,246,221,25,246,221
58,https://htmlpreview.github.io/?https://github.com/Christina96/boilerplate-sample-matches/blob/main/Csharp/runner-MDEwOlJlcG9zaXRvcnkxODQyODY4NzU=-flat-VssHttpClientBase.cs-runner-MDEwOlJlcG9zaXRvcnkxODQyODY4NzU=-flat-TaskAgentHttpClient.cs.html,14,runner-MDEwOlJlcG9zaXRvcnkxODQyODY4NzU=-flat-VssHttpClientBase.cs,runner-MDEwOlJlcG9zaXRvcnkxODQyODY4NzU=-flat-TaskAgentHttpClient.cs,204,207,3,61,64,3
59,https://htmlpreview.github.io/?https://github.com/Christina96/boilerplate-sample-matches/blob/main/Csharp/runner-MDEwOlJlcG9zaXRvcnkxODQyODY4NzU=-flat-PagingLoggerL0.cs-runner-MDEwOlJlcG9zaXRvcnkxODQyODY4NzU=-flat-SelfUpdaterL0.cs.html,12,runner-MDEwOlJlcG9zaXRvcnkxODQyODY4NzU=-flat-PagingLoggerL0.cs,runner-MDEwOlJlcG9zaXRvcnkxODQyODY4NzU=-flat-SelfUpdaterL0.cs,39,40,1,241,242,1
60,https://htmlpreview.github.io/?https://github.com/Christina96/boilerplate-sample-matches/blob/main/Csharp/runner-MDEwOlJlcG9zaXRvcnkxODQyODY4NzU=-flat-ProcessInvoker_16.cs-runner-MDEwOlJlcG9zaXRvcnkxODQyODY4NzU=-flat-ProcessExtensions.cs.html,12,runner-MDEwOlJlcG9zaXRvcnkxODQyODY4NzU=-flat-ProcessInvoker_16.cs,runner-MDEwOlJlcG9zaXRvcnkxODQyODY4NzU=-flat-ProcessExtensions.cs,680,683,3,212,215,3
61,https://htmlpreview.github.io/?https://github.com/Christina96/boilerplate-sample-matches/blob/main/Csharp/runner-MDEwOlJlcG9zaXRvcnkxODQyODY4NzU=-flat-TemplateSchema.cs-runner-MDEwOlJlcG9zaXRvcnkxODQyODY4NzU=-flat-TemplateSchema.cs.html,16,runner-MDEwOlJlcG9zaXRvcnkxODQyODY4NzU=-flat-TemplateSchema.cs,runner-MDEwOlJlcG9zaXRvcnkxODQyODY4NzU=-flat-TemplateSchema.cs,162,166,4,162,166,4
62,https://htmlpreview.github.io/?https://github.com/Christina96/boilerplate-sample-matches/blob/main/Csharp/runner-MDEwOlJlcG9zaXRvcnkxODQyODY4NzU=-flat-IdentityDescriptor.cs-MudBlazor-MDEwOlJlcG9zaXRvcnkyODg0Mjg2NzY=-flat-MudBaseDatePicker.razor.cs.html,13,runner-MDEwOlJlcG9zaXRvcnkxODQyODY4NzU=-flat-IdentityDescriptor.cs,MudBlazor-MDEwOlJlcG9zaXRvcnkyODg0Mjg2NzY=-flat-MudBaseDatePicker.razor.cs,175,177,2,163,165,2
63,https://htmlpreview.github.io/?https://github.com/Christina96/boilerplate-sample-matches/blob/main/Csharp/dotween-MDEwOlJlcG9zaXRvcnkzMjQ3NTE2Mg==-flat-Strings_25.cs-dotween-MDEwOlJlcG9zaXRvcnkzMjQ3NTE2Mg==-flat-Strings_25.cs.html,538,dotween-MDEwOlJlcG9zaXRvcnkzMjQ3NTE2Mg==-flat-Strings_25.cs,dotween-MDEwOlJlcG9zaXRvcnkzMjQ3NTE2Mg==-flat-Strings_25.cs,11,52,41,11,52,41
64,https://htmlpreview.github.io/?https://github.com/Christina96/boilerplate-sample-matches/blob/main/Csharp/Security-MDEwOlJlcG9zaXRvcnkxNzcyMzY5OQ==-flat-WsFederationTest.cs-Security-MDEwOlJlcG9zaXRvcnkxNzcyMzY5OQ==-flat-AuthenticationMiddlewareTests.cs.html,12,Security-MDEwOlJlcG9zaXRvcnkxNzcyMzY5OQ==-flat-WsFederationTest.cs,Security-MDEwOlJlcG9zaXRvcnkxNzcyMzY5OQ==-flat-AuthenticationMiddlewareTests.cs,173,175,2,26,28,2
65,https://htmlpreview.github.io/?https://github.com/Christina96/boilerplate-sample-matches/blob/main/Csharp/npgsql-MDEwOlJlcG9zaXRvcnkyODgzNTc0-flat-BuiltInTypeMappingResolver.cs-npgsql-MDEwOlJlcG9zaXRvcnkyODgzNTc0-flat-FullTextSearchTypeMappingResolver.cs.html,25,npgsql-MDEwOlJlcG9zaXRvcnkyODgzNTc0-flat-BuiltInTypeMappingResolver.cs,npgsql-MDEwOlJlcG9zaXRvcnkyODgzNTc0-flat-FullTextSearchTypeMappingResolver.cs,165,167,2,32,34,2
66,https://htmlpreview.github.io/?https://github.com/Christina96/boilerplate-sample-matches/blob/main/Csharp/NetCoreServer-MDEwOlJlcG9zaXRvcnkxNjYxMjMxNjQ=-flat-HttpResponse.cs-NetCoreServer-MDEwOlJlcG9zaXRvcnkxNjYxMjMxNjQ=-flat-HttpRequest.cs.html,18,NetCoreServer-MDEwOlJlcG9zaXRvcnkxNjYxMjMxNjQ=-flat-HttpResponse.cs,NetCoreServer-MDEwOlJlcG9zaXRvcnkxNjYxMjMxNjQ=-flat-HttpRequest.cs,257,259,2,94,96,2
67,https://htmlpreview.github.io/?https://github.com/Christina96/boilerplate-sample-matches/blob/main/Csharp/dotween-MDEwOlJlcG9zaXRvcnkzMjQ3NTE2Mg==-flat-Color2Plugin.cs-dotween-MDEwOlJlcG9zaXRvcnkzMjQ3NTE2Mg==-flat-QuaternionPlugin.cs.html,36,dotween-MDEwOlJlcG9zaXRvcnkzMjQ3NTE2Mg==-flat-Color2Plugin.cs,dotween-MDEwOlJlcG9zaXRvcnkzMjQ3NTE2Mg==-flat-QuaternionPlugin.cs,12,15,3,13,16,3
68,https://htmlpreview.github.io/?https://github.com/Christina96/boilerplate-sample-matches/blob/main/Csharp/runner-MDEwOlJlcG9zaXRvcnkxODQyODY4NzU=-flat-TemplateEvaluator.cs-runner-MDEwOlJlcG9zaXRvcnkxODQyODY4NzU=-flat-TemplateEvaluator.cs.html,32,runner-MDEwOlJlcG9zaXRvcnkxODQyODY4NzU=-flat-TemplateEvaluator.cs,runner-MDEwOlJlcG9zaXRvcnkxODQyODY4NzU=-flat-TemplateEvaluator.cs,284,293,9,284,293,9
69,https://htmlpreview.github.io/?https://github.com/Christina96/boilerplate-sample-matches/blob/main/Csharp/runner-MDEwOlJlcG9zaXRvcnkxODQyODY4NzU=-flat-JobExtensionRunner.cs-dotween-MDEwOlJlcG9zaXRvcnkzMjQ3NTE2Mg==-flat-FloatPlugin.cs.html,18,runner-MDEwOlJlcG9zaXRvcnkxODQyODY4NzU=-flat-JobExtensionRunner.cs,dotween-MDEwOlJlcG9zaXRvcnkzMjQ3NTE2Mg==-flat-FloatPlugin.cs,3,5,2,5,7,2
70,https://htmlpreview.github.io/?https://github.com/Christina96/boilerplate-sample-matches/blob/main/Csharp/runner-MDEwOlJlcG9zaXRvcnkxODQyODY4NzU=-flat-VssHttpClientBase.cs-runner-MDEwOlJlcG9zaXRvcnkxODQyODY4NzU=-flat-RawConnection.cs.html,13,runner-MDEwOlJlcG9zaXRvcnkxODQyODY4NzU=-flat-VssHttpClientBase.cs,runner-MDEwOlJlcG9zaXRvcnkxODQyODY4NzU=-flat-RawConnection.cs,638,641,3,63,66,3
71,https://htmlpreview.github.io/?https://github.com/Christina96/boilerplate-sample-matches/blob/main/Csharp/runner-MDEwOlJlcG9zaXRvcnkxODQyODY4NzU=-flat-VssConnection.cs-runner-MDEwOlJlcG9zaXRvcnkxODQyODY4NzU=-flat-VssConnection.cs.html,16,runner-MDEwOlJlcG9zaXRvcnkxODQyODY4NzU=-flat-VssConnection.cs,runner-MDEwOlJlcG9zaXRvcnkxODQyODY4NzU=-flat-VssConnection.cs,337,346,9,337,346,9
72,https://htmlpreview.github.io/?https://github.com/Christina96/boilerplate-sample-matches/blob/main/Csharp/NetCoreServer-MDEwOlJlcG9zaXRvcnkxNjYxMjMxNjQ=-flat-TcpSession.cs-NetCoreServer-MDEwOlJlcG9zaXRvcnkxNjYxMjMxNjQ=-flat-TcpSession.cs.html,18,NetCoreServer-MDEwOlJlcG9zaXRvcnkxNjYxMjMxNjQ=-flat-TcpSession.cs,NetCoreServer-MDEwOlJlcG9zaXRvcnkxNjYxMjMxNjQ=-flat-TcpSession.cs,212,217,5,212,217,5
73,https://htmlpreview.github.io/?https://github.com/Christina96/boilerplate-sample-matches/blob/main/Csharp/ZXing.Net.Mobile-MDEwOlJlcG9zaXRvcnk2MTYwNjcz-flat-ZXingScannerViewRenderer.tizen.cs-ZXing.Net.Mobile-MDEwOlJlcG9zaXRvcnk2MTYwNjcz-flat-ZXingScannerViewRenderer.ios.cs.html,12,ZXing.Net.Mobile-MDEwOlJlcG9zaXRvcnk2MTYwNjcz-flat-ZXingScannerViewRenderer.tizen.cs,ZXing.Net.Mobile-MDEwOlJlcG9zaXRvcnk2MTYwNjcz-flat-ZXingScannerViewRenderer.ios.cs,37,40,3,35,38,3
74,https://htmlpreview.github.io/?https://github.com/Christina96/boilerplate-sample-matches/blob/main/Csharp/dotween-MDEwOlJlcG9zaXRvcnkzMjQ3NTE2Mg==-flat-DOTweenModuleUtils_133.cs-dotween-MDEwOlJlcG9zaXRvcnkzMjQ3NTE2Mg==-flat-DOTweenModuleUtils_133.cs.html,206,dotween-MDEwOlJlcG9zaXRvcnkzMjQ3NTE2Mg==-flat-DOTweenModuleUtils_133.cs,dotween-MDEwOlJlcG9zaXRvcnkzMjQ3NTE2Mg==-flat-DOTweenModuleUtils_133.cs,87,123,36,87,123,36
75,https://htmlpreview.github.io/?https://github.com/Christina96/boilerplate-sample-matches/blob/main/Csharp/NetCoreServer-MDEwOlJlcG9zaXRvcnkxNjYxMjMxNjQ=-flat-Program_11.cs-NetCoreServer-MDEwOlJlcG9zaXRvcnkxNjYxMjMxNjQ=-flat-Program_11.cs.html,57,NetCoreServer-MDEwOlJlcG9zaXRvcnkxNjYxMjMxNjQ=-flat-Program_11.cs,NetCoreServer-MDEwOlJlcG9zaXRvcnkxNjYxMjMxNjQ=-flat-Program_11.cs,107,114,7,107,114,7
76,https://htmlpreview.github.io/?https://github.com/Christina96/boilerplate-sample-matches/blob/main/Csharp/MudBlazor-MDEwOlJlcG9zaXRvcnkyODg0Mjg2NzY=-flat-StringExtensionTests.cs-MudBlazor-MDEwOlJlcG9zaXRvcnkyODg0Mjg2NzY=-flat-StringExtensionTests.cs.html,168,MudBlazor-MDEwOlJlcG9zaXRvcnkyODg0Mjg2NzY=-flat-StringExtensionTests.cs,MudBlazor-MDEwOlJlcG9zaXRvcnkyODg0Mjg2NzY=-flat-StringExtensionTests.cs,12,23,11,27,38,11
77,https://htmlpreview.github.io/?https://github.com/Christina96/boilerplate-sample-matches/blob/main/Csharp/npgsql-MDEwOlJlcG9zaXRvcnkyODgzNTc0-flat-NpgsqlParameterCollection.cs-npgsql-MDEwOlJlcG9zaXRvcnkyODgzNTc0-flat-NpgsqlParameterCollection.cs.html,16,npgsql-MDEwOlJlcG9zaXRvcnkyODgzNTc0-flat-NpgsqlParameterCollection.cs,npgsql-MDEwOlJlcG9zaXRvcnkyODgzNTc0-flat-NpgsqlParameterCollection.cs,53,57,4,53,57,4
78,https://htmlpreview.github.io/?https://github.com/Christina96/boilerplate-sample-matches/blob/main/Csharp/MudBlazor-MDEwOlJlcG9zaXRvcnkyODg0Mjg2NzY=-flat-LanguageResource.Designer.cs-EarTrumpet-MDEwOlJlcG9zaXRvcnkzODkxOTcwMg==-flat-Resources.Designer.cs.html,692,MudBlazor-MDEwOlJlcG9zaXRvcnkyODg0Mjg2NzY=-flat-LanguageResource.Designer.cs,EarTrumpet-MDEwOlJlcG9zaXRvcnkzODkxOTcwMg==-flat-Resources.Designer.cs,27,211,184,27,211,184
79,https://htmlpreview.github.io/?https://github.com/Christina96/boilerplate-sample-matches/blob/main/Csharp/dotween-MDEwOlJlcG9zaXRvcnkzMjQ3NTE2Mg==-flat-SequenceEase_21.cs-dotween-MDEwOlJlcG9zaXRvcnkzMjQ3NTE2Mg==-flat-SequenceEase.cs.html,138,dotween-MDEwOlJlcG9zaXRvcnkzMjQ3NTE2Mg==-flat-SequenceEase_21.cs,dotween-MDEwOlJlcG9zaXRvcnkzMjQ3NTE2Mg==-flat-SequenceEase.cs,10,20,10,10,20,10
80,https://htmlpreview.github.io/?https://github.com/Christina96/boilerplate-sample-matches/blob/main/Csharp/ZXing.Net.Mobile-MDEwOlJlcG9zaXRvcnk2MTYwNjcz-flat-AssemblyInfo_9.cs-EarTrumpet-MDEwOlJlcG9zaXRvcnkzODkxOTcwMg==-flat-AssemblyInfo_6.cs.html,29,ZXing.Net.Mobile-MDEwOlJlcG9zaXRvcnk2MTYwNjcz-flat-AssemblyInfo_9.cs,EarTrumpet-MDEwOlJlcG9zaXRvcnkzODkxOTcwMg==-flat-AssemblyInfo_6.cs,4,8,4,2,6,4
81,https://htmlpreview.github.io/?https://github.com/Christina96/boilerplate-sample-matches/blob/main/Csharp/MudBlazor-MDEwOlJlcG9zaXRvcnkyODg0Mjg2NzY=-flat-LayoutService.cs-MudBlazor-MDEwOlJlcG9zaXRvcnkyODg0Mjg2NzY=-flat-LayoutService.cs.html,12,MudBlazor-MDEwOlJlcG9zaXRvcnkyODg0Mjg2NzY=-flat-LayoutService.cs,MudBlazor-MDEwOlJlcG9zaXRvcnkyODg0Mjg2NzY=-flat-LayoutService.cs,33,35,2,33,35,2
82,https://htmlpreview.github.io/?https://github.com/Christina96/boilerplate-sample-matches/blob/main/Csharp/dotween-MDEwOlJlcG9zaXRvcnkzMjQ3NTE2Mg==-flat-AbstractGoTweenCollection_99.cs-dotween-MDEwOlJlcG9zaXRvcnkzMjQ3NTE2Mg==-flat-AbstractGoTweenCollection.cs.html,1328,dotween-MDEwOlJlcG9zaXRvcnkzMjQ3NTE2Mg==-flat-AbstractGoTweenCollection_99.cs,dotween-MDEwOlJlcG9zaXRvcnkzMjQ3NTE2Mg==-flat-AbstractGoTweenCollection.cs,67,322,255,67,322,255
83,https://htmlpreview.github.io/?https://github.com/Christina96/boilerplate-sample-matches/blob/main/Csharp/MudBlazor-MDEwOlJlcG9zaXRvcnkyODg0Mjg2NzY=-flat-MockResizeListenerService.cs-MudBlazor-MDEwOlJlcG9zaXRvcnkyODg0Mjg2NzY=-flat-MockBreakpointService.cs.html,124,MudBlazor-MDEwOlJlcG9zaXRvcnkyODg0Mjg2NzY=-flat-MockResizeListenerService.cs,MudBlazor-MDEwOlJlcG9zaXRvcnkyODg0Mjg2NzY=-flat-MockBreakpointService.cs,18,45,27,12,39,27
84,https://htmlpreview.github.io/?https://github.com/Christina96/boilerplate-sample-matches/blob/main/Csharp/runner-MDEwOlJlcG9zaXRvcnkxODQyODY4NzU=-flat-ExpressionValue.cs-MudBlazor-MDEwOlJlcG9zaXRvcnkyODg0Mjg2NzY=-flat-ColorPickerTests.cs.html,13,runner-MDEwOlJlcG9zaXRvcnkxODQyODY4NzU=-flat-ExpressionValue.cs,MudBlazor-MDEwOlJlcG9zaXRvcnkyODg0Mjg2NzY=-flat-ColorPickerTests.cs,76,79,3,420,423,3
85,https://htmlpreview.github.io/?https://github.com/Christina96/boilerplate-sample-matches/blob/main/Csharp/MudBlazor-MDEwOlJlcG9zaXRvcnkyODg0Mjg2NzY=-flat-SwitchTests.cs-MudBlazor-MDEwOlJlcG9zaXRvcnkyODg0Mjg2NzY=-flat-FormTests.cs.html,14,MudBlazor-MDEwOlJlcG9zaXRvcnkyODg0Mjg2NzY=-flat-SwitchTests.cs,MudBlazor-MDEwOlJlcG9zaXRvcnkyODg0Mjg2NzY=-flat-FormTests.cs,19,20,1,1144,1145,1
86,https://htmlpreview.github.io/?https://github.com/Christina96/boilerplate-sample-matches/blob/main/Csharp/Simple.Data-MDEwOlJlcG9zaXRvcnk4MTg3Njg=-flat-TransactionRunner.cs-Simple.Data-MDEwOlJlcG9zaXRvcnk4MTg3Njg=-flat-TransactionRunner.cs.html,19,Simple.Data-MDEwOlJlcG9zaXRvcnk4MTg3Njg=-flat-TransactionRunner.cs,Simple.Data-MDEwOlJlcG9zaXRvcnk4MTg3Njg=-flat-TransactionRunner.cs,22,24,2,22,24,2
87,https://htmlpreview.github.io/?https://github.com/Christina96/boilerplate-sample-matches/blob/main/Csharp/MudBlazor-MDEwOlJlcG9zaXRvcnkyODg0Mjg2NzY=-flat-MudColor.cs-MudBlazor-MDEwOlJlcG9zaXRvcnkyODg0Mjg2NzY=-flat-MudColor.cs.html,22,MudBlazor-MDEwOlJlcG9zaXRvcnkyODg0Mjg2NzY=-flat-MudColor.cs,MudBlazor-MDEwOlJlcG9zaXRvcnkyODg0Mjg2NzY=-flat-MudColor.cs,79,81,2,80,82,2
88,https://htmlpreview.github.io/?https://github.com/Christina96/boilerplate-sample-matches/blob/main/Csharp/dotween-MDEwOlJlcG9zaXRvcnkzMjQ3NTE2Mg==-flat-iTween.cs-dotween-MDEwOlJlcG9zaXRvcnkzMjQ3NTE2Mg==-flat-iTween.cs.html,21,dotween-MDEwOlJlcG9zaXRvcnkzMjQ3NTE2Mg==-flat-iTween.cs,dotween-MDEwOlJlcG9zaXRvcnkzMjQ3NTE2Mg==-flat-iTween.cs,1089,1092,3,2047,2050,3
89,https://htmlpreview.github.io/?https://github.com/Christina96/boilerplate-sample-matches/blob/main/Csharp/runner-MDEwOlJlcG9zaXRvcnkxODQyODY4NzU=-flat-AgentJobRequestMessage.cs-runner-MDEwOlJlcG9zaXRvcnkxODQyODY4NzU=-flat-XmlUtility.cs.html,12,runner-MDEwOlJlcG9zaXRvcnkxODQyODY4NzU=-flat-AgentJobRequestMessage.cs,runner-MDEwOlJlcG9zaXRvcnkxODQyODY4NzU=-flat-XmlUtility.cs,37,40,3,656,659,3
90,https://htmlpreview.github.io/?https://github.com/Christina96/boilerplate-sample-matches/blob/main/Csharp/runner-MDEwOlJlcG9zaXRvcnkxODQyODY4NzU=-flat-ServiceDefinition.cs-runner-MDEwOlJlcG9zaXRvcnkxODQyODY4NzU=-flat-ServiceDefinition.cs.html,30,runner-MDEwOlJlcG9zaXRvcnkxODQyODY4NzU=-flat-ServiceDefinition.cs,runner-MDEwOlJlcG9zaXRvcnkxODQyODY4NzU=-flat-ServiceDefinition.cs,252,264,12,282,294,12
91,https://htmlpreview.github.io/?https://github.com/Christina96/boilerplate-sample-matches/blob/main/Csharp/dotween-MDEwOlJlcG9zaXRvcnkzMjQ3NTE2Mg==-flat-LeanTween.cs-dotween-MDEwOlJlcG9zaXRvcnkzMjQ3NTE2Mg==-flat-LeanTween_56.cs.html,647,dotween-MDEwOlJlcG9zaXRvcnkzMjQ3NTE2Mg==-flat-LeanTween.cs,dotween-MDEwOlJlcG9zaXRvcnkzMjQ3NTE2Mg==-flat-LeanTween_56.cs,723,811,88,723,811,88
92,https://htmlpreview.github.io/?https://github.com/Christina96/boilerplate-sample-matches/blob/main/Csharp/Simple.Data-MDEwOlJlcG9zaXRvcnk4MTg3Njg=-flat-SimpleResultSetTest.cs-Simple.Data-MDEwOlJlcG9zaXRvcnk4MTg3Njg=-flat-SimpleResultSetTest.cs.html,50,Simple.Data-MDEwOlJlcG9zaXRvcnk4MTg3Njg=-flat-SimpleResultSetTest.cs,Simple.Data-MDEwOlJlcG9zaXRvcnk4MTg3Njg=-flat-SimpleResultSetTest.cs,45,51,6,57,63,6
93,https://htmlpreview.github.io/?https://github.com/Christina96/boilerplate-sample-matches/blob/main/Csharp/dotween-MDEwOlJlcG9zaXRvcnkzMjQ3NTE2Mg==-flat-TweenParams.cs-dotween-MDEwOlJlcG9zaXRvcnkzMjQ3NTE2Mg==-flat-TweenParams.cs.html,20,dotween-MDEwOlJlcG9zaXRvcnkzMjQ3NTE2Mg==-flat-TweenParams.cs,dotween-MDEwOlJlcG9zaXRvcnkzMjQ3NTE2Mg==-flat-TweenParams.cs,116,121,5,63,68,5
94,https://htmlpreview.github.io/?https://github.com/Christina96/boilerplate-sample-matches/blob/main/Csharp/ZXing.Net.Mobile-MDEwOlJlcG9zaXRvcnk2MTYwNjcz-flat-ImagePage.xaml.cs-ZXing.Net.Mobile-MDEwOlJlcG9zaXRvcnk2MTYwNjcz-flat-MainPage.xaml_1.cs.html,18,ZXing.Net.Mobile-MDEwOlJlcG9zaXRvcnk2MTYwNjcz-flat-ImagePage.xaml.cs,ZXing.Net.Mobile-MDEwOlJlcG9zaXRvcnk2MTYwNjcz-flat-MainPage.xaml_1.cs,15,20,5,18,23,5
95,https://htmlpreview.github.io/?https://github.com/Christina96/boilerplate-sample-matches/blob/main/Csharp/npgsql-MDEwOlJlcG9zaXRvcnkyODgzNTc0-flat-CommonReplicationTests.cs-npgsql-MDEwOlJlcG9zaXRvcnkyODgzNTc0-flat-CommandTests.cs.html,17,npgsql-MDEwOlJlcG9zaXRvcnkyODgzNTc0-flat-CommonReplicationTests.cs,npgsql-MDEwOlJlcG9zaXRvcnkyODgzNTc0-flat-CommandTests.cs,107,110,3,663,666,3
96,https://htmlpreview.github.io/?https://github.com/Christina96/boilerplate-sample-matches/blob/main/Csharp/MudBlazor-MDEwOlJlcG9zaXRvcnkyODg0Mjg2NzY=-flat-SelectTests.cs-MudBlazor-MDEwOlJlcG9zaXRvcnkyODg0Mjg2NzY=-flat-SelectTests.cs.html,22,MudBlazor-MDEwOlJlcG9zaXRvcnkyODg0Mjg2NzY=-flat-SelectTests.cs,MudBlazor-MDEwOlJlcG9zaXRvcnkyODg0Mjg2NzY=-flat-SelectTests.cs,774,775,1,774,775,1
97,https://htmlpreview.github.io/?https://github.com/Christina96/boilerplate-sample-matches/blob/main/Csharp/MudBlazor-MDEwOlJlcG9zaXRvcnkyODg0Mjg2NzY=-flat-IPopoverObserver.cs-MudBlazor-MDEwOlJlcG9zaXRvcnkyODg0Mjg2NzY=-flat-IMudPopoverService.cs.html,13,MudBlazor-MDEwOlJlcG9zaXRvcnkyODg0Mjg2NzY=-flat-IPopoverObserver.cs,MudBlazor-MDEwOlJlcG9zaXRvcnkyODg0Mjg2NzY=-flat-IMudPopoverService.cs,2,5,3,4,7,3
98,https://htmlpreview.github.io/?https://github.com/Christina96/boilerplate-sample-matches/blob/main/Csharp/dotween-MDEwOlJlcG9zaXRvcnkzMjQ3NTE2Mg==-flat-TweenManager.cs-dotween-MDEwOlJlcG9zaXRvcnkzMjQ3NTE2Mg==-flat-EditorPreviewer.cs.html,14,dotween-MDEwOlJlcG9zaXRvcnkzMjQ3NTE2Mg==-flat-TweenManager.cs,dotween-MDEwOlJlcG9zaXRvcnkzMjQ3NTE2Mg==-flat-EditorPreviewer.cs,2,6,4,2,6,4
99,https://htmlpreview.github.io/?https://github.com/Christina96/boilerplate-sample-matches/blob/main/Csharp/npgsql-MDEwOlJlcG9zaXRvcnkyODgzNTc0-flat-DateHandler.cs-npgsql-MDEwOlJlcG9zaXRvcnkyODgzNTc0-flat-TidHandler.cs.html,18,npgsql-MDEwOlJlcG9zaXRvcnkyODgzNTc0-flat-DateHandler.cs,npgsql-MDEwOlJlcG9zaXRvcnkyODgzNTc0-flat-TidHandler.cs,33,35,2,21,23,2
100,https://htmlpreview.github.io/?https://github.com/Christina96/boilerplate-sample-matches/blob/main/Csharp/dotween-MDEwOlJlcG9zaXRvcnkzMjQ3NTE2Mg==-flat-TestScene.cs-dotween-MDEwOlJlcG9zaXRvcnkzMjQ3NTE2Mg==-flat-TestScene.cs.html,15,dotween-MDEwOlJlcG9zaXRvcnkzMjQ3NTE2Mg==-flat-TestScene.cs,dotween-MDEwOlJlcG9zaXRvcnkzMjQ3NTE2Mg==-flat-TestScene.cs,9,12,3,9,12,3
101,https://htmlpreview.github.io/?https://github.com/Christina96/boilerplate-sample-matches/blob/main/Csharp/20486D-DevelopingASPNETMVCWebApplications-MDEwOlJlcG9zaXRvcnkxMTkzNTI2Mzc=-flat-StoreController.cs-20486D-DevelopingASPNETMVCWebApplications-MDEwOlJlcG9zaXRvcnkxMTkzNTI2Mzc=-flat-StoreController_377.cs.html,51,20486D-DevelopingASPNETMVCWebApplications-MDEwOlJlcG9zaXRvcnkxMTkzNTI2Mzc=-flat-StoreController.cs,20486D-DevelopingASPNETMVCWebApplications-MDEwOlJlcG9zaXRvcnkxMTkzNTI2Mzc=-flat-StoreController_377.cs,15,19,4,15,19,4
102,https://htmlpreview.github.io/?https://github.com/Christina96/boilerplate-sample-matches/blob/main/Csharp/MudBlazor-MDEwOlJlcG9zaXRvcnkyODg0Mjg2NzY=-flat-BoundingClientRect.cs-MudBlazor-MDEwOlJlcG9zaXRvcnkyODg0Mjg2NzY=-flat-BoundingClientRect.cs.html,18,MudBlazor-MDEwOlJlcG9zaXRvcnkyODg0Mjg2NzY=-flat-BoundingClientRect.cs,MudBlazor-MDEwOlJlcG9zaXRvcnkyODg0Mjg2NzY=-flat-BoundingClientRect.cs,7,9,2,7,9,2
103,https://htmlpreview.github.io/?https://github.com/Christina96/boilerplate-sample-matches/blob/main/Csharp/Simple.Data-MDEwOlJlcG9zaXRvcnk4MTg3Njg=-flat-DatabaseSchema.cs-runner-MDEwOlJlcG9zaXRvcnkxODQyODY4NzU=-flat-IdentityDescriptor.cs.html,16,Simple.Data-MDEwOlJlcG9zaXRvcnk4MTg3Njg=-flat-DatabaseSchema.cs,runner-MDEwOlJlcG9zaXRvcnkxODQyODY4NzU=-flat-IdentityDescriptor.cs,126,128,2,405,407,2
104,https://htmlpreview.github.io/?https://github.com/Christina96/boilerplate-sample-matches/blob/main/Csharp/20486D-DevelopingASPNETMVCWebApplications-MDEwOlJlcG9zaXRvcnkxMTkzNTI2Mzc=-flat-Startup_44.cs-20486D-DevelopingASPNETMVCWebApplications-MDEwOlJlcG9zaXRvcnkxMTkzNTI2Mzc=-flat-Startup_454.cs.html,12,20486D-DevelopingASPNETMVCWebApplications-MDEwOlJlcG9zaXRvcnkxMTkzNTI2Mzc=-flat-Startup_44.cs,20486D-DevelopingASPNETMVCWebApplications-MDEwOlJlcG9zaXRvcnkxMTkzNTI2Mzc=-flat-Startup_454.cs,30,33,3,21,24,3
105,https://htmlpreview.github.io/?https://github.com/Christina96/boilerplate-sample-matches/blob/main/Csharp/EarTrumpet-MDEwOlJlcG9zaXRvcnkzODkxOTcwMg==-flat-PackageHelper.cs-runner-MDEwOlJlcG9zaXRvcnkxODQyODY4NzU=-flat-ActionManager.cs.html,14,EarTrumpet-MDEwOlJlcG9zaXRvcnkzODkxOTcwMg==-flat-PackageHelper.cs,runner-MDEwOlJlcG9zaXRvcnkxODQyODY4NzU=-flat-ActionManager.cs,52,54,2,839,841,2
106,https://htmlpreview.github.io/?https://github.com/Christina96/boilerplate-sample-matches/blob/main/Csharp/runner-MDEwOlJlcG9zaXRvcnkxODQyODY4NzU=-flat-IOUtil.cs-runner-MDEwOlJlcG9zaXRvcnkxODQyODY4NzU=-flat-ArgUtil.cs.html,12,runner-MDEwOlJlcG9zaXRvcnkxODQyODY4NzU=-flat-IOUtil.cs,runner-MDEwOlJlcG9zaXRvcnkxODQyODY4NzU=-flat-ArgUtil.cs,35,37,2,41,43,2
107,https://htmlpreview.github.io/?https://github.com/Christina96/boilerplate-sample-matches/blob/main/Csharp/runner-MDEwOlJlcG9zaXRvcnkxODQyODY4NzU=-flat-WrappedException.cs-runner-MDEwOlJlcG9zaXRvcnkxODQyODY4NzU=-flat-WrappedException.cs.html,15,runner-MDEwOlJlcG9zaXRvcnkxODQyODY4NzU=-flat-WrappedException.cs,runner-MDEwOlJlcG9zaXRvcnkxODQyODY4NzU=-flat-WrappedException.cs,131,139,8,137,145,8
108,https://htmlpreview.github.io/?https://github.com/Christina96/boilerplate-sample-matches/blob/main/Csharp/NetCoreServer-MDEwOlJlcG9zaXRvcnkxNjYxMjMxNjQ=-flat-HttpTests.cs-NetCoreServer-MDEwOlJlcG9zaXRvcnkxNjYxMjMxNjQ=-flat-HttpTests.cs.html,22,NetCoreServer-MDEwOlJlcG9zaXRvcnkxNjYxMjMxNjQ=-flat-HttpTests.cs,NetCoreServer-MDEwOlJlcG9zaXRvcnkxNjYxMjMxNjQ=-flat-HttpTests.cs,144,146,2,136,138,2
109,https://htmlpreview.github.io/?https://github.com/Christina96/boilerplate-sample-matches/blob/main/Csharp/dotween-MDEwOlJlcG9zaXRvcnkzMjQ3NTE2Mg==-flat-iTween_121.cs-dotween-MDEwOlJlcG9zaXRvcnkzMjQ3NTE2Mg==-flat-iTween_121.cs.html,1990,dotween-MDEwOlJlcG9zaXRvcnkzMjQ3NTE2Mg==-flat-iTween_121.cs,dotween-MDEwOlJlcG9zaXRvcnkzMjQ3NTE2Mg==-flat-iTween_121.cs,2125,2370,245,2125,2370,245
110,https://htmlpreview.github.io/?https://github.com/Christina96/boilerplate-sample-matches/blob/main/Csharp/dotween-MDEwOlJlcG9zaXRvcnkzMjQ3NTE2Mg==-flat-iTween_121.cs-dotween-MDEwOlJlcG9zaXRvcnkzMjQ3NTE2Mg==-flat-iTween.cs.html,4049,dotween-MDEwOlJlcG9zaXRvcnkzMjQ3NTE2Mg==-flat-iTween_121.cs,dotween-MDEwOlJlcG9zaXRvcnkzMjQ3NTE2Mg==-flat-iTween.cs,324,874,550,324,874,550
111,https://htmlpreview.github.io/?https://github.com/Christina96/boilerplate-sample-matches/blob/main/Csharp/dotween-MDEwOlJlcG9zaXRvcnkzMjQ3NTE2Mg==-flat-TweenDelegate.cs-dotween-MDEwOlJlcG9zaXRvcnkzMjQ3NTE2Mg==-flat-TweenDelegate_3.cs.html,29,dotween-MDEwOlJlcG9zaXRvcnkzMjQ3NTE2Mg==-flat-TweenDelegate.cs,dotween-MDEwOlJlcG9zaXRvcnkzMjQ3NTE2Mg==-flat-TweenDelegate_3.cs,26,34,8,26,34,8
112,https://htmlpreview.github.io/?https://github.com/Christina96/boilerplate-sample-matches/blob/main/Csharp/dotween-MDEwOlJlcG9zaXRvcnkzMjQ3NTE2Mg==-flat-iTween.cs-MudBlazor-MDEwOlJlcG9zaXRvcnkyODg0Mjg2NzY=-flat-MudListItem.razor.cs.html,13,dotween-MDEwOlJlcG9zaXRvcnkzMjQ3NTE2Mg==-flat-iTween.cs,MudBlazor-MDEwOlJlcG9zaXRvcnkyODg0Mjg2NzY=-flat-MudListItem.razor.cs,2951,2956,5,211,216,5
113,https://htmlpreview.github.io/?https://github.com/Christina96/boilerplate-sample-matches/blob/main/Csharp/runner-MDEwOlJlcG9zaXRvcnkxODQyODY4NzU=-flat-ActionStepDefinitionReferenceConverter.cs-runner-MDEwOlJlcG9zaXRvcnkxODQyODY4NzU=-flat-StepConverter.cs.html,190,runner-MDEwOlJlcG9zaXRvcnkxODQyODY4NzU=-flat-ActionStepDefinitionReferenceConverter.cs,runner-MDEwOlJlcG9zaXRvcnkxODQyODY4NzU=-flat-StepConverter.cs,8,49,41,8,49,41
114,https://htmlpreview.github.io/?https://github.com/Christina96/boilerplate-sample-matches/blob/main/Csharp/runner-MDEwOlJlcG9zaXRvcnkxODQyODY4NzU=-flat-TemplateToken.cs-runner-MDEwOlJlcG9zaXRvcnkxODQyODY4NzU=-flat-TemplateToken.cs.html,65,runner-MDEwOlJlcG9zaXRvcnkxODQyODY4NzU=-flat-TemplateToken.cs,runner-MDEwOlJlcG9zaXRvcnkxODQyODY4NzU=-flat-TemplateToken.cs,107,115,8,107,115,8
115,https://htmlpreview.github.io/?https://github.com/Christina96/boilerplate-sample-matches/blob/main/Csharp/runner-MDEwOlJlcG9zaXRvcnkxODQyODY4NzU=-flat-RunServer.cs-runner-MDEwOlJlcG9zaXRvcnkxODQyODY4NzU=-flat-BrokerServer.cs.html,12,runner-MDEwOlJlcG9zaXRvcnkxODQyODY4NzU=-flat-RunServer.cs,runner-MDEwOlJlcG9zaXRvcnkxODQyODY4NzU=-flat-BrokerServer.cs,40,41,1,30,31,1
116,https://htmlpreview.github.io/?https://github.com/Christina96/boilerplate-sample-matches/blob/main/Csharp/Security-MDEwOlJlcG9zaXRvcnkxNzcyMzY5OQ==-flat-CookieTests.cs-runner-MDEwOlJlcG9zaXRvcnkxODQyODY4NzU=-flat-CommandSettingsL0.cs.html,14,Security-MDEwOlJlcG9zaXRvcnkxNzcyMzY5OQ==-flat-CookieTests.cs,runner-MDEwOlJlcG9zaXRvcnkxODQyODY4NzU=-flat-CommandSettingsL0.cs,180,184,4,383,387,4
117,https://htmlpreview.github.io/?https://github.com/Christina96/boilerplate-sample-matches/blob/main/Csharp/runner-MDEwOlJlcG9zaXRvcnkxODQyODY4NzU=-flat-VssHttpClientBase.cs-runner-MDEwOlJlcG9zaXRvcnkxODQyODY4NzU=-flat-VssHttpClientBase.cs.html,13,runner-MDEwOlJlcG9zaXRvcnkxODQyODY4NzU=-flat-VssHttpClientBase.cs,runner-MDEwOlJlcG9zaXRvcnkxODQyODY4NzU=-flat-VssHttpClientBase.cs,758,759,1,758,759,1
118,https://htmlpreview.github.io/?https://github.com/Christina96/boilerplate-sample-matches/blob/main/Csharp/npgsql-MDEwOlJlcG9zaXRvcnkyODgzNTc0-flat-NpgsqlCommand.cs-npgsql-MDEwOlJlcG9zaXRvcnkyODgzNTc0-flat-NpgsqlCommand.cs.html,12,npgsql-MDEwOlJlcG9zaXRvcnkyODgzNTc0-flat-NpgsqlCommand.cs,npgsql-MDEwOlJlcG9zaXRvcnkyODgzNTc0-flat-NpgsqlCommand.cs,681,682,1,681,682,1
119,https://htmlpreview.github.io/?https://github.com/Christina96/boilerplate-sample-matches/blob/main/Csharp/npgsql-MDEwOlJlcG9zaXRvcnkyODgzNTc0-flat-ReadOnlySpanOfCharExtensions.cs-npgsql-MDEwOlJlcG9zaXRvcnkyODgzNTc0-flat-ReadOnlySpanOfCharExtensions.cs.html,14,npgsql-MDEwOlJlcG9zaXRvcnkyODgzNTc0-flat-ReadOnlySpanOfCharExtensions.cs,npgsql-MDEwOlJlcG9zaXRvcnkyODgzNTc0-flat-ReadOnlySpanOfCharExtensions.cs,4,8,4,4,8,4
120,https://htmlpreview.github.io/?https://github.com/Christina96/boilerplate-sample-matches/blob/main/Csharp/runner-MDEwOlJlcG9zaXRvcnkxODQyODY4NzU=-flat-TemplateReader.cs-runner-MDEwOlJlcG9zaXRvcnkxODQyODY4NzU=-flat-TemplateReader.cs.html,14,runner-MDEwOlJlcG9zaXRvcnkxODQyODY4NzU=-flat-TemplateReader.cs,runner-MDEwOlJlcG9zaXRvcnkxODQyODY4NzU=-flat-TemplateReader.cs,326,329,3,120,123,3
121,https://htmlpreview.github.io/?https://github.com/Christina96/boilerplate-sample-matches/blob/main/Csharp/runner-MDEwOlJlcG9zaXRvcnkxODQyODY4NzU=-flat-VssJsonMediaTypeFormatter.cs-runner-MDEwOlJlcG9zaXRvcnkxODQyODY4NzU=-flat-VssJsonMediaTypeFormatter.cs.html,18,runner-MDEwOlJlcG9zaXRvcnkxODQyODY4NzU=-flat-VssJsonMediaTypeFormatter.cs,runner-MDEwOlJlcG9zaXRvcnkxODQyODY4NzU=-flat-VssJsonMediaTypeFormatter.cs,105,107,2,105,107,2
122,https://htmlpreview.github.io/?https://github.com/Christina96/boilerplate-sample-matches/blob/main/Csharp/runner-MDEwOlJlcG9zaXRvcnkxODQyODY4NzU=-flat-VssHttpClientBase.cs-runner-MDEwOlJlcG9zaXRvcnkxODQyODY4NzU=-flat-VssHttpClientBase.cs.html,118,runner-MDEwOlJlcG9zaXRvcnkxODQyODY4NzU=-flat-VssHttpClientBase.cs,runner-MDEwOlJlcG9zaXRvcnkxODQyODY4NzU=-flat-VssHttpClientBase.cs,292,317,25,216,241,25
123,https://htmlpreview.github.io/?https://github.com/Christina96/boilerplate-sample-matches/blob/main/Csharp/Simple.Data-MDEwOlJlcG9zaXRvcnk4MTg3Njg=-flat-PropertySetterBuilder.cs-Simple.Data-MDEwOlJlcG9zaXRvcnk4MTg3Njg=-flat-PropertySetterBuilder.cs.html,13,Simple.Data-MDEwOlJlcG9zaXRvcnk4MTg3Njg=-flat-PropertySetterBuilder.cs,Simple.Data-MDEwOlJlcG9zaXRvcnk4MTg3Njg=-flat-PropertySetterBuilder.cs,150,151,1,150,151,1
124,https://htmlpreview.github.io/?https://github.com/Christina96/boilerplate-sample-matches/blob/main/Csharp/dotween-MDEwOlJlcG9zaXRvcnkzMjQ3NTE2Mg==-flat-iTween_121.cs-dotween-MDEwOlJlcG9zaXRvcnkzMjQ3NTE2Mg==-flat-iTween.cs.html,572,dotween-MDEwOlJlcG9zaXRvcnkzMjQ3NTE2Mg==-flat-iTween_121.cs,dotween-MDEwOlJlcG9zaXRvcnkzMjQ3NTE2Mg==-flat-iTween.cs,1901,1957,56,1901,1957,56
125,https://htmlpreview.github.io/?https://github.com/Christina96/boilerplate-sample-matches/blob/main/Csharp/npgsql-MDEwOlJlcG9zaXRvcnkyODgzNTc0-flat-PrepareTests.cs-npgsql-MDEwOlJlcG9zaXRvcnkyODgzNTc0-flat-PrepareTests.cs.html,25,npgsql-MDEwOlJlcG9zaXRvcnkyODgzNTc0-flat-PrepareTests.cs,npgsql-MDEwOlJlcG9zaXRvcnkyODgzNTc0-flat-PrepareTests.cs,166,172,6,166,172,6
126,https://htmlpreview.github.io/?https://github.com/Christina96/boilerplate-sample-matches/blob/main/Csharp/npgsql-MDEwOlJlcG9zaXRvcnkyODgzNTc0-flat-CopyMessages.cs-npgsql-MDEwOlJlcG9zaXRvcnkyODgzNTc0-flat-CopyMessages.cs.html,12,npgsql-MDEwOlJlcG9zaXRvcnkyODgzNTc0-flat-CopyMessages.cs,npgsql-MDEwOlJlcG9zaXRvcnkyODgzNTc0-flat-CopyMessages.cs,24,26,2,24,26,2
127,https://htmlpreview.github.io/?https://github.com/Christina96/boilerplate-sample-matches/blob/main/Csharp/Simple.Data-MDEwOlJlcG9zaXRvcnk4MTg3Njg=-flat-QueryTest.cs-runner-MDEwOlJlcG9zaXRvcnkxODQyODY4NzU=-flat-JobServerQueue.cs.html,13,Simple.Data-MDEwOlJlcG9zaXRvcnk4MTg3Njg=-flat-QueryTest.cs,runner-MDEwOlJlcG9zaXRvcnkxODQyODY4NzU=-flat-JobServerQueue.cs,86,89,3,285,288,3
128,https://htmlpreview.github.io/?https://github.com/Christina96/boilerplate-sample-matches/blob/main/Csharp/runner-MDEwOlJlcG9zaXRvcnkxODQyODY4NzU=-flat-FileContainerExceptions.cs-runner-MDEwOlJlcG9zaXRvcnkxODQyODY4NzU=-flat-FileContainerExceptions.cs.html,13,runner-MDEwOlJlcG9zaXRvcnkxODQyODY4NzU=-flat-FileContainerExceptions.cs,runner-MDEwOlJlcG9zaXRvcnkxODQyODY4NzU=-flat-FileContainerExceptions.cs,14,17,3,14,17,3
129,https://htmlpreview.github.io/?https://github.com/Christina96/boilerplate-sample-matches/blob/main/Csharp/npgsql-MDEwOlJlcG9zaXRvcnkyODgzNTc0-flat-BatchTests.cs-npgsql-MDEwOlJlcG9zaXRvcnkyODgzNTc0-flat-BatchTests.cs.html,15,npgsql-MDEwOlJlcG9zaXRvcnkyODgzNTc0-flat-BatchTests.cs,npgsql-MDEwOlJlcG9zaXRvcnkyODgzNTc0-flat-BatchTests.cs,7,9,2,7,9,2
130,https://htmlpreview.github.io/?https://github.com/Christina96/boilerplate-sample-matches/blob/main/Csharp/MudBlazor-MDEwOlJlcG9zaXRvcnkyODg0Mjg2NzY=-flat-AggregateDefinitionTests.cs-MudBlazor-MDEwOlJlcG9zaXRvcnkyODg0Mjg2NzY=-flat-AggregateDefinitionTests.cs.html,12,MudBlazor-MDEwOlJlcG9zaXRvcnkyODg0Mjg2NzY=-flat-AggregateDefinitionTests.cs,MudBlazor-MDEwOlJlcG9zaXRvcnkyODg0Mjg2NzY=-flat-AggregateDefinitionTests.cs,86,87,1,136,137,1
131,https://htmlpreview.github.io/?https://github.com/Christina96/boilerplate-sample-matches/blob/main/Csharp/NetCoreServer-MDEwOlJlcG9zaXRvcnkxNjYxMjMxNjQ=-flat-HttpClient.cs-NetCoreServer-MDEwOlJlcG9zaXRvcnkxNjYxMjMxNjQ=-flat-HttpClient.cs.html,324,NetCoreServer-MDEwOlJlcG9zaXRvcnkxNjYxMjMxNjQ=-flat-HttpClient.cs,NetCoreServer-MDEwOlJlcG9zaXRvcnkxNjYxMjMxNjQ=-flat-HttpClient.cs,23,72,49,23,72,49
132,https://htmlpreview.github.io/?https://github.com/Christina96/boilerplate-sample-matches/blob/main/Csharp/npgsql-MDEwOlJlcG9zaXRvcnkyODgzNTc0-flat-NpgsqlParameter.cs-Simple.Data-MDEwOlJlcG9zaXRvcnk4MTg3Njg=-flat-ProviderHelper.cs.html,12,npgsql-MDEwOlJlcG9zaXRvcnkyODgzNTc0-flat-NpgsqlParameter.cs,Simple.Data-MDEwOlJlcG9zaXRvcnk4MTg3Njg=-flat-ProviderHelper.cs,102,104,2,238,240,2
133,https://htmlpreview.github.io/?https://github.com/Christina96/boilerplate-sample-matches/blob/main/Csharp/runner-MDEwOlJlcG9zaXRvcnkxODQyODY4NzU=-flat-DictionaryContextData.cs-runner-MDEwOlJlcG9zaXRvcnkxODQyODY4NzU=-flat-DictionaryContextData.cs.html,169,runner-MDEwOlJlcG9zaXRvcnkxODQyODY4NzU=-flat-DictionaryContextData.cs,runner-MDEwOlJlcG9zaXRvcnkxODQyODY4NzU=-flat-DictionaryContextData.cs,214,258,44,214,258,44
134,https://htmlpreview.github.io/?https://github.com/Christina96/boilerplate-sample-matches/blob/main/Csharp/runner-MDEwOlJlcG9zaXRvcnkxODQyODY4NzU=-flat-ServiceInterfacesL0.cs-runner-MDEwOlJlcG9zaXRvcnkxODQyODY4NzU=-flat-ServiceInterfacesL0.cs.html,17,runner-MDEwOlJlcG9zaXRvcnkxODQyODY4NzU=-flat-ServiceInterfacesL0.cs,runner-MDEwOlJlcG9zaXRvcnkxODQyODY4NzU=-flat-ServiceInterfacesL0.cs,35,39,4,21,25,4
135,https://htmlpreview.github.io/?https://github.com/Christina96/boilerplate-sample-matches/blob/main/Csharp/Simple.Data-MDEwOlJlcG9zaXRvcnk4MTg3Njg=-flat-FunctionSignature.cs-MudBlazor-MDEwOlJlcG9zaXRvcnkyODg0Mjg2NzY=-flat-ResizeBasedServiceTests.cs.html,28,Simple.Data-MDEwOlJlcG9zaXRvcnk4MTg3Njg=-flat-FunctionSignature.cs,MudBlazor-MDEwOlJlcG9zaXRvcnkyODg0Mjg2NzY=-flat-ResizeBasedServiceTests.cs,45,48,3,376,379,3
136,https://htmlpreview.github.io/?https://github.com/Christina96/boilerplate-sample-matches/blob/main/Csharp/npgsql-MDEwOlJlcG9zaXRvcnkyODgzNTc0-flat-SecurityTests.cs-npgsql-MDEwOlJlcG9zaXRvcnkyODgzNTc0-flat-SecurityTests.cs.html,163,npgsql-MDEwOlJlcG9zaXRvcnkyODgzNTc0-flat-SecurityTests.cs,npgsql-MDEwOlJlcG9zaXRvcnkyODgzNTc0-flat-SecurityTests.cs,378,396,18,338,356,18
137,https://htmlpreview.github.io/?https://github.com/Christina96/boilerplate-sample-matches/blob/main/Csharp/NetCoreServer-MDEwOlJlcG9zaXRvcnkxNjYxMjMxNjQ=-flat-com.chronoxor.simple.cs-NetCoreServer-MDEwOlJlcG9zaXRvcnkxNjYxMjMxNjQ=-flat-com.chronoxor.simple.cs.html,22,NetCoreServer-MDEwOlJlcG9zaXRvcnkxNjYxMjMxNjQ=-flat-com.chronoxor.simple.cs,NetCoreServer-MDEwOlJlcG9zaXRvcnkxNjYxMjMxNjQ=-flat-com.chronoxor.simple.cs,1717,1718,1,1716,1717,1
138,https://htmlpreview.github.io/?https://github.com/Christina96/boilerplate-sample-matches/blob/main/Csharp/npgsql-MDEwOlJlcG9zaXRvcnkyODgzNTc0-flat-DistributedTransactionTests.cs-npgsql-MDEwOlJlcG9zaXRvcnkyODgzNTc0-flat-DistributedTransactionTests.cs.html,12,npgsql-MDEwOlJlcG9zaXRvcnkyODgzNTc0-flat-DistributedTransactionTests.cs,npgsql-MDEwOlJlcG9zaXRvcnkyODgzNTc0-flat-DistributedTransactionTests.cs,215,218,3,215,218,3
139,https://htmlpreview.github.io/?https://github.com/Christina96/boilerplate-sample-matches/blob/main/Csharp/dotween-MDEwOlJlcG9zaXRvcnkzMjQ3NTE2Mg==-flat-GoTweenChain_60.cs-dotween-MDEwOlJlcG9zaXRvcnkzMjQ3NTE2Mg==-flat-GoTweenChain.cs.html,26,dotween-MDEwOlJlcG9zaXRvcnkzMjQ3NTE2Mg==-flat-GoTweenChain_60.cs,dotween-MDEwOlJlcG9zaXRvcnkzMjQ3NTE2Mg==-flat-GoTweenChain.cs,28,34,6,56,62,6
140,https://htmlpreview.github.io/?https://github.com/Christina96/boilerplate-sample-matches/blob/main/Csharp/npgsql-MDEwOlJlcG9zaXRvcnkyODgzNTc0-flat-NpgsqlSchema.cs-npgsql-MDEwOlJlcG9zaXRvcnkyODgzNTc0-flat-NpgsqlSchema.cs.html,15,npgsql-MDEwOlJlcG9zaXRvcnkyODgzNTc0-flat-NpgsqlSchema.cs,npgsql-MDEwOlJlcG9zaXRvcnkyODgzNTc0-flat-NpgsqlSchema.cs,85,86,1,81,82,1
141,https://htmlpreview.github.io/?https://github.com/Christina96/boilerplate-sample-matches/blob/main/Csharp/runner-MDEwOlJlcG9zaXRvcnkxODQyODY4NzU=-flat-TaskHttpClient.cs-runner-MDEwOlJlcG9zaXRvcnkxODQyODY4NzU=-flat-RunServiceHttpClient.cs.html,71,runner-MDEwOlJlcG9zaXRvcnkxODQyODY4NzU=-flat-TaskHttpClient.cs,runner-MDEwOlJlcG9zaXRvcnkxODQyODY4NzU=-flat-RunServiceHttpClient.cs,29,48,19,34,53,19
142,https://htmlpreview.github.io/?https://github.com/Christina96/boilerplate-sample-matches/blob/main/Csharp/runner-MDEwOlJlcG9zaXRvcnkxODQyODY4NzU=-flat-ActionManagerL0.cs-runner-MDEwOlJlcG9zaXRvcnkxODQyODY4NzU=-flat-ActionManager.cs.html,16,runner-MDEwOlJlcG9zaXRvcnkxODQyODY4NzU=-flat-ActionManagerL0.cs,runner-MDEwOlJlcG9zaXRvcnkxODQyODY4NzU=-flat-ActionManager.cs,1252,1253,1,316,317,1
143,https://htmlpreview.github.io/?https://github.com/Christina96/boilerplate-sample-matches/blob/main/Csharp/ZXing.Net.Mobile-MDEwOlJlcG9zaXRvcnk2MTYwNjcz-flat-App.xaml_11.cs-ZXing.Net.Mobile-MDEwOlJlcG9zaXRvcnk2MTYwNjcz-flat-App.xaml_11.cs.html,16,ZXing.Net.Mobile-MDEwOlJlcG9zaXRvcnk2MTYwNjcz-flat-App.xaml_11.cs,ZXing.Net.Mobile-MDEwOlJlcG9zaXRvcnk2MTYwNjcz-flat-App.xaml_11.cs,15,21,6,18,24,6
144,https://htmlpreview.github.io/?https://github.com/Christina96/boilerplate-sample-matches/blob/main/Csharp/npgsql-MDEwOlJlcG9zaXRvcnkyODgzNTc0-flat-BuiltInTypeHandlerResolver.cs-npgsql-MDEwOlJlcG9zaXRvcnkyODgzNTc0-flat-NodaTimeTypeHandlerResolver.cs.html,12,npgsql-MDEwOlJlcG9zaXRvcnkyODgzNTc0-flat-BuiltInTypeHandlerResolver.cs,npgsql-MDEwOlJlcG9zaXRvcnkyODgzNTc0-flat-NodaTimeTypeHandlerResolver.cs,69,72,3,23,26,3
145,https://htmlpreview.github.io/?https://github.com/Christina96/boilerplate-sample-matches/blob/main/Csharp/NetCoreServer-MDEwOlJlcG9zaXRvcnkxNjYxMjMxNjQ=-flat-UdpClient.cs-NetCoreServer-MDEwOlJlcG9zaXRvcnkxNjYxMjMxNjQ=-flat-SslClient.cs.html,16,NetCoreServer-MDEwOlJlcG9zaXRvcnkxNjYxMjMxNjQ=-flat-UdpClient.cs,NetCoreServer-MDEwOlJlcG9zaXRvcnkxNjYxMjMxNjQ=-flat-SslClient.cs,54,57,3,187,190,3
146,https://htmlpreview.github.io/?https://github.com/Christina96/boilerplate-sample-matches/blob/main/Csharp/MudBlazor-MDEwOlJlcG9zaXRvcnkyODg0Mjg2NzY=-flat-ResizeBasedServiceTests.cs-MudBlazor-MDEwOlJlcG9zaXRvcnkyODg0Mjg2NzY=-flat-ResizeBasedServiceTests.cs.html,61,MudBlazor-MDEwOlJlcG9zaXRvcnkyODg0Mjg2NzY=-flat-ResizeBasedServiceTests.cs,MudBlazor-MDEwOlJlcG9zaXRvcnkyODg0Mjg2NzY=-flat-ResizeBasedServiceTests.cs,289,297,8,289,297,8
147,https://htmlpreview.github.io/?https://github.com/Christina96/boilerplate-sample-matches/blob/main/Csharp/dotween-MDEwOlJlcG9zaXRvcnkzMjQ3NTE2Mg==-flat-AbstractGoTweenCollection_99.cs-dotween-MDEwOlJlcG9zaXRvcnkzMjQ3NTE2Mg==-flat-AbstractGoTweenCollection_99.cs.html,22,dotween-MDEwOlJlcG9zaXRvcnkzMjQ3NTE2Mg==-flat-AbstractGoTweenCollection_99.cs,dotween-MDEwOlJlcG9zaXRvcnkzMjQ3NTE2Mg==-flat-AbstractGoTweenCollection_99.cs,30,34,4,30,34,4
148,https://htmlpreview.github.io/?https://github.com/Christina96/boilerplate-sample-matches/blob/main/Csharp/dotween-MDEwOlJlcG9zaXRvcnkzMjQ3NTE2Mg==-flat-GoSplineQuadraticBezierSolver_67.cs-dotween-MDEwOlJlcG9zaXRvcnkzMjQ3NTE2Mg==-flat-GoSplineQuadraticBezierSolver_67.cs.html,177,dotween-MDEwOlJlcG9zaXRvcnkzMjQ3NTE2Mg==-flat-GoSplineQuadraticBezierSolver_67.cs,dotween-MDEwOlJlcG9zaXRvcnkzMjQ3NTE2Mg==-flat-GoSplineQuadraticBezierSolver_67.cs,27,53,26,27,53,26
149,https://htmlpreview.github.io/?https://github.com/Christina96/boilerplate-sample-matches/blob/main/Csharp/NetCoreServer-MDEwOlJlcG9zaXRvcnkxNjYxMjMxNjQ=-flat-com.chronoxor.fbe.cs-NetCoreServer-MDEwOlJlcG9zaXRvcnkxNjYxMjMxNjQ=-flat-com.chronoxor.fbe.cs.html,139,NetCoreServer-MDEwOlJlcG9zaXRvcnkxNjYxMjMxNjQ=-flat-com.chronoxor.fbe.cs,NetCoreServer-MDEwOlJlcG9zaXRvcnkxNjYxMjMxNjQ=-flat-com.chronoxor.fbe.cs,1215,1231,16,1215,1231,16
150,https://htmlpreview.github.io/?https://github.com/Christina96/boilerplate-sample-matches/blob/main/Csharp/dotween-MDEwOlJlcG9zaXRvcnkzMjQ3NTE2Mg==-flat-AbstractGoSplineSolver.cs-dotween-MDEwOlJlcG9zaXRvcnkzMjQ3NTE2Mg==-flat-AbstractGoSplineSolver_70.cs.html,40,dotween-MDEwOlJlcG9zaXRvcnkzMjQ3NTE2Mg==-flat-AbstractGoSplineSolver.cs,dotween-MDEwOlJlcG9zaXRvcnkzMjQ3NTE2Mg==-flat-AbstractGoSplineSolver_70.cs,51,60,9,51,60,9
151,https://htmlpreview.github.io/?https://github.com/Christina96/boilerplate-sample-matches/blob/main/Csharp/runner-MDEwOlJlcG9zaXRvcnkxODQyODY4NzU=-flat-VssFileStorage.cs-runner-MDEwOlJlcG9zaXRvcnkxODQyODY4NzU=-flat-VssFileStorage.cs.html,15,runner-MDEwOlJlcG9zaXRvcnkxODQyODY4NzU=-flat-VssFileStorage.cs,runner-MDEwOlJlcG9zaXRvcnkxODQyODY4NzU=-flat-VssFileStorage.cs,220,224,4,220,224,4
152,https://htmlpreview.github.io/?https://github.com/Christina96/boilerplate-sample-matches/blob/main/Csharp/runner-MDEwOlJlcG9zaXRvcnkxODQyODY4NzU=-flat-GitSourceProvider_1.cs-runner-MDEwOlJlcG9zaXRvcnkxODQyODY4NzU=-flat-GitSourceProvider_1.cs.html,69,runner-MDEwOlJlcG9zaXRvcnkxODQyODY4NzU=-flat-GitSourceProvider_1.cs,runner-MDEwOlJlcG9zaXRvcnkxODQyODY4NzU=-flat-GitSourceProvider_1.cs,200,209,9,200,209,9
153,https://htmlpreview.github.io/?https://github.com/Christina96/boilerplate-sample-matches/blob/main/Csharp/runner-MDEwOlJlcG9zaXRvcnkxODQyODY4NzU=-flat-ProcessExtensions.cs-runner-MDEwOlJlcG9zaXRvcnkxODQyODY4NzU=-flat-ProcessExtensions.cs.html,12,runner-MDEwOlJlcG9zaXRvcnkxODQyODY4NzU=-flat-ProcessExtensions.cs,runner-MDEwOlJlcG9zaXRvcnkxODQyODY4NzU=-flat-ProcessExtensions.cs,205,208,3,222,225,3
154,https://htmlpreview.github.io/?https://github.com/Christina96/boilerplate-sample-matches/blob/main/Csharp/npgsql-MDEwOlJlcG9zaXRvcnkyODgzNTc0-flat-CopyTests.cs-npgsql-MDEwOlJlcG9zaXRvcnkyODgzNTc0-flat-ReaderOldSchemaTests.cs.html,19,npgsql-MDEwOlJlcG9zaXRvcnkyODgzNTc0-flat-CopyTests.cs,npgsql-MDEwOlJlcG9zaXRvcnkyODgzNTc0-flat-ReaderOldSchemaTests.cs,100,104,4,93,97,4
155,https://htmlpreview.github.io/?https://github.com/Christina96/boilerplate-sample-matches/blob/main/Csharp/MudBlazor-MDEwOlJlcG9zaXRvcnkyODg0Mjg2NzY=-flat-IIJSRuntimeExtentionsTests.cs-MudBlazor-MDEwOlJlcG9zaXRvcnkyODg0Mjg2NzY=-flat-IIJSRuntimeExtentionsTests.cs.html,29,MudBlazor-MDEwOlJlcG9zaXRvcnkyODg0Mjg2NzY=-flat-IIJSRuntimeExtentionsTests.cs,MudBlazor-MDEwOlJlcG9zaXRvcnkyODg0Mjg2NzY=-flat-IIJSRuntimeExtentionsTests.cs,88,92,4,88,92,4
156,https://htmlpreview.github.io/?https://github.com/Christina96/boilerplate-sample-matches/blob/main/Csharp/NetCoreServer-MDEwOlJlcG9zaXRvcnkxNjYxMjMxNjQ=-flat-Program_35.cs-NetCoreServer-MDEwOlJlcG9zaXRvcnkxNjYxMjMxNjQ=-flat-Program_11.cs.html,12,NetCoreServer-MDEwOlJlcG9zaXRvcnkxNjYxMjMxNjQ=-flat-Program_35.cs,NetCoreServer-MDEwOlJlcG9zaXRvcnkxNjYxMjMxNjQ=-flat-Program_11.cs,30,34,4,62,66,4
157,https://htmlpreview.github.io/?https://github.com/Christina96/boilerplate-sample-matches/blob/main/Csharp/dotween-MDEwOlJlcG9zaXRvcnkzMjQ3NTE2Mg==-flat-GoDummyPathEditor.cs-dotween-MDEwOlJlcG9zaXRvcnkzMjQ3NTE2Mg==-flat-GoDummyPathEditor.cs.html,1929,dotween-MDEwOlJlcG9zaXRvcnkzMjQ3NTE2Mg==-flat-GoDummyPathEditor.cs,dotween-MDEwOlJlcG9zaXRvcnkzMjQ3NTE2Mg==-flat-GoDummyPathEditor.cs,68,356,288,68,356,288
158,https://htmlpreview.github.io/?https://github.com/Christina96/boilerplate-sample-matches/blob/main/Csharp/npgsql-MDEwOlJlcG9zaXRvcnkyODgzNTc0-flat-INpgsqlTypeMapper.cs-npgsql-MDEwOlJlcG9zaXRvcnkyODgzNTc0-flat-INpgsqlTypeMapper.cs.html,18,npgsql-MDEwOlJlcG9zaXRvcnkyODgzNTc0-flat-INpgsqlTypeMapper.cs,npgsql-MDEwOlJlcG9zaXRvcnkyODgzNTc0-flat-INpgsqlTypeMapper.cs,10,13,3,10,13,3
159,https://htmlpreview.github.io/?https://github.com/Christina96/boilerplate-sample-matches/blob/main/Csharp/Security-MDEwOlJlcG9zaXRvcnkxNzcyMzY5OQ==-flat-OAuthTests.cs-runner-MDEwOlJlcG9zaXRvcnkxODQyODY4NzU=-flat-UriUtility.cs.html,13,Security-MDEwOlJlcG9zaXRvcnkxNzcyMzY5OQ==-flat-OAuthTests.cs,runner-MDEwOlJlcG9zaXRvcnkxODQyODY4NzU=-flat-UriUtility.cs,279,280,1,201,202,1
160,https://htmlpreview.github.io/?https://github.com/Christina96/boilerplate-sample-matches/blob/main/Csharp/dotween-MDEwOlJlcG9zaXRvcnkzMjQ3NTE2Mg==-flat-From_16.cs-dotween-MDEwOlJlcG9zaXRvcnkzMjQ3NTE2Mg==-flat-From_16.cs.html,120,dotween-MDEwOlJlcG9zaXRvcnkzMjQ3NTE2Mg==-flat-From_16.cs,dotween-MDEwOlJlcG9zaXRvcnkzMjQ3NTE2Mg==-flat-From_16.cs,7,26,19,7,26,19
161,https://htmlpreview.github.io/?https://github.com/Christina96/boilerplate-sample-matches/blob/main/Csharp/NetCoreServer-MDEwOlJlcG9zaXRvcnkxNjYxMjMxNjQ=-flat-HttpRequest.cs-NetCoreServer-MDEwOlJlcG9zaXRvcnkxNjYxMjMxNjQ=-flat-HttpResponse.cs.html,31,NetCoreServer-MDEwOlJlcG9zaXRvcnkxNjYxMjMxNjQ=-flat-HttpRequest.cs,NetCoreServer-MDEwOlJlcG9zaXRvcnkxNjYxMjMxNjQ=-flat-HttpResponse.cs,233,236,3,373,376,3
162,https://htmlpreview.github.io/?https://github.com/Christina96/boilerplate-sample-matches/blob/main/Csharp/NetCoreServer-MDEwOlJlcG9zaXRvcnkxNjYxMjMxNjQ=-flat-Buffer.cs-NetCoreServer-MDEwOlJlcG9zaXRvcnkxNjYxMjMxNjQ=-flat-Buffer.cs.html,15,NetCoreServer-MDEwOlJlcG9zaXRvcnkxNjYxMjMxNjQ=-flat-Buffer.cs,NetCoreServer-MDEwOlJlcG9zaXRvcnkxNjYxMjMxNjQ=-flat-Buffer.cs,29,34,5,29,34,5
163,https://htmlpreview.github.io/?https://github.com/Christina96/boilerplate-sample-matches/blob/main/Csharp/Simple.Data-MDEwOlJlcG9zaXRvcnk4MTg3Njg=-flat-SqlTypeResolver_42.cs-runner-MDEwOlJlcG9zaXRvcnkxODQyODY4NzU=-flat-UriUtility.cs.html,12,Simple.Data-MDEwOlJlcG9zaXRvcnk4MTg3Njg=-flat-SqlTypeResolver_42.cs,runner-MDEwOlJlcG9zaXRvcnkxODQyODY4NzU=-flat-UriUtility.cs,44,47,3,283,286,3
164,https://htmlpreview.github.io/?https://github.com/Christina96/boilerplate-sample-matches/blob/main/Csharp/npgsql-MDEwOlJlcG9zaXRvcnkyODgzNTc0-flat-Prepare.cs-npgsql-MDEwOlJlcG9zaXRvcnkyODgzNTc0-flat-ReadColumns.cs.html,42,npgsql-MDEwOlJlcG9zaXRvcnkyODgzNTc0-flat-Prepare.cs,npgsql-MDEwOlJlcG9zaXRvcnkyODgzNTc0-flat-ReadColumns.cs,80,86,6,43,50,7
165,https://htmlpreview.github.io/?https://github.com/Christina96/boilerplate-sample-matches/blob/main/Csharp/Simple.Data-MDEwOlJlcG9zaXRvcnk4MTg3Njg=-flat-QueryTest.cs-Simple.Data-MDEwOlJlcG9zaXRvcnk4MTg3Njg=-flat-ProcedureTest.cs.html,37,Simple.Data-MDEwOlJlcG9zaXRvcnk4MTg3Njg=-flat-QueryTest.cs,Simple.Data-MDEwOlJlcG9zaXRvcnk4MTg3Njg=-flat-ProcedureTest.cs,411,416,5,70,75,5
166,https://htmlpreview.github.io/?https://github.com/Christina96/boilerplate-sample-matches/blob/main/Csharp/ZXing.Net.Mobile-MDEwOlJlcG9zaXRvcnk2MTYwNjcz-flat-ZXingMediaView.tizen.cs-ZXing.Net.Mobile-MDEwOlJlcG9zaXRvcnk2MTYwNjcz-flat-ZXingScannerView.shared.cs.html,20,ZXing.Net.Mobile-MDEwOlJlcG9zaXRvcnk2MTYwNjcz-flat-ZXingMediaView.tizen.cs,ZXing.Net.Mobile-MDEwOlJlcG9zaXRvcnk2MTYwNjcz-flat-ZXingScannerView.shared.cs,37,39,2,27,29,2
167,https://htmlpreview.github.io/?https://github.com/Christina96/boilerplate-sample-matches/blob/main/Csharp/MudBlazor-MDEwOlJlcG9zaXRvcnkyODg0Mjg2NzY=-flat-PopoverTests.cs-MudBlazor-MDEwOlJlcG9zaXRvcnkyODg0Mjg2NzY=-flat-PopoverTests.cs.html,22,MudBlazor-MDEwOlJlcG9zaXRvcnkyODg0Mjg2NzY=-flat-PopoverTests.cs,MudBlazor-MDEwOlJlcG9zaXRvcnkyODg0Mjg2NzY=-flat-PopoverTests.cs,38,40,2,65,67,2
168,https://htmlpreview.github.io/?https://github.com/Christina96/boilerplate-sample-matches/blob/main/Csharp/dotween-MDEwOlJlcG9zaXRvcnkzMjQ3NTE2Mg==-flat-GoTween_59.cs-NetCoreServer-MDEwOlJlcG9zaXRvcnkxNjYxMjMxNjQ=-flat-com.chronoxor.simple.cs.html,15,dotween-MDEwOlJlcG9zaXRvcnkzMjQ3NTE2Mg==-flat-GoTween_59.cs,NetCoreServer-MDEwOlJlcG9zaXRvcnkxNjYxMjMxNjQ=-flat-com.chronoxor.simple.cs,132,137,5,2022,2027,5
169,https://htmlpreview.github.io/?https://github.com/Christina96/boilerplate-sample-matches/blob/main/Csharp/MudBlazor-MDEwOlJlcG9zaXRvcnkyODg0Mjg2NzY=-flat-XmlDocumentation_5.cs-MudBlazor-MDEwOlJlcG9zaXRvcnkyODg0Mjg2NzY=-flat-XmlDocumentation_5.cs.html,114,MudBlazor-MDEwOlJlcG9zaXRvcnkyODg0Mjg2NzY=-flat-XmlDocumentation_5.cs,MudBlazor-MDEwOlJlcG9zaXRvcnkyODg0Mjg2NzY=-flat-XmlDocumentation_5.cs,344,365,21,344,365,21
170,https://htmlpreview.github.io/?https://github.com/Christina96/boilerplate-sample-matches/blob/main/Csharp/Security-MDEwOlJlcG9zaXRvcnkxNzcyMzY5OQ==-flat-DefaultAuthorizationPolicyProvider.cs-Security-MDEwOlJlcG9zaXRvcnkxNzcyMzY5OQ==-flat-DefaultAuthorizationPolicyProvider.cs.html,21,Security-MDEwOlJlcG9zaXRvcnkxNzcyMzY5OQ==-flat-DefaultAuthorizationPolicyProvider.cs,Security-MDEwOlJlcG9zaXRvcnkxNzcyMzY5OQ==-flat-DefaultAuthorizationPolicyProvider.cs,19,23,4,19,23,4
171,https://htmlpreview.github.io/?https://github.com/Christina96/boilerplate-sample-matches/blob/main/Csharp/MudBlazor-MDEwOlJlcG9zaXRvcnkyODg0Mjg2NzY=-flat-TypeIdentifier.cs-MudBlazor-MDEwOlJlcG9zaXRvcnkyODg0Mjg2NzY=-flat-TypeIdentifier.cs.html,19,MudBlazor-MDEwOlJlcG9zaXRvcnkyODg0Mjg2NzY=-flat-TypeIdentifier.cs,MudBlazor-MDEwOlJlcG9zaXRvcnkyODg0Mjg2NzY=-flat-TypeIdentifier.cs,57,61,4,75,79,4
172,https://htmlpreview.github.io/?https://github.com/Christina96/boilerplate-sample-matches/blob/main/Csharp/NetCoreServer-MDEwOlJlcG9zaXRvcnkxNjYxMjMxNjQ=-flat-ProtoTests.cs-NetCoreServer-MDEwOlJlcG9zaXRvcnkxNjYxMjMxNjQ=-flat-UdpMulticastTests.cs.html,34,NetCoreServer-MDEwOlJlcG9zaXRvcnkxNjYxMjMxNjQ=-flat-ProtoTests.cs,NetCoreServer-MDEwOlJlcG9zaXRvcnkxNjYxMjMxNjQ=-flat-UdpMulticastTests.cs,12,17,5,10,15,5
173,https://htmlpreview.github.io/?https://github.com/Christina96/boilerplate-sample-matches/blob/main/Csharp/runner-MDEwOlJlcG9zaXRvcnkxODQyODY4NzU=-flat-ContainerInfo.cs-runner-MDEwOlJlcG9zaXRvcnkxODQyODY4NzU=-flat-ContainerInfo.cs.html,175,runner-MDEwOlJlcG9zaXRvcnkxODQyODY4NzU=-flat-ContainerInfo.cs,runner-MDEwOlJlcG9zaXRvcnkxODQyODY4NzU=-flat-ContainerInfo.cs,173,203,30,143,173,30
174,https://htmlpreview.github.io/?https://github.com/Christina96/boilerplate-sample-matches/blob/main/Csharp/runner-MDEwOlJlcG9zaXRvcnkxODQyODY4NzU=-flat-ActionCommandManager.cs-runner-MDEwOlJlcG9zaXRvcnkxODQyODY4NzU=-flat-FileCommandManager.cs.html,16,runner-MDEwOlJlcG9zaXRvcnkxODQyODY4NzU=-flat-ActionCommandManager.cs,runner-MDEwOlJlcG9zaXRvcnkxODQyODY4NzU=-flat-FileCommandManager.cs,19,22,3,16,19,3
175,https://htmlpreview.github.io/?https://github.com/Christina96/boilerplate-sample-matches/blob/main/Csharp/MudBlazor-MDEwOlJlcG9zaXRvcnkyODg0Mjg2NzY=-flat-DataGridTests.cs-MudBlazor-MDEwOlJlcG9zaXRvcnkyODg0Mjg2NzY=-flat-DataGridTests.cs.html,19,MudBlazor-MDEwOlJlcG9zaXRvcnkyODg0Mjg2NzY=-flat-DataGridTests.cs,MudBlazor-MDEwOlJlcG9zaXRvcnkyODg0Mjg2NzY=-flat-DataGridTests.cs,1474,1477,3,1393,1396,3
176,https://htmlpreview.github.io/?https://github.com/Christina96/boilerplate-sample-matches/blob/main/Csharp/MudBlazor-MDEwOlJlcG9zaXRvcnkyODg0Mjg2NzY=-flat-NavigationManagerExtensions.cs-MudBlazor-MDEwOlJlcG9zaXRvcnkyODg0Mjg2NzY=-flat-NavigationManagerExtensions.cs.html,33,MudBlazor-MDEwOlJlcG9zaXRvcnkyODg0Mjg2NzY=-flat-NavigationManagerExtensions.cs,MudBlazor-MDEwOlJlcG9zaXRvcnkyODg0Mjg2NzY=-flat-NavigationManagerExtensions.cs,18,21,3,10,13,3
177,https://htmlpreview.github.io/?https://github.com/Christina96/boilerplate-sample-matches/blob/main/Csharp/runner-MDEwOlJlcG9zaXRvcnkxODQyODY4NzU=-flat-SaveStateFileCommandL0.cs-runner-MDEwOlJlcG9zaXRvcnkxODQyODY4NzU=-flat-SaveStateFileCommandL0.cs.html,14,runner-MDEwOlJlcG9zaXRvcnkxODQyODY4NzU=-flat-SaveStateFileCommandL0.cs,runner-MDEwOlJlcG9zaXRvcnkxODQyODY4NzU=-flat-SaveStateFileCommandL0.cs,234,240,6,234,240,6
178,https://htmlpreview.github.io/?https://github.com/Christina96/boilerplate-sample-matches/blob/main/Csharp/runner-MDEwOlJlcG9zaXRvcnkxODQyODY4NzU=-flat-VssPerformanceEventSource.cs-runner-MDEwOlJlcG9zaXRvcnkxODQyODY4NzU=-flat-VssPerformanceEventSource.cs.html,36,runner-MDEwOlJlcG9zaXRvcnkxODQyODY4NzU=-flat-VssPerformanceEventSource.cs,runner-MDEwOlJlcG9zaXRvcnkxODQyODY4NzU=-flat-VssPerformanceEventSource.cs,301,307,6,293,299,6
179,https://htmlpreview.github.io/?https://github.com/Christina96/boilerplate-sample-matches/blob/main/Csharp/EarTrumpet-MDEwOlJlcG9zaXRvcnkzODkxOTcwMg==-flat-OperatingSystemExtensions.cs-EarTrumpet-MDEwOlJlcG9zaXRvcnkzODkxOTcwMg==-flat-Shell32.cs.html,26,EarTrumpet-MDEwOlJlcG9zaXRvcnkzODkxOTcwMg==-flat-OperatingSystemExtensions.cs,EarTrumpet-MDEwOlJlcG9zaXRvcnkzODkxOTcwMg==-flat-Shell32.cs,4,11,7,39,46,7
180,https://htmlpreview.github.io/?https://github.com/Christina96/boilerplate-sample-matches/blob/main/Csharp/npgsql-MDEwOlJlcG9zaXRvcnkyODgzNTc0-flat-SystemTextJsonHandler.cs-npgsql-MDEwOlJlcG9zaXRvcnkyODgzNTc0-flat-NpgsqlRawCopyStream.cs.html,12,npgsql-MDEwOlJlcG9zaXRvcnkyODgzNTc0-flat-SystemTextJsonHandler.cs,npgsql-MDEwOlJlcG9zaXRvcnkyODgzNTc0-flat-NpgsqlRawCopyStream.cs,74,75,1,57,58,1
181,https://htmlpreview.github.io/?https://github.com/Christina96/boilerplate-sample-matches/blob/main/Csharp/runner-MDEwOlJlcG9zaXRvcnkxODQyODY4NzU=-flat-VssOAuthCredential.cs-Security-MDEwOlJlcG9zaXRvcnkxNzcyMzY5OQ==-flat-RolesAuthorizationRequirement.cs.html,12,runner-MDEwOlJlcG9zaXRvcnkxODQyODY4NzU=-flat-VssOAuthCredential.cs,Security-MDEwOlJlcG9zaXRvcnkxNzcyMzY5OQ==-flat-RolesAuthorizationRequirement.cs,82,86,4,22,24,2
182,https://htmlpreview.github.io/?https://github.com/Christina96/boilerplate-sample-matches/blob/main/Csharp/runner-MDEwOlJlcG9zaXRvcnkxODQyODY4NzU=-flat-ServiceControlManagerL0.cs-runner-MDEwOlJlcG9zaXRvcnkxODQyODY4NzU=-flat-ServiceControlManagerL0.cs.html,19,runner-MDEwOlJlcG9zaXRvcnkxODQyODY4NzU=-flat-ServiceControlManagerL0.cs,runner-MDEwOlJlcG9zaXRvcnkxODQyODY4NzU=-flat-ServiceControlManagerL0.cs,115,118,3,27,30,3
183,https://htmlpreview.github.io/?https://github.com/Christina96/boilerplate-sample-matches/blob/main/Csharp/npgsql-MDEwOlJlcG9zaXRvcnkyODgzNTc0-flat-VolatileResourceManager.cs-npgsql-MDEwOlJlcG9zaXRvcnkyODgzNTc0-flat-VolatileResourceManager.cs.html,48,npgsql-MDEwOlJlcG9zaXRvcnkyODgzNTc0-flat-VolatileResourceManager.cs,npgsql-MDEwOlJlcG9zaXRvcnkyODgzNTc0-flat-VolatileResourceManager.cs,84,93,9,171,180,9
184,https://htmlpreview.github.io/?https://github.com/Christina96/boilerplate-sample-matches/blob/main/Csharp/NetCoreServer-MDEwOlJlcG9zaXRvcnkxNjYxMjMxNjQ=-flat-TcpClient.cs-NetCoreServer-MDEwOlJlcG9zaXRvcnkxNjYxMjMxNjQ=-flat-TcpSession.cs.html,15,NetCoreServer-MDEwOlJlcG9zaXRvcnkxNjYxMjMxNjQ=-flat-TcpClient.cs,NetCoreServer-MDEwOlJlcG9zaXRvcnkxNjYxMjMxNjQ=-flat-TcpSession.cs,418,422,4,301,305,4
185,https://htmlpreview.github.io/?https://github.com/Christina96/boilerplate-sample-matches/blob/main/Csharp/MudBlazor-MDEwOlJlcG9zaXRvcnkyODg0Mjg2NzY=-flat-MudColor.cs-MudBlazor-MDEwOlJlcG9zaXRvcnkyODg0Mjg2NzY=-flat-PrerenderMiddleware.cs.html,12,MudBlazor-MDEwOlJlcG9zaXRvcnkyODg0Mjg2NzY=-flat-MudColor.cs,MudBlazor-MDEwOlJlcG9zaXRvcnkyODg0Mjg2NzY=-flat-PrerenderMiddleware.cs,107,109,2,21,23,2
186,https://htmlpreview.github.io/?https://github.com/Christina96/boilerplate-sample-matches/blob/main/Csharp/EarTrumpet-MDEwOlJlcG9zaXRvcnkzODkxOTcwMg==-flat-Kernel32.cs-EarTrumpet-MDEwOlJlcG9zaXRvcnkzODkxOTcwMg==-flat-Kernel32.cs.html,14,EarTrumpet-MDEwOlJlcG9zaXRvcnkzODkxOTcwMg==-flat-Kernel32.cs,EarTrumpet-MDEwOlJlcG9zaXRvcnkzODkxOTcwMg==-flat-Kernel32.cs,10,12,2,11,13,2
187,https://htmlpreview.github.io/?https://github.com/Christina96/boilerplate-sample-matches/blob/main/Csharp/ZXing.Net.Mobile-MDEwOlJlcG9zaXRvcnk2MTYwNjcz-flat-HomePage.cs-20486D-DevelopingASPNETMVCWebApplications-MDEwOlJlcG9zaXRvcnkxMTkzNTI2Mzc=-flat-AccountController_205.cs.html,13,ZXing.Net.Mobile-MDEwOlJlcG9zaXRvcnk2MTYwNjcz-flat-HomePage.cs,20486D-DevelopingASPNETMVCWebApplications-MDEwOlJlcG9zaXRvcnkxMTkzNTI2Mzc=-flat-AccountController_205.cs,49,52,3,61,64,3
188,https://htmlpreview.github.io/?https://github.com/Christina96/boilerplate-sample-matches/blob/main/Csharp/runner-MDEwOlJlcG9zaXRvcnkxODQyODY4NzU=-flat-SetEnvFileCommandL0.cs-runner-MDEwOlJlcG9zaXRvcnkxODQyODY4NzU=-flat-SetOutputFileCommandL0.cs.html,12,runner-MDEwOlJlcG9zaXRvcnkxODQyODY4NzU=-flat-SetEnvFileCommandL0.cs,runner-MDEwOlJlcG9zaXRvcnkxODQyODY4NzU=-flat-SetOutputFileCommandL0.cs,235,240,5,266,271,5
189,https://htmlpreview.github.io/?https://github.com/Christina96/boilerplate-sample-matches/blob/main/Csharp/runner-MDEwOlJlcG9zaXRvcnkxODQyODY4NzU=-flat-SelfUpdater.cs-MudBlazor-MDEwOlJlcG9zaXRvcnkyODg0Mjg2NzY=-flat-LayoutService.cs.html,12,runner-MDEwOlJlcG9zaXRvcnkxODQyODY4NzU=-flat-SelfUpdater.cs,MudBlazor-MDEwOlJlcG9zaXRvcnkyODg0Mjg2NzY=-flat-LayoutService.cs,199,202,3,67,70,3
190,https://htmlpreview.github.io/?https://github.com/Christina96/boilerplate-sample-matches/blob/main/Csharp/MudBlazor-MDEwOlJlcG9zaXRvcnkyODg0Mjg2NzY=-flat-TabsTests.cs-MudBlazor-MDEwOlJlcG9zaXRvcnkyODg0Mjg2NzY=-flat-TabsTests.cs.html,21,MudBlazor-MDEwOlJlcG9zaXRvcnkyODg0Mjg2NzY=-flat-TabsTests.cs,MudBlazor-MDEwOlJlcG9zaXRvcnkyODg0Mjg2NzY=-flat-TabsTests.cs,143,147,4,222,226,4
191,https://htmlpreview.github.io/?https://github.com/Christina96/boilerplate-sample-matches/blob/main/Csharp/runner-MDEwOlJlcG9zaXRvcnkxODQyODY4NzU=-flat-ConnectionData.cs-runner-MDEwOlJlcG9zaXRvcnkxODQyODY4NzU=-flat-IdentityDescriptor.cs.html,23,runner-MDEwOlJlcG9zaXRvcnkxODQyODY4NzU=-flat-ConnectionData.cs,runner-MDEwOlJlcG9zaXRvcnkxODQyODY4NzU=-flat-IdentityDescriptor.cs,77,83,6,130,136,6
192,https://htmlpreview.github.io/?https://github.com/Christina96/boilerplate-sample-matches/blob/main/Csharp/dotween-MDEwOlJlcG9zaXRvcnkzMjQ3NTE2Mg==-flat-DOTweenModuleUtils_141.cs-dotween-MDEwOlJlcG9zaXRvcnkzMjQ3NTE2Mg==-flat-DOTweenModuleUtils_141.cs.html,500,dotween-MDEwOlJlcG9zaXRvcnkzMjQ3NTE2Mg==-flat-DOTweenModuleUtils_141.cs,dotween-MDEwOlJlcG9zaXRvcnkzMjQ3NTE2Mg==-flat-DOTweenModuleUtils_141.cs,26,123,97,26,123,97
193,https://htmlpreview.github.io/?https://github.com/Christina96/boilerplate-sample-matches/blob/main/Csharp/Security-MDEwOlJlcG9zaXRvcnkxNzcyMzY5OQ==-flat-LoggingExtensions_28.cs-Security-MDEwOlJlcG9zaXRvcnkxNzcyMzY5OQ==-flat-LoggingExtensions_28.cs.html,33,Security-MDEwOlJlcG9zaXRvcnkxNzcyMzY5OQ==-flat-LoggingExtensions_28.cs,Security-MDEwOlJlcG9zaXRvcnkxNzcyMzY5OQ==-flat-LoggingExtensions_28.cs,418,424,6,406,412,6
194,https://htmlpreview.github.io/?https://github.com/Christina96/boilerplate-sample-matches/blob/main/Csharp/runner-MDEwOlJlcG9zaXRvcnkxODQyODY4NzU=-flat-ActionCommandL0.cs-runner-MDEwOlJlcG9zaXRvcnkxODQyODY4NzU=-flat-ActionCommandL0.cs.html,12,runner-MDEwOlJlcG9zaXRvcnkxODQyODY4NzU=-flat-ActionCommandL0.cs,runner-MDEwOlJlcG9zaXRvcnkxODQyODY4NzU=-flat-ActionCommandL0.cs,64,67,3,57,60,3
195,https://htmlpreview.github.io/?https://github.com/Christina96/boilerplate-sample-matches/blob/main/Csharp/MudBlazor-MDEwOlJlcG9zaXRvcnkyODg0Mjg2NzY=-flat-TextFieldTests.cs-MudBlazor-MDEwOlJlcG9zaXRvcnkyODg0Mjg2NzY=-flat-TextFieldTests.cs.html,97,MudBlazor-MDEwOlJlcG9zaXRvcnkyODg0Mjg2NzY=-flat-TextFieldTests.cs,MudBlazor-MDEwOlJlcG9zaXRvcnkyODg0Mjg2NzY=-flat-TextFieldTests.cs,129,144,15,129,144,15
196,https://htmlpreview.github.io/?https://github.com/Christina96/boilerplate-sample-matches/blob/main/Csharp/Security-MDEwOlJlcG9zaXRvcnkxNzcyMzY5OQ==-flat-TwitterTests.cs-runner-MDEwOlJlcG9zaXRvcnkxODQyODY4NzU=-flat-PipelineTemplateConverter.cs.html,12,Security-MDEwOlJlcG9zaXRvcnkxNzcyMzY5OQ==-flat-TwitterTests.cs,runner-MDEwOlJlcG9zaXRvcnkxODQyODY4NzU=-flat-PipelineTemplateConverter.cs,136,140,4,424,425,1
197,https://htmlpreview.github.io/?https://github.com/Christina96/boilerplate-sample-matches/blob/main/Csharp/Simple.Data-MDEwOlJlcG9zaXRvcnk4MTg3Njg=-flat-CommandHelper.cs-Simple.Data-MDEwOlJlcG9zaXRvcnk4MTg3Njg=-flat-CommandHelper.cs.html,15,Simple.Data-MDEwOlJlcG9zaXRvcnk4MTg3Njg=-flat-CommandHelper.cs,Simple.Data-MDEwOlJlcG9zaXRvcnk4MTg3Njg=-flat-CommandHelper.cs,104,108,4,104,108,4
198,https://htmlpreview.github.io/?https://github.com/Christina96/boilerplate-sample-matches/blob/main/Csharp/runner-MDEwOlJlcG9zaXRvcnkxODQyODY4NzU=-flat-RunnerDotcomServer.cs-MudBlazor-MDEwOlJlcG9zaXRvcnkyODg0Mjg2NzY=-flat-MudSwipeArea.razor.cs.html,13,runner-MDEwOlJlcG9zaXRvcnkxODQyODY4NzU=-flat-RunnerDotcomServer.cs,MudBlazor-MDEwOlJlcG9zaXRvcnkyODg0Mjg2NzY=-flat-MudSwipeArea.razor.cs,162,166,4,46,50,4
199,https://htmlpreview.github.io/?https://github.com/Christina96/boilerplate-sample-matches/blob/main/Csharp/runner-MDEwOlJlcG9zaXRvcnkxODQyODY4NzU=-flat-IOUtilL0.cs-runner-MDEwOlJlcG9zaXRvcnkxODQyODY4NzU=-flat-IOUtilL0.cs.html,14,runner-MDEwOlJlcG9zaXRvcnkxODQyODY4NzU=-flat-IOUtilL0.cs,runner-MDEwOlJlcG9zaXRvcnkxODQyODY4NzU=-flat-IOUtilL0.cs,567,568,1,567,568,1
200,https://htmlpreview.github.io/?https://github.com/Christina96/boilerplate-sample-matches/blob/main/Csharp/runner-MDEwOlJlcG9zaXRvcnkxODQyODY4NzU=-flat-Contracts.cs-runner-MDEwOlJlcG9zaXRvcnkxODQyODY4NzU=-flat-Contracts.cs.html,33,runner-MDEwOlJlcG9zaXRvcnkxODQyODY4NzU=-flat-Contracts.cs,runner-MDEwOlJlcG9zaXRvcnkxODQyODY4NzU=-flat-Contracts.cs,51,60,9,16,25,9
201,https://htmlpreview.github.io/?https://github.com/Christina96/boilerplate-sample-matches/blob/main/Csharp/dotween-MDEwOlJlcG9zaXRvcnkzMjQ3NTE2Mg==-flat-FloatTweenProperty_80.cs-dotween-MDEwOlJlcG9zaXRvcnkzMjQ3NTE2Mg==-flat-FloatTweenProperty_80.cs.html,102,dotween-MDEwOlJlcG9zaXRvcnkzMjQ3NTE2Mg==-flat-FloatTweenProperty_80.cs,dotween-MDEwOlJlcG9zaXRvcnkzMjQ3NTE2Mg==-flat-FloatTweenProperty_80.cs,24,45,21,24,45,21
202,https://htmlpreview.github.io/?https://github.com/Christina96/boilerplate-sample-matches/blob/main/Csharp/NetCoreServer-MDEwOlJlcG9zaXRvcnkxNjYxMjMxNjQ=-flat-UdpServer.cs-NetCoreServer-MDEwOlJlcG9zaXRvcnkxNjYxMjMxNjQ=-flat-UdpServer.cs.html,308,NetCoreServer-MDEwOlJlcG9zaXRvcnkxNjYxMjMxNjQ=-flat-UdpServer.cs,NetCoreServer-MDEwOlJlcG9zaXRvcnkxNjYxMjMxNjQ=-flat-UdpServer.cs,216,287,71,216,287,71
203,https://htmlpreview.github.io/?https://github.com/Christina96/boilerplate-sample-matches/blob/main/Csharp/dotween-MDEwOlJlcG9zaXRvcnkzMjQ3NTE2Mg==-flat-TweenEnginesComparisonInternal.cs-dotween-MDEwOlJlcG9zaXRvcnkzMjQ3NTE2Mg==-flat-TweenEnginesComparisonInternal_37.cs.html,460,dotween-MDEwOlJlcG9zaXRvcnkzMjQ3NTE2Mg==-flat-TweenEnginesComparisonInternal.cs,dotween-MDEwOlJlcG9zaXRvcnkzMjQ3NTE2Mg==-flat-TweenEnginesComparisonInternal_37.cs,63,117,54,63,117,54
204,https://htmlpreview.github.io/?https://github.com/Christina96/boilerplate-sample-matches/blob/main/Csharp/dotween-MDEwOlJlcG9zaXRvcnkzMjQ3NTE2Mg==-flat-iTween.cs-dotween-MDEwOlJlcG9zaXRvcnkzMjQ3NTE2Mg==-flat-iTween.cs.html,3126,dotween-MDEwOlJlcG9zaXRvcnkzMjQ3NTE2Mg==-flat-iTween.cs,dotween-MDEwOlJlcG9zaXRvcnkzMjQ3NTE2Mg==-flat-iTween.cs,421,874,453,421,874,453
205,https://htmlpreview.github.io/?https://github.com/Christina96/boilerplate-sample-matches/blob/main/Csharp/dotween-MDEwOlJlcG9zaXRvcnkzMjQ3NTE2Mg==-flat-LeanTween_56.cs-dotween-MDEwOlJlcG9zaXRvcnkzMjQ3NTE2Mg==-flat-LeanTween.cs.html,4939,dotween-MDEwOlJlcG9zaXRvcnkzMjQ3NTE2Mg==-flat-LeanTween_56.cs,dotween-MDEwOlJlcG9zaXRvcnkzMjQ3NTE2Mg==-flat-LeanTween.cs,71,811,740,71,811,740
206,https://htmlpreview.github.io/?https://github.com/Christina96/boilerplate-sample-matches/blob/main/Csharp/npgsql-MDEwOlJlcG9zaXRvcnkyODgzNTc0-flat-ReaderTests.cs-npgsql-MDEwOlJlcG9zaXRvcnkyODgzNTc0-flat-ReaderTests.cs.html,16,npgsql-MDEwOlJlcG9zaXRvcnkyODgzNTc0-flat-ReaderTests.cs,npgsql-MDEwOlJlcG9zaXRvcnkyODgzNTc0-flat-ReaderTests.cs,153,158,5,776,788,12
207,https://htmlpreview.github.io/?https://github.com/Christina96/boilerplate-sample-matches/blob/main/Csharp/runner-MDEwOlJlcG9zaXRvcnkxODQyODY4NzU=-flat-VssHttpClientBase.cs-runner-MDEwOlJlcG9zaXRvcnkxODQyODY4NzU=-flat-RawHttpClientBase.cs.html,159,runner-MDEwOlJlcG9zaXRvcnkxODQyODY4NzU=-flat-VssHttpClientBase.cs,runner-MDEwOlJlcG9zaXRvcnkxODQyODY4NzU=-flat-RawHttpClientBase.cs,27,62,35,27,62,35
208,https://htmlpreview.github.io/?https://github.com/Christina96/boilerplate-sample-matches/blob/main/Csharp/EarTrumpet-MDEwOlJlcG9zaXRvcnkzODkxOTcwMg==-flat-HotkeyViewModel.cs-20486D-DevelopingASPNETMVCWebApplications-MDEwOlJlcG9zaXRvcnkxMTkzNTI2Mzc=-flat-ShirtController.cs.html,21,EarTrumpet-MDEwOlJlcG9zaXRvcnkzODkxOTcwMg==-flat-HotkeyViewModel.cs,20486D-DevelopingASPNETMVCWebApplications-MDEwOlJlcG9zaXRvcnkxMTkzNTI2Mzc=-flat-ShirtController.cs,29,33,4,14,18,4
209,https://htmlpreview.github.io/?https://github.com/Christina96/boilerplate-sample-matches/blob/main/Csharp/20486D-DevelopingASPNETMVCWebApplications-MDEwOlJlcG9zaXRvcnkxMTkzNTI2Mzc=-flat-20180801103729_InitialCreate.cs-20486D-DevelopingASPNETMVCWebApplications-MDEwOlJlcG9zaXRvcnkxMTkzNTI2Mzc=-flat-20181225114624_InitialCreate.cs.html,37,20486D-DevelopingASPNETMVCWebApplications-MDEwOlJlcG9zaXRvcnkxMTkzNTI2Mzc=-flat-20180801103729_InitialCreate.cs,20486D-DevelopingASPNETMVCWebApplications-MDEwOlJlcG9zaXRvcnkxMTkzNTI2Mzc=-flat-20181225114624_InitialCreate.cs,24,30,6,10,16,6
210,https://htmlpreview.github.io/?https://github.com/Christina96/boilerplate-sample-matches/blob/main/Csharp/runner-MDEwOlJlcG9zaXRvcnkxODQyODY4NzU=-flat-ContainerHookManager.cs-runner-MDEwOlJlcG9zaXRvcnkxODQyODY4NzU=-flat-ContainerHookManager.cs.html,27,runner-MDEwOlJlcG9zaXRvcnkxODQyODY4NzU=-flat-ContainerHookManager.cs,runner-MDEwOlJlcG9zaXRvcnkxODQyODY4NzU=-flat-ContainerHookManager.cs,144,148,4,144,148,4
211,https://htmlpreview.github.io/?https://github.com/Christina96/boilerplate-sample-matches/blob/main/Csharp/NetCoreServer-MDEwOlJlcG9zaXRvcnkxNjYxMjMxNjQ=-flat-WebSocket.cs-NetCoreServer-MDEwOlJlcG9zaXRvcnkxNjYxMjMxNjQ=-flat-WebSocket.cs.html,15,NetCoreServer-MDEwOlJlcG9zaXRvcnkxNjYxMjMxNjQ=-flat-WebSocket.cs,NetCoreServer-MDEwOlJlcG9zaXRvcnkxNjYxMjMxNjQ=-flat-WebSocket.cs,197,199,2,178,180,2
212,https://htmlpreview.github.io/?https://github.com/Christina96/boilerplate-sample-matches/blob/main/Csharp/MudBlazor-MDEwOlJlcG9zaXRvcnkyODg0Mjg2NzY=-flat-MockBreakpointService.cs-MudBlazor-MDEwOlJlcG9zaXRvcnkyODg0Mjg2NzY=-flat-MockResizeService.cs.html,101,MudBlazor-MDEwOlJlcG9zaXRvcnkyODg0Mjg2NzY=-flat-MockBreakpointService.cs,MudBlazor-MDEwOlJlcG9zaXRvcnkyODg0Mjg2NzY=-flat-MockResizeService.cs,17,39,22,17,39,22
213,https://htmlpreview.github.io/?https://github.com/Christina96/boilerplate-sample-matches/blob/main/Csharp/NetCoreServer-MDEwOlJlcG9zaXRvcnkxNjYxMjMxNjQ=-flat-SslSession.cs-MudBlazor-MDEwOlJlcG9zaXRvcnkyODg0Mjg2NzY=-flat-MudDataGrid.razor.cs.html,15,NetCoreServer-MDEwOlJlcG9zaXRvcnkxNjYxMjMxNjQ=-flat-SslSession.cs,MudBlazor-MDEwOlJlcG9zaXRvcnkyODg0Mjg2NzY=-flat-MudDataGrid.razor.cs,287,290,3,527,530,3
214,https://htmlpreview.github.io/?https://github.com/Christina96/boilerplate-sample-matches/blob/main/Csharp/dotween-MDEwOlJlcG9zaXRvcnkzMjQ3NTE2Mg==-flat-GoTweenUtils.cs-dotween-MDEwOlJlcG9zaXRvcnkzMjQ3NTE2Mg==-flat-GoTweenUtils.cs.html,61,dotween-MDEwOlJlcG9zaXRvcnkzMjQ3NTE2Mg==-flat-GoTweenUtils.cs,dotween-MDEwOlJlcG9zaXRvcnkzMjQ3NTE2Mg==-flat-GoTweenUtils.cs,88,96,8,106,114,8
215,https://htmlpreview.github.io/?https://github.com/Christina96/boilerplate-sample-matches/blob/main/Csharp/runner-MDEwOlJlcG9zaXRvcnkxODQyODY4NzU=-flat-GenerateConstantAttributes.cs-runner-MDEwOlJlcG9zaXRvcnkxODQyODY4NzU=-flat-GenerateConstantAttributes.cs.html,22,runner-MDEwOlJlcG9zaXRvcnkxODQyODY4NzU=-flat-GenerateConstantAttributes.cs,runner-MDEwOlJlcG9zaXRvcnkxODQyODY4NzU=-flat-GenerateConstantAttributes.cs,25,32,7,16,23,7
216,https://htmlpreview.github.io/?https://github.com/Christina96/boilerplate-sample-matches/blob/main/Csharp/MudBlazor-MDEwOlJlcG9zaXRvcnkyODg0Mjg2NzY=-flat-ColorPickerTests.cs-MudBlazor-MDEwOlJlcG9zaXRvcnkyODg0Mjg2NzY=-flat-ColorPickerTests.cs.html,43,MudBlazor-MDEwOlJlcG9zaXRvcnkyODg0Mjg2NzY=-flat-ColorPickerTests.cs,MudBlazor-MDEwOlJlcG9zaXRvcnkyODg0Mjg2NzY=-flat-ColorPickerTests.cs,249,255,6,249,255,6
217,https://htmlpreview.github.io/?https://github.com/Christina96/boilerplate-sample-matches/blob/main/Csharp/NetCoreServer-MDEwOlJlcG9zaXRvcnkxNjYxMjMxNjQ=-flat-Program_14.cs-NetCoreServer-MDEwOlJlcG9zaXRvcnkxNjYxMjMxNjQ=-flat-Program_12.cs.html,18,NetCoreServer-MDEwOlJlcG9zaXRvcnkxNjYxMjMxNjQ=-flat-Program_14.cs,NetCoreServer-MDEwOlJlcG9zaXRvcnkxNjYxMjMxNjQ=-flat-Program_12.cs,55,57,2,95,97,2
218,https://htmlpreview.github.io/?https://github.com/Christina96/boilerplate-sample-matches/blob/main/Csharp/ZXing.Net.Mobile-MDEwOlJlcG9zaXRvcnk2MTYwNjcz-flat-ZXingScannerControl.xaml.cs-MudBlazor-MDEwOlJlcG9zaXRvcnkyODg0Mjg2NzY=-flat-Column.razor.cs.html,12,ZXing.Net.Mobile-MDEwOlJlcG9zaXRvcnk2MTYwNjcz-flat-ZXingScannerControl.xaml.cs,MudBlazor-MDEwOlJlcG9zaXRvcnkyODg0Mjg2NzY=-flat-Column.razor.cs,572,577,5,179,184,5
219,https://htmlpreview.github.io/?https://github.com/Christina96/boilerplate-sample-matches/blob/main/Csharp/runner-MDEwOlJlcG9zaXRvcnkxODQyODY4NzU=-flat-ServiceDefinition.cs-runner-MDEwOlJlcG9zaXRvcnkxODQyODY4NzU=-flat-ServiceDefinition.cs.html,32,runner-MDEwOlJlcG9zaXRvcnkxODQyODY4NzU=-flat-ServiceDefinition.cs,runner-MDEwOlJlcG9zaXRvcnkxODQyODY4NzU=-flat-ServiceDefinition.cs,250,264,14,220,234,14
220,https://htmlpreview.github.io/?https://github.com/Christina96/boilerplate-sample-matches/blob/main/Csharp/runner-MDEwOlJlcG9zaXRvcnkxODQyODY4NzU=-flat-VssHttpClientBase.cs-runner-MDEwOlJlcG9zaXRvcnkxODQyODY4NzU=-flat-VssHttpClientBase.cs.html,14,runner-MDEwOlJlcG9zaXRvcnkxODQyODY4NzU=-flat-VssHttpClientBase.cs,runner-MDEwOlJlcG9zaXRvcnkxODQyODY4NzU=-flat-VssHttpClientBase.cs,185,188,3,261,264,3
221,https://htmlpreview.github.io/?https://github.com/Christina96/boilerplate-sample-matches/blob/main/Csharp/ZXing.Net.Mobile-MDEwOlJlcG9zaXRvcnk2MTYwNjcz-flat-ZXingScannerControl.xaml.cs-ZXing.Net.Mobile-MDEwOlJlcG9zaXRvcnk2MTYwNjcz-flat-ZXingScannerControl.xaml.cs.html,13,ZXing.Net.Mobile-MDEwOlJlcG9zaXRvcnk2MTYwNjcz-flat-ZXingScannerControl.xaml.cs,ZXing.Net.Mobile-MDEwOlJlcG9zaXRvcnk2MTYwNjcz-flat-ZXingScannerControl.xaml.cs,49,52,3,49,52,3
222,https://htmlpreview.github.io/?https://github.com/Christina96/boilerplate-sample-matches/blob/main/Csharp/MudBlazor-MDEwOlJlcG9zaXRvcnkyODg0Mjg2NzY=-flat-Bar.razor.cs-MudBlazor-MDEwOlJlcG9zaXRvcnkyODg0Mjg2NzY=-flat-Bar.razor.cs.html,65,MudBlazor-MDEwOlJlcG9zaXRvcnkyODg0Mjg2NzY=-flat-Bar.razor.cs,MudBlazor-MDEwOlJlcG9zaXRvcnkyODg0Mjg2NzY=-flat-Bar.razor.cs,32,47,15,32,47,15
223,https://htmlpreview.github.io/?https://github.com/Christina96/boilerplate-sample-matches/blob/main/Csharp/runner-MDEwOlJlcG9zaXRvcnkxODQyODY4NzU=-flat-ServerDataProvider.cs-runner-MDEwOlJlcG9zaXRvcnkxODQyODY4NzU=-flat-ServerDataProvider.cs.html,13,runner-MDEwOlJlcG9zaXRvcnkxODQyODY4NzU=-flat-ServerDataProvider.cs,runner-MDEwOlJlcG9zaXRvcnkxODQyODY4NzU=-flat-ServerDataProvider.cs,59,63,4,52,55,3
224,https://htmlpreview.github.io/?https://github.com/Christina96/boilerplate-sample-matches/blob/main/Csharp/NetCoreServer-MDEwOlJlcG9zaXRvcnkxNjYxMjMxNjQ=-flat-Program_24.cs-NetCoreServer-MDEwOlJlcG9zaXRvcnkxNjYxMjMxNjQ=-flat-Program_21.cs.html,304,NetCoreServer-MDEwOlJlcG9zaXRvcnkxNjYxMjMxNjQ=-flat-Program_24.cs,NetCoreServer-MDEwOlJlcG9zaXRvcnkxNjYxMjMxNjQ=-flat-Program_21.cs,50,103,53,52,105,53
225,https://htmlpreview.github.io/?https://github.com/Christina96/boilerplate-sample-matches/blob/main/Csharp/NetCoreServer-MDEwOlJlcG9zaXRvcnkxNjYxMjMxNjQ=-flat-SslSession.cs-NetCoreServer-MDEwOlJlcG9zaXRvcnkxNjYxMjMxNjQ=-flat-SslClient.cs.html,23,NetCoreServer-MDEwOlJlcG9zaXRvcnkxNjYxMjMxNjQ=-flat-SslSession.cs,NetCoreServer-MDEwOlJlcG9zaXRvcnkxNjYxMjMxNjQ=-flat-SslClient.cs,368,376,8,486,494,8
226,https://htmlpreview.github.io/?https://github.com/Christina96/boilerplate-sample-matches/blob/main/Csharp/npgsql-MDEwOlJlcG9zaXRvcnkyODgzNTc0-flat-VoidHandler.cs-npgsql-MDEwOlJlcG9zaXRvcnkyODgzNTc0-flat-RangeHandler.cs.html,43,npgsql-MDEwOlJlcG9zaXRvcnkyODgzNTc0-flat-VoidHandler.cs,npgsql-MDEwOlJlcG9zaXRvcnkyODgzNTc0-flat-RangeHandler.cs,22,27,5,102,107,5
227,https://htmlpreview.github.io/?https://github.com/Christina96/boilerplate-sample-matches/blob/main/Csharp/runner-MDEwOlJlcG9zaXRvcnkxODQyODY4NzU=-flat-TemplateMemory.cs-npgsql-MDEwOlJlcG9zaXRvcnkyODgzNTc0-flat-NpgsqlDataReader.cs.html,13,runner-MDEwOlJlcG9zaXRvcnkxODQyODY4NzU=-flat-TemplateMemory.cs,npgsql-MDEwOlJlcG9zaXRvcnkyODgzNTc0-flat-NpgsqlDataReader.cs,56,58,2,1060,1062,2
228,https://htmlpreview.github.io/?https://github.com/Christina96/boilerplate-sample-matches/blob/main/Csharp/npgsql-MDEwOlJlcG9zaXRvcnkyODgzNTc0-flat-SecurityTests.cs-npgsql-MDEwOlJlcG9zaXRvcnkyODgzNTc0-flat-SecurityTests.cs.html,163,npgsql-MDEwOlJlcG9zaXRvcnkyODgzNTc0-flat-SecurityTests.cs,npgsql-MDEwOlJlcG9zaXRvcnkyODgzNTc0-flat-SecurityTests.cs,378,396,18,378,396,18
229,https://htmlpreview.github.io/?https://github.com/Christina96/boilerplate-sample-matches/blob/main/Csharp/runner-MDEwOlJlcG9zaXRvcnkxODQyODY4NzU=-flat-TemplateContext.cs-runner-MDEwOlJlcG9zaXRvcnkxODQyODY4NzU=-flat-TemplateContext.cs.html,50,runner-MDEwOlJlcG9zaXRvcnkxODQyODY4NzU=-flat-TemplateContext.cs,runner-MDEwOlJlcG9zaXRvcnkxODQyODY4NzU=-flat-TemplateContext.cs,105,114,9,105,114,9
230,https://htmlpreview.github.io/?https://github.com/Christina96/boilerplate-sample-matches/blob/main/Csharp/dotween-MDEwOlJlcG9zaXRvcnkzMjQ3NTE2Mg==-flat-iTween_121.cs-dotween-MDEwOlJlcG9zaXRvcnkzMjQ3NTE2Mg==-flat-iTween.cs.html,403,dotween-MDEwOlJlcG9zaXRvcnkzMjQ3NTE2Mg==-flat-iTween_121.cs,dotween-MDEwOlJlcG9zaXRvcnkzMjQ3NTE2Mg==-flat-iTween.cs,1792,1842,50,1792,1842,50
231,https://htmlpreview.github.io/?https://github.com/Christina96/boilerplate-sample-matches/blob/main/Csharp/MudBlazor-MDEwOlJlcG9zaXRvcnkyODg0Mjg2NzY=-flat-MudListItem.razor.cs-dotween-MDEwOlJlcG9zaXRvcnkzMjQ3NTE2Mg==-flat-MaterialColorTweenProperty.cs.html,13,MudBlazor-MDEwOlJlcG9zaXRvcnkyODg0Mjg2NzY=-flat-MudListItem.razor.cs,dotween-MDEwOlJlcG9zaXRvcnkzMjQ3NTE2Mg==-flat-MaterialColorTweenProperty.cs,90,92,2,27,29,2
232,https://htmlpreview.github.io/?https://github.com/Christina96/boilerplate-sample-matches/blob/main/Csharp/npgsql-MDEwOlJlcG9zaXRvcnkyODgzNTc0-flat-CommandTests.cs-npgsql-MDEwOlJlcG9zaXRvcnkyODgzNTc0-flat-BugTests.cs.html,13,npgsql-MDEwOlJlcG9zaXRvcnkyODgzNTc0-flat-CommandTests.cs,npgsql-MDEwOlJlcG9zaXRvcnkyODgzNTc0-flat-BugTests.cs,15,19,4,13,17,4
233,https://htmlpreview.github.io/?https://github.com/Christina96/boilerplate-sample-matches/blob/main/Csharp/runner-MDEwOlJlcG9zaXRvcnkxODQyODY4NzU=-flat-HandlerFactory.cs-runner-MDEwOlJlcG9zaXRvcnkxODQyODY4NzU=-flat-HandlerFactory.cs.html,33,runner-MDEwOlJlcG9zaXRvcnkxODQyODY4NzU=-flat-HandlerFactory.cs,runner-MDEwOlJlcG9zaXRvcnkxODQyODY4NzU=-flat-HandlerFactory.cs,28,36,8,15,22,7
234,https://htmlpreview.github.io/?https://github.com/Christina96/boilerplate-sample-matches/blob/main/Csharp/dotween-MDEwOlJlcG9zaXRvcnkzMjQ3NTE2Mg==-flat-GoSpline.cs-dotween-MDEwOlJlcG9zaXRvcnkzMjQ3NTE2Mg==-flat-GoSpline.cs.html,39,dotween-MDEwOlJlcG9zaXRvcnkzMjQ3NTE2Mg==-flat-GoSpline.cs,dotween-MDEwOlJlcG9zaXRvcnkzMjQ3NTE2Mg==-flat-GoSpline.cs,145,153,8,145,153,8
235,https://htmlpreview.github.io/?https://github.com/Christina96/boilerplate-sample-matches/blob/main/Csharp/npgsql-MDEwOlJlcG9zaXRvcnkyODgzNTc0-flat-NodaTimeTypeHandlerResolver.cs-npgsql-MDEwOlJlcG9zaXRvcnkyODgzNTc0-flat-NodaTimeTypeHandlerResolver.cs.html,24,npgsql-MDEwOlJlcG9zaXRvcnkyODgzNTc0-flat-NodaTimeTypeHandlerResolver.cs,npgsql-MDEwOlJlcG9zaXRvcnkyODgzNTc0-flat-NodaTimeTypeHandlerResolver.cs,114,117,3,111,114,3
236,https://htmlpreview.github.io/?https://github.com/Christina96/boilerplate-sample-matches/blob/main/Csharp/runner-MDEwOlJlcG9zaXRvcnkxODQyODY4NzU=-flat-SetEnvFileCommandL0.cs-runner-MDEwOlJlcG9zaXRvcnkxODQyODY4NzU=-flat-SetOutputFileCommandL0.cs.html,26,runner-MDEwOlJlcG9zaXRvcnkxODQyODY4NzU=-flat-SetEnvFileCommandL0.cs,runner-MDEwOlJlcG9zaXRvcnkxODQyODY4NzU=-flat-SetOutputFileCommandL0.cs,381,385,4,383,387,4
237,https://htmlpreview.github.io/?https://github.com/Christina96/boilerplate-sample-matches/blob/main/Csharp/npgsql-MDEwOlJlcG9zaXRvcnkyODgzNTc0-flat-PoolTests.cs-npgsql-MDEwOlJlcG9zaXRvcnkyODgzNTc0-flat-ConnectionTests.cs.html,15,npgsql-MDEwOlJlcG9zaXRvcnkyODgzNTc0-flat-PoolTests.cs,npgsql-MDEwOlJlcG9zaXRvcnkyODgzNTc0-flat-ConnectionTests.cs,317,319,2,574,576,2
238,https://htmlpreview.github.io/?https://github.com/Christina96/boilerplate-sample-matches/blob/main/Csharp/npgsql-MDEwOlJlcG9zaXRvcnkyODgzNTc0-flat-NpgsqlCommand.cs-npgsql-MDEwOlJlcG9zaXRvcnkyODgzNTc0-flat-NpgsqlCommand.cs.html,38,npgsql-MDEwOlJlcG9zaXRvcnkyODgzNTc0-flat-NpgsqlCommand.cs,npgsql-MDEwOlJlcG9zaXRvcnkyODgzNTc0-flat-NpgsqlCommand.cs,717,722,5,730,735,5
239,https://htmlpreview.github.io/?https://github.com/Christina96/boilerplate-sample-matches/blob/main/Csharp/MudBlazor-MDEwOlJlcG9zaXRvcnkyODg0Mjg2NzY=-flat-MudTimePicker.razor.cs-MudBlazor-MDEwOlJlcG9zaXRvcnkyODg0Mjg2NzY=-flat-MudTimePicker.razor.cs.html,15,MudBlazor-MDEwOlJlcG9zaXRvcnkyODg0Mjg2NzY=-flat-MudTimePicker.razor.cs,MudBlazor-MDEwOlJlcG9zaXRvcnkyODg0Mjg2NzY=-flat-MudTimePicker.razor.cs,182,186,4,193,197,4
240,https://htmlpreview.github.io/?https://github.com/Christina96/boilerplate-sample-matches/blob/main/Csharp/dotween-MDEwOlJlcG9zaXRvcnkzMjQ3NTE2Mg==-flat-BrainBase.cs-dotween-MDEwOlJlcG9zaXRvcnkzMjQ3NTE2Mg==-flat-CustomPluginExampleBrain_55.cs.html,16,dotween-MDEwOlJlcG9zaXRvcnkzMjQ3NTE2Mg==-flat-BrainBase.cs,dotween-MDEwOlJlcG9zaXRvcnkzMjQ3NTE2Mg==-flat-CustomPluginExampleBrain_55.cs,2,6,4,2,6,4
241,https://htmlpreview.github.io/?https://github.com/Christina96/boilerplate-sample-matches/blob/main/Csharp/MudBlazor-MDEwOlJlcG9zaXRvcnkyODg0Mjg2NzY=-flat-PatternMask.cs-MudBlazor-MDEwOlJlcG9zaXRvcnkyODg0Mjg2NzY=-flat-RegexMask.cs.html,23,MudBlazor-MDEwOlJlcG9zaXRvcnkyODg0Mjg2NzY=-flat-PatternMask.cs,MudBlazor-MDEwOlJlcG9zaXRvcnkyODg0Mjg2NzY=-flat-RegexMask.cs,41,46,5,46,51,5
242,https://htmlpreview.github.io/?https://github.com/Christina96/boilerplate-sample-matches/blob/main/Csharp/runner-MDEwOlJlcG9zaXRvcnkxODQyODY4NzU=-flat-TemplateTokenExtensions_9.cs-runner-MDEwOlJlcG9zaXRvcnkxODQyODY4NzU=-flat-TemplateTokenExtensions_9.cs.html,27,runner-MDEwOlJlcG9zaXRvcnkxODQyODY4NzU=-flat-TemplateTokenExtensions_9.cs,runner-MDEwOlJlcG9zaXRvcnkxODQyODY4NzU=-flat-TemplateTokenExtensions_9.cs,202,211,9,202,211,9
243,https://htmlpreview.github.io/?https://github.com/Christina96/boilerplate-sample-matches/blob/main/Csharp/runner-MDEwOlJlcG9zaXRvcnkxODQyODY4NzU=-flat-ResourceProperties.cs-runner-MDEwOlJlcG9zaXRvcnkxODQyODY4NzU=-flat-ResourceProperties.cs.html,18,runner-MDEwOlJlcG9zaXRvcnkxODQyODY4NzU=-flat-ResourceProperties.cs,runner-MDEwOlJlcG9zaXRvcnkxODQyODY4NzU=-flat-ResourceProperties.cs,212,216,4,212,216,4
244,https://htmlpreview.github.io/?https://github.com/Christina96/boilerplate-sample-matches/blob/main/Csharp/dotween-MDEwOlJlcG9zaXRvcnkzMjQ3NTE2Mg==-flat-LeanTween_56.cs-dotween-MDEwOlJlcG9zaXRvcnkzMjQ3NTE2Mg==-flat-LeanTween.cs.html,394,dotween-MDEwOlJlcG9zaXRvcnkzMjQ3NTE2Mg==-flat-LeanTween_56.cs,dotween-MDEwOlJlcG9zaXRvcnkzMjQ3NTE2Mg==-flat-LeanTween.cs,766,811,45,766,811,45
245,https://htmlpreview.github.io/?https://github.com/Christina96/boilerplate-sample-matches/blob/main/Csharp/ZXing.Net.Mobile-MDEwOlJlcG9zaXRvcnk2MTYwNjcz-flat-ZXingScannerPage.shared.cs-ZXing.Net.Mobile-MDEwOlJlcG9zaXRvcnk2MTYwNjcz-flat-ZXingScannerPage.shared.cs.html,11,ZXing.Net.Mobile-MDEwOlJlcG9zaXRvcnk2MTYwNjcz-flat-ZXingScannerPage.shared.cs,ZXing.Net.Mobile-MDEwOlJlcG9zaXRvcnk2MTYwNjcz-flat-ZXingScannerPage.shared.cs,139,142,3,139,142,3
246,https://htmlpreview.github.io/?https://github.com/Christina96/boilerplate-sample-matches/blob/main/Csharp/runner-MDEwOlJlcG9zaXRvcnkxODQyODY4NzU=-flat-TrackingManagerL0.cs-runner-MDEwOlJlcG9zaXRvcnkxODQyODY4NzU=-flat-TrackingManagerL0.cs.html,13,runner-MDEwOlJlcG9zaXRvcnkxODQyODY4NzU=-flat-TrackingManagerL0.cs,runner-MDEwOlJlcG9zaXRvcnkxODQyODY4NzU=-flat-TrackingManagerL0.cs,87,88,1,87,88,1
247,https://htmlpreview.github.io/?https://github.com/Christina96/boilerplate-sample-matches/blob/main/Csharp/npgsql-MDEwOlJlcG9zaXRvcnkyODgzNTc0-flat-PgPassFileTests.cs-npgsql-MDEwOlJlcG9zaXRvcnkyODgzNTc0-flat-PgPassFileTests.cs.html,28,npgsql-MDEwOlJlcG9zaXRvcnkyODgzNTc0-flat-PgPassFileTests.cs,npgsql-MDEwOlJlcG9zaXRvcnkyODgzNTc0-flat-PgPassFileTests.cs,25,28,3,18,21,3
248,https://htmlpreview.github.io/?https://github.com/Christina96/boilerplate-sample-matches/blob/main/Csharp/runner-MDEwOlJlcG9zaXRvcnkxODQyODY4NzU=-flat-SaveStateFileCommandL0.cs-runner-MDEwOlJlcG9zaXRvcnkxODQyODY4NzU=-flat-SaveStateFileCommandL0.cs.html,12,runner-MDEwOlJlcG9zaXRvcnkxODQyODY4NzU=-flat-SaveStateFileCommandL0.cs,runner-MDEwOlJlcG9zaXRvcnkxODQyODY4NzU=-flat-SaveStateFileCommandL0.cs,369,370,1,369,370,1
249,https://htmlpreview.github.io/?https://github.com/Christina96/boilerplate-sample-matches/blob/main/Csharp/dotween-MDEwOlJlcG9zaXRvcnkzMjQ3NTE2Mg==-flat-TrailAndLineRenderer_19.cs-dotween-MDEwOlJlcG9zaXRvcnkzMjQ3NTE2Mg==-flat-TrailAndLineRenderer.cs.html,59,dotween-MDEwOlJlcG9zaXRvcnkzMjQ3NTE2Mg==-flat-TrailAndLineRenderer_19.cs,dotween-MDEwOlJlcG9zaXRvcnkzMjQ3NTE2Mg==-flat-TrailAndLineRenderer.cs,15,22,7,15,22,7
250,https://htmlpreview.github.io/?https://github.com/Christina96/boilerplate-sample-matches/blob/main/Csharp/npgsql-MDEwOlJlcG9zaXRvcnkyODgzNTc0-flat-NpgsqlConnection.cs-npgsql-MDEwOlJlcG9zaXRvcnkyODgzNTc0-flat-NpgsqlConnection.cs.html,197,npgsql-MDEwOlJlcG9zaXRvcnkyODgzNTc0-flat-NpgsqlConnection.cs,npgsql-MDEwOlJlcG9zaXRvcnkyODgzNTc0-flat-NpgsqlConnection.cs,700,725,25,700,725,25
251,https://htmlpreview.github.io/?https://github.com/Christina96/boilerplate-sample-matches/blob/main/Csharp/dotween-MDEwOlJlcG9zaXRvcnkzMjQ3NTE2Mg==-flat-MultipleAxisRotation_44.cs-dotween-MDEwOlJlcG9zaXRvcnkzMjQ3NTE2Mg==-flat-MultipleAxisRotation_44.cs.html,107,dotween-MDEwOlJlcG9zaXRvcnkzMjQ3NTE2Mg==-flat-MultipleAxisRotation_44.cs,dotween-MDEwOlJlcG9zaXRvcnkzMjQ3NTE2Mg==-flat-MultipleAxisRotation_44.cs,14,23,9,14,23,9
252,https://htmlpreview.github.io/?https://github.com/Christina96/boilerplate-sample-matches/blob/main/Csharp/ZXing.Net.Mobile-MDEwOlJlcG9zaXRvcnk2MTYwNjcz-flat-ZxingOverlayView.android.cs-ZXing.Net.Mobile-MDEwOlJlcG9zaXRvcnk2MTYwNjcz-flat-ZxingOverlayView.android.cs.html,19,ZXing.Net.Mobile-MDEwOlJlcG9zaXRvcnk2MTYwNjcz-flat-ZxingOverlayView.android.cs,ZXing.Net.Mobile-MDEwOlJlcG9zaXRvcnk2MTYwNjcz-flat-ZxingOverlayView.android.cs,71,72,1,78,79,1
253,https://htmlpreview.github.io/?https://github.com/Christina96/boilerplate-sample-matches/blob/main/Csharp/dotween-MDEwOlJlcG9zaXRvcnkzMjQ3NTE2Mg==-flat-AddTweenIndexOutOfRange_50.cs-dotween-MDEwOlJlcG9zaXRvcnkzMjQ3NTE2Mg==-flat-AddTweenIndexOutOfRange.cs.html,198,dotween-MDEwOlJlcG9zaXRvcnkzMjQ3NTE2Mg==-flat-AddTweenIndexOutOfRange_50.cs,dotween-MDEwOlJlcG9zaXRvcnkzMjQ3NTE2Mg==-flat-AddTweenIndexOutOfRange.cs,17,48,31,17,48,31
254,https://htmlpreview.github.io/?https://github.com/Christina96/boilerplate-sample-matches/blob/main/Csharp/20486D-DevelopingASPNETMVCWebApplications-MDEwOlJlcG9zaXRvcnkxMTkzNTI2Mzc=-flat-ICounter_11.cs-20486D-DevelopingASPNETMVCWebApplications-MDEwOlJlcG9zaXRvcnkxMTkzNTI2Mzc=-flat-ICounter_11.cs.html,25,20486D-DevelopingASPNETMVCWebApplications-MDEwOlJlcG9zaXRvcnkxMTkzNTI2Mzc=-flat-ICounter_11.cs,20486D-DevelopingASPNETMVCWebApplications-MDEwOlJlcG9zaXRvcnkxMTkzNTI2Mzc=-flat-ICounter_11.cs,7,12,5,7,12,5
255,https://htmlpreview.github.io/?https://github.com/Christina96/boilerplate-sample-matches/blob/main/Csharp/dotween-MDEwOlJlcG9zaXRvcnkzMjQ3NTE2Mg==-flat-GoSplineStraightLineSolver.cs-dotween-MDEwOlJlcG9zaXRvcnkzMjQ3NTE2Mg==-flat-GoSplineStraightLineSolver_68.cs.html,119,dotween-MDEwOlJlcG9zaXRvcnkzMjQ3NTE2Mg==-flat-GoSplineStraightLineSolver.cs,dotween-MDEwOlJlcG9zaXRvcnkzMjQ3NTE2Mg==-flat-GoSplineStraightLineSolver_68.cs,44,66,22,44,66,22
256,https://htmlpreview.github.io/?https://github.com/Christina96/boilerplate-sample-matches/blob/main/Csharp/Simple.Data-MDEwOlJlcG9zaXRvcnk4MTg3Njg=-flat-UpdateTests.cs-MudBlazor-MDEwOlJlcG9zaXRvcnkyODg0Mjg2NzY=-flat-DateRangePickerTests.cs.html,14,Simple.Data-MDEwOlJlcG9zaXRvcnk4MTg3Njg=-flat-UpdateTests.cs,MudBlazor-MDEwOlJlcG9zaXRvcnkyODg0Mjg2NzY=-flat-DateRangePickerTests.cs,82,83,1,448,449,1
257,https://htmlpreview.github.io/?https://github.com/Christina96/boilerplate-sample-matches/blob/main/Csharp/NetCoreServer-MDEwOlJlcG9zaXRvcnkxNjYxMjMxNjQ=-flat-Program_37.cs-NetCoreServer-MDEwOlJlcG9zaXRvcnkxNjYxMjMxNjQ=-flat-Program_48.cs.html,12,NetCoreServer-MDEwOlJlcG9zaXRvcnkxNjYxMjMxNjQ=-flat-Program_37.cs,NetCoreServer-MDEwOlJlcG9zaXRvcnkxNjYxMjMxNjQ=-flat-Program_48.cs,63,66,3,54,57,3
258,https://htmlpreview.github.io/?https://github.com/Christina96/boilerplate-sample-matches/blob/main/Csharp/20486D-DevelopingASPNETMVCWebApplications-MDEwOlJlcG9zaXRvcnkxMTkzNTI2Mzc=-flat-RestaurantContext.cs-20486D-DevelopingASPNETMVCWebApplications-MDEwOlJlcG9zaXRvcnkxMTkzNTI2Mzc=-flat-RestaurantContext.cs.html,22,20486D-DevelopingASPNETMVCWebApplications-MDEwOlJlcG9zaXRvcnkxMTkzNTI2Mzc=-flat-RestaurantContext.cs,20486D-DevelopingASPNETMVCWebApplications-MDEwOlJlcG9zaXRvcnkxMTkzNTI2Mzc=-flat-RestaurantContext.cs,93,100,7,93,100,7
259,https://htmlpreview.github.io/?https://github.com/Christina96/boilerplate-sample-matches/blob/main/Csharp/MudBlazor-MDEwOlJlcG9zaXRvcnkyODg0Mjg2NzY=-flat-NumericFieldTests.cs-MudBlazor-MDEwOlJlcG9zaXRvcnkyODg0Mjg2NzY=-flat-NumericFieldTests.cs.html,14,MudBlazor-MDEwOlJlcG9zaXRvcnkyODg0Mjg2NzY=-flat-NumericFieldTests.cs,MudBlazor-MDEwOlJlcG9zaXRvcnkyODg0Mjg2NzY=-flat-NumericFieldTests.cs,165,166,1,185,186,1
260,https://htmlpreview.github.io/?https://github.com/Christina96/boilerplate-sample-matches/blob/main/Csharp/npgsql-MDEwOlJlcG9zaXRvcnkyODgzNTc0-flat-NpgsqlDataReader.cs-dotween-MDEwOlJlcG9zaXRvcnkzMjQ3NTE2Mg==-flat-RuntimeComponentInspector.cs.html,17,npgsql-MDEwOlJlcG9zaXRvcnkyODgzNTc0-flat-NpgsqlDataReader.cs,dotween-MDEwOlJlcG9zaXRvcnkzMjQ3NTE2Mg==-flat-RuntimeComponentInspector.cs,879,883,4,55,57,2
261,https://htmlpreview.github.io/?https://github.com/Christina96/boilerplate-sample-matches/blob/main/Csharp/dotween-MDEwOlJlcG9zaXRvcnkzMjQ3NTE2Mg==-flat-LeanTween.cs-dotween-MDEwOlJlcG9zaXRvcnkzMjQ3NTE2Mg==-flat-LeanTween_56.cs.html,13108,dotween-MDEwOlJlcG9zaXRvcnkzMjQ3NTE2Mg==-flat-LeanTween.cs,dotween-MDEwOlJlcG9zaXRvcnkzMjQ3NTE2Mg==-flat-LeanTween_56.cs,1184,2560,1376,1184,2560,1376
262,https://htmlpreview.github.io/?https://github.com/Christina96/boilerplate-sample-matches/blob/main/Csharp/NetCoreServer-MDEwOlJlcG9zaXRvcnkxNjYxMjMxNjQ=-flat-Program_31.cs-Simple.Data-MDEwOlJlcG9zaXRvcnk4MTg3Njg=-flat-DictionaryQueryRunnerTest.cs.html,13,NetCoreServer-MDEwOlJlcG9zaXRvcnkxNjYxMjMxNjQ=-flat-Program_31.cs,Simple.Data-MDEwOlJlcG9zaXRvcnk4MTg3Njg=-flat-DictionaryQueryRunnerTest.cs,85,86,1,208,209,1
263,https://htmlpreview.github.io/?https://github.com/Christina96/boilerplate-sample-matches/blob/main/Csharp/npgsql-MDEwOlJlcG9zaXRvcnkyODgzNTc0-flat-SecurityTests.cs-npgsql-MDEwOlJlcG9zaXRvcnkyODgzNTc0-flat-SecurityTests.cs.html,59,npgsql-MDEwOlJlcG9zaXRvcnkyODgzNTc0-flat-SecurityTests.cs,npgsql-MDEwOlJlcG9zaXRvcnkyODgzNTc0-flat-SecurityTests.cs,120,135,15,120,135,15
264,https://htmlpreview.github.io/?https://github.com/Christina96/boilerplate-sample-matches/blob/main/Csharp/dotween-MDEwOlJlcG9zaXRvcnkzMjQ3NTE2Mg==-flat-LeanTween.cs-dotween-MDEwOlJlcG9zaXRvcnkzMjQ3NTE2Mg==-flat-LeanTween.cs.html,7806,dotween-MDEwOlJlcG9zaXRvcnkzMjQ3NTE2Mg==-flat-LeanTween.cs,dotween-MDEwOlJlcG9zaXRvcnkzMjQ3NTE2Mg==-flat-LeanTween.cs,1774,2560,786,1774,2560,786
265,https://htmlpreview.github.io/?https://github.com/Christina96/boilerplate-sample-matches/blob/main/Csharp/20486D-DevelopingASPNETMVCWebApplications-MDEwOlJlcG9zaXRvcnkxMTkzNTI2Mzc=-flat-Counter_5.cs-20486D-DevelopingASPNETMVCWebApplications-MDEwOlJlcG9zaXRvcnkxMTkzNTI2Mzc=-flat-Counter.cs.html,56,20486D-DevelopingASPNETMVCWebApplications-MDEwOlJlcG9zaXRvcnkxMTkzNTI2Mzc=-flat-Counter_5.cs,20486D-DevelopingASPNETMVCWebApplications-MDEwOlJlcG9zaXRvcnkxMTkzNTI2Mzc=-flat-Counter.cs,10,19,9,10,19,9
266,https://htmlpreview.github.io/?https://github.com/Christina96/boilerplate-sample-matches/blob/main/Csharp/NetCoreServer-MDEwOlJlcG9zaXRvcnkxNjYxMjMxNjQ=-flat-com.chronoxor.fbe.cs-NetCoreServer-MDEwOlJlcG9zaXRvcnkxNjYxMjMxNjQ=-flat-com.chronoxor.fbe.cs.html,75,NetCoreServer-MDEwOlJlcG9zaXRvcnkxNjYxMjMxNjQ=-flat-com.chronoxor.fbe.cs,NetCoreServer-MDEwOlJlcG9zaXRvcnkxNjYxMjMxNjQ=-flat-com.chronoxor.fbe.cs,1122,1127,5,1051,1056,5
267,https://htmlpreview.github.io/?https://github.com/Christina96/boilerplate-sample-matches/blob/main/Csharp/npgsql-MDEwOlJlcG9zaXRvcnkyODgzNTc0-flat-ReplicationConnection.cs-npgsql-MDEwOlJlcG9zaXRvcnkyODgzNTc0-flat-ReplicationConnection.cs.html,23,npgsql-MDEwOlJlcG9zaXRvcnkyODgzNTc0-flat-ReplicationConnection.cs,npgsql-MDEwOlJlcG9zaXRvcnkyODgzNTc0-flat-ReplicationConnection.cs,76,79,3,71,74,3
268,https://htmlpreview.github.io/?https://github.com/Christina96/boilerplate-sample-matches/blob/main/Csharp/npgsql-MDEwOlJlcG9zaXRvcnkyODgzNTc0-flat-ReaderTests.cs-npgsql-MDEwOlJlcG9zaXRvcnkyODgzNTc0-flat-ReaderTests.cs.html,65,npgsql-MDEwOlJlcG9zaXRvcnkyODgzNTc0-flat-ReaderTests.cs,npgsql-MDEwOlJlcG9zaXRvcnkyODgzNTc0-flat-ReaderTests.cs,496,501,5,496,501,5
269,https://htmlpreview.github.io/?https://github.com/Christina96/boilerplate-sample-matches/blob/main/Csharp/ZXing.Net.Mobile-MDEwOlJlcG9zaXRvcnk2MTYwNjcz-flat-MainPage.xaml_1.cs-ZXing.Net.Mobile-MDEwOlJlcG9zaXRvcnk2MTYwNjcz-flat-MainPage.xaml.cs.html,13,ZXing.Net.Mobile-MDEwOlJlcG9zaXRvcnk2MTYwNjcz-flat-MainPage.xaml_1.cs,ZXing.Net.Mobile-MDEwOlJlcG9zaXRvcnk2MTYwNjcz-flat-MainPage.xaml.cs,23,27,4,22,26,4
270,https://htmlpreview.github.io/?https://github.com/Christina96/boilerplate-sample-matches/blob/main/Csharp/dotween-MDEwOlJlcG9zaXRvcnkzMjQ3NTE2Mg==-flat-LeanTween_56.cs-dotween-MDEwOlJlcG9zaXRvcnkzMjQ3NTE2Mg==-flat-LeanTween.cs.html,7676,dotween-MDEwOlJlcG9zaXRvcnkzMjQ3NTE2Mg==-flat-LeanTween_56.cs,dotween-MDEwOlJlcG9zaXRvcnkzMjQ3NTE2Mg==-flat-LeanTween.cs,1785,2560,775,1785,2560,775
271,https://htmlpreview.github.io/?https://github.com/Christina96/boilerplate-sample-matches/blob/main/Csharp/dotween-MDEwOlJlcG9zaXRvcnkzMjQ3NTE2Mg==-flat-LeanTween.cs-dotween-MDEwOlJlcG9zaXRvcnkzMjQ3NTE2Mg==-flat-LeanTween.cs.html,3399,dotween-MDEwOlJlcG9zaXRvcnkzMjQ3NTE2Mg==-flat-LeanTween.cs,dotween-MDEwOlJlcG9zaXRvcnkzMjQ3NTE2Mg==-flat-LeanTween.cs,344,811,467,344,811,467
272,https://htmlpreview.github.io/?https://github.com/Christina96/boilerplate-sample-matches/blob/main/Csharp/runner-MDEwOlJlcG9zaXRvcnkxODQyODY4NzU=-flat-ActionManagerL0.cs-runner-MDEwOlJlcG9zaXRvcnkxODQyODY4NzU=-flat-ActionManagerL0.cs.html,20,runner-MDEwOlJlcG9zaXRvcnkxODQyODY4NzU=-flat-ActionManagerL0.cs,runner-MDEwOlJlcG9zaXRvcnkxODQyODY4NzU=-flat-ActionManagerL0.cs,1621,1623,2,1130,1132,2
273,https://htmlpreview.github.io/?https://github.com/Christina96/boilerplate-sample-matches/blob/main/Csharp/runner-MDEwOlJlcG9zaXRvcnkxODQyODY4NzU=-flat-TaskHttpClientBase.cs-runner-MDEwOlJlcG9zaXRvcnkxODQyODY4NzU=-flat-TaskHttpClientBase.cs.html,112,runner-MDEwOlJlcG9zaXRvcnkxODQyODY4NzU=-flat-TaskHttpClientBase.cs,runner-MDEwOlJlcG9zaXRvcnkxODQyODY4NzU=-flat-TaskHttpClientBase.cs,176,195,19,176,195,19
274,https://htmlpreview.github.io/?https://github.com/Christina96/boilerplate-sample-matches/blob/main/Csharp/NetCoreServer-MDEwOlJlcG9zaXRvcnkxNjYxMjMxNjQ=-flat-TcpServer.cs-NetCoreServer-MDEwOlJlcG9zaXRvcnkxNjYxMjMxNjQ=-flat-TcpClient.cs.html,14,NetCoreServer-MDEwOlJlcG9zaXRvcnkxNjYxMjMxNjQ=-flat-TcpServer.cs,NetCoreServer-MDEwOlJlcG9zaXRvcnkxNjYxMjMxNjQ=-flat-TcpClient.cs,24,26,2,22,24,2
275,https://htmlpreview.github.io/?https://github.com/Christina96/boilerplate-sample-matches/blob/main/Csharp/dotween-MDEwOlJlcG9zaXRvcnkzMjQ3NTE2Mg==-flat-DOTweenUtilityWindow.cs-dotween-MDEwOlJlcG9zaXRvcnkzMjQ3NTE2Mg==-flat-DOTweenUtilityWindow.cs.html,23,dotween-MDEwOlJlcG9zaXRvcnkzMjQ3NTE2Mg==-flat-DOTweenUtilityWindow.cs,dotween-MDEwOlJlcG9zaXRvcnkzMjQ3NTE2Mg==-flat-DOTweenUtilityWindow.cs,64,65,1,64,65,1
276,https://htmlpreview.github.io/?https://github.com/Christina96/boilerplate-sample-matches/blob/main/Csharp/runner-MDEwOlJlcG9zaXRvcnkxODQyODY4NzU=-flat-TemplateUnraveler.cs-runner-MDEwOlJlcG9zaXRvcnkxODQyODY4NzU=-flat-TemplateUnraveler.cs.html,145,runner-MDEwOlJlcG9zaXRvcnkxODQyODY4NzU=-flat-TemplateUnraveler.cs,runner-MDEwOlJlcG9zaXRvcnkxODQyODY4NzU=-flat-TemplateUnraveler.cs,35,70,35,35,70,35
277,https://htmlpreview.github.io/?https://github.com/Christina96/boilerplate-sample-matches/blob/main/Csharp/dotween-MDEwOlJlcG9zaXRvcnkzMjQ3NTE2Mg==-flat-EnginesComparison_0.cs-dotween-MDEwOlJlcG9zaXRvcnkzMjQ3NTE2Mg==-flat-EnginesComparison_0.cs.html,15,dotween-MDEwOlJlcG9zaXRvcnkzMjQ3NTE2Mg==-flat-EnginesComparison_0.cs,dotween-MDEwOlJlcG9zaXRvcnkzMjQ3NTE2Mg==-flat-EnginesComparison_0.cs,133,136,3,143,146,3
278,https://htmlpreview.github.io/?https://github.com/Christina96/boilerplate-sample-matches/blob/main/Csharp/EarTrumpet-MDEwOlJlcG9zaXRvcnkzODkxOTcwMg==-flat-FlyoutViewModel.cs-EarTrumpet-MDEwOlJlcG9zaXRvcnkzODkxOTcwMg==-flat-FlyoutViewModel.cs.html,19,EarTrumpet-MDEwOlJlcG9zaXRvcnkzODkxOTcwMg==-flat-FlyoutViewModel.cs,EarTrumpet-MDEwOlJlcG9zaXRvcnkzODkxOTcwMg==-flat-FlyoutViewModel.cs,62,66,4,62,66,4
279,https://htmlpreview.github.io/?https://github.com/Christina96/boilerplate-sample-matches/blob/main/Csharp/Security-MDEwOlJlcG9zaXRvcnkxNzcyMzY5OQ==-flat-PolicyTests.cs-Security-MDEwOlJlcG9zaXRvcnkxNzcyMzY5OQ==-flat-PolicyTests.cs.html,17,Security-MDEwOlJlcG9zaXRvcnkxNzcyMzY5OQ==-flat-PolicyTests.cs,Security-MDEwOlJlcG9zaXRvcnkxNzcyMzY5OQ==-flat-PolicyTests.cs,382,387,5,367,372,5
280,https://htmlpreview.github.io/?https://github.com/Christina96/boilerplate-sample-matches/blob/main/Csharp/runner-MDEwOlJlcG9zaXRvcnkxODQyODY4NzU=-flat-DockerUtilL0.cs-runner-MDEwOlJlcG9zaXRvcnkxODQyODY4NzU=-flat-DockerUtilL0.cs.html,54,runner-MDEwOlJlcG9zaXRvcnkxODQyODY4NzU=-flat-DockerUtilL0.cs,runner-MDEwOlJlcG9zaXRvcnkxODQyODY4NzU=-flat-DockerUtilL0.cs,46,52,6,52,58,6
281,https://htmlpreview.github.io/?https://github.com/Christina96/boilerplate-sample-matches/blob/main/Csharp/Simple.Data-MDEwOlJlcG9zaXRvcnk4MTg3Njg=-flat-NameResolutionTest.cs-Simple.Data-MDEwOlJlcG9zaXRvcnk4MTg3Njg=-flat-SchemaQualifiedTests.cs.html,20,Simple.Data-MDEwOlJlcG9zaXRvcnk4MTg3Njg=-flat-NameResolutionTest.cs,Simple.Data-MDEwOlJlcG9zaXRvcnk4MTg3Njg=-flat-SchemaQualifiedTests.cs,7,14,7,7,14,7
282,https://htmlpreview.github.io/?https://github.com/Christina96/boilerplate-sample-matches/blob/main/Csharp/dotween-MDEwOlJlcG9zaXRvcnkzMjQ3NTE2Mg==-flat-GoTween_59.cs-dotween-MDEwOlJlcG9zaXRvcnkzMjQ3NTE2Mg==-flat-GoTween_59.cs.html,851,dotween-MDEwOlJlcG9zaXRvcnkzMjQ3NTE2Mg==-flat-GoTween_59.cs,dotween-MDEwOlJlcG9zaXRvcnkzMjQ3NTE2Mg==-flat-GoTween_59.cs,21,200,179,21,200,179
283,https://htmlpreview.github.io/?https://github.com/Christina96/boilerplate-sample-matches/blob/main/Csharp/dotween-MDEwOlJlcG9zaXRvcnkzMjQ3NTE2Mg==-flat-TweenEnginesComparisonInternal_37.cs-dotween-MDEwOlJlcG9zaXRvcnkzMjQ3NTE2Mg==-flat-LeanTween.cs.html,12,dotween-MDEwOlJlcG9zaXRvcnkzMjQ3NTE2Mg==-flat-TweenEnginesComparisonInternal_37.cs,dotween-MDEwOlJlcG9zaXRvcnkzMjQ3NTE2Mg==-flat-LeanTween.cs,135,137,2,744,746,2
284,https://htmlpreview.github.io/?https://github.com/Christina96/boilerplate-sample-matches/blob/main/Csharp/dotween-MDEwOlJlcG9zaXRvcnkzMjQ3NTE2Mg==-flat-PositionTweenProperty_93.cs-dotween-MDEwOlJlcG9zaXRvcnkzMjQ3NTE2Mg==-flat-PositionTweenProperty_93.cs.html,151,dotween-MDEwOlJlcG9zaXRvcnkzMjQ3NTE2Mg==-flat-PositionTweenProperty_93.cs,dotween-MDEwOlJlcG9zaXRvcnkzMjQ3NTE2Mg==-flat-PositionTweenProperty_93.cs,29,67,38,29,67,38
285,https://htmlpreview.github.io/?https://github.com/Christina96/boilerplate-sample-matches/blob/main/Csharp/runner-MDEwOlJlcG9zaXRvcnkxODQyODY4NzU=-flat-LocationXmlOperator.cs-runner-MDEwOlJlcG9zaXRvcnkxODQyODY4NzU=-flat-LocationXmlOperator.cs.html,23,runner-MDEwOlJlcG9zaXRvcnkxODQyODY4NzU=-flat-LocationXmlOperator.cs,runner-MDEwOlJlcG9zaXRvcnkxODQyODY4NzU=-flat-LocationXmlOperator.cs,63,64,1,39,40,1
286,https://htmlpreview.github.io/?https://github.com/Christina96/boilerplate-sample-matches/blob/main/Csharp/EarTrumpet-MDEwOlJlcG9zaXRvcnkzODkxOTcwMg==-flat-HotkeyData.cs-EarTrumpet-MDEwOlJlcG9zaXRvcnkzODkxOTcwMg==-flat-HotkeyData.cs.html,12,EarTrumpet-MDEwOlJlcG9zaXRvcnkzODkxOTcwMg==-flat-HotkeyData.cs,EarTrumpet-MDEwOlJlcG9zaXRvcnkzODkxOTcwMg==-flat-HotkeyData.cs,72,77,5,72,77,5
287,https://htmlpreview.github.io/?https://github.com/Christina96/boilerplate-sample-matches/blob/main/Csharp/runner-MDEwOlJlcG9zaXRvcnkxODQyODY4NzU=-flat-LocationCacheManager.cs-runner-MDEwOlJlcG9zaXRvcnkxODQyODY4NzU=-flat-LocationCacheManager.cs.html,40,runner-MDEwOlJlcG9zaXRvcnkxODQyODY4NzU=-flat-LocationCacheManager.cs,runner-MDEwOlJlcG9zaXRvcnkxODQyODY4NzU=-flat-LocationCacheManager.cs,52,71,19,67,86,19
288,https://htmlpreview.github.io/?https://github.com/Christina96/boilerplate-sample-matches/blob/main/Csharp/dotween-MDEwOlJlcG9zaXRvcnkzMjQ3NTE2Mg==-flat-GoTween.cs-dotween-MDEwOlJlcG9zaXRvcnkzMjQ3NTE2Mg==-flat-GoTween_59.cs.html,345,dotween-MDEwOlJlcG9zaXRvcnkzMjQ3NTE2Mg==-flat-GoTween.cs,dotween-MDEwOlJlcG9zaXRvcnkzMjQ3NTE2Mg==-flat-GoTween_59.cs,120,200,80,120,200,80
289,https://htmlpreview.github.io/?https://github.com/Christina96/boilerplate-sample-matches/blob/main/Csharp/runner-MDEwOlJlcG9zaXRvcnkxODQyODY4NzU=-flat-LocationService.cs-runner-MDEwOlJlcG9zaXRvcnkxODQyODY4NzU=-flat-VssConnection.cs.html,16,runner-MDEwOlJlcG9zaXRvcnkxODQyODY4NzU=-flat-LocationService.cs,runner-MDEwOlJlcG9zaXRvcnkxODQyODY4NzU=-flat-VssConnection.cs,32,33,1,208,209,1
290,https://htmlpreview.github.io/?https://github.com/Christina96/boilerplate-sample-matches/blob/main/Csharp/MudBlazor-MDEwOlJlcG9zaXRvcnkyODg0Mjg2NzY=-flat-ResizeBasedServiceTests.cs-MudBlazor-MDEwOlJlcG9zaXRvcnkyODg0Mjg2NzY=-flat-BreakpointServiceTests.cs.html,17,MudBlazor-MDEwOlJlcG9zaXRvcnkyODg0Mjg2NzY=-flat-ResizeBasedServiceTests.cs,MudBlazor-MDEwOlJlcG9zaXRvcnkyODg0Mjg2NzY=-flat-BreakpointServiceTests.cs,65,66,1,202,203,1
291,https://htmlpreview.github.io/?https://github.com/Christina96/boilerplate-sample-matches/blob/main/Csharp/NetCoreServer-MDEwOlJlcG9zaXRvcnkxNjYxMjMxNjQ=-flat-SslSession.cs-NetCoreServer-MDEwOlJlcG9zaXRvcnkxNjYxMjMxNjQ=-flat-SslSession.cs.html,23,NetCoreServer-MDEwOlJlcG9zaXRvcnkxNjYxMjMxNjQ=-flat-SslSession.cs,NetCoreServer-MDEwOlJlcG9zaXRvcnkxNjYxMjMxNjQ=-flat-SslSession.cs,368,376,8,336,344,8
292,https://htmlpreview.github.io/?https://github.com/Christina96/boilerplate-sample-matches/blob/main/Csharp/Security-MDEwOlJlcG9zaXRvcnkxNzcyMzY5OQ==-flat-GoogleHandler.cs-Security-MDEwOlJlcG9zaXRvcnkxNzcyMzY5OQ==-flat-TestSettings.cs.html,12,Security-MDEwOlJlcG9zaXRvcnkxNzcyMzY5OQ==-flat-GoogleHandler.cs,Security-MDEwOlJlcG9zaXRvcnkxNzcyMzY5OQ==-flat-TestSettings.cs,78,80,2,126,128,2
293,https://htmlpreview.github.io/?https://github.com/Christina96/boilerplate-sample-matches/blob/main/Csharp/runner-MDEwOlJlcG9zaXRvcnkxODQyODY4NzU=-flat-GitCheck.cs-runner-MDEwOlJlcG9zaXRvcnkxODQyODY4NzU=-flat-FileCommandManager.cs.html,15,runner-MDEwOlJlcG9zaXRvcnkxODQyODY4NzU=-flat-GitCheck.cs,runner-MDEwOlJlcG9zaXRvcnkxODQyODY4NzU=-flat-FileCommandManager.cs,19,21,2,227,229,2
294,https://htmlpreview.github.io/?https://github.com/Christina96/boilerplate-sample-matches/blob/main/Csharp/Simple.Data-MDEwOlJlcG9zaXRvcnk4MTg3Njg=-flat-InMemoryTests.cs-Simple.Data-MDEwOlJlcG9zaXRvcnk4MTg3Njg=-flat-InMemoryTests.cs.html,12,Simple.Data-MDEwOlJlcG9zaXRvcnk4MTg3Njg=-flat-InMemoryTests.cs,Simple.Data-MDEwOlJlcG9zaXRvcnk4MTg3Njg=-flat-InMemoryTests.cs,704,707,3,704,707,3
295,https://htmlpreview.github.io/?https://github.com/Christina96/boilerplate-sample-matches/blob/main/Csharp/MudBlazor-MDEwOlJlcG9zaXRvcnkyODg0Mjg2NzY=-flat-ElementReferenceExtensions.cs-MudBlazor-MDEwOlJlcG9zaXRvcnkyODg0Mjg2NzY=-flat-ElementReferenceExtensions.cs.html,27,MudBlazor-MDEwOlJlcG9zaXRvcnkyODg0Mjg2NzY=-flat-ElementReferenceExtensions.cs,MudBlazor-MDEwOlJlcG9zaXRvcnkyODg0Mjg2NzY=-flat-ElementReferenceExtensions.cs,34,36,2,28,30,2
296,https://htmlpreview.github.io/?https://github.com/Christina96/boilerplate-sample-matches/blob/main/Csharp/npgsql-MDEwOlJlcG9zaXRvcnkyODgzNTc0-flat-BatchTests.cs-npgsql-MDEwOlJlcG9zaXRvcnkyODgzNTc0-flat-BatchTests.cs.html,15,npgsql-MDEwOlJlcG9zaXRvcnkyODgzNTc0-flat-BatchTests.cs,npgsql-MDEwOlJlcG9zaXRvcnkyODgzNTc0-flat-BatchTests.cs,419,422,3,419,422,3
297,https://htmlpreview.github.io/?https://github.com/Christina96/boilerplate-sample-matches/blob/main/Csharp/MudBlazor-MDEwOlJlcG9zaXRvcnkyODg0Mjg2NzY=-flat-DateRangePickerTests.cs-MudBlazor-MDEwOlJlcG9zaXRvcnkyODg0Mjg2NzY=-flat-DateRangePickerTests.cs.html,13,MudBlazor-MDEwOlJlcG9zaXRvcnkyODg0Mjg2NzY=-flat-DateRangePickerTests.cs,MudBlazor-MDEwOlJlcG9zaXRvcnkyODg0Mjg2NzY=-flat-DateRangePickerTests.cs,474,475,1,474,475,1
298,https://htmlpreview.github.io/?https://github.com/Christina96/boilerplate-sample-matches/blob/main/Csharp/NetCoreServer-MDEwOlJlcG9zaXRvcnkxNjYxMjMxNjQ=-flat-TcpClient.cs-NetCoreServer-MDEwOlJlcG9zaXRvcnkxNjYxMjMxNjQ=-flat-UdsClient.cs.html,38,NetCoreServer-MDEwOlJlcG9zaXRvcnkxNjYxMjMxNjQ=-flat-TcpClient.cs,NetCoreServer-MDEwOlJlcG9zaXRvcnkxNjYxMjMxNjQ=-flat-UdsClient.cs,444,453,9,407,416,9
299,https://htmlpreview.github.io/?https://github.com/Christina96/boilerplate-sample-matches/blob/main/Csharp/NetCoreServer-MDEwOlJlcG9zaXRvcnkxNjYxMjMxNjQ=-flat-com.chronoxor.simple.cs-NetCoreServer-MDEwOlJlcG9zaXRvcnkxNjYxMjMxNjQ=-flat-com.chronoxor.simple.cs.html,780,NetCoreServer-MDEwOlJlcG9zaXRvcnkxNjYxMjMxNjQ=-flat-com.chronoxor.simple.cs,NetCoreServer-MDEwOlJlcG9zaXRvcnkxNjYxMjMxNjQ=-flat-com.chronoxor.simple.cs,1503,1581,78,1910,1988,78
300,https://htmlpreview.github.io/?https://github.com/Christina96/boilerplate-sample-matches/blob/main/Csharp/MudBlazor-MDEwOlJlcG9zaXRvcnkyODg0Mjg2NzY=-flat-ResizeBasedServiceTests.cs-MudBlazor-MDEwOlJlcG9zaXRvcnkyODg0Mjg2NzY=-flat-BreakpointServiceTests.cs.html,19,MudBlazor-MDEwOlJlcG9zaXRvcnkyODg0Mjg2NzY=-flat-ResizeBasedServiceTests.cs,MudBlazor-MDEwOlJlcG9zaXRvcnkyODg0Mjg2NzY=-flat-BreakpointServiceTests.cs,39,40,1,155,156,1
301,https://htmlpreview.github.io/?https://github.com/Christina96/boilerplate-sample-matches/blob/main/Csharp/MudBlazor-MDEwOlJlcG9zaXRvcnkyODg0Mjg2NzY=-flat-DialogService.cs-MudBlazor-MDEwOlJlcG9zaXRvcnkyODg0Mjg2NzY=-flat-DialogService.cs.html,20,MudBlazor-MDEwOlJlcG9zaXRvcnkyODg0Mjg2NzY=-flat-DialogService.cs,MudBlazor-MDEwOlJlcG9zaXRvcnkyODg0Mjg2NzY=-flat-DialogService.cs,111,113,2,111,113,2
302,https://htmlpreview.github.io/?https://github.com/Christina96/boilerplate-sample-matches/blob/main/Csharp/runner-MDEwOlJlcG9zaXRvcnkxODQyODY4NzU=-flat-JobServerQueue.cs-runner-MDEwOlJlcG9zaXRvcnkxODQyODY4NzU=-flat-JobServerQueue.cs.html,22,runner-MDEwOlJlcG9zaXRvcnkxODQyODY4NzU=-flat-JobServerQueue.cs,runner-MDEwOlJlcG9zaXRvcnkxODQyODY4NzU=-flat-JobServerQueue.cs,139,142,3,142,145,3
303,https://htmlpreview.github.io/?https://github.com/Christina96/boilerplate-sample-matches/blob/main/Csharp/dotween-MDEwOlJlcG9zaXRvcnkzMjQ3NTE2Mg==-flat-TweenManager_146.cs-dotween-MDEwOlJlcG9zaXRvcnkzMjQ3NTE2Mg==-flat-TweenManager_146.cs.html,41,dotween-MDEwOlJlcG9zaXRvcnkzMjQ3NTE2Mg==-flat-TweenManager_146.cs,dotween-MDEwOlJlcG9zaXRvcnkzMjQ3NTE2Mg==-flat-TweenManager_146.cs,251,256,5,251,256,5
304,https://htmlpreview.github.io/?https://github.com/Christina96/boilerplate-sample-matches/blob/main/Csharp/EarTrumpet-MDEwOlJlcG9zaXRvcnkzODkxOTcwMg==-flat-EveryAppViewModel.cs-EarTrumpet-MDEwOlJlcG9zaXRvcnkzODkxOTcwMg==-flat-DefaultPlaybackDeviceViewModel.cs.html,13,EarTrumpet-MDEwOlJlcG9zaXRvcnkzODkxOTcwMg==-flat-EveryAppViewModel.cs,EarTrumpet-MDEwOlJlcG9zaXRvcnkzODkxOTcwMg==-flat-DefaultPlaybackDeviceViewModel.cs,7,10,3,6,9,3
305,https://htmlpreview.github.io/?https://github.com/Christina96/boilerplate-sample-matches/blob/main/Csharp/dotween-MDEwOlJlcG9zaXRvcnkzMjQ3NTE2Mg==-flat-EnginesComparison_0.cs-dotween-MDEwOlJlcG9zaXRvcnkzMjQ3NTE2Mg==-flat-EnginesComparison.cs.html,586,dotween-MDEwOlJlcG9zaXRvcnkzMjQ3NTE2Mg==-flat-EnginesComparison_0.cs,dotween-MDEwOlJlcG9zaXRvcnkzMjQ3NTE2Mg==-flat-EnginesComparison.cs,250,316,66,250,316,66
306,https://htmlpreview.github.io/?https://github.com/Christina96/boilerplate-sample-matches/blob/main/Csharp/MudBlazor-MDEwOlJlcG9zaXRvcnkyODg0Mjg2NzY=-flat-Outlined_7.cs-MudBlazor-MDEwOlJlcG9zaXRvcnkyODg0Mjg2NzY=-flat-TwoTone_10.cs.html,14,MudBlazor-MDEwOlJlcG9zaXRvcnkyODg0Mjg2NzY=-flat-Outlined_7.cs,MudBlazor-MDEwOlJlcG9zaXRvcnkyODg0Mjg2NzY=-flat-TwoTone_10.cs,542,544,2,721,723,2
307,https://htmlpreview.github.io/?https://github.com/Christina96/boilerplate-sample-matches/blob/main/Csharp/runner-MDEwOlJlcG9zaXRvcnkxODQyODY4NzU=-flat-BrokerMessageListener.cs-runner-MDEwOlJlcG9zaXRvcnkxODQyODY4NzU=-flat-MessageListener.cs.html,40,runner-MDEwOlJlcG9zaXRvcnkxODQyODY4NzU=-flat-BrokerMessageListener.cs,runner-MDEwOlJlcG9zaXRvcnkxODQyODY4NzU=-flat-MessageListener.cs,100,109,9,233,243,10
308,https://htmlpreview.github.io/?https://github.com/Christina96/boilerplate-sample-matches/blob/main/Csharp/NetCoreServer-MDEwOlJlcG9zaXRvcnkxNjYxMjMxNjQ=-flat-HttpRequest.cs-NetCoreServer-MDEwOlJlcG9zaXRvcnkxNjYxMjMxNjQ=-flat-HttpRequest.cs.html,31,NetCoreServer-MDEwOlJlcG9zaXRvcnkxNjYxMjMxNjQ=-flat-HttpRequest.cs,NetCoreServer-MDEwOlJlcG9zaXRvcnkxNjYxMjMxNjQ=-flat-HttpRequest.cs,233,236,3,233,236,3
309,https://htmlpreview.github.io/?https://github.com/Christina96/boilerplate-sample-matches/blob/main/Csharp/runner-MDEwOlJlcG9zaXRvcnkxODQyODY4NzU=-flat-JobDispatcher.cs-runner-MDEwOlJlcG9zaXRvcnkxODQyODY4NzU=-flat-JobDispatcher.cs.html,14,runner-MDEwOlJlcG9zaXRvcnkxODQyODY4NzU=-flat-JobDispatcher.cs,runner-MDEwOlJlcG9zaXRvcnkxODQyODY4NzU=-flat-JobDispatcher.cs,144,147,3,144,147,3
310,https://htmlpreview.github.io/?https://github.com/Christina96/boilerplate-sample-matches/blob/main/Csharp/Simple.Data-MDEwOlJlcG9zaXRvcnk4MTg3Njg=-flat-InsertCommand.cs-Simple.Data-MDEwOlJlcG9zaXRvcnk4MTg3Njg=-flat-GetCountCommand.cs.html,26,Simple.Data-MDEwOlJlcG9zaXRvcnk4MTg3Njg=-flat-InsertCommand.cs,Simple.Data-MDEwOlJlcG9zaXRvcnk4MTg3Njg=-flat-GetCountCommand.cs,27,32,5,17,22,5
311,https://htmlpreview.github.io/?https://github.com/Christina96/boilerplate-sample-matches/blob/main/Csharp/runner-MDEwOlJlcG9zaXRvcnkxODQyODY4NzU=-flat-DockerUtil.cs-runner-MDEwOlJlcG9zaXRvcnkxODQyODY4NzU=-flat-ScriptHandlerHelpers.cs.html,12,runner-MDEwOlJlcG9zaXRvcnkxODQyODY4NzU=-flat-DockerUtil.cs,runner-MDEwOlJlcG9zaXRvcnkxODQyODY4NzU=-flat-ScriptHandlerHelpers.cs,37,38,1,63,64,1
312,https://htmlpreview.github.io/?https://github.com/Christina96/boilerplate-sample-matches/blob/main/Csharp/runner-MDEwOlJlcG9zaXRvcnkxODQyODY4NzU=-flat-TemplateEvaluator.cs-runner-MDEwOlJlcG9zaXRvcnkxODQyODY4NzU=-flat-TemplateEvaluator.cs.html,15,runner-MDEwOlJlcG9zaXRvcnkxODQyODY4NzU=-flat-TemplateEvaluator.cs,runner-MDEwOlJlcG9zaXRvcnkxODQyODY4NzU=-flat-TemplateEvaluator.cs,34,39,5,34,39,5
313,https://htmlpreview.github.io/?https://github.com/Christina96/boilerplate-sample-matches/blob/main/Csharp/MudBlazor-MDEwOlJlcG9zaXRvcnkyODg0Mjg2NzY=-flat-MudThemeProvider.razor.cs-MudBlazor-MDEwOlJlcG9zaXRvcnkyODg0Mjg2NzY=-flat-MudSlider.razor.cs.html,16,MudBlazor-MDEwOlJlcG9zaXRvcnkyODg0Mjg2NzY=-flat-MudThemeProvider.razor.cs,MudBlazor-MDEwOlJlcG9zaXRvcnkyODg0Mjg2NzY=-flat-MudSlider.razor.cs,36,42,6,78,84,6
314,https://htmlpreview.github.io/?https://github.com/Christina96/boilerplate-sample-matches/blob/main/Csharp/runner-MDEwOlJlcG9zaXRvcnkxODQyODY4NzU=-flat-ActionManifestManager.cs-runner-MDEwOlJlcG9zaXRvcnkxODQyODY4NzU=-flat-ActionManifestManager.cs.html,31,runner-MDEwOlJlcG9zaXRvcnkxODQyODY4NzU=-flat-ActionManifestManager.cs,runner-MDEwOlJlcG9zaXRvcnkxODQyODY4NzU=-flat-ActionManifestManager.cs,365,372,7,365,372,7
315,https://htmlpreview.github.io/?https://github.com/Christina96/boilerplate-sample-matches/blob/main/Csharp/20486D-DevelopingASPNETMVCWebApplications-MDEwOlJlcG9zaXRvcnkxMTkzNTI2Mzc=-flat-StudentContext_341.cs-20486D-DevelopingASPNETMVCWebApplications-MDEwOlJlcG9zaXRvcnkxMTkzNTI2Mzc=-flat-ChessLeagueContext_55.cs.html,18,20486D-DevelopingASPNETMVCWebApplications-MDEwOlJlcG9zaXRvcnkxMTkzNTI2Mzc=-flat-StudentContext_341.cs,20486D-DevelopingASPNETMVCWebApplications-MDEwOlJlcG9zaXRvcnkxMTkzNTI2Mzc=-flat-ChessLeagueContext_55.cs,18,22,4,18,22,4
316,https://htmlpreview.github.io/?https://github.com/Christina96/boilerplate-sample-matches/blob/main/Csharp/runner-MDEwOlJlcG9zaXRvcnkxODQyODY4NzU=-flat-TemplateUnraveler.cs-runner-MDEwOlJlcG9zaXRvcnkxODQyODY4NzU=-flat-TemplateUnraveler.cs.html,40,runner-MDEwOlJlcG9zaXRvcnkxODQyODY4NzU=-flat-TemplateUnraveler.cs,runner-MDEwOlJlcG9zaXRvcnkxODQyODY4NzU=-flat-TemplateUnraveler.cs,381,390,9,381,390,9
317,https://htmlpreview.github.io/?https://github.com/Christina96/boilerplate-sample-matches/blob/main/Csharp/Simple.Data-MDEwOlJlcG9zaXRvcnk4MTg3Njg=-flat-WhereClauseHandler.cs-Simple.Data-MDEwOlJlcG9zaXRvcnk4MTg3Njg=-flat-WhereClauseHandler.cs.html,15,Simple.Data-MDEwOlJlcG9zaXRvcnk4MTg3Njg=-flat-WhereClauseHandler.cs,Simple.Data-MDEwOlJlcG9zaXRvcnk4MTg3Njg=-flat-WhereClauseHandler.cs,13,16,3,13,16,3
318,https://htmlpreview.github.io/?https://github.com/Christina96/boilerplate-sample-matches/blob/main/Csharp/MudBlazor-MDEwOlJlcG9zaXRvcnkyODg0Mjg2NzY=-flat-MudSelect.razor.cs-MudBlazor-MDEwOlJlcG9zaXRvcnkyODg0Mjg2NzY=-flat-MudSelect.razor.cs.html,39,MudBlazor-MDEwOlJlcG9zaXRvcnkyODg0Mjg2NzY=-flat-MudSelect.razor.cs,MudBlazor-MDEwOlJlcG9zaXRvcnkyODg0Mjg2NzY=-flat-MudSelect.razor.cs,596,602,6,746,752,6
319,https://htmlpreview.github.io/?https://github.com/Christina96/boilerplate-sample-matches/blob/main/Csharp/EarTrumpet-MDEwOlJlcG9zaXRvcnkzODkxOTcwMg==-flat-ProcessWatcher.cs-dotween-MDEwOlJlcG9zaXRvcnkzMjQ3NTE2Mg==-flat-RestartAndChangeDelay.cs.html,14,EarTrumpet-MDEwOlJlcG9zaXRvcnkzODkxOTcwMg==-flat-ProcessWatcher.cs,dotween-MDEwOlJlcG9zaXRvcnkzMjQ3NTE2Mg==-flat-RestartAndChangeDelay.cs,122,126,4,18,22,4
320,https://htmlpreview.github.io/?https://github.com/Christina96/boilerplate-sample-matches/blob/main/Csharp/20486D-DevelopingASPNETMVCWebApplications-MDEwOlJlcG9zaXRvcnkxMTkzNTI2Mzc=-flat-LibraryController_235.cs-20486D-DevelopingASPNETMVCWebApplications-MDEwOlJlcG9zaXRvcnkxMTkzNTI2Mzc=-flat-LibraryController_223.cs.html,203,20486D-DevelopingASPNETMVCWebApplications-MDEwOlJlcG9zaXRvcnkxMTkzNTI2Mzc=-flat-LibraryController_235.cs,20486D-DevelopingASPNETMVCWebApplications-MDEwOlJlcG9zaXRvcnkxMTkzNTI2Mzc=-flat-LibraryController_223.cs,57,100,43,59,102,43
321,https://htmlpreview.github.io/?https://github.com/Christina96/boilerplate-sample-matches/blob/main/Csharp/runner-MDEwOlJlcG9zaXRvcnkxODQyODY4NzU=-flat-GitSourceProvider_1.cs-runner-MDEwOlJlcG9zaXRvcnkxODQyODY4NzU=-flat-GitSourceProvider_1.cs.html,90,runner-MDEwOlJlcG9zaXRvcnkxODQyODY4NzU=-flat-GitSourceProvider_1.cs,runner-MDEwOlJlcG9zaXRvcnkxODQyODY4NzU=-flat-GitSourceProvider_1.cs,401,418,17,401,418,17
322,https://htmlpreview.github.io/?https://github.com/Christina96/boilerplate-sample-matches/blob/main/Csharp/runner-MDEwOlJlcG9zaXRvcnkxODQyODY4NzU=-flat-RunnerWebProxy.cs-runner-MDEwOlJlcG9zaXRvcnkxODQyODY4NzU=-flat-RunnerWebProxy.cs.html,68,runner-MDEwOlJlcG9zaXRvcnkxODQyODY4NzU=-flat-RunnerWebProxy.cs,runner-MDEwOlJlcG9zaXRvcnkxODQyODY4NzU=-flat-RunnerWebProxy.cs,74,83,9,74,83,9
323,https://htmlpreview.github.io/?https://github.com/Christina96/boilerplate-sample-matches/blob/main/Csharp/dotween-MDEwOlJlcG9zaXRvcnkzMjQ3NTE2Mg==-flat-TweenEnginesComparisonInternal_37.cs-dotween-MDEwOlJlcG9zaXRvcnkzMjQ3NTE2Mg==-flat-TweenEnginesComparisonInternal.cs.html,494,dotween-MDEwOlJlcG9zaXRvcnkzMjQ3NTE2Mg==-flat-TweenEnginesComparisonInternal_37.cs,dotween-MDEwOlJlcG9zaXRvcnkzMjQ3NTE2Mg==-flat-TweenEnginesComparisonInternal.cs,57,117,60,57,117,60
324,https://htmlpreview.github.io/?https://github.com/Christina96/boilerplate-sample-matches/blob/main/Csharp/dotween-MDEwOlJlcG9zaXRvcnkzMjQ3NTE2Mg==-flat-GoTweenConfig.cs-dotween-MDEwOlJlcG9zaXRvcnkzMjQ3NTE2Mg==-flat-GoTweenConfig.cs.html,40,dotween-MDEwOlJlcG9zaXRvcnkzMjQ3NTE2Mg==-flat-GoTweenConfig.cs,dotween-MDEwOlJlcG9zaXRvcnkzMjQ3NTE2Mg==-flat-GoTweenConfig.cs,132,138,6,144,150,6
325,https://htmlpreview.github.io/?https://github.com/Christina96/boilerplate-sample-matches/blob/main/Csharp/MudBlazor-MDEwOlJlcG9zaXRvcnkyODg0Mjg2NzY=-flat-RegexMask.cs-MudBlazor-MDEwOlJlcG9zaXRvcnkyODg0Mjg2NzY=-flat-RegexMask.cs.html,67,MudBlazor-MDEwOlJlcG9zaXRvcnkyODg0Mjg2NzY=-flat-RegexMask.cs,MudBlazor-MDEwOlJlcG9zaXRvcnkyODg0Mjg2NzY=-flat-RegexMask.cs,154,166,12,154,166,12
326,https://htmlpreview.github.io/?https://github.com/Christina96/boilerplate-sample-matches/blob/main/Csharp/MudBlazor-MDEwOlJlcG9zaXRvcnkyODg0Mjg2NzY=-flat-MudFormComponent.cs-MudBlazor-MDEwOlJlcG9zaXRvcnkyODg0Mjg2NzY=-flat-MudFormComponent.cs.html,28,MudBlazor-MDEwOlJlcG9zaXRvcnkyODg0Mjg2NzY=-flat-MudFormComponent.cs,MudBlazor-MDEwOlJlcG9zaXRvcnkyODg0Mjg2NzY=-flat-MudFormComponent.cs,442,444,2,442,444,2
327,https://htmlpreview.github.io/?https://github.com/Christina96/boilerplate-sample-matches/blob/main/Csharp/runner-MDEwOlJlcG9zaXRvcnkxODQyODY4NzU=-flat-HandlerFactory.cs-Security-MDEwOlJlcG9zaXRvcnkxNzcyMzY5OQ==-flat-GoogleHandler.cs.html,14,runner-MDEwOlJlcG9zaXRvcnkxODQyODY4NzU=-flat-HandlerFactory.cs,Security-MDEwOlJlcG9zaXRvcnkxNzcyMzY5OQ==-flat-GoogleHandler.cs,32,35,3,79,82,3
328,https://htmlpreview.github.io/?https://github.com/Christina96/boilerplate-sample-matches/blob/main/Csharp/Simple.Data-MDEwOlJlcG9zaXRvcnk4MTg3Njg=-flat-SqlObservableQueryRunner.cs-Simple.Data-MDEwOlJlcG9zaXRvcnk4MTg3Njg=-flat-AdapterFactory.cs.html,15,Simple.Data-MDEwOlJlcG9zaXRvcnk4MTg3Njg=-flat-SqlObservableQueryRunner.cs,Simple.Data-MDEwOlJlcG9zaXRvcnk4MTg3Njg=-flat-AdapterFactory.cs,31,33,2,26,28,2
329,https://htmlpreview.github.io/?https://github.com/Christina96/boilerplate-sample-matches/blob/main/Csharp/ZXing.Net.Mobile-MDEwOlJlcG9zaXRvcnk2MTYwNjcz-flat-CustomContinuousScanPage.cs-ZXing.Net.Mobile-MDEwOlJlcG9zaXRvcnk2MTYwNjcz-flat-CustomScanPage.cs.html,20,ZXing.Net.Mobile-MDEwOlJlcG9zaXRvcnk2MTYwNjcz-flat-CustomContinuousScanPage.cs,ZXing.Net.Mobile-MDEwOlJlcG9zaXRvcnk2MTYwNjcz-flat-CustomScanPage.cs,83,88,5,54,59,5
330,https://htmlpreview.github.io/?https://github.com/Christina96/boilerplate-sample-matches/blob/main/Csharp/npgsql-MDEwOlJlcG9zaXRvcnkyODgzNTc0-flat-PostgresDatabaseInfo.cs-npgsql-MDEwOlJlcG9zaXRvcnkyODgzNTc0-flat-PostgresDatabaseInfo.cs.html,15,npgsql-MDEwOlJlcG9zaXRvcnkyODgzNTc0-flat-PostgresDatabaseInfo.cs,npgsql-MDEwOlJlcG9zaXRvcnkyODgzNTc0-flat-PostgresDatabaseInfo.cs,199,201,2,199,201,2
331,https://htmlpreview.github.io/?https://github.com/Christina96/boilerplate-sample-matches/blob/main/Csharp/dotween-MDEwOlJlcG9zaXRvcnkzMjQ3NTE2Mg==-flat-LeanTween.cs-dotween-MDEwOlJlcG9zaXRvcnkzMjQ3NTE2Mg==-flat-LeanTween_56.cs.html,1365,dotween-MDEwOlJlcG9zaXRvcnkzMjQ3NTE2Mg==-flat-LeanTween.cs,dotween-MDEwOlJlcG9zaXRvcnkzMjQ3NTE2Mg==-flat-LeanTween_56.cs,2417,2560,143,2417,2560,143
332,https://htmlpreview.github.io/?https://github.com/Christina96/boilerplate-sample-matches/blob/main/Csharp/dotween-MDEwOlJlcG9zaXRvcnkzMjQ3NTE2Mg==-flat-LeanTween.cs-dotween-MDEwOlJlcG9zaXRvcnkzMjQ3NTE2Mg==-flat-LeanTween_56.cs.html,4993,dotween-MDEwOlJlcG9zaXRvcnkzMjQ3NTE2Mg==-flat-LeanTween.cs,dotween-MDEwOlJlcG9zaXRvcnkzMjQ3NTE2Mg==-flat-LeanTween_56.cs,2019,2560,541,2019,2560,541
333,https://htmlpreview.github.io/?https://github.com/Christina96/boilerplate-sample-matches/blob/main/Csharp/dotween-MDEwOlJlcG9zaXRvcnkzMjQ3NTE2Mg==-flat-GoEaseBounce.cs-dotween-MDEwOlJlcG9zaXRvcnkzMjQ3NTE2Mg==-flat-GoEaseBounce.cs.html,136,dotween-MDEwOlJlcG9zaXRvcnkzMjQ3NTE2Mg==-flat-GoEaseBounce.cs,dotween-MDEwOlJlcG9zaXRvcnkzMjQ3NTE2Mg==-flat-GoEaseBounce.cs,17,33,16,17,33,16
334,https://htmlpreview.github.io/?https://github.com/Christina96/boilerplate-sample-matches/blob/main/Csharp/runner-MDEwOlJlcG9zaXRvcnkxODQyODY4NzU=-flat-IdentityDescriptor.cs-runner-MDEwOlJlcG9zaXRvcnkxODQyODY4NzU=-flat-IdentityDescriptor.cs.html,33,runner-MDEwOlJlcG9zaXRvcnkxODQyODY4NzU=-flat-IdentityDescriptor.cs,runner-MDEwOlJlcG9zaXRvcnkxODQyODY4NzU=-flat-IdentityDescriptor.cs,282,285,3,283,285,2
335,https://htmlpreview.github.io/?https://github.com/Christina96/boilerplate-sample-matches/blob/main/Csharp/MudBlazor-MDEwOlJlcG9zaXRvcnkyODg0Mjg2NzY=-flat-MudDialogInstance.razor.cs-MudBlazor-MDEwOlJlcG9zaXRvcnkyODg0Mjg2NzY=-flat-MudDialogInstance.razor.cs.html,12,MudBlazor-MDEwOlJlcG9zaXRvcnkyODg0Mjg2NzY=-flat-MudDialogInstance.razor.cs,MudBlazor-MDEwOlJlcG9zaXRvcnkyODg0Mjg2NzY=-flat-MudDialogInstance.razor.cs,160,164,4,160,164,4
336,https://htmlpreview.github.io/?https://github.com/Christina96/boilerplate-sample-matches/blob/main/Csharp/NetCoreServer-MDEwOlJlcG9zaXRvcnkxNjYxMjMxNjQ=-flat-HttpResponse.cs-NetCoreServer-MDEwOlJlcG9zaXRvcnkxNjYxMjMxNjQ=-flat-HttpResponse.cs.html,35,NetCoreServer-MDEwOlJlcG9zaXRvcnkxNjYxMjMxNjQ=-flat-HttpResponse.cs,NetCoreServer-MDEwOlJlcG9zaXRvcnkxNjYxMjMxNjQ=-flat-HttpResponse.cs,329,336,7,339,346,7
337,https://htmlpreview.github.io/?https://github.com/Christina96/boilerplate-sample-matches/blob/main/Csharp/runner-MDEwOlJlcG9zaXRvcnkxODQyODY4NzU=-flat-PipelineTemplateEvaluator.cs-runner-MDEwOlJlcG9zaXRvcnkxODQyODY4NzU=-flat-PipelineTemplateEvaluator.cs.html,12,runner-MDEwOlJlcG9zaXRvcnkxODQyODY4NzU=-flat-PipelineTemplateEvaluator.cs,runner-MDEwOlJlcG9zaXRvcnkxODQyODY4NzU=-flat-PipelineTemplateEvaluator.cs,291,294,3,238,241,3
338,https://htmlpreview.github.io/?https://github.com/Christina96/boilerplate-sample-matches/blob/main/Csharp/20486D-DevelopingASPNETMVCWebApplications-MDEwOlJlcG9zaXRvcnkxMTkzNTI2Mzc=-flat-ProductViewComponent.cs-20486D-DevelopingASPNETMVCWebApplications-MDEwOlJlcG9zaXRvcnkxMTkzNTI2Mzc=-flat-PersonCardViewComponent.cs.html,18,20486D-DevelopingASPNETMVCWebApplications-MDEwOlJlcG9zaXRvcnkxMTkzNTI2Mzc=-flat-ProductViewComponent.cs,20486D-DevelopingASPNETMVCWebApplications-MDEwOlJlcG9zaXRvcnkxMTkzNTI2Mzc=-flat-PersonCardViewComponent.cs,20,23,3,12,15,3
339,https://htmlpreview.github.io/?https://github.com/Christina96/boilerplate-sample-matches/blob/main/Csharp/Simple.Data-MDEwOlJlcG9zaXRvcnk4MTg3Njg=-flat-SqlQueryBuilder.cs-Simple.Data-MDEwOlJlcG9zaXRvcnk4MTg3Njg=-flat-SqlQueryBuilder.cs.html,33,Simple.Data-MDEwOlJlcG9zaXRvcnk4MTg3Njg=-flat-SqlQueryBuilder.cs,Simple.Data-MDEwOlJlcG9zaXRvcnk4MTg3Njg=-flat-SqlQueryBuilder.cs,16,25,9,16,25,9
340,https://htmlpreview.github.io/?https://github.com/Christina96/boilerplate-sample-matches/blob/main/Csharp/20486D-DevelopingASPNETMVCWebApplications-MDEwOlJlcG9zaXRvcnkxMTkzNTI2Mzc=-flat-CupcakeContext.cs-20486D-DevelopingASPNETMVCWebApplications-MDEwOlJlcG9zaXRvcnkxMTkzNTI2Mzc=-flat-CupcakeContext.cs.html,16,20486D-DevelopingASPNETMVCWebApplications-MDEwOlJlcG9zaXRvcnkxMTkzNTI2Mzc=-flat-CupcakeContext.cs,20486D-DevelopingASPNETMVCWebApplications-MDEwOlJlcG9zaXRvcnkxMTkzNTI2Mzc=-flat-CupcakeContext.cs,30,36,6,30,36,6
341,https://htmlpreview.github.io/?https://github.com/Christina96/boilerplate-sample-matches/blob/main/Csharp/dotween-MDEwOlJlcG9zaXRvcnkzMjQ3NTE2Mg==-flat-LoopTypeRestart.cs-dotween-MDEwOlJlcG9zaXRvcnkzMjQ3NTE2Mg==-flat-UIMisc_34.cs.html,17,dotween-MDEwOlJlcG9zaXRvcnkzMjQ3NTE2Mg==-flat-LoopTypeRestart.cs,dotween-MDEwOlJlcG9zaXRvcnkzMjQ3NTE2Mg==-flat-UIMisc_34.cs,18,20,2,11,13,2
342,https://htmlpreview.github.io/?https://github.com/Christina96/boilerplate-sample-matches/blob/main/Csharp/EarTrumpet-MDEwOlJlcG9zaXRvcnkzODkxOTcwMg==-flat-AudioDeviceSession.cs-EarTrumpet-MDEwOlJlcG9zaXRvcnkzODkxOTcwMg==-flat-AudioDeviceSessionCollection.cs.html,17,EarTrumpet-MDEwOlJlcG9zaXRvcnkzODkxOTcwMg==-flat-AudioDeviceSession.cs,EarTrumpet-MDEwOlJlcG9zaXRvcnkzODkxOTcwMg==-flat-AudioDeviceSessionCollection.cs,318,321,3,78,81,3
343,https://htmlpreview.github.io/?https://github.com/Christina96/boilerplate-sample-matches/blob/main/Csharp/Security-MDEwOlJlcG9zaXRvcnkxNzcyMzY5OQ==-flat-AuthorizationMiddlewareTests.cs-Security-MDEwOlJlcG9zaXRvcnkxNzcyMzY5OQ==-flat-AuthorizationMiddlewareTests.cs.html,44,Security-MDEwOlJlcG9zaXRvcnkxNzcyMzY5OQ==-flat-AuthorizationMiddlewareTests.cs,Security-MDEwOlJlcG9zaXRvcnkxNzcyMzY5OQ==-flat-AuthorizationMiddlewareTests.cs,189,196,7,133,140,7
344,https://htmlpreview.github.io/?https://github.com/Christina96/boilerplate-sample-matches/blob/main/Csharp/runner-MDEwOlJlcG9zaXRvcnkxODQyODY4NzU=-flat-BooleanContextData.cs-runner-MDEwOlJlcG9zaXRvcnkxODQyODY4NzU=-flat-BooleanContextData.cs.html,29,runner-MDEwOlJlcG9zaXRvcnkxODQyODY4NzU=-flat-BooleanContextData.cs,runner-MDEwOlJlcG9zaXRvcnkxODQyODY4NzU=-flat-BooleanContextData.cs,21,32,11,21,32,11
345,https://htmlpreview.github.io/?https://github.com/Christina96/boilerplate-sample-matches/blob/main/Csharp/dotween-MDEwOlJlcG9zaXRvcnkzMjQ3NTE2Mg==-flat-DOTweenUtils46.cs-dotween-MDEwOlJlcG9zaXRvcnkzMjQ3NTE2Mg==-flat-DOTweenModuleUI_143.cs.html,118,dotween-MDEwOlJlcG9zaXRvcnkzMjQ3NTE2Mg==-flat-DOTweenUtils46.cs,dotween-MDEwOlJlcG9zaXRvcnkzMjQ3NTE2Mg==-flat-DOTweenModuleUI_143.cs,7,17,10,378,389,11
346,https://htmlpreview.github.io/?https://github.com/Christina96/boilerplate-sample-matches/blob/main/Csharp/runner-MDEwOlJlcG9zaXRvcnkxODQyODY4NzU=-flat-CaseSensitiveDictionaryContextData.cs-runner-MDEwOlJlcG9zaXRvcnkxODQyODY4NzU=-flat-DictionaryContextData.cs.html,22,runner-MDEwOlJlcG9zaXRvcnkxODQyODY4NzU=-flat-CaseSensitiveDictionaryContextData.cs,runner-MDEwOlJlcG9zaXRvcnkxODQyODY4NzU=-flat-DictionaryContextData.cs,190,194,4,200,204,4
347,https://htmlpreview.github.io/?https://github.com/Christina96/boilerplate-sample-matches/blob/main/Csharp/MudBlazor-MDEwOlJlcG9zaXRvcnkyODg0Mjg2NzY=-flat-MudColor.cs-MudBlazor-MDEwOlJlcG9zaXRvcnkyODg0Mjg2NzY=-flat-MudColor.cs.html,19,MudBlazor-MDEwOlJlcG9zaXRvcnkyODg0Mjg2NzY=-flat-MudColor.cs,MudBlazor-MDEwOlJlcG9zaXRvcnkyODg0Mjg2NzY=-flat-MudColor.cs,210,211,1,212,213,1
348,https://htmlpreview.github.io/?https://github.com/Christina96/boilerplate-sample-matches/blob/main/Csharp/NetCoreServer-MDEwOlJlcG9zaXRvcnkxNjYxMjMxNjQ=-flat-com.chronoxor.fbe.cs-NetCoreServer-MDEwOlJlcG9zaXRvcnkxNjYxMjMxNjQ=-flat-com.chronoxor.fbe.cs.html,19,NetCoreServer-MDEwOlJlcG9zaXRvcnkxNjYxMjMxNjQ=-flat-com.chronoxor.fbe.cs,NetCoreServer-MDEwOlJlcG9zaXRvcnkxNjYxMjMxNjQ=-flat-com.chronoxor.fbe.cs,2227,2230,3,2629,2632,3
349,https://htmlpreview.github.io/?https://github.com/Christina96/boilerplate-sample-matches/blob/main/Csharp/runner-MDEwOlJlcG9zaXRvcnkxODQyODY4NzU=-flat-Container.cs-npgsql-MDEwOlJlcG9zaXRvcnkyODgzNTc0-flat-NpgsqlParameterCollection.cs.html,13,runner-MDEwOlJlcG9zaXRvcnkxODQyODY4NzU=-flat-Container.cs,npgsql-MDEwOlJlcG9zaXRvcnkyODgzNTc0-flat-NpgsqlParameterCollection.cs,12,14,2,173,175,2
350,https://htmlpreview.github.io/?https://github.com/Christina96/boilerplate-sample-matches/blob/main/Csharp/Simple.Data-MDEwOlJlcG9zaXRvcnk4MTg3Njg=-flat-IObservableQueryRunner.cs-Simple.Data-MDEwOlJlcG9zaXRvcnk4MTg3Njg=-flat-DbCommandExtensions.cs.html,18,Simple.Data-MDEwOlJlcG9zaXRvcnk4MTg3Njg=-flat-IObservableQueryRunner.cs,Simple.Data-MDEwOlJlcG9zaXRvcnk4MTg3Njg=-flat-DbCommandExtensions.cs,53,57,4,85,89,4
351,https://htmlpreview.github.io/?https://github.com/Christina96/boilerplate-sample-matches/blob/main/Csharp/runner-MDEwOlJlcG9zaXRvcnkxODQyODY4NzU=-flat-TraceManager.cs-runner-MDEwOlJlcG9zaXRvcnkxODQyODY4NzU=-flat-JobDispatcher.cs.html,16,runner-MDEwOlJlcG9zaXRvcnkxODQyODY4NzU=-flat-TraceManager.cs,runner-MDEwOlJlcG9zaXRvcnkxODQyODY4NzU=-flat-JobDispatcher.cs,49,53,4,1011,1015,4
352,https://htmlpreview.github.io/?https://github.com/Christina96/boilerplate-sample-matches/blob/main/Csharp/Security-MDEwOlJlcG9zaXRvcnkxNzcyMzY5OQ==-flat-ChunkingCookieManager_19.cs-Security-MDEwOlJlcG9zaXRvcnkxNzcyMzY5OQ==-flat-ChunkingCookieManager.cs.html,338,Security-MDEwOlJlcG9zaXRvcnkxNzcyMzY5OQ==-flat-ChunkingCookieManager_19.cs,Security-MDEwOlJlcG9zaXRvcnkxNzcyMzY5OQ==-flat-ChunkingCookieManager.cs,115,163,48,130,178,48
353,https://htmlpreview.github.io/?https://github.com/Christina96/boilerplate-sample-matches/blob/main/Csharp/npgsql-MDEwOlJlcG9zaXRvcnkyODgzNTc0-flat-CommandBuilderTests.cs-npgsql-MDEwOlJlcG9zaXRvcnkyODgzNTc0-flat-CommandBuilderTests.cs.html,24,npgsql-MDEwOlJlcG9zaXRvcnkyODgzNTc0-flat-CommandBuilderTests.cs,npgsql-MDEwOlJlcG9zaXRvcnkyODgzNTc0-flat-CommandBuilderTests.cs,189,190,1,189,190,1
354,https://htmlpreview.github.io/?https://github.com/Christina96/boilerplate-sample-matches/blob/main/Csharp/dotween-MDEwOlJlcG9zaXRvcnkzMjQ3NTE2Mg==-flat-Strings.cs-dotween-MDEwOlJlcG9zaXRvcnkzMjQ3NTE2Mg==-flat-Strings_25.cs.html,546,dotween-MDEwOlJlcG9zaXRvcnkzMjQ3NTE2Mg==-flat-Strings.cs,dotween-MDEwOlJlcG9zaXRvcnkzMjQ3NTE2Mg==-flat-Strings_25.cs,9,52,43,9,52,43
355,https://htmlpreview.github.io/?https://github.com/Christina96/boilerplate-sample-matches/blob/main/Csharp/npgsql-MDEwOlJlcG9zaXRvcnkyODgzNTc0-flat-NpgsqlRawCopyStream.cs-npgsql-MDEwOlJlcG9zaXRvcnkyODgzNTc0-flat-VolatileResourceManager.cs.html,19,npgsql-MDEwOlJlcG9zaXRvcnkyODgzNTc0-flat-NpgsqlRawCopyStream.cs,npgsql-MDEwOlJlcG9zaXRvcnkyODgzNTc0-flat-VolatileResourceManager.cs,364,369,5,202,208,6
356,https://htmlpreview.github.io/?https://github.com/Christina96/boilerplate-sample-matches/blob/main/Csharp/Simple.Data-MDEwOlJlcG9zaXRvcnk4MTg3Njg=-flat-InMemoryTests.cs-Simple.Data-MDEwOlJlcG9zaXRvcnk4MTg3Njg=-flat-InMemoryTests.cs.html,57,Simple.Data-MDEwOlJlcG9zaXRvcnk4MTg3Njg=-flat-InMemoryTests.cs,Simple.Data-MDEwOlJlcG9zaXRvcnk4MTg3Njg=-flat-InMemoryTests.cs,460,468,8,478,486,8
357,https://htmlpreview.github.io/?https://github.com/Christina96/boilerplate-sample-matches/blob/main/Csharp/dotween-MDEwOlJlcG9zaXRvcnkzMjQ3NTE2Mg==-flat-iTween_121.cs-dotween-MDEwOlJlcG9zaXRvcnkzMjQ3NTE2Mg==-flat-iTween_121.cs.html,3702,dotween-MDEwOlJlcG9zaXRvcnkzMjQ3NTE2Mg==-flat-iTween_121.cs,dotween-MDEwOlJlcG9zaXRvcnkzMjQ3NTE2Mg==-flat-iTween_121.cs,1032,1426,394,1032,1426,394
358,https://htmlpreview.github.io/?https://github.com/Christina96/boilerplate-sample-matches/blob/main/Csharp/npgsql-MDEwOlJlcG9zaXRvcnkyODgzNTc0-flat-ReplicationConnection.cs-npgsql-MDEwOlJlcG9zaXRvcnkyODgzNTc0-flat-ReplicationConnection.cs.html,21,npgsql-MDEwOlJlcG9zaXRvcnkyODgzNTc0-flat-ReplicationConnection.cs,npgsql-MDEwOlJlcG9zaXRvcnkyODgzNTc0-flat-ReplicationConnection.cs,324,328,4,324,328,4
359,https://htmlpreview.github.io/?https://github.com/Christina96/boilerplate-sample-matches/blob/main/Csharp/runner-MDEwOlJlcG9zaXRvcnkxODQyODY4NzU=-flat-ProcessInvoker_16.cs-runner-MDEwOlJlcG9zaXRvcnkxODQyODY4NzU=-flat-ProcessExtensions.cs.html,12,runner-MDEwOlJlcG9zaXRvcnkxODQyODY4NzU=-flat-ProcessInvoker_16.cs,runner-MDEwOlJlcG9zaXRvcnkxODQyODY4NzU=-flat-ProcessExtensions.cs,682,685,3,214,217,3
360,https://htmlpreview.github.io/?https://github.com/Christina96/boilerplate-sample-matches/blob/main/Csharp/runner-MDEwOlJlcG9zaXRvcnkxODQyODY4NzU=-flat-TimelineRecord.cs-runner-MDEwOlJlcG9zaXRvcnkxODQyODY4NzU=-flat-TimelineRecord.cs.html,20,runner-MDEwOlJlcG9zaXRvcnkxODQyODY4NzU=-flat-TimelineRecord.cs,runner-MDEwOlJlcG9zaXRvcnkxODQyODY4NzU=-flat-TimelineRecord.cs,153,161,8,235,243,8
361,https://htmlpreview.github.io/?https://github.com/Christina96/boilerplate-sample-matches/blob/main/Csharp/MudBlazor-MDEwOlJlcG9zaXRvcnkyODg0Mjg2NzY=-flat-Line.razor.cs-MudBlazor-MDEwOlJlcG9zaXRvcnkyODg0Mjg2NzY=-flat-Bar.razor.cs.html,170,MudBlazor-MDEwOlJlcG9zaXRvcnkyODg0Mjg2NzY=-flat-Line.razor.cs,MudBlazor-MDEwOlJlcG9zaXRvcnkyODg0Mjg2NzY=-flat-Bar.razor.cs,78,104,26,66,92,26
362,https://htmlpreview.github.io/?https://github.com/Christina96/boilerplate-sample-matches/blob/main/Csharp/runner-MDEwOlJlcG9zaXRvcnkxODQyODY4NzU=-flat-ResourceProperties.cs-runner-MDEwOlJlcG9zaXRvcnkxODQyODY4NzU=-flat-ServiceEndpoint.cs.html,17,runner-MDEwOlJlcG9zaXRvcnkxODQyODY4NzU=-flat-ResourceProperties.cs,runner-MDEwOlJlcG9zaXRvcnkxODQyODY4NzU=-flat-ServiceEndpoint.cs,22,23,1,93,94,1
363,https://htmlpreview.github.io/?https://github.com/Christina96/boilerplate-sample-matches/blob/main/Csharp/MudBlazor-MDEwOlJlcG9zaXRvcnkyODg0Mjg2NzY=-flat-TabsTests.cs-MudBlazor-MDEwOlJlcG9zaXRvcnkyODg0Mjg2NzY=-flat-TabsTests.cs.html,77,MudBlazor-MDEwOlJlcG9zaXRvcnkyODg0Mjg2NzY=-flat-TabsTests.cs,MudBlazor-MDEwOlJlcG9zaXRvcnkyODg0Mjg2NzY=-flat-TabsTests.cs,363,370,7,363,370,7
364,https://htmlpreview.github.io/?https://github.com/Christina96/boilerplate-sample-matches/blob/main/Csharp/runner-MDEwOlJlcG9zaXRvcnkxODQyODY4NzU=-flat-HandlerFactory.cs-runner-MDEwOlJlcG9zaXRvcnkxODQyODY4NzU=-flat-HandlerFactory.cs.html,24,runner-MDEwOlJlcG9zaXRvcnkxODQyODY4NzU=-flat-HandlerFactory.cs,runner-MDEwOlJlcG9zaXRvcnkxODQyODY4NzU=-flat-HandlerFactory.cs,80,84,4,47,50,3
365,https://htmlpreview.github.io/?https://github.com/Christina96/boilerplate-sample-matches/blob/main/Csharp/20486D-DevelopingASPNETMVCWebApplications-MDEwOlJlcG9zaXRvcnkxMTkzNTI2Mzc=-flat-Aquarium.cs-20486D-DevelopingASPNETMVCWebApplications-MDEwOlJlcG9zaXRvcnkxMTkzNTI2Mzc=-flat-Aquarium.cs.html,23,20486D-DevelopingASPNETMVCWebApplications-MDEwOlJlcG9zaXRvcnkxMTkzNTI2Mzc=-flat-Aquarium.cs,20486D-DevelopingASPNETMVCWebApplications-MDEwOlJlcG9zaXRvcnkxMTkzNTI2Mzc=-flat-Aquarium.cs,15,18,3,15,18,3
366,https://htmlpreview.github.io/?https://github.com/Christina96/boilerplate-sample-matches/blob/main/Csharp/npgsql-MDEwOlJlcG9zaXRvcnkyODgzNTc0-flat-BugTests.cs-npgsql-MDEwOlJlcG9zaXRvcnkyODgzNTc0-flat-BugTests.cs.html,12,npgsql-MDEwOlJlcG9zaXRvcnkyODgzNTc0-flat-BugTests.cs,npgsql-MDEwOlJlcG9zaXRvcnkyODgzNTc0-flat-BugTests.cs,523,529,6,673,679,6
367,https://htmlpreview.github.io/?https://github.com/Christina96/boilerplate-sample-matches/blob/main/Csharp/npgsql-MDEwOlJlcG9zaXRvcnkyODgzNTc0-flat-ReaderTests.cs-npgsql-MDEwOlJlcG9zaXRvcnkyODgzNTc0-flat-ReaderTests.cs.html,14,npgsql-MDEwOlJlcG9zaXRvcnkyODgzNTc0-flat-ReaderTests.cs,npgsql-MDEwOlJlcG9zaXRvcnkyODgzNTc0-flat-ReaderTests.cs,464,465,1,465,466,1
368,https://htmlpreview.github.io/?https://github.com/Christina96/boilerplate-sample-matches/blob/main/Csharp/dotween-MDEwOlJlcG9zaXRvcnkzMjQ3NTE2Mg==-flat-EnginesComparison_0.cs-dotween-MDEwOlJlcG9zaXRvcnkzMjQ3NTE2Mg==-flat-EnginesComparison.cs.html,84,dotween-MDEwOlJlcG9zaXRvcnkzMjQ3NTE2Mg==-flat-EnginesComparison_0.cs,dotween-MDEwOlJlcG9zaXRvcnkzMjQ3NTE2Mg==-flat-EnginesComparison.cs,92,102,10,92,102,10
369,https://htmlpreview.github.io/?https://github.com/Christina96/boilerplate-sample-matches/blob/main/Csharp/dotween-MDEwOlJlcG9zaXRvcnkzMjQ3NTE2Mg==-flat-Sequences.cs-dotween-MDEwOlJlcG9zaXRvcnkzMjQ3NTE2Mg==-flat-Sequences.cs.html,567,dotween-MDEwOlJlcG9zaXRvcnkzMjQ3NTE2Mg==-flat-Sequences.cs,dotween-MDEwOlJlcG9zaXRvcnkzMjQ3NTE2Mg==-flat-Sequences.cs,9,65,56,9,65,56
370,https://htmlpreview.github.io/?https://github.com/Christina96/boilerplate-sample-matches/blob/main/Csharp/NetCoreServer-MDEwOlJlcG9zaXRvcnkxNjYxMjMxNjQ=-flat-SslClient.cs-NetCoreServer-MDEwOlJlcG9zaXRvcnkxNjYxMjMxNjQ=-flat-SslClient.cs.html,229,NetCoreServer-MDEwOlJlcG9zaXRvcnkxNjYxMjMxNjQ=-flat-SslClient.cs,NetCoreServer-MDEwOlJlcG9zaXRvcnkxNjYxMjMxNjQ=-flat-SslClient.cs,307,367,60,307,367,60
371,https://htmlpreview.github.io/?https://github.com/Christina96/boilerplate-sample-matches/blob/main/Csharp/npgsql-MDEwOlJlcG9zaXRvcnkyODgzNTc0-flat-NpgsqlConnectionStringBuilderSourceGenerator.cs-npgsql-MDEwOlJlcG9zaXRvcnkyODgzNTc0-flat-NpgsqlConnectionStringBuilderSourceGenerator.cs.html,16,npgsql-MDEwOlJlcG9zaXRvcnkyODgzNTc0-flat-NpgsqlConnectionStringBuilderSourceGenerator.cs,npgsql-MDEwOlJlcG9zaXRvcnkyODgzNTc0-flat-NpgsqlConnectionStringBuilderSourceGenerator.cs,84,88,4,84,88,4
372,https://htmlpreview.github.io/?https://github.com/Christina96/boilerplate-sample-matches/blob/main/Csharp/EarTrumpet-MDEwOlJlcG9zaXRvcnkzODkxOTcwMg==-flat-ActionProcessor.cs-Security-MDEwOlJlcG9zaXRvcnkxNzcyMzY5OQ==-flat-MicrosoftAccountTests.cs.html,13,EarTrumpet-MDEwOlJlcG9zaXRvcnkzODkxOTcwMg==-flat-ActionProcessor.cs,Security-MDEwOlJlcG9zaXRvcnkxNzcyMzY5OQ==-flat-MicrosoftAccountTests.cs,108,111,3,227,230,3
373,https://htmlpreview.github.io/?https://github.com/Christina96/boilerplate-sample-matches/blob/main/Csharp/runner-MDEwOlJlcG9zaXRvcnkxODQyODY4NzU=-flat-ContainerOperationProvider.cs-runner-MDEwOlJlcG9zaXRvcnkxODQyODY4NzU=-flat-ContainerOperationProvider.cs.html,25,runner-MDEwOlJlcG9zaXRvcnkxODQyODY4NzU=-flat-ContainerOperationProvider.cs,runner-MDEwOlJlcG9zaXRvcnkxODQyODY4NzU=-flat-ContainerOperationProvider.cs,128,130,2,128,130,2
374,https://htmlpreview.github.io/?https://github.com/Christina96/boilerplate-sample-matches/blob/main/Csharp/ZXing.Net.Mobile-MDEwOlJlcG9zaXRvcnk2MTYwNjcz-flat-ZXingScannerView.ios.cs-EarTrumpet-MDEwOlJlcG9zaXRvcnkzODkxOTcwMg==-flat-ComboBoxEx.cs.html,15,ZXing.Net.Mobile-MDEwOlJlcG9zaXRvcnk2MTYwNjcz-flat-ZXingScannerView.ios.cs,EarTrumpet-MDEwOlJlcG9zaXRvcnkzODkxOTcwMg==-flat-ComboBoxEx.cs,195,197,2,64,66,2
375,https://htmlpreview.github.io/?https://github.com/Christina96/boilerplate-sample-matches/blob/main/Csharp/npgsql-MDEwOlJlcG9zaXRvcnkyODgzNTc0-flat-JsonNetTypeHandlerResolver.cs-npgsql-MDEwOlJlcG9zaXRvcnkyODgzNTc0-flat-JsonNetTypeHandlerResolver.cs.html,12,npgsql-MDEwOlJlcG9zaXRvcnkyODgzNTc0-flat-JsonNetTypeHandlerResolver.cs,npgsql-MDEwOlJlcG9zaXRvcnkyODgzNTc0-flat-JsonNetTypeHandlerResolver.cs,17,20,3,17,20,3
376,https://htmlpreview.github.io/?https://github.com/Christina96/boilerplate-sample-matches/blob/main/Csharp/EarTrumpet-MDEwOlJlcG9zaXRvcnkzODkxOTcwMg==-flat-ModernAppInfo.cs-EarTrumpet-MDEwOlJlcG9zaXRvcnkzODkxOTcwMg==-flat-ModernAppInfo.cs.html,13,EarTrumpet-MDEwOlJlcG9zaXRvcnkzODkxOTcwMg==-flat-ModernAppInfo.cs,EarTrumpet-MDEwOlJlcG9zaXRvcnkzODkxOTcwMg==-flat-ModernAppInfo.cs,99,100,1,99,100,1
377,https://htmlpreview.github.io/?https://github.com/Christina96/boilerplate-sample-matches/blob/main/Csharp/dotween-MDEwOlJlcG9zaXRvcnkzMjQ3NTE2Mg==-flat-TweenManager_146.cs-dotween-MDEwOlJlcG9zaXRvcnkzMjQ3NTE2Mg==-flat-TweenManager_146.cs.html,19,dotween-MDEwOlJlcG9zaXRvcnkzMjQ3NTE2Mg==-flat-TweenManager_146.cs,dotween-MDEwOlJlcG9zaXRvcnkzMjQ3NTE2Mg==-flat-TweenManager_146.cs,156,164,8,882,890,8
378,https://htmlpreview.github.io/?https://github.com/Christina96/boilerplate-sample-matches/blob/main/Csharp/Simple.Data-MDEwOlJlcG9zaXRvcnk4MTg3Njg=-flat-MockDbTransaction.cs-Simple.Data-MDEwOlJlcG9zaXRvcnk4MTg3Njg=-flat-MockDbTransaction.cs.html,12,Simple.Data-MDEwOlJlcG9zaXRvcnk4MTg3Njg=-flat-MockDbTransaction.cs,Simple.Data-MDEwOlJlcG9zaXRvcnk4MTg3Njg=-flat-MockDbTransaction.cs,18,22,4,18,22,4
379,https://htmlpreview.github.io/?https://github.com/Christina96/boilerplate-sample-matches/blob/main/Csharp/runner-MDEwOlJlcG9zaXRvcnkxODQyODY4NzU=-flat-ActionRunnerL0.cs-runner-MDEwOlJlcG9zaXRvcnkxODQyODY4NzU=-flat-ActionRunnerL0.cs.html,55,runner-MDEwOlJlcG9zaXRvcnkxODQyODY4NzU=-flat-ActionRunnerL0.cs,runner-MDEwOlJlcG9zaXRvcnkxODQyODY4NzU=-flat-ActionRunnerL0.cs,103,107,4,182,186,4
380,https://htmlpreview.github.io/?https://github.com/Christina96/boilerplate-sample-matches/blob/main/Csharp/runner-MDEwOlJlcG9zaXRvcnkxODQyODY4NzU=-flat-Worker.cs-EarTrumpet-MDEwOlJlcG9zaXRvcnkzODkxOTcwMg==-flat-FlyoutViewModel.cs.html,18,runner-MDEwOlJlcG9zaXRvcnkxODQyODY4NzU=-flat-Worker.cs,EarTrumpet-MDEwOlJlcG9zaXRvcnkzODkxOTcwMg==-flat-FlyoutViewModel.cs,89,93,4,212,216,4
381,https://htmlpreview.github.io/?https://github.com/Christina96/boilerplate-sample-matches/blob/main/Csharp/Simple.Data-MDEwOlJlcG9zaXRvcnk4MTg3Njg=-flat-SimpleEmptyExpression.cs-Simple.Data-MDEwOlJlcG9zaXRvcnk4MTg3Njg=-flat-FunctionReference.cs.html,14,Simple.Data-MDEwOlJlcG9zaXRvcnk4MTg3Njg=-flat-SimpleEmptyExpression.cs,Simple.Data-MDEwOlJlcG9zaXRvcnk4MTg3Njg=-flat-FunctionReference.cs,3,6,3,6,9,3
382,https://htmlpreview.github.io/?https://github.com/Christina96/boilerplate-sample-matches/blob/main/Csharp/runner-MDEwOlJlcG9zaXRvcnkxODQyODY4NzU=-flat-LocationXmlOperator.cs-runner-MDEwOlJlcG9zaXRvcnkxODQyODY4NzU=-flat-LocationXmlOperator.cs.html,12,runner-MDEwOlJlcG9zaXRvcnkxODQyODY4NzU=-flat-LocationXmlOperator.cs,runner-MDEwOlJlcG9zaXRvcnkxODQyODY4NzU=-flat-LocationXmlOperator.cs,31,32,1,34,35,1
383,https://htmlpreview.github.io/?https://github.com/Christina96/boilerplate-sample-matches/blob/main/Csharp/runner-MDEwOlJlcG9zaXRvcnkxODQyODY4NzU=-flat-ProcessExtensions.cs-runner-MDEwOlJlcG9zaXRvcnkxODQyODY4NzU=-flat-ProcessExtensions.cs.html,23,runner-MDEwOlJlcG9zaXRvcnkxODQyODY4NzU=-flat-ProcessExtensions.cs,runner-MDEwOlJlcG9zaXRvcnkxODQyODY4NzU=-flat-ProcessExtensions.cs,135,139,4,135,139,4
