ID,Link,Similarity,Tokens,File 1,File 2,Start 1,End 1,Detected Lines 1,Start 2,End 2,Detected Lines 2
2851,https://htmlpreview.github.io/?https://github.com/Christina96/boilerplate-sample-matches/blob/main/Csharp/20486D-DevelopingASPNETMVCWebApplications-MDEwOlJlcG9zaXRvcnkxMTkzNTI2Mzc=-flat-StudentContext_303.cs-NetCoreServer-MDEwOlJlcG9zaXRvcnkxNjYxMjMxNjQ=-flat-TcpTests.cs.html,0.07,14,20486D-DevelopingASPNETMVCWebApplications-MDEwOlJlcG9zaXRvcnkxMTkzNTI2Mzc=-flat-StudentContext_303.cs,NetCoreServer-MDEwOlJlcG9zaXRvcnkxNjYxMjMxNjQ=-flat-TcpTests.cs,16,17,1,12,13,1
3975,https://htmlpreview.github.io/?https://github.com/Christina96/boilerplate-sample-matches/blob/main/Csharp/npgsql-MDEwOlJlcG9zaXRvcnkyODgzNTc0-flat-LogicalDecodingMessage.cs-runner-MDEwOlJlcG9zaXRvcnkxODQyODY4NzU=-flat-ThrottlingReportHandler.cs.html,0.27184466019417475,14,npgsql-MDEwOlJlcG9zaXRvcnkyODgzNTc0-flat-LogicalDecodingMessage.cs,runner-MDEwOlJlcG9zaXRvcnkxODQyODY4NzU=-flat-ThrottlingReportHandler.cs,7,8,1,18,19,1
4119,https://htmlpreview.github.io/?https://github.com/Christina96/boilerplate-sample-matches/blob/main/Csharp/Simple.Data-MDEwOlJlcG9zaXRvcnk4MTg3Njg=-flat-InsertTest.cs-MudBlazor-MDEwOlJlcG9zaXRvcnkyODg0Mjg2NzY=-flat-DateRangePickerTests.cs.html,0.0958904109589041,11,Simple.Data-MDEwOlJlcG9zaXRvcnk4MTg3Njg=-flat-InsertTest.cs,MudBlazor-MDEwOlJlcG9zaXRvcnkyODg0Mjg2NzY=-flat-DateRangePickerTests.cs,31,39,8,71,81,10
4437,https://htmlpreview.github.io/?https://github.com/Christina96/boilerplate-sample-matches/blob/main/Csharp/MudBlazor-MDEwOlJlcG9zaXRvcnkyODg0Mjg2NzY=-flat-OverlayTests.cs-MudBlazor-MDEwOlJlcG9zaXRvcnkyODg0Mjg2NzY=-flat-MudDrawer.razor.cs.html,0.2978723404255319,11,MudBlazor-MDEwOlJlcG9zaXRvcnkyODg0Mjg2NzY=-flat-OverlayTests.cs,MudBlazor-MDEwOlJlcG9zaXRvcnkyODg0Mjg2NzY=-flat-MudDrawer.razor.cs,38,45,7,26,33,7
5951,https://htmlpreview.github.io/?https://github.com/Christina96/boilerplate-sample-matches/blob/main/Csharp/MudBlazor-MDEwOlJlcG9zaXRvcnkyODg0Mjg2NzY=-flat-MudTablePager.razor.cs-MudBlazor-MDEwOlJlcG9zaXRvcnkyODg0Mjg2NzY=-flat-MudBooleanInput.cs.html,0.2,10,MudBlazor-MDEwOlJlcG9zaXRvcnkyODg0Mjg2NzY=-flat-MudTablePager.razor.cs,MudBlazor-MDEwOlJlcG9zaXRvcnkyODg0Mjg2NzY=-flat-MudBooleanInput.cs,22,23,1,13,16,3
6230,https://htmlpreview.github.io/?https://github.com/Christina96/boilerplate-sample-matches/blob/main/Csharp/EarTrumpet-MDEwOlJlcG9zaXRvcnkzODkxOTcwMg==-flat-IPartWithText.cs-20486D-DevelopingASPNETMVCWebApplications-MDEwOlJlcG9zaXRvcnkxMTkzNTI2Mzc=-flat-IData_397.cs.html,0.6896551724137931,10,EarTrumpet-MDEwOlJlcG9zaXRvcnkzODkxOTcwMg==-flat-IPartWithText.cs,20486D-DevelopingASPNETMVCWebApplications-MDEwOlJlcG9zaXRvcnkxMTkzNTI2Mzc=-flat-IData_397.cs,2,5,3,6,9,3
8042,https://htmlpreview.github.io/?https://github.com/Christina96/boilerplate-sample-matches/blob/main/Csharp/MudBlazor-MDEwOlJlcG9zaXRvcnkyODg0Mjg2NzY=-flat-FooterContext.cs-npgsql-MDEwOlJlcG9zaXRvcnkyODgzNTc0-flat-RelationMessage.cs.html,0.16666666666666666,10,MudBlazor-MDEwOlJlcG9zaXRvcnkyODg0Mjg2NzY=-flat-FooterContext.cs,npgsql-MDEwOlJlcG9zaXRvcnkyODgzNTc0-flat-RelationMessage.cs,13,22,9,37,39,2
13628,https://htmlpreview.github.io/?https://github.com/Christina96/boilerplate-sample-matches/blob/main/Csharp/runner-MDEwOlJlcG9zaXRvcnkxODQyODY4NzU=-flat-RunnerPluginManager.cs-Security-MDEwOlJlcG9zaXRvcnkxNzcyMzY5OQ==-flat-TestAuthenticationService.cs.html,0.3925233644859813,21,runner-MDEwOlJlcG9zaXRvcnkxODQyODY4NzU=-flat-RunnerPluginManager.cs,Security-MDEwOlJlcG9zaXRvcnkxNzcyMzY5OQ==-flat-TestAuthenticationService.cs,121,123,2,14,16,2
13865,https://htmlpreview.github.io/?https://github.com/Christina96/boilerplate-sample-matches/blob/main/Csharp/20486D-DevelopingASPNETMVCWebApplications-MDEwOlJlcG9zaXRvcnkxMTkzNTI2Mzc=-flat-Data_398.cs-20486D-DevelopingASPNETMVCWebApplications-MDEwOlJlcG9zaXRvcnkxMTkzNTI2Mzc=-flat-RestaurantBranch.cs.html,0.24691358024691357,10,20486D-DevelopingASPNETMVCWebApplications-MDEwOlJlcG9zaXRvcnkxMTkzNTI2Mzc=-flat-Data_398.cs,20486D-DevelopingASPNETMVCWebApplications-MDEwOlJlcG9zaXRvcnkxMTkzNTI2Mzc=-flat-RestaurantBranch.cs,1,9,8,1,13,12
14987,https://htmlpreview.github.io/?https://github.com/Christina96/boilerplate-sample-matches/blob/main/Csharp/20486D-DevelopingASPNETMVCWebApplications-MDEwOlJlcG9zaXRvcnkxMTkzNTI2Mzc=-flat-JobApplication_103.cs-MudBlazor-MDEwOlJlcG9zaXRvcnkyODg0Mjg2NzY=-flat-PaletteDark.cs.html,0.07220216606498195,10,20486D-DevelopingASPNETMVCWebApplications-MDEwOlJlcG9zaXRvcnkxMTkzNTI2Mzc=-flat-JobApplication_103.cs,MudBlazor-MDEwOlJlcG9zaXRvcnkyODg0Mjg2NzY=-flat-PaletteDark.cs,1,10,9,1,6,5
15176,https://htmlpreview.github.io/?https://github.com/Christina96/boilerplate-sample-matches/blob/main/Csharp/MudBlazor-MDEwOlJlcG9zaXRvcnkyODg0Mjg2NzY=-flat-DrawerTest.cs-npgsql-MDEwOlJlcG9zaXRvcnkyODgzNTc0-flat-CopyTests.cs.html,0.30186170212765956,10,MudBlazor-MDEwOlJlcG9zaXRvcnkyODg0Mjg2NzY=-flat-DrawerTest.cs,npgsql-MDEwOlJlcG9zaXRvcnkyODgzNTc0-flat-CopyTests.cs,89,94,5,624,631,7
15649,https://htmlpreview.github.io/?https://github.com/Christina96/boilerplate-sample-matches/blob/main/Csharp/MudBlazor-MDEwOlJlcG9zaXRvcnkyODg0Mjg2NzY=-flat-MudDataGrid.razor.cs-MudBlazor-MDEwOlJlcG9zaXRvcnkyODg0Mjg2NzY=-flat-MudPicker.razor.cs.html,0.2876949740034662,11,MudBlazor-MDEwOlJlcG9zaXRvcnkyODg0Mjg2NzY=-flat-MudDataGrid.razor.cs,MudBlazor-MDEwOlJlcG9zaXRvcnkyODg0Mjg2NzY=-flat-MudPicker.razor.cs,59,67,8,44,53,9
16683,https://htmlpreview.github.io/?https://github.com/Christina96/boilerplate-sample-matches/blob/main/Csharp/20486D-DevelopingASPNETMVCWebApplications-MDEwOlJlcG9zaXRvcnkxMTkzNTI2Mzc=-flat-ZooContext_208.cs-NetCoreServer-MDEwOlJlcG9zaXRvcnkxNjYxMjMxNjQ=-flat-UdsTests.cs.html,0.06965174129353234,14,20486D-DevelopingASPNETMVCWebApplications-MDEwOlJlcG9zaXRvcnkxMTkzNTI2Mzc=-flat-ZooContext_208.cs,NetCoreServer-MDEwOlJlcG9zaXRvcnkxNjYxMjMxNjQ=-flat-UdsTests.cs,14,15,1,12,13,1
17744,https://htmlpreview.github.io/?https://github.com/Christina96/boilerplate-sample-matches/blob/main/Csharp/dotween-MDEwOlJlcG9zaXRvcnkzMjQ3NTE2Mg==-flat-GoEaseExponential.cs-Simple.Data-MDEwOlJlcG9zaXRvcnk4MTg3Njg=-flat-SimpleResultSet.cs.html,0.072992700729927,10,dotween-MDEwOlJlcG9zaXRvcnkzMjQ3NTE2Mg==-flat-GoEaseExponential.cs,Simple.Data-MDEwOlJlcG9zaXRvcnk4MTg3Njg=-flat-SimpleResultSet.cs,5,13,8,54,62,8
18794,https://htmlpreview.github.io/?https://github.com/Christina96/boilerplate-sample-matches/blob/main/Csharp/20486D-DevelopingASPNETMVCWebApplications-MDEwOlJlcG9zaXRvcnkxMTkzNTI2Mzc=-flat-Startup_73.cs-20486D-DevelopingASPNETMVCWebApplications-MDEwOlJlcG9zaXRvcnkxMTkzNTI2Mzc=-flat-Startup_4.cs.html,1.0,12,20486D-DevelopingASPNETMVCWebApplications-MDEwOlJlcG9zaXRvcnkxMTkzNTI2Mzc=-flat-Startup_73.cs,20486D-DevelopingASPNETMVCWebApplications-MDEwOlJlcG9zaXRvcnkxMTkzNTI2Mzc=-flat-Startup_4.cs,1,25,24,1,23,22
19799,https://htmlpreview.github.io/?https://github.com/Christina96/boilerplate-sample-matches/blob/main/Csharp/EarTrumpet-MDEwOlJlcG9zaXRvcnkzODkxOTcwMg==-flat-Ref.cs-20486D-DevelopingASPNETMVCWebApplications-MDEwOlJlcG9zaXRvcnkxMTkzNTI2Mzc=-flat-MenuCategory.cs.html,0.8076923076923077,21,EarTrumpet-MDEwOlJlcG9zaXRvcnkzODkxOTcwMg==-flat-Ref.cs,20486D-DevelopingASPNETMVCWebApplications-MDEwOlJlcG9zaXRvcnkxMTkzNTI2Mzc=-flat-MenuCategory.cs,1,8,7,1,11,10
22189,https://htmlpreview.github.io/?https://github.com/Christina96/boilerplate-sample-matches/blob/main/Csharp/runner-MDEwOlJlcG9zaXRvcnkxODQyODY4NzU=-flat-AgentLabel.cs-20486D-DevelopingASPNETMVCWebApplications-MDEwOlJlcG9zaXRvcnkxMTkzNTI2Mzc=-flat-Photo_47.cs.html,0.3770491803278688,23,runner-MDEwOlJlcG9zaXRvcnkxODQyODY4NzU=-flat-AgentLabel.cs,20486D-DevelopingASPNETMVCWebApplications-MDEwOlJlcG9zaXRvcnkxMTkzNTI2Mzc=-flat-Photo_47.cs,29,44,15,14,18,4
22237,https://htmlpreview.github.io/?https://github.com/Christina96/boilerplate-sample-matches/blob/main/Csharp/MudBlazor-MDEwOlJlcG9zaXRvcnkyODg0Mjg2NzY=-flat-SvgCircle.cs-npgsql-MDEwOlJlcG9zaXRvcnkyODgzNTc0-flat-Program_1.cs.html,0.2132701421800948,16,MudBlazor-MDEwOlJlcG9zaXRvcnkyODg0Mjg2NzY=-flat-SvgCircle.cs,npgsql-MDEwOlJlcG9zaXRvcnkyODgzNTc0-flat-Program_1.cs,9,12,3,333,336,3
23647,https://htmlpreview.github.io/?https://github.com/Christina96/boilerplate-sample-matches/blob/main/Csharp/20486D-DevelopingASPNETMVCWebApplications-MDEwOlJlcG9zaXRvcnkxMTkzNTI2Mzc=-flat-RegisterViewModel.cs-runner-MDEwOlJlcG9zaXRvcnkxODQyODY4NzU=-flat-PackageMetadata.cs.html,0.43010752688172044,11,20486D-DevelopingASPNETMVCWebApplications-MDEwOlJlcG9zaXRvcnkxMTkzNTI2Mzc=-flat-RegisterViewModel.cs,runner-MDEwOlJlcG9zaXRvcnkxODQyODY4NzU=-flat-PackageMetadata.cs,14,16,2,47,53,6
24667,https://htmlpreview.github.io/?https://github.com/Christina96/boilerplate-sample-matches/blob/main/Csharp/20486D-DevelopingASPNETMVCWebApplications-MDEwOlJlcG9zaXRvcnkxMTkzNTI2Mzc=-flat-Program_71.cs-20486D-DevelopingASPNETMVCWebApplications-MDEwOlJlcG9zaXRvcnkxMTkzNTI2Mzc=-flat-Program_250.cs.html,1.0,12,20486D-DevelopingASPNETMVCWebApplications-MDEwOlJlcG9zaXRvcnkxMTkzNTI2Mzc=-flat-Program_71.cs,20486D-DevelopingASPNETMVCWebApplications-MDEwOlJlcG9zaXRvcnkxMTkzNTI2Mzc=-flat-Program_250.cs,1,22,21,1,22,21
24738,https://htmlpreview.github.io/?https://github.com/Christina96/boilerplate-sample-matches/blob/main/Csharp/20486D-DevelopingASPNETMVCWebApplications-MDEwOlJlcG9zaXRvcnkxMTkzNTI2Mzc=-flat-City_460.cs-NetCoreServer-MDEwOlJlcG9zaXRvcnkxNjYxMjMxNjQ=-flat-Program_9.cs.html,0.11891891891891893,11,20486D-DevelopingASPNETMVCWebApplications-MDEwOlJlcG9zaXRvcnkxMTkzNTI2Mzc=-flat-City_460.cs,NetCoreServer-MDEwOlJlcG9zaXRvcnkxNjYxMjMxNjQ=-flat-Program_9.cs,8,10,2,26,28,2
26908,https://htmlpreview.github.io/?https://github.com/Christina96/boilerplate-sample-matches/blob/main/Csharp/MudBlazor-MDEwOlJlcG9zaXRvcnkyODg0Mjg2NzY=-flat-TextFieldTests.cs-runner-MDEwOlJlcG9zaXRvcnkxODQyODY4NzU=-flat-ActionManagerL0.cs.html,0.10334603981363828,18,MudBlazor-MDEwOlJlcG9zaXRvcnkyODg0Mjg2NzY=-flat-TextFieldTests.cs,runner-MDEwOlJlcG9zaXRvcnkxODQyODY4NzU=-flat-ActionManagerL0.cs,446,457,11,1846,1849,3
27856,https://htmlpreview.github.io/?https://github.com/Christina96/boilerplate-sample-matches/blob/main/Csharp/MudBlazor-MDEwOlJlcG9zaXRvcnkyODg0Mjg2NzY=-flat-TimelineAlign.cs-MudBlazor-MDEwOlJlcG9zaXRvcnkyODg0Mjg2NzY=-flat-Origin.cs.html,0.5555555555555556,10,MudBlazor-MDEwOlJlcG9zaXRvcnkyODg0Mjg2NzY=-flat-TimelineAlign.cs,MudBlazor-MDEwOlJlcG9zaXRvcnkyODg0Mjg2NzY=-flat-Origin.cs,1,10,9,1,10,9
27867,https://htmlpreview.github.io/?https://github.com/Christina96/boilerplate-sample-matches/blob/main/Csharp/MudBlazor-MDEwOlJlcG9zaXRvcnkyODg0Mjg2NzY=-flat-MudTimeline.razor.cs-NetCoreServer-MDEwOlJlcG9zaXRvcnkxNjYxMjMxNjQ=-flat-HttpClient.cs.html,0.0989399293286219,14,MudBlazor-MDEwOlJlcG9zaXRvcnkyODg0Mjg2NzY=-flat-MudTimeline.razor.cs,NetCoreServer-MDEwOlJlcG9zaXRvcnkxNjYxMjMxNjQ=-flat-HttpClient.cs,26,36,10,18,34,16
28172,https://htmlpreview.github.io/?https://github.com/Christina96/boilerplate-sample-matches/blob/main/Csharp/EarTrumpet-MDEwOlJlcG9zaXRvcnkzODkxOTcwMg==-flat-ContextMenuItem.cs-MudBlazor-MDEwOlJlcG9zaXRvcnkyODg0Mjg2NzY=-flat-ResizeBasedServiceTests.cs.html,0.06896551724137931,15,EarTrumpet-MDEwOlJlcG9zaXRvcnkzODkxOTcwMg==-flat-ContextMenuItem.cs,MudBlazor-MDEwOlJlcG9zaXRvcnkyODg0Mjg2NzY=-flat-ResizeBasedServiceTests.cs,6,8,2,296,298,2
29505,https://htmlpreview.github.io/?https://github.com/Christina96/boilerplate-sample-matches/blob/main/Csharp/EarTrumpet-MDEwOlJlcG9zaXRvcnkzODkxOTcwMg==-flat-SettingsAppItemViewModel.cs-MudBlazor-MDEwOlJlcG9zaXRvcnkyODg0Mjg2NzY=-flat-JsEventOptions.cs.html,0.6666666666666666,17,EarTrumpet-MDEwOlJlcG9zaXRvcnkzODkxOTcwMg==-flat-SettingsAppItemViewModel.cs,MudBlazor-MDEwOlJlcG9zaXRvcnkyODg0Mjg2NzY=-flat-JsEventOptions.cs,1,13,12,1,7,6
30123,https://htmlpreview.github.io/?https://github.com/Christina96/boilerplate-sample-matches/blob/main/Csharp/dotween-MDEwOlJlcG9zaXRvcnkzMjQ3NTE2Mg==-flat-DORotateTests.cs-NetCoreServer-MDEwOlJlcG9zaXRvcnkxNjYxMjMxNjQ=-flat-WsSession.cs.html,0.07622504537205081,10,dotween-MDEwOlJlcG9zaXRvcnkzMjQ3NTE2Mg==-flat-DORotateTests.cs,NetCoreServer-MDEwOlJlcG9zaXRvcnkxNjYxMjMxNjQ=-flat-WsSession.cs,139,148,9,206,216,10
30595,https://htmlpreview.github.io/?https://github.com/Christina96/boilerplate-sample-matches/blob/main/Csharp/dotween-MDEwOlJlcG9zaXRvcnkzMjQ3NTE2Mg==-flat-OnWaypointChangedTests.cs-npgsql-MDEwOlJlcG9zaXRvcnkyODgzNTc0-flat-ExceptionTests.cs.html,0.11970074812967581,12,dotween-MDEwOlJlcG9zaXRvcnkzMjQ3NTE2Mg==-flat-OnWaypointChangedTests.cs,npgsql-MDEwOlJlcG9zaXRvcnkyODgzNTc0-flat-ExceptionTests.cs,126,132,6,225,236,11
30708,https://htmlpreview.github.io/?https://github.com/Christina96/boilerplate-sample-matches/blob/main/Csharp/npgsql-MDEwOlJlcG9zaXRvcnkyODgzNTc0-flat-ReplicationSlotOptions.cs-MudBlazor-MDEwOlJlcG9zaXRvcnkyODg0Mjg2NzY=-flat-SnackbarOptions.cs.html,0.14457831325301204,12,npgsql-MDEwOlJlcG9zaXRvcnkyODgzNTc0-flat-ReplicationSlotOptions.cs,MudBlazor-MDEwOlJlcG9zaXRvcnkyODg0Mjg2NzY=-flat-SnackbarOptions.cs,19,21,2,13,15,2
30863,https://htmlpreview.github.io/?https://github.com/Christina96/boilerplate-sample-matches/blob/main/Csharp/20486D-DevelopingASPNETMVCWebApplications-MDEwOlJlcG9zaXRvcnkxMTkzNTI2Mzc=-flat-ZooContext_208.cs-npgsql-MDEwOlJlcG9zaXRvcnkyODgzNTc0-flat-BeginMessage.cs.html,0.56,14,20486D-DevelopingASPNETMVCWebApplications-MDEwOlJlcG9zaXRvcnkxMTkzNTI2Mzc=-flat-ZooContext_208.cs,npgsql-MDEwOlJlcG9zaXRvcnkyODgzNTc0-flat-BeginMessage.cs,14,15,1,6,7,1
31042,https://htmlpreview.github.io/?https://github.com/Christina96/boilerplate-sample-matches/blob/main/Csharp/20486D-DevelopingASPNETMVCWebApplications-MDEwOlJlcG9zaXRvcnkxMTkzNTI2Mzc=-flat-Product_33.cs-MudBlazor-MDEwOlJlcG9zaXRvcnkyODg0Mjg2NzY=-flat-ColorTransformation.cs.html,0.17959183673469387,22,20486D-DevelopingASPNETMVCWebApplications-MDEwOlJlcG9zaXRvcnkxMTkzNTI2Mzc=-flat-Product_33.cs,MudBlazor-MDEwOlJlcG9zaXRvcnkyODg0Mjg2NzY=-flat-ColorTransformation.cs,12,15,3,12,15,3
31282,https://htmlpreview.github.io/?https://github.com/Christina96/boilerplate-sample-matches/blob/main/Csharp/MudBlazor-MDEwOlJlcG9zaXRvcnkyODg0Mjg2NzY=-flat-MudRating.razor.cs-MudBlazor-MDEwOlJlcG9zaXRvcnkyODg0Mjg2NzY=-flat-MudPicker.razor.cs.html,0.48434237995824636,16,MudBlazor-MDEwOlJlcG9zaXRvcnkyODg0Mjg2NzY=-flat-MudRating.razor.cs,MudBlazor-MDEwOlJlcG9zaXRvcnkyODg0Mjg2NzY=-flat-MudPicker.razor.cs,47,56,9,150,156,6
31481,https://htmlpreview.github.io/?https://github.com/Christina96/boilerplate-sample-matches/blob/main/Csharp/Simple.Data-MDEwOlJlcG9zaXRvcnk4MTg3Njg=-flat-ProcedureTest_35.cs-MudBlazor-MDEwOlJlcG9zaXRvcnkyODg0Mjg2NzY=-flat-RegexMaskIPv6Tests.cs.html,0.13274336283185842,15,Simple.Data-MDEwOlJlcG9zaXRvcnk4MTg3Njg=-flat-ProcedureTest_35.cs,MudBlazor-MDEwOlJlcG9zaXRvcnkyODg0Mjg2NzY=-flat-RegexMaskIPv6Tests.cs,45,56,11,64,73,9
31584,https://htmlpreview.github.io/?https://github.com/Christina96/boilerplate-sample-matches/blob/main/Csharp/npgsql-MDEwOlJlcG9zaXRvcnkyODgzNTc0-flat-GlobalTypeMapper.cs-MudBlazor-MDEwOlJlcG9zaXRvcnkyODg0Mjg2NzY=-flat-SnackbarOptions.cs.html,0.15,12,npgsql-MDEwOlJlcG9zaXRvcnkyODgzNTc0-flat-GlobalTypeMapper.cs,MudBlazor-MDEwOlJlcG9zaXRvcnkyODg0Mjg2NzY=-flat-SnackbarOptions.cs,17,18,1,14,15,1
32031,https://htmlpreview.github.io/?https://github.com/Christina96/boilerplate-sample-matches/blob/main/Csharp/MudBlazor-MDEwOlJlcG9zaXRvcnkyODg0Mjg2NzY=-flat-ToggleIconButtonTest.cs-runner-MDEwOlJlcG9zaXRvcnkxODQyODY4NzU=-flat-IssueExtensions.cs.html,0.13157894736842105,10,MudBlazor-MDEwOlJlcG9zaXRvcnkyODg0Mjg2NzY=-flat-ToggleIconButtonTest.cs,runner-MDEwOlJlcG9zaXRvcnkxODQyODY4NzU=-flat-IssueExtensions.cs,50,54,4,16,20,4
32159,https://htmlpreview.github.io/?https://github.com/Christina96/boilerplate-sample-matches/blob/main/Csharp/20486D-DevelopingASPNETMVCWebApplications-MDEwOlJlcG9zaXRvcnkxMTkzNTI2Mzc=-flat-Book_320.cs-Security-MDEwOlJlcG9zaXRvcnkxNzcyMzY5OQ==-flat-OpenIdConnectOptions.cs.html,0.5333333333333333,11,20486D-DevelopingASPNETMVCWebApplications-MDEwOlJlcG9zaXRvcnkxMTkzNTI2Mzc=-flat-Book_320.cs,Security-MDEwOlJlcG9zaXRvcnkxNzcyMzY5OQ==-flat-OpenIdConnectOptions.cs,23,24,1,79,80,1
32652,https://htmlpreview.github.io/?https://github.com/Christina96/boilerplate-sample-matches/blob/main/Csharp/Simple.Data-MDEwOlJlcG9zaXRvcnk4MTg3Njg=-flat-DictionaryQueryRunnerTest.cs-NetCoreServer-MDEwOlJlcG9zaXRvcnkxNjYxMjMxNjQ=-flat-SslTests.cs.html,0.08596713021491782,17,Simple.Data-MDEwOlJlcG9zaXRvcnk4MTg3Njg=-flat-DictionaryQueryRunnerTest.cs,NetCoreServer-MDEwOlJlcG9zaXRvcnkxNjYxMjMxNjQ=-flat-SslTests.cs,72,87,15,88,104,16
33156,https://htmlpreview.github.io/?https://github.com/Christina96/boilerplate-sample-matches/blob/main/Csharp/20486D-DevelopingASPNETMVCWebApplications-MDEwOlJlcG9zaXRvcnkxMTkzNTI2Mzc=-flat-Program_233.cs-20486D-DevelopingASPNETMVCWebApplications-MDEwOlJlcG9zaXRvcnkxMTkzNTI2Mzc=-flat-Program_272.cs.html,1.0,12,20486D-DevelopingASPNETMVCWebApplications-MDEwOlJlcG9zaXRvcnkxMTkzNTI2Mzc=-flat-Program_233.cs,20486D-DevelopingASPNETMVCWebApplications-MDEwOlJlcG9zaXRvcnkxMTkzNTI2Mzc=-flat-Program_272.cs,1,22,21,1,22,21
37488,https://htmlpreview.github.io/?https://github.com/Christina96/boilerplate-sample-matches/blob/main/Csharp/runner-MDEwOlJlcG9zaXRvcnkxODQyODY4NzU=-flat-JobRunnerL0.cs-MudBlazor-MDEwOlJlcG9zaXRvcnkyODg0Mjg2NzY=-flat-TypeIdentifierTests.cs.html,0.20168067226890757,12,runner-MDEwOlJlcG9zaXRvcnkxODQyODY4NzU=-flat-JobRunnerL0.cs,MudBlazor-MDEwOlJlcG9zaXRvcnkyODg0Mjg2NzY=-flat-TypeIdentifierTests.cs,29,142,113,20,31,11
38370,https://htmlpreview.github.io/?https://github.com/Christina96/boilerplate-sample-matches/blob/main/Csharp/Security-MDEwOlJlcG9zaXRvcnkxNzcyMzY5OQ==-flat-CookiePolicyTests.cs-MudBlazor-MDEwOlJlcG9zaXRvcnkyODg0Mjg2NzY=-flat-PopoverTests.cs.html,0.14241960183767227,13,Security-MDEwOlJlcG9zaXRvcnkxNzcyMzY5OQ==-flat-CookiePolicyTests.cs,MudBlazor-MDEwOlJlcG9zaXRvcnkyODg0Mjg2NzY=-flat-PopoverTests.cs,200,214,14,744,752,8
38775,https://htmlpreview.github.io/?https://github.com/Christina96/boilerplate-sample-matches/blob/main/Csharp/npgsql-MDEwOlJlcG9zaXRvcnkyODgzNTc0-flat-SystemTransactionTests.cs-npgsql-MDEwOlJlcG9zaXRvcnkyODgzNTc0-flat-ReaderTests.cs.html,0.12495562655307065,12,npgsql-MDEwOlJlcG9zaXRvcnkyODgzNTc0-flat-SystemTransactionTests.cs,npgsql-MDEwOlJlcG9zaXRvcnkyODgzNTc0-flat-ReaderTests.cs,96,108,12,1323,1331,8
41053,https://htmlpreview.github.io/?https://github.com/Christina96/boilerplate-sample-matches/blob/main/Csharp/runner-MDEwOlJlcG9zaXRvcnkxODQyODY4NzU=-flat-Issue.cs-NetCoreServer-MDEwOlJlcG9zaXRvcnkxNjYxMjMxNjQ=-flat-HttpRequest.cs.html,0.030165912518853696,10,runner-MDEwOlJlcG9zaXRvcnkxODQyODY4NzU=-flat-Issue.cs,NetCoreServer-MDEwOlJlcG9zaXRvcnkxNjYxMjMxNjQ=-flat-HttpRequest.cs,45,53,8,18,19,1
42078,https://htmlpreview.github.io/?https://github.com/Christina96/boilerplate-sample-matches/blob/main/Csharp/Security-MDEwOlJlcG9zaXRvcnkxNzcyMzY5OQ==-flat-Startup_10.cs-MudBlazor-MDEwOlJlcG9zaXRvcnkyODg0Mjg2NzY=-flat-HiddenTests.cs.html,0.0975609756097561,13,Security-MDEwOlJlcG9zaXRvcnkxNzcyMzY5OQ==-flat-Startup_10.cs,MudBlazor-MDEwOlJlcG9zaXRvcnkyODg0Mjg2NzY=-flat-HiddenTests.cs,174,183,9,52,55,3
43372,https://htmlpreview.github.io/?https://github.com/Christina96/boilerplate-sample-matches/blob/main/Csharp/runner-MDEwOlJlcG9zaXRvcnkxODQyODY4NzU=-flat-TimelineRecordLogLine.cs-20486D-DevelopingASPNETMVCWebApplications-MDEwOlJlcG9zaXRvcnkxMTkzNTI2Mzc=-flat-OrderTable_94.cs.html,0.3333333333333333,18,runner-MDEwOlJlcG9zaXRvcnkxODQyODY4NzU=-flat-TimelineRecordLogLine.cs,20486D-DevelopingASPNETMVCWebApplications-MDEwOlJlcG9zaXRvcnkxMTkzNTI2Mzc=-flat-OrderTable_94.cs,11,23,12,21,25,4
43905,https://htmlpreview.github.io/?https://github.com/Christina96/boilerplate-sample-matches/blob/main/Csharp/npgsql-MDEwOlJlcG9zaXRvcnkyODgzNTc0-flat-BeginMessage.cs-runner-MDEwOlJlcG9zaXRvcnkxODQyODY4NzU=-flat-VssTraceActivity.cs.html,0.1834862385321101,10,npgsql-MDEwOlJlcG9zaXRvcnkyODgzNTc0-flat-BeginMessage.cs,runner-MDEwOlJlcG9zaXRvcnkxODQyODY4NzU=-flat-VssTraceActivity.cs,6,7,1,18,26,8
44552,https://htmlpreview.github.io/?https://github.com/Christina96/boilerplate-sample-matches/blob/main/Csharp/dotween-MDEwOlJlcG9zaXRvcnkzMjQ3NTE2Mg==-flat-UGUI.cs-runner-MDEwOlJlcG9zaXRvcnkxODQyODY4NzU=-flat-JobExtensionL0.cs.html,0.1415929203539823,21,dotween-MDEwOlJlcG9zaXRvcnkzMjQ3NTE2Mg==-flat-UGUI.cs,runner-MDEwOlJlcG9zaXRvcnkxODQyODY4NzU=-flat-JobExtensionL0.cs,17,23,6,97,117,20
45422,https://htmlpreview.github.io/?https://github.com/Christina96/boilerplate-sample-matches/blob/main/Csharp/NetCoreServer-MDEwOlJlcG9zaXRvcnkxNjYxMjMxNjQ=-flat-Utilities.cs-MudBlazor-MDEwOlJlcG9zaXRvcnkyODg0Mjg2NzY=-flat-MudRatingItem.razor.cs.html,0.062111801242236024,10,NetCoreServer-MDEwOlJlcG9zaXRvcnkxNjYxMjMxNjQ=-flat-Utilities.cs,MudBlazor-MDEwOlJlcG9zaXRvcnkyODg0Mjg2NzY=-flat-MudRatingItem.razor.cs,74,83,9,12,20,8
47645,https://htmlpreview.github.io/?https://github.com/Christina96/boilerplate-sample-matches/blob/main/Csharp/Security-MDEwOlJlcG9zaXRvcnkxNzcyMzY5OQ==-flat-Program_9.cs-dotween-MDEwOlJlcG9zaXRvcnkzMjQ3NTE2Mg==-flat-PathWaypointReached_54.cs.html,0.24175824175824176,11,Security-MDEwOlJlcG9zaXRvcnkxNzcyMzY5OQ==-flat-Program_9.cs,dotween-MDEwOlJlcG9zaXRvcnkzMjQ3NTE2Mg==-flat-PathWaypointReached_54.cs,11,22,11,19,28,9
47751,https://htmlpreview.github.io/?https://github.com/Christina96/boilerplate-sample-matches/blob/main/Csharp/runner-MDEwOlJlcG9zaXRvcnkxODQyODY4NzU=-flat-VssJsonMediaTypeFormatter.cs-Security-MDEwOlJlcG9zaXRvcnkxNzcyMzY5OQ==-flat-TestHandlers.cs.html,0.19708029197080293,10,runner-MDEwOlJlcG9zaXRvcnkxODQyODY4NzU=-flat-VssJsonMediaTypeFormatter.cs,Security-MDEwOlJlcG9zaXRvcnkxNzcyMzY5OQ==-flat-TestHandlers.cs,74,78,4,13,14,1
50655,https://htmlpreview.github.io/?https://github.com/Christina96/boilerplate-sample-matches/blob/main/Csharp/MudBlazor-MDEwOlJlcG9zaXRvcnkyODg0Mjg2NzY=-flat-DocsLink.cs-runner-MDEwOlJlcG9zaXRvcnkxODQyODY4NzU=-flat-RawHttpMessageHandler.cs.html,0.0979020979020979,14,MudBlazor-MDEwOlJlcG9zaXRvcnkyODg0Mjg2NzY=-flat-DocsLink.cs,runner-MDEwOlJlcG9zaXRvcnkxODQyODY4NzU=-flat-RawHttpMessageHandler.cs,5,6,1,46,54,8
51234,https://htmlpreview.github.io/?https://github.com/Christina96/boilerplate-sample-matches/blob/main/Csharp/MudBlazor-MDEwOlJlcG9zaXRvcnkyODg0Mjg2NzY=-flat-RegexMaskTests.cs-MudBlazor-MDEwOlJlcG9zaXRvcnkyODg0Mjg2NzY=-flat-MudBadge.razor.cs.html,0.16455696202531644,13,MudBlazor-MDEwOlJlcG9zaXRvcnkyODg0Mjg2NzY=-flat-RegexMaskTests.cs,MudBlazor-MDEwOlJlcG9zaXRvcnkyODg0Mjg2NzY=-flat-MudBadge.razor.cs,10,17,7,21,28,7
51611,https://htmlpreview.github.io/?https://github.com/Christina96/boilerplate-sample-matches/blob/main/Csharp/MudBlazor-MDEwOlJlcG9zaXRvcnkyODg0Mjg2NzY=-flat-MudColorTests.cs-MudBlazor-MDEwOlJlcG9zaXRvcnkyODg0Mjg2NzY=-flat-NumericFieldTests.cs.html,0.48188405797101447,15,MudBlazor-MDEwOlJlcG9zaXRvcnkyODg0Mjg2NzY=-flat-MudColorTests.cs,MudBlazor-MDEwOlJlcG9zaXRvcnkyODg0Mjg2NzY=-flat-NumericFieldTests.cs,78,89,11,254,265,11
51641,https://htmlpreview.github.io/?https://github.com/Christina96/boilerplate-sample-matches/blob/main/Csharp/npgsql-MDEwOlJlcG9zaXRvcnkyODgzNTc0-flat-MultipleHostsTests.cs-MudBlazor-MDEwOlJlcG9zaXRvcnkyODg0Mjg2NzY=-flat-FormTests.cs.html,0.22505307855626328,16,npgsql-MDEwOlJlcG9zaXRvcnkyODgzNTc0-flat-MultipleHostsTests.cs,MudBlazor-MDEwOlJlcG9zaXRvcnkyODg0Mjg2NzY=-flat-FormTests.cs,430,441,11,992,1003,11
51982,https://htmlpreview.github.io/?https://github.com/Christina96/boilerplate-sample-matches/blob/main/Csharp/MudBlazor-MDEwOlJlcG9zaXRvcnkyODg0Mjg2NzY=-flat-FilterOptions.cs-ZXing.Net.Mobile-MDEwOlJlcG9zaXRvcnk2MTYwNjcz-flat-AVCaptureScannerView.ios.cs.html,0.037162162162162164,11,MudBlazor-MDEwOlJlcG9zaXRvcnkyODg0Mjg2NzY=-flat-FilterOptions.cs,ZXing.Net.Mobile-MDEwOlJlcG9zaXRvcnk2MTYwNjcz-flat-AVCaptureScannerView.ios.cs,6,7,1,38,39,1
52300,https://htmlpreview.github.io/?https://github.com/Christina96/boilerplate-sample-matches/blob/main/Csharp/MudBlazor-MDEwOlJlcG9zaXRvcnkyODg0Mjg2NzY=-flat-IMask.cs-npgsql-MDEwOlJlcG9zaXRvcnkyODgzNTc0-flat-NpgsqlLargeObjectManager.cs.html,0.12435233160621761,12,MudBlazor-MDEwOlJlcG9zaXRvcnkyODg0Mjg2NzY=-flat-IMask.cs,npgsql-MDEwOlJlcG9zaXRvcnkyODgzNTc0-flat-NpgsqlLargeObjectManager.cs,11,13,2,12,13,1
53917,https://htmlpreview.github.io/?https://github.com/Christina96/boilerplate-sample-matches/blob/main/Csharp/20486D-DevelopingASPNETMVCWebApplications-MDEwOlJlcG9zaXRvcnkxMTkzNTI2Mzc=-flat-Program_23.cs-20486D-DevelopingASPNETMVCWebApplications-MDEwOlJlcG9zaXRvcnkxMTkzNTI2Mzc=-flat-Program_258.cs.html,1.0,12,20486D-DevelopingASPNETMVCWebApplications-MDEwOlJlcG9zaXRvcnkxMTkzNTI2Mzc=-flat-Program_23.cs,20486D-DevelopingASPNETMVCWebApplications-MDEwOlJlcG9zaXRvcnkxMTkzNTI2Mzc=-flat-Program_258.cs,1,22,21,1,22,21
54720,https://htmlpreview.github.io/?https://github.com/Christina96/boilerplate-sample-matches/blob/main/Csharp/Simple.Data-MDEwOlJlcG9zaXRvcnk4MTg3Njg=-flat-SqlColumn.cs-Security-MDEwOlJlcG9zaXRvcnkxNzcyMzY5OQ==-flat-DefaultAuthorizationServiceTests.cs.html,0.02826086956521739,13,Simple.Data-MDEwOlJlcG9zaXRvcnk4MTg3Njg=-flat-SqlColumn.cs,Security-MDEwOlJlcG9zaXRvcnkxNzcyMzY5OQ==-flat-DefaultAuthorizationServiceTests.cs,27,39,12,857,871,14
55464,https://htmlpreview.github.io/?https://github.com/Christina96/boilerplate-sample-matches/blob/main/Csharp/EarTrumpet-MDEwOlJlcG9zaXRvcnkzODkxOTcwMg==-flat-SettingsPageViewModel.cs-dotween-MDEwOlJlcG9zaXRvcnkzMjQ3NTE2Mg==-flat-GoTween.cs.html,0.08396946564885496,11,EarTrumpet-MDEwOlJlcG9zaXRvcnkzODkxOTcwMg==-flat-SettingsPageViewModel.cs,dotween-MDEwOlJlcG9zaXRvcnkzMjQ3NTE2Mg==-flat-GoTween.cs,8,10,2,7,9,2
56541,https://htmlpreview.github.io/?https://github.com/Christina96/boilerplate-sample-matches/blob/main/Csharp/20486D-DevelopingASPNETMVCWebApplications-MDEwOlJlcG9zaXRvcnkxMTkzNTI2Mzc=-flat-CupcakeContext.cs-Security-MDEwOlJlcG9zaXRvcnkxNzcyMzY5OQ==-flat-RemoteAuthenticationContext.cs.html,0.5555555555555556,15,20486D-DevelopingASPNETMVCWebApplications-MDEwOlJlcG9zaXRvcnkxMTkzNTI2Mzc=-flat-CupcakeContext.cs,Security-MDEwOlJlcG9zaXRvcnkxNzcyMzY5OQ==-flat-RemoteAuthenticationContext.cs,11,15,4,14,16,2
56882,https://htmlpreview.github.io/?https://github.com/Christina96/boilerplate-sample-matches/blob/main/Csharp/runner-MDEwOlJlcG9zaXRvcnkxODQyODY4NzU=-flat-RawHttpClientResult.cs-Simple.Data-MDEwOlJlcG9zaXRvcnk4MTg3Njg=-flat-MockDatabase.cs.html,0.37362637362637363,17,runner-MDEwOlJlcG9zaXRvcnkxODQyODY4NzU=-flat-RawHttpClientResult.cs,Simple.Data-MDEwOlJlcG9zaXRvcnk4MTg3Njg=-flat-MockDatabase.cs,6,8,2,18,22,4
62721,https://htmlpreview.github.io/?https://github.com/Christina96/boilerplate-sample-matches/blob/main/Csharp/MudBlazor-MDEwOlJlcG9zaXRvcnkyODg0Mjg2NzY=-flat-CommonSnackbarOptions.cs-runner-MDEwOlJlcG9zaXRvcnkxODQyODY4NzU=-flat-TrackingConfig.cs.html,0.25668449197860965,24,MudBlazor-MDEwOlJlcG9zaXRvcnkyODg0Mjg2NzY=-flat-CommonSnackbarOptions.cs,runner-MDEwOlJlcG9zaXRvcnkxODQyODY4NzU=-flat-TrackingConfig.cs,5,8,3,60,66,6
63680,https://htmlpreview.github.io/?https://github.com/Christina96/boilerplate-sample-matches/blob/main/Csharp/Simple.Data-MDEwOlJlcG9zaXRvcnk4MTg3Njg=-flat-SqlQueryPager.cs-runner-MDEwOlJlcG9zaXRvcnkxODQyODY4NzU=-flat-CheckUtil.cs.html,0.03929273084479371,10,Simple.Data-MDEwOlJlcG9zaXRvcnk4MTg3Njg=-flat-SqlQueryPager.cs,runner-MDEwOlJlcG9zaXRvcnkxODQyODY4NzU=-flat-CheckUtil.cs,31,39,8,292,296,4
64793,https://htmlpreview.github.io/?https://github.com/Christina96/boilerplate-sample-matches/blob/main/Csharp/Security-MDEwOlJlcG9zaXRvcnkxNzcyMzY5OQ==-flat-TwitterEvents.cs-runner-MDEwOlJlcG9zaXRvcnkxODQyODY4NzU=-flat-VssConnection.cs.html,0.055226824457593686,14,Security-MDEwOlJlcG9zaXRvcnkxNzcyMzY5OQ==-flat-TwitterEvents.cs,runner-MDEwOlJlcG9zaXRvcnkxODQyODY4NzU=-flat-VssConnection.cs,7,8,1,489,497,8
65401,https://htmlpreview.github.io/?https://github.com/Christina96/boilerplate-sample-matches/blob/main/Csharp/runner-MDEwOlJlcG9zaXRvcnkxODQyODY4NzU=-flat-Join.cs-runner-MDEwOlJlcG9zaXRvcnkxODQyODY4NzU=-flat-TemplateContext.cs.html,0.09266409266409266,12,runner-MDEwOlJlcG9zaXRvcnkxODQyODY4NzU=-flat-Join.cs,runner-MDEwOlJlcG9zaXRvcnkxODQyODY4NzU=-flat-TemplateContext.cs,48,57,9,180,189,9
66330,https://htmlpreview.github.io/?https://github.com/Christina96/boilerplate-sample-matches/blob/main/Csharp/MudBlazor-MDEwOlJlcG9zaXRvcnkyODg0Mjg2NzY=-flat-LayoutProperties.cs-MudBlazor-MDEwOlJlcG9zaXRvcnkyODg0Mjg2NzY=-flat-GithubContributors.cs.html,0.2564102564102564,15,MudBlazor-MDEwOlJlcG9zaXRvcnkyODg0Mjg2NzY=-flat-LayoutProperties.cs,MudBlazor-MDEwOlJlcG9zaXRvcnkyODg0Mjg2NzY=-flat-GithubContributors.cs,6,8,2,7,9,2
68606,https://htmlpreview.github.io/?https://github.com/Christina96/boilerplate-sample-matches/blob/main/Csharp/ZXing.Net.Mobile-MDEwOlJlcG9zaXRvcnk2MTYwNjcz-flat-MobileBarcodeScanner.uwp.cs-runner-MDEwOlJlcG9zaXRvcnkxODQyODY4NzU=-flat-WrappedException.cs.html,0.04835924006908463,14,ZXing.Net.Mobile-MDEwOlJlcG9zaXRvcnk2MTYwNjcz-flat-MobileBarcodeScanner.uwp.cs,runner-MDEwOlJlcG9zaXRvcnkxODQyODY4NzU=-flat-WrappedException.cs,18,19,1,71,72,1
69736,https://htmlpreview.github.io/?https://github.com/Christina96/boilerplate-sample-matches/blob/main/Csharp/Security-MDEwOlJlcG9zaXRvcnkxNzcyMzY5OQ==-flat-OAuthTokenResponse.cs-Simple.Data-MDEwOlJlcG9zaXRvcnk4MTg3Njg=-flat-BulkInsertTest.cs.html,0.37130801687763715,28,Security-MDEwOlJlcG9zaXRvcnkxNzcyMzY5OQ==-flat-OAuthTokenResponse.cs,Simple.Data-MDEwOlJlcG9zaXRvcnk4MTg3Njg=-flat-BulkInsertTest.cs,27,30,3,89,92,3
70350,https://htmlpreview.github.io/?https://github.com/Christina96/boilerplate-sample-matches/blob/main/Csharp/runner-MDEwOlJlcG9zaXRvcnkxODQyODY4NzU=-flat-LocationMapping.cs-Simple.Data-MDEwOlJlcG9zaXRvcnk4MTg3Njg=-flat-MockDbCommand.cs.html,0.11560693641618497,10,runner-MDEwOlJlcG9zaXRvcnkxODQyODY4NzU=-flat-LocationMapping.cs,Simple.Data-MDEwOlJlcG9zaXRvcnk4MTg3Njg=-flat-MockDbCommand.cs,28,36,8,59,62,3
70677,https://htmlpreview.github.io/?https://github.com/Christina96/boilerplate-sample-matches/blob/main/Csharp/20486D-DevelopingASPNETMVCWebApplications-MDEwOlJlcG9zaXRvcnkxMTkzNTI2Mzc=-flat-RegisterViewModel.cs-runner-MDEwOlJlcG9zaXRvcnkxODQyODY4NzU=-flat-TaskLog.cs.html,0.6274509803921569,12,20486D-DevelopingASPNETMVCWebApplications-MDEwOlJlcG9zaXRvcnkxMTkzNTI2Mzc=-flat-RegisterViewModel.cs,runner-MDEwOlJlcG9zaXRvcnkxODQyODY4NzU=-flat-TaskLog.cs,10,13,3,15,23,8
71245,https://htmlpreview.github.io/?https://github.com/Christina96/boilerplate-sample-matches/blob/main/Csharp/Simple.Data-MDEwOlJlcG9zaXRvcnk4MTg3Njg=-flat-ICommandBuilder.cs-runner-MDEwOlJlcG9zaXRvcnkxODQyODY4NzU=-flat-ActionCommand.cs.html,0.28169014084507044,10,Simple.Data-MDEwOlJlcG9zaXRvcnk4MTg3Njg=-flat-ICommandBuilder.cs,runner-MDEwOlJlcG9zaXRvcnkxODQyODY4NzU=-flat-ActionCommand.cs,14,15,1,194,195,1
71300,https://htmlpreview.github.io/?https://github.com/Christina96/boilerplate-sample-matches/blob/main/Csharp/runner-MDEwOlJlcG9zaXRvcnkxODQyODY4NzU=-flat-ParseException.cs-Security-MDEwOlJlcG9zaXRvcnkxNzcyMzY5OQ==-flat-SharedAuthenticationTests.cs.html,0.08710801393728224,25,runner-MDEwOlJlcG9zaXRvcnkxODQyODY4NzU=-flat-ParseException.cs,Security-MDEwOlJlcG9zaXRvcnkxNzcyMzY5OQ==-flat-SharedAuthenticationTests.cs,55,59,4,13,17,4
71756,https://htmlpreview.github.io/?https://github.com/Christina96/boilerplate-sample-matches/blob/main/Csharp/Simple.Data-MDEwOlJlcG9zaXRvcnk4MTg3Njg=-flat-RangeAndArrayFindTest.cs-npgsql-MDEwOlJlcG9zaXRvcnkyODgzNTc0-flat-DbColumnSchemaGenerator.cs.html,0.08130081300813008,10,Simple.Data-MDEwOlJlcG9zaXRvcnk4MTg3Njg=-flat-RangeAndArrayFindTest.cs,npgsql-MDEwOlJlcG9zaXRvcnkyODgzNTc0-flat-DbColumnSchemaGenerator.cs,29,33,4,161,173,12
71955,https://htmlpreview.github.io/?https://github.com/Christina96/boilerplate-sample-matches/blob/main/Csharp/20486D-DevelopingASPNETMVCWebApplications-MDEwOlJlcG9zaXRvcnkxMTkzNTI2Mzc=-flat-Person_122.cs-MudBlazor-MDEwOlJlcG9zaXRvcnkyODg0Mjg2NzY=-flat-MudFormComponent.cs.html,0.2764227642276423,17,20486D-DevelopingASPNETMVCWebApplications-MDEwOlJlcG9zaXRvcnkxMTkzNTI2Mzc=-flat-Person_122.cs,MudBlazor-MDEwOlJlcG9zaXRvcnkyODg0Mjg2NzY=-flat-MudFormComponent.cs,10,13,3,25,28,3
72959,https://htmlpreview.github.io/?https://github.com/Christina96/boilerplate-sample-matches/blob/main/Csharp/MudBlazor-MDEwOlJlcG9zaXRvcnkyODg0Mjg2NzY=-flat-DialogTests.cs-MudBlazor-MDEwOlJlcG9zaXRvcnkyODg0Mjg2NzY=-flat-TableTests.cs.html,0.3563674874238814,29,MudBlazor-MDEwOlJlcG9zaXRvcnkyODg0Mjg2NzY=-flat-DialogTests.cs,MudBlazor-MDEwOlJlcG9zaXRvcnkyODg0Mjg2NzY=-flat-TableTests.cs,325,337,12,163,171,8
73674,https://htmlpreview.github.io/?https://github.com/Christina96/boilerplate-sample-matches/blob/main/Csharp/EarTrumpet-MDEwOlJlcG9zaXRvcnkzODkxOTcwMg==-flat-Rule.cs-runner-MDEwOlJlcG9zaXRvcnkxODQyODY4NzU=-flat-HookInput.cs.html,0.1267605633802817,18,EarTrumpet-MDEwOlJlcG9zaXRvcnkzODkxOTcwMg==-flat-Rule.cs,runner-MDEwOlJlcG9zaXRvcnkxODQyODY4NzU=-flat-HookInput.cs,16,18,2,11,13,2
73862,https://htmlpreview.github.io/?https://github.com/Christina96/boilerplate-sample-matches/blob/main/Csharp/20486D-DevelopingASPNETMVCWebApplications-MDEwOlJlcG9zaXRvcnkxMTkzNTI2Mzc=-flat-20181225115939_AddFishCommonName.Designer.cs-MudBlazor-MDEwOlJlcG9zaXRvcnkyODg0Mjg2NzY=-flat-SubscriptionInfoTests.cs.html,0.5079365079365079,22,20486D-DevelopingASPNETMVCWebApplications-MDEwOlJlcG9zaXRvcnkxMTkzNTI2Mzc=-flat-20181225115939_AddFishCommonName.Designer.cs,MudBlazor-MDEwOlJlcG9zaXRvcnkyODg0Mjg2NzY=-flat-SubscriptionInfoTests.cs,40,69,29,49,58,9
74587,https://htmlpreview.github.io/?https://github.com/Christina96/boilerplate-sample-matches/blob/main/Csharp/Security-MDEwOlJlcG9zaXRvcnkxNzcyMzY5OQ==-flat-Startup_2.cs-MudBlazor-MDEwOlJlcG9zaXRvcnkyODg0Mjg2NzY=-flat-BlockMaskTests.cs.html,0.09316770186335403,15,Security-MDEwOlJlcG9zaXRvcnkxNzcyMzY5OQ==-flat-Startup_2.cs,MudBlazor-MDEwOlJlcG9zaXRvcnkyODg0Mjg2NzY=-flat-BlockMaskTests.cs,77,91,14,21,29,8
74867,https://htmlpreview.github.io/?https://github.com/Christina96/boilerplate-sample-matches/blob/main/Csharp/dotween-MDEwOlJlcG9zaXRvcnkzMjQ3NTE2Mg==-flat-DOTweenModuleEPOOutline.cs-runner-MDEwOlJlcG9zaXRvcnkxODQyODY4NzU=-flat-DockerCommandManager.cs.html,0.03683241252302026,10,dotween-MDEwOlJlcG9zaXRvcnkzMjQ3NTE2Mg==-flat-DOTweenModuleEPOOutline.cs,runner-MDEwOlJlcG9zaXRvcnkxODQyODY4NzU=-flat-DockerCommandManager.cs,62,72,10,202,212,10
75192,https://htmlpreview.github.io/?https://github.com/Christina96/boilerplate-sample-matches/blob/main/Csharp/Simple.Data-MDEwOlJlcG9zaXRvcnk4MTg3Njg=-flat-BulkInsertTest_40.cs-Simple.Data-MDEwOlJlcG9zaXRvcnk4MTg3Njg=-flat-QueryTest.cs.html,0.19158200290275762,10,Simple.Data-MDEwOlJlcG9zaXRvcnk4MTg3Njg=-flat-BulkInsertTest_40.cs,Simple.Data-MDEwOlJlcG9zaXRvcnk4MTg3Njg=-flat-QueryTest.cs,113,120,7,206,216,10
75384,https://htmlpreview.github.io/?https://github.com/Christina96/boilerplate-sample-matches/blob/main/Csharp/20486D-DevelopingASPNETMVCWebApplications-MDEwOlJlcG9zaXRvcnkxMTkzNTI2Mzc=-flat-Genre.cs-MudBlazor-MDEwOlJlcG9zaXRvcnkyODg0Mjg2NzY=-flat-ExpressionExtensionsTests.cs.html,0.2542372881355932,15,20486D-DevelopingASPNETMVCWebApplications-MDEwOlJlcG9zaXRvcnkxMTkzNTI2Mzc=-flat-Genre.cs,MudBlazor-MDEwOlJlcG9zaXRvcnkyODg0Mjg2NzY=-flat-ExpressionExtensionsTests.cs,8,10,2,18,20,2
75627,https://htmlpreview.github.io/?https://github.com/Christina96/boilerplate-sample-matches/blob/main/Csharp/EarTrumpet-MDEwOlJlcG9zaXRvcnkzODkxOTcwMg==-flat-EarTrumpetAddon.cs-MudBlazor-MDEwOlJlcG9zaXRvcnkyODg0Mjg2NzY=-flat-MudBreadcrumbs.razor.cs.html,0.2054794520547945,15,EarTrumpet-MDEwOlJlcG9zaXRvcnkzODkxOTcwMg==-flat-EarTrumpetAddon.cs,MudBlazor-MDEwOlJlcG9zaXRvcnkyODg0Mjg2NzY=-flat-MudBreadcrumbs.razor.cs,18,21,3,25,28,3
77061,https://htmlpreview.github.io/?https://github.com/Christina96/boilerplate-sample-matches/blob/main/Csharp/MudBlazor-MDEwOlJlcG9zaXRvcnkyODg0Mjg2NzY=-flat-TreeViewTest.cs-MudBlazor-MDEwOlJlcG9zaXRvcnkyODg0Mjg2NzY=-flat-TimePickerTests.cs.html,0.46291208791208793,15,MudBlazor-MDEwOlJlcG9zaXRvcnkyODg0Mjg2NzY=-flat-TreeViewTest.cs,MudBlazor-MDEwOlJlcG9zaXRvcnkyODg0Mjg2NzY=-flat-TimePickerTests.cs,132,138,6,444,451,7
78260,https://htmlpreview.github.io/?https://github.com/Christina96/boilerplate-sample-matches/blob/main/Csharp/Security-MDEwOlJlcG9zaXRvcnkxNzcyMzY5OQ==-flat-DefaultAuthorizationServiceTests.cs-MudBlazor-MDEwOlJlcG9zaXRvcnkyODg0Mjg2NzY=-flat-DatePickerTests.cs.html,0.13273942093541202,11,Security-MDEwOlJlcG9zaXRvcnkxNzcyMzY5OQ==-flat-DefaultAuthorizationServiceTests.cs,MudBlazor-MDEwOlJlcG9zaXRvcnkyODg0Mjg2NzY=-flat-DatePickerTests.cs,42,54,12,249,256,7
78480,https://htmlpreview.github.io/?https://github.com/Christina96/boilerplate-sample-matches/blob/main/Csharp/20486D-DevelopingASPNETMVCWebApplications-MDEwOlJlcG9zaXRvcnkxMTkzNTI2Mzc=-flat-EmployeeRequirements.cs-ZXing.Net.Mobile-MDEwOlJlcG9zaXRvcnk2MTYwNjcz-flat-AVCaptureScannerViewController.ios.cs.html,0.28,21,20486D-DevelopingASPNETMVCWebApplications-MDEwOlJlcG9zaXRvcnkxMTkzNTI2Mzc=-flat-EmployeeRequirements.cs,ZXing.Net.Mobile-MDEwOlJlcG9zaXRvcnk2MTYwNjcz-flat-AVCaptureScannerViewController.ios.cs,9,11,2,16,18,2
79134,https://htmlpreview.github.io/?https://github.com/Christina96/boilerplate-sample-matches/blob/main/Csharp/20486D-DevelopingASPNETMVCWebApplications-MDEwOlJlcG9zaXRvcnkxMTkzNTI2Mzc=-flat-LoginViewModel_308.cs-runner-MDEwOlJlcG9zaXRvcnkxODQyODY4NzU=-flat-IssueMatcher.cs.html,0.10964083175803403,18,20486D-DevelopingASPNETMVCWebApplications-MDEwOlJlcG9zaXRvcnkxMTkzNTI2Mzc=-flat-LoginViewModel_308.cs,runner-MDEwOlJlcG9zaXRvcnkxODQyODY4NzU=-flat-IssueMatcher.cs,14,17,3,323,326,3
79180,https://htmlpreview.github.io/?https://github.com/Christina96/boilerplate-sample-matches/blob/main/Csharp/EarTrumpet-MDEwOlJlcG9zaXRvcnkzODkxOTcwMg==-flat-IAppItemViewModel.cs-npgsql-MDEwOlJlcG9zaXRvcnkyODgzNTc0-flat-ReplicationValue.cs.html,0.10852713178294573,14,EarTrumpet-MDEwOlJlcG9zaXRvcnkzODkxOTcwMg==-flat-IAppItemViewModel.cs,npgsql-MDEwOlJlcG9zaXRvcnkyODgzNTc0-flat-ReplicationValue.cs,10,11,1,14,15,1
80122,https://htmlpreview.github.io/?https://github.com/Christina96/boilerplate-sample-matches/blob/main/Csharp/MudBlazor-MDEwOlJlcG9zaXRvcnkyODg0Mjg2NzY=-flat-TableState.cs-runner-MDEwOlJlcG9zaXRvcnkxODQyODY4NzU=-flat-TemplateContext.cs.html,0.24489795918367346,11,MudBlazor-MDEwOlJlcG9zaXRvcnkyODg0Mjg2NzY=-flat-TableState.cs,runner-MDEwOlJlcG9zaXRvcnkxODQyODY4NzU=-flat-TemplateContext.cs,12,14,2,13,18,5
80151,https://htmlpreview.github.io/?https://github.com/Christina96/boilerplate-sample-matches/blob/main/Csharp/MudBlazor-MDEwOlJlcG9zaXRvcnkyODg0Mjg2NzY=-flat-BrowserWindowSizeProvider.cs-MudBlazor-MDEwOlJlcG9zaXRvcnkyODg0Mjg2NzY=-flat-KeyInterceptorFactory.cs.html,0.7586206896551724,11,MudBlazor-MDEwOlJlcG9zaXRvcnkyODg0Mjg2NzY=-flat-BrowserWindowSizeProvider.cs,MudBlazor-MDEwOlJlcG9zaXRvcnkyODg0Mjg2NzY=-flat-KeyInterceptorFactory.cs,1,15,14,1,19,18
81162,https://htmlpreview.github.io/?https://github.com/Christina96/boilerplate-sample-matches/blob/main/Csharp/20486D-DevelopingASPNETMVCWebApplications-MDEwOlJlcG9zaXRvcnkxMTkzNTI2Mzc=-flat-RestaurantContext.cs-20486D-DevelopingASPNETMVCWebApplications-MDEwOlJlcG9zaXRvcnkxMTkzNTI2Mzc=-flat-IceCream.cs.html,0.2857142857142857,14,20486D-DevelopingASPNETMVCWebApplications-MDEwOlJlcG9zaXRvcnkxMTkzNTI2Mzc=-flat-RestaurantContext.cs,20486D-DevelopingASPNETMVCWebApplications-MDEwOlJlcG9zaXRvcnkxMTkzNTI2Mzc=-flat-IceCream.cs,15,16,1,24,25,1
81483,https://htmlpreview.github.io/?https://github.com/Christina96/boilerplate-sample-matches/blob/main/Csharp/MudBlazor-MDEwOlJlcG9zaXRvcnkyODg0Mjg2NzY=-flat-MudButtonGroup.razor.cs-MudBlazor-MDEwOlJlcG9zaXRvcnkyODg0Mjg2NzY=-flat-MudDataGrid.razor.cs.html,0.1949685534591195,17,MudBlazor-MDEwOlJlcG9zaXRvcnkyODg0Mjg2NzY=-flat-MudButtonGroup.razor.cs,MudBlazor-MDEwOlJlcG9zaXRvcnkyODg0Mjg2NzY=-flat-MudDataGrid.razor.cs,8,19,11,31,47,16
81851,https://htmlpreview.github.io/?https://github.com/Christina96/boilerplate-sample-matches/blob/main/Csharp/runner-MDEwOlJlcG9zaXRvcnkxODQyODY4NzU=-flat-ExpressionResources.g.cs-Simple.Data-MDEwOlJlcG9zaXRvcnk4MTg3Njg=-flat-ProviderHelper.cs.html,0.06811145510835913,11,runner-MDEwOlJlcG9zaXRvcnkxODQyODY4NzU=-flat-ExpressionResources.g.cs,Simple.Data-MDEwOlJlcG9zaXRvcnk4MTg3Njg=-flat-ProviderHelper.cs,9,22,13,60,71,11
83343,https://htmlpreview.github.io/?https://github.com/Christina96/boilerplate-sample-matches/blob/main/Csharp/MudBlazor-MDEwOlJlcG9zaXRvcnkyODg0Mjg2NzY=-flat-MudAvatar.razor.cs-runner-MDEwOlJlcG9zaXRvcnkxODQyODY4NzU=-flat-NodeScriptActionHandler.cs.html,0.06896551724137931,10,MudBlazor-MDEwOlJlcG9zaXRvcnkyODg0Mjg2NzY=-flat-MudAvatar.razor.cs,runner-MDEwOlJlcG9zaXRvcnkxODQyODY4NzU=-flat-NodeScriptActionHandler.cs,52,56,4,24,28,4
84100,https://htmlpreview.github.io/?https://github.com/Christina96/boilerplate-sample-matches/blob/main/Csharp/dotween-MDEwOlJlcG9zaXRvcnkzMjQ3NTE2Mg==-flat-EmptySequences.cs-MudBlazor-MDEwOlJlcG9zaXRvcnkyODg0Mjg2NzY=-flat-PatternMaskTests.cs.html,0.18620689655172415,14,dotween-MDEwOlJlcG9zaXRvcnkzMjQ3NTE2Mg==-flat-EmptySequences.cs,MudBlazor-MDEwOlJlcG9zaXRvcnkyODg0Mjg2NzY=-flat-PatternMaskTests.cs,54,60,6,35,42,7
84565,https://htmlpreview.github.io/?https://github.com/Christina96/boilerplate-sample-matches/blob/main/Csharp/Security-MDEwOlJlcG9zaXRvcnkxNzcyMzY5OQ==-flat-GoogleHandler.cs-MudBlazor-MDEwOlJlcG9zaXRvcnkyODg0Mjg2NzY=-flat-RegexMaskIPv4Tests.cs.html,0.054455445544554455,11,Security-MDEwOlJlcG9zaXRvcnkxNzcyMzY5OQ==-flat-GoogleHandler.cs,MudBlazor-MDEwOlJlcG9zaXRvcnkyODg0Mjg2NzY=-flat-RegexMaskIPv4Tests.cs,41,49,8,21,26,5
87420,https://htmlpreview.github.io/?https://github.com/Christina96/boilerplate-sample-matches/blob/main/Csharp/npgsql-MDEwOlJlcG9zaXRvcnkyODgzNTc0-flat-StoredProcedureTests.cs-MudBlazor-MDEwOlJlcG9zaXRvcnkyODg0Mjg2NzY=-flat-TableTests.cs.html,0.05023761031907671,22,npgsql-MDEwOlJlcG9zaXRvcnkyODgzNTc0-flat-StoredProcedureTests.cs,MudBlazor-MDEwOlJlcG9zaXRvcnkyODg0Mjg2NzY=-flat-TableTests.cs,123,141,18,469,477,8
88319,https://htmlpreview.github.io/?https://github.com/Christina96/boilerplate-sample-matches/blob/main/Csharp/runner-MDEwOlJlcG9zaXRvcnkxODQyODY4NzU=-flat-GitCheck.cs-Security-MDEwOlJlcG9zaXRvcnkxNzcyMzY5OQ==-flat-OpenIdConnectConfigurationTests.cs.html,0.03184713375796178,10,runner-MDEwOlJlcG9zaXRvcnkxODQyODY4NzU=-flat-GitCheck.cs,Security-MDEwOlJlcG9zaXRvcnkxNzcyMzY5OQ==-flat-OpenIdConnectConfigurationTests.cs,61,65,4,43,52,9
89981,https://htmlpreview.github.io/?https://github.com/Christina96/boilerplate-sample-matches/blob/main/Csharp/runner-MDEwOlJlcG9zaXRvcnkxODQyODY4NzU=-flat-OutputManagerL0.cs-MudBlazor-MDEwOlJlcG9zaXRvcnkyODg0Mjg2NzY=-flat-PopoverTests.cs.html,0.26533166458072593,20,runner-MDEwOlJlcG9zaXRvcnkxODQyODY4NzU=-flat-OutputManagerL0.cs,MudBlazor-MDEwOlJlcG9zaXRvcnkyODg0Mjg2NzY=-flat-PopoverTests.cs,619,633,14,64,78,14
90896,https://htmlpreview.github.io/?https://github.com/Christina96/boilerplate-sample-matches/blob/main/Csharp/NetCoreServer-MDEwOlJlcG9zaXRvcnkxNjYxMjMxNjQ=-flat-WsTests.cs-dotween-MDEwOlJlcG9zaXRvcnkzMjQ3NTE2Mg==-flat-Basics.cs.html,0.05755395683453238,14,NetCoreServer-MDEwOlJlcG9zaXRvcnkxNjYxMjMxNjQ=-flat-WsTests.cs,dotween-MDEwOlJlcG9zaXRvcnkzMjQ3NTE2Mg==-flat-Basics.cs,85,98,13,99,103,4
91018,https://htmlpreview.github.io/?https://github.com/Christina96/boilerplate-sample-matches/blob/main/Csharp/Simple.Data-MDEwOlJlcG9zaXRvcnk4MTg3Njg=-flat-MockDatabase.cs-dotween-MDEwOlJlcG9zaXRvcnkzMjQ3NTE2Mg==-flat-Pooling.cs.html,0.05913978494623656,11,Simple.Data-MDEwOlJlcG9zaXRvcnk4MTg3Njg=-flat-MockDatabase.cs,dotween-MDEwOlJlcG9zaXRvcnkzMjQ3NTE2Mg==-flat-Pooling.cs,13,17,4,101,108,7
91266,https://htmlpreview.github.io/?https://github.com/Christina96/boilerplate-sample-matches/blob/main/Csharp/MudBlazor-MDEwOlJlcG9zaXRvcnkyODg0Mjg2NzY=-flat-MessageBoxTests.cs-Security-MDEwOlJlcG9zaXRvcnkxNzcyMzY5OQ==-flat-OpenIdConnectConfigurationTests.cs.html,0.28164556962025317,12,MudBlazor-MDEwOlJlcG9zaXRvcnkyODg0Mjg2NzY=-flat-MessageBoxTests.cs,Security-MDEwOlJlcG9zaXRvcnkxNzcyMzY5OQ==-flat-OpenIdConnectConfigurationTests.cs,76,81,5,210,221,11
91706,https://htmlpreview.github.io/?https://github.com/Christina96/boilerplate-sample-matches/blob/main/Csharp/dotween-MDEwOlJlcG9zaXRvcnkzMjQ3NTE2Mg==-flat-Pooling_24.cs-Simple.Data-MDEwOlJlcG9zaXRvcnk4MTg3Njg=-flat-InMemoryTests.cs.html,0.016570008285004142,10,dotween-MDEwOlJlcG9zaXRvcnkzMjQ3NTE2Mg==-flat-Pooling_24.cs,Simple.Data-MDEwOlJlcG9zaXRvcnk4MTg3Njg=-flat-InMemoryTests.cs,163,168,5,135,139,4
94243,https://htmlpreview.github.io/?https://github.com/Christina96/boilerplate-sample-matches/blob/main/Csharp/20486D-DevelopingASPNETMVCWebApplications-MDEwOlJlcG9zaXRvcnkxMTkzNTI2Mzc=-flat-Shirt_375.cs-Security-MDEwOlJlcG9zaXRvcnkxNzcyMzY5OQ==-flat-WsFederationEvents.cs.html,0.19047619047619047,10,20486D-DevelopingASPNETMVCWebApplications-MDEwOlJlcG9zaXRvcnkxMTkzNTI2Mzc=-flat-Shirt_375.cs,Security-MDEwOlJlcG9zaXRvcnkxNzcyMzY5OQ==-flat-WsFederationEvents.cs,1,11,10,1,7,6
95910,https://htmlpreview.github.io/?https://github.com/Christina96/boilerplate-sample-matches/blob/main/Csharp/MudBlazor-MDEwOlJlcG9zaXRvcnkyODg0Mjg2NzY=-flat-SvgText.cs-ZXing.Net.Mobile-MDEwOlJlcG9zaXRvcnk2MTYwNjcz-flat-CameraAnalyzer.android.cs.html,0.13157894736842105,10,MudBlazor-MDEwOlJlcG9zaXRvcnkyODg0Mjg2NzY=-flat-SvgText.cs,ZXing.Net.Mobile-MDEwOlJlcG9zaXRvcnk2MTYwNjcz-flat-CameraAnalyzer.android.cs,5,6,1,24,25,1
97431,https://htmlpreview.github.io/?https://github.com/Christina96/boilerplate-sample-matches/blob/main/Csharp/MudBlazor-MDEwOlJlcG9zaXRvcnkyODg0Mjg2NzY=-flat-MudGlobal.cs-20486D-DevelopingASPNETMVCWebApplications-MDEwOlJlcG9zaXRvcnkxMTkzNTI2Mzc=-flat-Person_421.cs.html,0.37735849056603776,10,MudBlazor-MDEwOlJlcG9zaXRvcnkyODg0Mjg2NzY=-flat-MudGlobal.cs,20486D-DevelopingASPNETMVCWebApplications-MDEwOlJlcG9zaXRvcnkxMTkzNTI2Mzc=-flat-Person_421.cs,1,11,10,1,9,8
98193,https://htmlpreview.github.io/?https://github.com/Christina96/boilerplate-sample-matches/blob/main/Csharp/MudBlazor-MDEwOlJlcG9zaXRvcnkyODg0Mjg2NzY=-flat-IMask.cs-Simple.Data-MDEwOlJlcG9zaXRvcnk4MTg3Njg=-flat-Program.cs.html,0.09855072463768116,17,MudBlazor-MDEwOlJlcG9zaXRvcnkyODg0Mjg2NzY=-flat-IMask.cs,Simple.Data-MDEwOlJlcG9zaXRvcnk4MTg3Njg=-flat-Program.cs,11,14,3,14,16,2
98369,https://htmlpreview.github.io/?https://github.com/Christina96/boilerplate-sample-matches/blob/main/Csharp/EarTrumpet-MDEwOlJlcG9zaXRvcnkzODkxOTcwMg==-flat-SettingsSearchItemViewModel.cs-runner-MDEwOlJlcG9zaXRvcnkxODQyODY4NzU=-flat-HookResponse.cs.html,0.5945945945945946,23,EarTrumpet-MDEwOlJlcG9zaXRvcnkzODkxOTcwMg==-flat-SettingsSearchItemViewModel.cs,runner-MDEwOlJlcG9zaXRvcnkxODQyODY4NzU=-flat-HookResponse.cs,7,12,5,31,35,4
98594,https://htmlpreview.github.io/?https://github.com/Christina96/boilerplate-sample-matches/blob/main/Csharp/MudBlazor-MDEwOlJlcG9zaXRvcnkyODg0Mjg2NzY=-flat-BrowserWindowSize.cs-20486D-DevelopingASPNETMVCWebApplications-MDEwOlJlcG9zaXRvcnkxMTkzNTI2Mzc=-flat-UnderwaterContext.cs.html,0.6222222222222222,14,MudBlazor-MDEwOlJlcG9zaXRvcnkyODg0Mjg2NzY=-flat-BrowserWindowSize.cs,20486D-DevelopingASPNETMVCWebApplications-MDEwOlJlcG9zaXRvcnkxMTkzNTI2Mzc=-flat-UnderwaterContext.cs,6,7,1,14,15,1
99452,https://htmlpreview.github.io/?https://github.com/Christina96/boilerplate-sample-matches/blob/main/Csharp/EarTrumpet-MDEwOlJlcG9zaXRvcnkzODkxOTcwMg==-flat-SetAppVolumeActionViewModel.cs-MudBlazor-MDEwOlJlcG9zaXRvcnkyODg0Mjg2NzY=-flat-Colors.cs.html,0.03036876355748373,21,EarTrumpet-MDEwOlJlcG9zaXRvcnkzODkxOTcwMg==-flat-SetAppVolumeActionViewModel.cs,MudBlazor-MDEwOlJlcG9zaXRvcnkyODg0Mjg2NzY=-flat-Colors.cs,6,10,4,8,12,4
99805,https://htmlpreview.github.io/?https://github.com/Christina96/boilerplate-sample-matches/blob/main/Csharp/Security-MDEwOlJlcG9zaXRvcnkxNzcyMzY5OQ==-flat-RolesAuthorizationRequirement.cs-npgsql-MDEwOlJlcG9zaXRvcnkyODgzNTc0-flat-NpgsqlTransaction.cs.html,0.08333333333333333,11,Security-MDEwOlJlcG9zaXRvcnkxNzcyMzY5OQ==-flat-RolesAuthorizationRequirement.cs,npgsql-MDEwOlJlcG9zaXRvcnkyODgzNTc0-flat-NpgsqlTransaction.cs,11,18,7,129,132,3
100185,https://htmlpreview.github.io/?https://github.com/Christina96/boilerplate-sample-matches/blob/main/Csharp/runner-MDEwOlJlcG9zaXRvcnkxODQyODY4NzU=-flat-CreateStepSummaryCommandL0.cs-npgsql-MDEwOlJlcG9zaXRvcnkyODgzNTc0-flat-NpgsqlParameterTests.cs.html,0.22939866369710468,17,runner-MDEwOlJlcG9zaXRvcnkxODQyODY4NzU=-flat-CreateStepSummaryCommandL0.cs,npgsql-MDEwOlJlcG9zaXRvcnkyODgzNTc0-flat-NpgsqlParameterTests.cs,89,97,8,217,232,15
100714,https://htmlpreview.github.io/?https://github.com/Christina96/boilerplate-sample-matches/blob/main/Csharp/dotween-MDEwOlJlcG9zaXRvcnkzMjQ3NTE2Mg==-flat-DGUtils.cs-npgsql-MDEwOlJlcG9zaXRvcnkyODgzNTc0-flat-LogicalReplicationConnectionExtensions.cs.html,0.13513513513513514,10,dotween-MDEwOlJlcG9zaXRvcnkzMjQ3NTE2Mg==-flat-DGUtils.cs,npgsql-MDEwOlJlcG9zaXRvcnkyODgzNTc0-flat-LogicalReplicationConnectionExtensions.cs,11,16,5,94,102,8
102353,https://htmlpreview.github.io/?https://github.com/Christina96/boilerplate-sample-matches/blob/main/Csharp/20486D-DevelopingASPNETMVCWebApplications-MDEwOlJlcG9zaXRvcnkxMTkzNTI2Mzc=-flat-Pizza_78.cs-Security-MDEwOlJlcG9zaXRvcnkxNzcyMzY5OQ==-flat-AuthorizationOptions.cs.html,0.27722772277227725,14,20486D-DevelopingASPNETMVCWebApplications-MDEwOlJlcG9zaXRvcnkxMTkzNTI2Mzc=-flat-Pizza_78.cs,Security-MDEwOlJlcG9zaXRvcnkxNzcyMzY5OQ==-flat-AuthorizationOptions.cs,12,13,1,8,9,1
102662,https://htmlpreview.github.io/?https://github.com/Christina96/boilerplate-sample-matches/blob/main/Csharp/EarTrumpet-MDEwOlJlcG9zaXRvcnkzODkxOTcwMg==-flat-DeviceViewModelBase.cs-NetCoreServer-MDEwOlJlcG9zaXRvcnkxNjYxMjMxNjQ=-flat-UdpClient.cs.html,0.09427609427609428,28,EarTrumpet-MDEwOlJlcG9zaXRvcnkzODkxOTcwMg==-flat-DeviceViewModelBase.cs,NetCoreServer-MDEwOlJlcG9zaXRvcnkxNjYxMjMxNjQ=-flat-UdpClient.cs,5,8,3,23,26,3
103794,https://htmlpreview.github.io/?https://github.com/Christina96/boilerplate-sample-matches/blob/main/Csharp/Security-MDEwOlJlcG9zaXRvcnkxNzcyMzY5OQ==-flat-GoogleOptions.cs-MudBlazor-MDEwOlJlcG9zaXRvcnkyODg0Mjg2NzY=-flat-MudRangeInput.razor.cs.html,0.19801980198019803,10,Security-MDEwOlJlcG9zaXRvcnkxNzcyMzY5OQ==-flat-GoogleOptions.cs,MudBlazor-MDEwOlJlcG9zaXRvcnkyODg0Mjg2NzY=-flat-MudRangeInput.razor.cs,18,25,7,26,34,8
104484,https://htmlpreview.github.io/?https://github.com/Christina96/boilerplate-sample-matches/blob/main/Csharp/MudBlazor-MDEwOlJlcG9zaXRvcnkyODg0Mjg2NzY=-flat-TabsTests.cs-npgsql-MDEwOlJlcG9zaXRvcnkyODgzNTc0-flat-ReaderTests.cs.html,0.26738544474393533,11,MudBlazor-MDEwOlJlcG9zaXRvcnkyODg0Mjg2NzY=-flat-TabsTests.cs,npgsql-MDEwOlJlcG9zaXRvcnkyODgzNTc0-flat-ReaderTests.cs,362,367,5,1556,1563,7
105249,https://htmlpreview.github.io/?https://github.com/Christina96/boilerplate-sample-matches/blob/main/Csharp/20486D-DevelopingASPNETMVCWebApplications-MDEwOlJlcG9zaXRvcnkxMTkzNTI2Mzc=-flat-CityController_461.cs-Simple.Data-MDEwOlJlcG9zaXRvcnk4MTg3Njg=-flat-BinderHelper.cs.html,0.417910447761194,14,20486D-DevelopingASPNETMVCWebApplications-MDEwOlJlcG9zaXRvcnkxMTkzNTI2Mzc=-flat-CityController_461.cs,Simple.Data-MDEwOlJlcG9zaXRvcnk4MTg3Njg=-flat-BinderHelper.cs,14,26,12,36,48,12
105510,https://htmlpreview.github.io/?https://github.com/Christina96/boilerplate-sample-matches/blob/main/Csharp/MudBlazor-MDEwOlJlcG9zaXRvcnkyODg0Mjg2NzY=-flat-PaginationTests.cs-runner-MDEwOlJlcG9zaXRvcnkxODQyODY4NzU=-flat-MessageListenerL0.cs.html,0.3029197080291971,13,MudBlazor-MDEwOlJlcG9zaXRvcnkyODg0Mjg2NzY=-flat-PaginationTests.cs,runner-MDEwOlJlcG9zaXRvcnkxODQyODY4NzU=-flat-MessageListenerL0.cs,190,196,6,166,176,10
106288,https://htmlpreview.github.io/?https://github.com/Christina96/boilerplate-sample-matches/blob/main/Csharp/MudBlazor-MDEwOlJlcG9zaXRvcnkyODg0Mjg2NzY=-flat-MudVirtualize.razor.cs-MudBlazor-MDEwOlJlcG9zaXRvcnkyODg0Mjg2NzY=-flat-LayoutProperties.cs.html,0.5263157894736842,15,MudBlazor-MDEwOlJlcG9zaXRvcnkyODg0Mjg2NzY=-flat-MudVirtualize.razor.cs,MudBlazor-MDEwOlJlcG9zaXRvcnkyODg0Mjg2NzY=-flat-LayoutProperties.cs,13,15,2,14,16,2
106805,https://htmlpreview.github.io/?https://github.com/Christina96/boilerplate-sample-matches/blob/main/Csharp/dotween-MDEwOlJlcG9zaXRvcnkzMjQ3NTE2Mg==-flat-AutoJumpActor.cs-runner-MDEwOlJlcG9zaXRvcnkxODQyODY4NzU=-flat-ExecutionContextL0.cs.html,0.014357501794687724,10,dotween-MDEwOlJlcG9zaXRvcnkzMjQ3NTE2Mg==-flat-AutoJumpActor.cs,runner-MDEwOlJlcG9zaXRvcnkxODQyODY4NzU=-flat-ExecutionContextL0.cs,25,30,5,238,243,5
107396,https://htmlpreview.github.io/?https://github.com/Christina96/boilerplate-sample-matches/blob/main/Csharp/Simple.Data-MDEwOlJlcG9zaXRvcnk4MTg3Njg=-flat-ExpressionHelperTest.cs-Security-MDEwOlJlcG9zaXRvcnkxNzcyMzY5OQ==-flat-Program_7.cs.html,0.29850746268656714,10,Simple.Data-MDEwOlJlcG9zaXRvcnk4MTg3Njg=-flat-ExpressionHelperTest.cs,Security-MDEwOlJlcG9zaXRvcnkxNzcyMzY5OQ==-flat-Program_7.cs,22,29,7,25,34,9
109281,https://htmlpreview.github.io/?https://github.com/Christina96/boilerplate-sample-matches/blob/main/Csharp/MudBlazor-MDEwOlJlcG9zaXRvcnkyODg0Mjg2NzY=-flat-MudScrollToTop.razor.cs-MudBlazor-MDEwOlJlcG9zaXRvcnkyODg0Mjg2NzY=-flat-PatternMaskTests.cs.html,0.03503184713375796,11,MudBlazor-MDEwOlJlcG9zaXRvcnkyODg0Mjg2NzY=-flat-MudScrollToTop.razor.cs,MudBlazor-MDEwOlJlcG9zaXRvcnkyODg0Mjg2NzY=-flat-PatternMaskTests.cs,12,18,6,19,24,5
109669,https://htmlpreview.github.io/?https://github.com/Christina96/boilerplate-sample-matches/blob/main/Csharp/20486D-DevelopingASPNETMVCWebApplications-MDEwOlJlcG9zaXRvcnkxMTkzNTI2Mzc=-flat-Person_421.cs-20486D-DevelopingASPNETMVCWebApplications-MDEwOlJlcG9zaXRvcnkxMTkzNTI2Mzc=-flat-Fish_60.cs.html,0.4827586206896552,28,20486D-DevelopingASPNETMVCWebApplications-MDEwOlJlcG9zaXRvcnkxMTkzNTI2Mzc=-flat-Person_421.cs,20486D-DevelopingASPNETMVCWebApplications-MDEwOlJlcG9zaXRvcnkxMTkzNTI2Mzc=-flat-Fish_60.cs,9,12,3,20,23,3
111535,https://htmlpreview.github.io/?https://github.com/Christina96/boilerplate-sample-matches/blob/main/Csharp/20486D-DevelopingASPNETMVCWebApplications-MDEwOlJlcG9zaXRvcnkxMTkzNTI2Mzc=-flat-Person_430.cs-Security-MDEwOlJlcG9zaXRvcnkxNzcyMzY5OQ==-flat-Transaction_0.cs.html,0.5166666666666667,31,20486D-DevelopingASPNETMVCWebApplications-MDEwOlJlcG9zaXRvcnkxMTkzNTI2Mzc=-flat-Person_430.cs,Security-MDEwOlJlcG9zaXRvcnkxNzcyMzY5OQ==-flat-Transaction_0.cs,1,12,11,1,12,11
111810,https://htmlpreview.github.io/?https://github.com/Christina96/boilerplate-sample-matches/blob/main/Csharp/runner-MDEwOlJlcG9zaXRvcnkxODQyODY4NzU=-flat-HostContextL0.cs-MudBlazor-MDEwOlJlcG9zaXRvcnkyODg0Mjg2NzY=-flat-TabsTests.cs.html,0.06809078771695594,12,runner-MDEwOlJlcG9zaXRvcnkxODQyODY4NzU=-flat-HostContextL0.cs,MudBlazor-MDEwOlJlcG9zaXRvcnkyODg0Mjg2NzY=-flat-TabsTests.cs,124,130,6,530,535,5
112234,https://htmlpreview.github.io/?https://github.com/Christina96/boilerplate-sample-matches/blob/main/Csharp/Simple.Data-MDEwOlJlcG9zaXRvcnk4MTg3Njg=-flat-SimpleRecordAsDictionaryTest.cs-npgsql-MDEwOlJlcG9zaXRvcnkyODgzNTc0-flat-CommandBuilderTests.cs.html,0.1435114503816794,16,Simple.Data-MDEwOlJlcG9zaXRvcnk4MTg3Njg=-flat-SimpleRecordAsDictionaryTest.cs,npgsql-MDEwOlJlcG9zaXRvcnkyODgzNTc0-flat-CommandBuilderTests.cs,22,35,13,132,144,12
112832,https://htmlpreview.github.io/?https://github.com/Christina96/boilerplate-sample-matches/blob/main/Csharp/MudBlazor-MDEwOlJlcG9zaXRvcnkyODg0Mjg2NzY=-flat-Server.cs-runner-MDEwOlJlcG9zaXRvcnkxODQyODY4NzU=-flat-WrappedException.cs.html,0.09108159392789374,10,MudBlazor-MDEwOlJlcG9zaXRvcnkyODg0Mjg2NzY=-flat-Server.cs,runner-MDEwOlJlcG9zaXRvcnkxODQyODY4NzU=-flat-WrappedException.cs,8,9,1,76,80,4
113512,https://htmlpreview.github.io/?https://github.com/Christina96/boilerplate-sample-matches/blob/main/Csharp/runner-MDEwOlJlcG9zaXRvcnkxODQyODY4NzU=-flat-CreateStepSummaryCommandL0.cs-Simple.Data-MDEwOlJlcG9zaXRvcnk4MTg3Njg=-flat-InMemoryTests.cs.html,0.14211438474870017,17,runner-MDEwOlJlcG9zaXRvcnkxODQyODY4NzU=-flat-CreateStepSummaryCommandL0.cs,Simple.Data-MDEwOlJlcG9zaXRvcnk4MTg3Njg=-flat-InMemoryTests.cs,44,53,9,122,131,9
114313,https://htmlpreview.github.io/?https://github.com/Christina96/boilerplate-sample-matches/blob/main/Csharp/runner-MDEwOlJlcG9zaXRvcnkxODQyODY4NzU=-flat-SetOutputFileCommandL0.cs-Simple.Data-MDEwOlJlcG9zaXRvcnk4MTg3Njg=-flat-QueryTest.cs.html,0.23255813953488372,11,runner-MDEwOlJlcG9zaXRvcnkxODQyODY4NzU=-flat-SetOutputFileCommandL0.cs,Simple.Data-MDEwOlJlcG9zaXRvcnk4MTg3Njg=-flat-QueryTest.cs,227,250,23,204,213,9
117184,https://htmlpreview.github.io/?https://github.com/Christina96/boilerplate-sample-matches/blob/main/Csharp/MudBlazor-MDEwOlJlcG9zaXRvcnkyODg0Mjg2NzY=-flat-MudIcon.razor.cs-MudBlazor-MDEwOlJlcG9zaXRvcnkyODg0Mjg2NzY=-flat-StringExtensionTests.cs.html,0.13580246913580246,11,MudBlazor-MDEwOlJlcG9zaXRvcnkyODg0Mjg2NzY=-flat-MudIcon.razor.cs,MudBlazor-MDEwOlJlcG9zaXRvcnkyODg0Mjg2NzY=-flat-StringExtensionTests.cs,10,15,5,12,15,3
117323,https://htmlpreview.github.io/?https://github.com/Christina96/boilerplate-sample-matches/blob/main/Csharp/npgsql-MDEwOlJlcG9zaXRvcnkyODgzNTc0-flat-InternalTypeTests.cs-npgsql-MDEwOlJlcG9zaXRvcnkyODgzNTc0-flat-CommandTests.cs.html,0.0405924300603401,14,npgsql-MDEwOlJlcG9zaXRvcnkyODgzNTc0-flat-InternalTypeTests.cs,npgsql-MDEwOlJlcG9zaXRvcnkyODgzNTc0-flat-CommandTests.cs,75,84,9,245,255,10
121274,https://htmlpreview.github.io/?https://github.com/Christina96/boilerplate-sample-matches/blob/main/Csharp/MudBlazor-MDEwOlJlcG9zaXRvcnkyODg0Mjg2NzY=-flat-Snackbar.cs-runner-MDEwOlJlcG9zaXRvcnkxODQyODY4NzU=-flat-LocationServerMapCache.cs.html,0.0582010582010582,11,MudBlazor-MDEwOlJlcG9zaXRvcnkyODg0Mjg2NzY=-flat-Snackbar.cs,runner-MDEwOlJlcG9zaXRvcnkxODQyODY4NzU=-flat-LocationServerMapCache.cs,9,10,1,20,27,7
121463,https://htmlpreview.github.io/?https://github.com/Christina96/boilerplate-sample-matches/blob/main/Csharp/Simple.Data-MDEwOlJlcG9zaXRvcnk4MTg3Njg=-flat-ProcedureTest_35.cs-npgsql-MDEwOlJlcG9zaXRvcnkyODgzNTc0-flat-RowDescriptionMessage.cs.html,0.06116207951070336,10,Simple.Data-MDEwOlJlcG9zaXRvcnk4MTg3Njg=-flat-ProcedureTest_35.cs,npgsql-MDEwOlJlcG9zaXRvcnkyODgzNTc0-flat-RowDescriptionMessage.cs,43,48,5,48,59,11
122422,https://htmlpreview.github.io/?https://github.com/Christina96/boilerplate-sample-matches/blob/main/Csharp/Simple.Data-MDEwOlJlcG9zaXRvcnk4MTg3Njg=-flat-RangeTest.cs-npgsql-MDEwOlJlcG9zaXRvcnkyODgzNTc0-flat-AutoPrepareTests.cs.html,0.06962025316455696,11,Simple.Data-MDEwOlJlcG9zaXRvcnk4MTg3Njg=-flat-RangeTest.cs,npgsql-MDEwOlJlcG9zaXRvcnkyODgzNTc0-flat-AutoPrepareTests.cs,88,97,9,118,126,8
124403,https://htmlpreview.github.io/?https://github.com/Christina96/boilerplate-sample-matches/blob/main/Csharp/MudBlazor-MDEwOlJlcG9zaXRvcnkyODg0Mjg2NzY=-flat-BrowserWindowSize.cs-npgsql-MDEwOlJlcG9zaXRvcnkyODgzNTc0-flat-OriginMessage.cs.html,0.6666666666666666,15,MudBlazor-MDEwOlJlcG9zaXRvcnkyODg0Mjg2NzY=-flat-BrowserWindowSize.cs,npgsql-MDEwOlJlcG9zaXRvcnkyODgzNTc0-flat-OriginMessage.cs,5,7,2,5,7,2
124707,https://htmlpreview.github.io/?https://github.com/Christina96/boilerplate-sample-matches/blob/main/Csharp/runner-MDEwOlJlcG9zaXRvcnkxODQyODY4NzU=-flat-ReplacementPosition.cs-Security-MDEwOlJlcG9zaXRvcnkxNzcyMzY5OQ==-flat-WsFederationOptions.cs.html,0.33663366336633666,17,runner-MDEwOlJlcG9zaXRvcnkxODQyODY4NzU=-flat-ReplacementPosition.cs,Security-MDEwOlJlcG9zaXRvcnkxNzcyMzY5OQ==-flat-WsFederationOptions.cs,16,21,5,37,39,2
125605,https://htmlpreview.github.io/?https://github.com/Christina96/boilerplate-sample-matches/blob/main/Csharp/20486D-DevelopingASPNETMVCWebApplications-MDEwOlJlcG9zaXRvcnkxMTkzNTI2Mzc=-flat-PersonProvider_431.cs-20486D-DevelopingASPNETMVCWebApplications-MDEwOlJlcG9zaXRvcnkxMTkzNTI2Mzc=-flat-RestaurantBranch.cs.html,0.19801980198019803,10,20486D-DevelopingASPNETMVCWebApplications-MDEwOlJlcG9zaXRvcnkxMTkzNTI2Mzc=-flat-PersonProvider_431.cs,20486D-DevelopingASPNETMVCWebApplications-MDEwOlJlcG9zaXRvcnkxMTkzNTI2Mzc=-flat-RestaurantBranch.cs,1,9,8,1,13,12
126052,https://htmlpreview.github.io/?https://github.com/Christina96/boilerplate-sample-matches/blob/main/Csharp/Security-MDEwOlJlcG9zaXRvcnkxNzcyMzY5OQ==-flat-FacebookOptions.cs-runner-MDEwOlJlcG9zaXRvcnkxODQyODY4NzU=-flat-FileContainerServer.cs.html,0.13836477987421383,11,Security-MDEwOlJlcG9zaXRvcnkxNzcyMzY5OQ==-flat-FacebookOptions.cs,runner-MDEwOlJlcG9zaXRvcnkxODQyODY4NzU=-flat-FileContainerServer.cs,61,62,1,516,517,1
127357,https://htmlpreview.github.io/?https://github.com/Christina96/boilerplate-sample-matches/blob/main/Csharp/MudBlazor-MDEwOlJlcG9zaXRvcnkyODg0Mjg2NzY=-flat-MudDebouncedInput.cs-MudBlazor-MDEwOlJlcG9zaXRvcnkyODg0Mjg2NzY=-flat-MudAvatarGroup.razor.cs.html,0.5,10,MudBlazor-MDEwOlJlcG9zaXRvcnkyODg0Mjg2NzY=-flat-MudDebouncedInput.cs,MudBlazor-MDEwOlJlcG9zaXRvcnkyODg0Mjg2NzY=-flat-MudAvatarGroup.razor.cs,9,18,9,22,32,10
127772,https://htmlpreview.github.io/?https://github.com/Christina96/boilerplate-sample-matches/blob/main/Csharp/20486D-DevelopingASPNETMVCWebApplications-MDEwOlJlcG9zaXRvcnkxMTkzNTI2Mzc=-flat-Photo.cs-runner-MDEwOlJlcG9zaXRvcnkxODQyODY4NzU=-flat-StringDefinition.cs.html,0.15384615384615385,14,20486D-DevelopingASPNETMVCWebApplications-MDEwOlJlcG9zaXRvcnkxMTkzNTI2Mzc=-flat-Photo.cs,runner-MDEwOlJlcG9zaXRvcnkxODQyODY4NzU=-flat-StringDefinition.cs,26,27,1,50,51,1
128169,https://htmlpreview.github.io/?https://github.com/Christina96/boilerplate-sample-matches/blob/main/Csharp/npgsql-MDEwOlJlcG9zaXRvcnkyODgzNTc0-flat-ReplicationSystemIdentification.cs-npgsql-MDEwOlJlcG9zaXRvcnkyODgzNTc0-flat-NpgsqlNotificationEventArgs.cs.html,0.4918032786885246,15,npgsql-MDEwOlJlcG9zaXRvcnkyODgzNTc0-flat-ReplicationSystemIdentification.cs,npgsql-MDEwOlJlcG9zaXRvcnkyODgzNTc0-flat-NpgsqlNotificationEventArgs.cs,12,14,2,6,8,2
128700,https://htmlpreview.github.io/?https://github.com/Christina96/boilerplate-sample-matches/blob/main/Csharp/ZXing.Net.Mobile-MDEwOlJlcG9zaXRvcnk2MTYwNjcz-flat-MobileBarcodeScanner.uwp.cs-runner-MDEwOlJlcG9zaXRvcnkxODQyODY4NzU=-flat-StepHost.cs.html,0.09302325581395349,14,ZXing.Net.Mobile-MDEwOlJlcG9zaXRvcnk2MTYwNjcz-flat-MobileBarcodeScanner.uwp.cs,runner-MDEwOlJlcG9zaXRvcnkxODQyODY4NzU=-flat-StepHost.cs,18,19,1,37,38,1
129427,https://htmlpreview.github.io/?https://github.com/Christina96/boilerplate-sample-matches/blob/main/Csharp/Security-MDEwOlJlcG9zaXRvcnkxNzcyMzY5OQ==-flat-Startup_6.cs-MudBlazor-MDEwOlJlcG9zaXRvcnkyODg0Mjg2NzY=-flat-SliderTests.cs.html,0.07455012853470437,18,Security-MDEwOlJlcG9zaXRvcnkxNzcyMzY5OQ==-flat-Startup_6.cs,MudBlazor-MDEwOlJlcG9zaXRvcnkyODg0Mjg2NzY=-flat-SliderTests.cs,372,383,11,27,36,9
130166,https://htmlpreview.github.io/?https://github.com/Christina96/boilerplate-sample-matches/blob/main/Csharp/Security-MDEwOlJlcG9zaXRvcnkxNzcyMzY5OQ==-flat-GoogleOptions.cs-runner-MDEwOlJlcG9zaXRvcnkxODQyODY4NzU=-flat-CheckUtil.cs.html,0.0468384074941452,10,Security-MDEwOlJlcG9zaXRvcnkxNzcyMzY5OQ==-flat-GoogleOptions.cs,runner-MDEwOlJlcG9zaXRvcnkxODQyODY4NzU=-flat-CheckUtil.cs,14,23,9,66,71,5
131644,https://htmlpreview.github.io/?https://github.com/Christina96/boilerplate-sample-matches/blob/main/Csharp/20486D-DevelopingASPNETMVCWebApplications-MDEwOlJlcG9zaXRvcnkxMTkzNTI2Mzc=-flat-RestaurantBranch_101.cs-runner-MDEwOlJlcG9zaXRvcnkxODQyODY4NzU=-flat-VssResponseContext.cs.html,0.2,14,20486D-DevelopingASPNETMVCWebApplications-MDEwOlJlcG9zaXRvcnkxMTkzNTI2Mzc=-flat-RestaurantBranch_101.cs,runner-MDEwOlJlcG9zaXRvcnkxODQyODY4NzU=-flat-VssResponseContext.cs,17,18,1,58,59,1
132760,https://htmlpreview.github.io/?https://github.com/Christina96/boilerplate-sample-matches/blob/main/Csharp/MudBlazor-MDEwOlJlcG9zaXRvcnkyODg0Mjg2NzY=-flat-ChipSetTests.cs-runner-MDEwOlJlcG9zaXRvcnkxODQyODY4NzU=-flat-ActionManifestManagerL0.cs.html,0.5856164383561644,14,MudBlazor-MDEwOlJlcG9zaXRvcnkyODg0Mjg2NzY=-flat-ChipSetTests.cs,runner-MDEwOlJlcG9zaXRvcnkxODQyODY4NzU=-flat-ActionManifestManagerL0.cs,154,158,4,180,188,8
134200,https://htmlpreview.github.io/?https://github.com/Christina96/boilerplate-sample-matches/blob/main/Csharp/runner-MDEwOlJlcG9zaXRvcnkxODQyODY4NzU=-flat-PathUtil.cs-dotween-MDEwOlJlcG9zaXRvcnkzMjQ3NTE2Mg==-flat-Go.cs.html,0.06825938566552901,10,runner-MDEwOlJlcG9zaXRvcnkxODQyODY4NzU=-flat-PathUtil.cs,dotween-MDEwOlJlcG9zaXRvcnkzMjQ3NTE2Mg==-flat-Go.cs,14,21,7,166,169,3
136105,https://htmlpreview.github.io/?https://github.com/Christina96/boilerplate-sample-matches/blob/main/Csharp/Security-MDEwOlJlcG9zaXRvcnkxNzcyMzY5OQ==-flat-AppendCookieContext.cs-Security-MDEwOlJlcG9zaXRvcnkxNzcyMzY5OQ==-flat-FacebookTests.cs.html,0.056338028169014086,10,Security-MDEwOlJlcG9zaXRvcnkxNzcyMzY5OQ==-flat-AppendCookieContext.cs,Security-MDEwOlJlcG9zaXRvcnkxNzcyMzY5OQ==-flat-FacebookTests.cs,13,14,1,25,26,1
137705,https://htmlpreview.github.io/?https://github.com/Christina96/boilerplate-sample-matches/blob/main/Csharp/20486D-DevelopingASPNETMVCWebApplications-MDEwOlJlcG9zaXRvcnkxMTkzNTI2Mzc=-flat-Butterfly.cs-ZXing.Net.Mobile-MDEwOlJlcG9zaXRvcnk2MTYwNjcz-flat-ZXingScannerFragment.android.cs.html,0.23045267489711935,28,20486D-DevelopingASPNETMVCWebApplications-MDEwOlJlcG9zaXRvcnkxMTkzNTI2Mzc=-flat-Butterfly.cs,ZXing.Net.Mobile-MDEwOlJlcG9zaXRvcnk2MTYwNjcz-flat-ZXingScannerFragment.android.cs,33,36,3,78,81,3
139371,https://htmlpreview.github.io/?https://github.com/Christina96/boilerplate-sample-matches/blob/main/Csharp/20486D-DevelopingASPNETMVCWebApplications-MDEwOlJlcG9zaXRvcnkxMTkzNTI2Mzc=-flat-StoreContext.cs-runner-MDEwOlJlcG9zaXRvcnkxODQyODY4NzU=-flat-SetOutputFileCommandL0.cs.html,0.0546448087431694,10,20486D-DevelopingASPNETMVCWebApplications-MDEwOlJlcG9zaXRvcnkxMTkzNTI2Mzc=-flat-StoreContext.cs,runner-MDEwOlJlcG9zaXRvcnkxODQyODY4NzU=-flat-SetOutputFileCommandL0.cs,27,84,57,281,291,10
139381,https://htmlpreview.github.io/?https://github.com/Christina96/boilerplate-sample-matches/blob/main/Csharp/runner-MDEwOlJlcG9zaXRvcnkxODQyODY4NzU=-flat-MessageListenerL0.cs-npgsql-MDEwOlJlcG9zaXRvcnkyODgzNTc0-flat-CommandTests.cs.html,0.14228456913827656,11,runner-MDEwOlJlcG9zaXRvcnkxODQyODY4NzU=-flat-MessageListenerL0.cs,npgsql-MDEwOlJlcG9zaXRvcnkyODgzNTc0-flat-CommandTests.cs,234,241,7,1190,1197,7
140846,https://htmlpreview.github.io/?https://github.com/Christina96/boilerplate-sample-matches/blob/main/Csharp/MudBlazor-MDEwOlJlcG9zaXRvcnkyODg0Mjg2NzY=-flat-ExpansionPanelTests.cs-NetCoreServer-MDEwOlJlcG9zaXRvcnkxNjYxMjMxNjQ=-flat-TcpTests.cs.html,0.15332197614991483,11,MudBlazor-MDEwOlJlcG9zaXRvcnkyODg0Mjg2NzY=-flat-ExpansionPanelTests.cs,NetCoreServer-MDEwOlJlcG9zaXRvcnkxNjYxMjMxNjQ=-flat-TcpTests.cs,152,159,7,237,247,10
141014,https://htmlpreview.github.io/?https://github.com/Christina96/boilerplate-sample-matches/blob/main/Csharp/20486D-DevelopingASPNETMVCWebApplications-MDEwOlJlcG9zaXRvcnkxMTkzNTI2Mzc=-flat-Data_398.cs-Security-MDEwOlJlcG9zaXRvcnkxNzcyMzY5OQ==-flat-Transaction.cs.html,0.2,10,20486D-DevelopingASPNETMVCWebApplications-MDEwOlJlcG9zaXRvcnkxMTkzNTI2Mzc=-flat-Data_398.cs,Security-MDEwOlJlcG9zaXRvcnkxNzcyMzY5OQ==-flat-Transaction.cs,1,9,8,1,9,8
141240,https://htmlpreview.github.io/?https://github.com/Christina96/boilerplate-sample-matches/blob/main/Csharp/runner-MDEwOlJlcG9zaXRvcnkxODQyODY4NzU=-flat-CommandLineParserL0.cs-NetCoreServer-MDEwOlJlcG9zaXRvcnkxNjYxMjMxNjQ=-flat-UdpTests.cs.html,0.06984126984126984,11,runner-MDEwOlJlcG9zaXRvcnkxODQyODY4NzU=-flat-CommandLineParserL0.cs,NetCoreServer-MDEwOlJlcG9zaXRvcnkxNjYxMjMxNjQ=-flat-UdpTests.cs,70,81,11,58,68,10
141591,https://htmlpreview.github.io/?https://github.com/Christina96/boilerplate-sample-matches/blob/main/Csharp/MudBlazor-MDEwOlJlcG9zaXRvcnkyODg0Mjg2NzY=-flat-ToggleIconButtonTest.cs-runner-MDEwOlJlcG9zaXRvcnkxODQyODY4NzU=-flat-JobDispatcherL0.cs.html,0.06979062811565304,12,MudBlazor-MDEwOlJlcG9zaXRvcnkyODg0Mjg2NzY=-flat-ToggleIconButtonTest.cs,runner-MDEwOlJlcG9zaXRvcnkxODQyODY4NzU=-flat-JobDispatcherL0.cs,26,32,6,121,126,5
142841,https://htmlpreview.github.io/?https://github.com/Christina96/boilerplate-sample-matches/blob/main/Csharp/MudBlazor-MDEwOlJlcG9zaXRvcnkyODg0Mjg2NzY=-flat-MudBaseButton.cs-MudBlazor-MDEwOlJlcG9zaXRvcnkyODg0Mjg2NzY=-flat-MudMenuItem.razor.cs.html,0.9320388349514563,30,MudBlazor-MDEwOlJlcG9zaXRvcnkyODg0Mjg2NzY=-flat-MudBaseButton.cs,MudBlazor-MDEwOlJlcG9zaXRvcnkyODg0Mjg2NzY=-flat-MudMenuItem.razor.cs,1,20,19,1,13,12
145740,https://htmlpreview.github.io/?https://github.com/Christina96/boilerplate-sample-matches/blob/main/Csharp/MudBlazor-MDEwOlJlcG9zaXRvcnkyODg0Mjg2NzY=-flat-IForm.cs-ZXing.Net.Mobile-MDEwOlJlcG9zaXRvcnk2MTYwNjcz-flat-CameraController.android.cs.html,0.05641025641025641,11,MudBlazor-MDEwOlJlcG9zaXRvcnkyODg0Mjg2NzY=-flat-IForm.cs,ZXing.Net.Mobile-MDEwOlJlcG9zaXRvcnk2MTYwNjcz-flat-CameraController.android.cs,6,9,3,31,34,3
146959,https://htmlpreview.github.io/?https://github.com/Christina96/boilerplate-sample-matches/blob/main/Csharp/MudBlazor-MDEwOlJlcG9zaXRvcnkyODg0Mjg2NzY=-flat-MudBaseSelectItem.cs-runner-MDEwOlJlcG9zaXRvcnkxODQyODY4NzU=-flat-RawClientHttpRequestSettings.cs.html,0.11764705882352941,15,MudBlazor-MDEwOlJlcG9zaXRvcnkyODg0Mjg2NzY=-flat-MudBaseSelectItem.cs,runner-MDEwOlJlcG9zaXRvcnkxODQyODY4NzU=-flat-RawClientHttpRequestSettings.cs,32,33,1,37,46,9
147202,https://htmlpreview.github.io/?https://github.com/Christina96/boilerplate-sample-matches/blob/main/Csharp/runner-MDEwOlJlcG9zaXRvcnkxODQyODY4NzU=-flat-StringUtilL0.cs-dotween-MDEwOlJlcG9zaXRvcnkzMjQ3NTE2Mg==-flat-TweenEnginesComparisonInternal_56.cs.html,0.041015625,10,runner-MDEwOlJlcG9zaXRvcnkxODQyODY4NzU=-flat-StringUtilL0.cs,dotween-MDEwOlJlcG9zaXRvcnkzMjQ3NTE2Mg==-flat-TweenEnginesComparisonInternal_56.cs,136,146,10,559,568,9
149746,https://htmlpreview.github.io/?https://github.com/Christina96/boilerplate-sample-matches/blob/main/Csharp/dotween-MDEwOlJlcG9zaXRvcnkzMjQ3NTE2Mg==-flat-OnWaypointChangedTests.cs-MudBlazor-MDEwOlJlcG9zaXRvcnkyODg0Mjg2NzY=-flat-DateRangePickerTests.cs.html,0.1625,11,dotween-MDEwOlJlcG9zaXRvcnkzMjQ3NTE2Mg==-flat-OnWaypointChangedTests.cs,MudBlazor-MDEwOlJlcG9zaXRvcnkyODg0Mjg2NzY=-flat-DateRangePickerTests.cs,116,122,6,116,120,4
150849,https://htmlpreview.github.io/?https://github.com/Christina96/boilerplate-sample-matches/blob/main/Csharp/runner-MDEwOlJlcG9zaXRvcnkxODQyODY4NzU=-flat-EndpointAuthorization.cs-MudBlazor-MDEwOlJlcG9zaXRvcnkyODg0Mjg2NzY=-flat-IFormComponent.cs.html,0.16393442622950818,10,runner-MDEwOlJlcG9zaXRvcnkxODQyODY4NzU=-flat-EndpointAuthorization.cs,MudBlazor-MDEwOlJlcG9zaXRvcnkyODg0Mjg2NzY=-flat-IFormComponent.cs,29,37,8,9,10,1
152062,https://htmlpreview.github.io/?https://github.com/Christina96/boilerplate-sample-matches/blob/main/Csharp/dotween-MDEwOlJlcG9zaXRvcnkzMjQ3NTE2Mg==-flat-InvertedTweens.cs-dotween-MDEwOlJlcG9zaXRvcnkzMjQ3NTE2Mg==-flat-Sequences_27.cs.html,0.178743961352657,12,dotween-MDEwOlJlcG9zaXRvcnkzMjQ3NTE2Mg==-flat-InvertedTweens.cs,dotween-MDEwOlJlcG9zaXRvcnkzMjQ3NTE2Mg==-flat-Sequences_27.cs,48,54,6,42,48,6
152360,https://htmlpreview.github.io/?https://github.com/Christina96/boilerplate-sample-matches/blob/main/Csharp/MudBlazor-MDEwOlJlcG9zaXRvcnkyODg0Mjg2NzY=-flat-CheckBoxTests.cs-npgsql-MDEwOlJlcG9zaXRvcnkyODgzNTc0-flat-CommandTests.cs.html,0.16627524659464538,15,MudBlazor-MDEwOlJlcG9zaXRvcnkyODg0Mjg2NzY=-flat-CheckBoxTests.cs,npgsql-MDEwOlJlcG9zaXRvcnkyODgzNTc0-flat-CommandTests.cs,71,79,8,666,672,6
152388,https://htmlpreview.github.io/?https://github.com/Christina96/boilerplate-sample-matches/blob/main/Csharp/MudBlazor-MDEwOlJlcG9zaXRvcnkyODg0Mjg2NzY=-flat-StringExtensionTests.cs-npgsql-MDEwOlJlcG9zaXRvcnkyODgzNTc0-flat-ReaderTests.cs.html,0.06644790812141099,14,MudBlazor-MDEwOlJlcG9zaXRvcnkyODg0Mjg2NzY=-flat-StringExtensionTests.cs,npgsql-MDEwOlJlcG9zaXRvcnkyODgzNTc0-flat-ReaderTests.cs,12,16,4,53,60,7
152809,https://htmlpreview.github.io/?https://github.com/Christina96/boilerplate-sample-matches/blob/main/Csharp/MudBlazor-MDEwOlJlcG9zaXRvcnkyODg0Mjg2NzY=-flat-StyleBuilderTests.cs-runner-MDEwOlJlcG9zaXRvcnkxODQyODY4NzU=-flat-TimelineRecordL0.cs.html,0.19631901840490798,11,MudBlazor-MDEwOlJlcG9zaXRvcnkyODg0Mjg2NzY=-flat-StyleBuilderTests.cs,runner-MDEwOlJlcG9zaXRvcnkxODQyODY4NzU=-flat-TimelineRecordL0.cs,18,26,8,19,28,9
153026,https://htmlpreview.github.io/?https://github.com/Christina96/boilerplate-sample-matches/blob/main/Csharp/MudBlazor-MDEwOlJlcG9zaXRvcnkyODg0Mjg2NzY=-flat-TableRowClickEventArgs.cs-EarTrumpet-MDEwOlJlcG9zaXRvcnkzODkxOTcwMg==-flat-ColorItemViewModel.cs.html,0.8679245283018868,23,MudBlazor-MDEwOlJlcG9zaXRvcnkyODg0Mjg2NzY=-flat-TableRowClickEventArgs.cs,EarTrumpet-MDEwOlJlcG9zaXRvcnkzODkxOTcwMg==-flat-ColorItemViewModel.cs,7,11,4,7,11,4
153262,https://htmlpreview.github.io/?https://github.com/Christina96/boilerplate-sample-matches/blob/main/Csharp/Simple.Data-MDEwOlJlcG9zaXRvcnk4MTg3Njg=-flat-XmlMockAdapterTest.cs-MudBlazor-MDEwOlJlcG9zaXRvcnkyODg0Mjg2NzY=-flat-PopoverTests.cs.html,0.20666097352690008,11,Simple.Data-MDEwOlJlcG9zaXRvcnk4MTg3Njg=-flat-XmlMockAdapterTest.cs,MudBlazor-MDEwOlJlcG9zaXRvcnkyODg0Mjg2NzY=-flat-PopoverTests.cs,78,85,7,752,758,6
154064,https://htmlpreview.github.io/?https://github.com/Christina96/boilerplate-sample-matches/blob/main/Csharp/MudBlazor-MDEwOlJlcG9zaXRvcnkyODg0Mjg2NzY=-flat-CheckBoxTests.cs-MudBlazor-MDEwOlJlcG9zaXRvcnkyODg0Mjg2NzY=-flat-DatePickerTests.cs.html,0.29312288613303267,12,MudBlazor-MDEwOlJlcG9zaXRvcnkyODg0Mjg2NzY=-flat-CheckBoxTests.cs,MudBlazor-MDEwOlJlcG9zaXRvcnkyODg0Mjg2NzY=-flat-DatePickerTests.cs,192,196,4,802,805,3
154160,https://htmlpreview.github.io/?https://github.com/Christina96/boilerplate-sample-matches/blob/main/Csharp/MudBlazor-MDEwOlJlcG9zaXRvcnkyODg0Mjg2NzY=-flat-ExpansionPanelTests.cs-Simple.Data-MDEwOlJlcG9zaXRvcnk4MTg3Njg=-flat-InMemoryTests.cs.html,0.17749313815187556,10,MudBlazor-MDEwOlJlcG9zaXRvcnkyODg0Mjg2NzY=-flat-ExpansionPanelTests.cs,Simple.Data-MDEwOlJlcG9zaXRvcnk4MTg3Njg=-flat-InMemoryTests.cs,82,89,7,153,162,9
154979,https://htmlpreview.github.io/?https://github.com/Christina96/boilerplate-sample-matches/blob/main/Csharp/MudBlazor-MDEwOlJlcG9zaXRvcnkyODg0Mjg2NzY=-flat-ColorTransformation.cs-MudBlazor-MDEwOlJlcG9zaXRvcnkyODg0Mjg2NzY=-flat-MudDataGrid.razor.cs.html,0.10966057441253264,21,MudBlazor-MDEwOlJlcG9zaXRvcnkyODg0Mjg2NzY=-flat-ColorTransformation.cs,MudBlazor-MDEwOlJlcG9zaXRvcnkyODg0Mjg2NzY=-flat-MudDataGrid.razor.cs,13,15,2,135,137,2
156253,https://htmlpreview.github.io/?https://github.com/Christina96/boilerplate-sample-matches/blob/main/Csharp/MudBlazor-MDEwOlJlcG9zaXRvcnkyODg0Mjg2NzY=-flat-SnackbarOptions.cs-Simple.Data-MDEwOlJlcG9zaXRvcnk4MTg3Njg=-flat-SimpleResultSetTest.cs.html,0.05357142857142857,15,MudBlazor-MDEwOlJlcG9zaXRvcnkyODg0Mjg2NzY=-flat-SnackbarOptions.cs,Simple.Data-MDEwOlJlcG9zaXRvcnk4MTg3Njg=-flat-SimpleResultSetTest.cs,9,11,2,356,358,2
156892,https://htmlpreview.github.io/?https://github.com/Christina96/boilerplate-sample-matches/blob/main/Csharp/EarTrumpet-MDEwOlJlcG9zaXRvcnkzODkxOTcwMg==-flat-PartViewModelFactory.cs-20486D-DevelopingASPNETMVCWebApplications-MDEwOlJlcG9zaXRvcnkxMTkzNTI2Mzc=-flat-Photo_47.cs.html,0.21212121212121213,14,EarTrumpet-MDEwOlJlcG9zaXRvcnkzODkxOTcwMg==-flat-PartViewModelFactory.cs,20486D-DevelopingASPNETMVCWebApplications-MDEwOlJlcG9zaXRvcnkxMTkzNTI2Mzc=-flat-Photo_47.cs,11,12,1,26,27,1
157930,https://htmlpreview.github.io/?https://github.com/Christina96/boilerplate-sample-matches/blob/main/Csharp/Security-MDEwOlJlcG9zaXRvcnkxNzcyMzY5OQ==-flat-PolicyAuthorizationResult.cs-npgsql-MDEwOlJlcG9zaXRvcnkyODgzNTc0-flat-RelationMessage.cs.html,0.39622641509433965,21,Security-MDEwOlJlcG9zaXRvcnkxNzcyMzY5OQ==-flat-PolicyAuthorizationResult.cs,npgsql-MDEwOlJlcG9zaXRvcnkyODgzNTc0-flat-RelationMessage.cs,6,8,2,9,11,2
158043,https://htmlpreview.github.io/?https://github.com/Christina96/boilerplate-sample-matches/blob/main/Csharp/dotween-MDEwOlJlcG9zaXRvcnkzMjQ3NTE2Mg==-flat-TweenSettingsExtensions.cs-NetCoreServer-MDEwOlJlcG9zaXRvcnkxNjYxMjMxNjQ=-flat-com.chronoxor.simple.cs.html,0.05578342904019688,11,dotween-MDEwOlJlcG9zaXRvcnkzMjQ3NTE2Mg==-flat-TweenSettingsExtensions.cs,NetCoreServer-MDEwOlJlcG9zaXRvcnkxNjYxMjMxNjQ=-flat-com.chronoxor.simple.cs,52,58,6,775,782,7
158593,https://htmlpreview.github.io/?https://github.com/Christina96/boilerplate-sample-matches/blob/main/Csharp/Simple.Data-MDEwOlJlcG9zaXRvcnk4MTg3Njg=-flat-MockDbConnection.cs-runner-MDEwOlJlcG9zaXRvcnkxODQyODY4NzU=-flat-VssHttpMessageHandler.cs.html,0.04040404040404041,10,Simple.Data-MDEwOlJlcG9zaXRvcnk4MTg3Njg=-flat-MockDbConnection.cs,runner-MDEwOlJlcG9zaXRvcnkxODQyODY4NzU=-flat-VssHttpMessageHandler.cs,16,20,4,53,62,9
158673,https://htmlpreview.github.io/?https://github.com/Christina96/boilerplate-sample-matches/blob/main/Csharp/MudBlazor-MDEwOlJlcG9zaXRvcnkyODg0Mjg2NzY=-flat-NavMenuTests.cs-Security-MDEwOlJlcG9zaXRvcnkxNzcyMzY5OQ==-flat-TwitterTests.cs.html,0.056555269922879174,11,MudBlazor-MDEwOlJlcG9zaXRvcnkyODg0Mjg2NzY=-flat-NavMenuTests.cs,Security-MDEwOlJlcG9zaXRvcnkxNzcyMzY5OQ==-flat-TwitterTests.cs,47,55,8,183,191,8
161432,https://htmlpreview.github.io/?https://github.com/Christina96/boilerplate-sample-matches/blob/main/Csharp/20486D-DevelopingASPNETMVCWebApplications-MDEwOlJlcG9zaXRvcnkxMTkzNTI2Mzc=-flat-DivisionResult_355.cs-20486D-DevelopingASPNETMVCWebApplications-MDEwOlJlcG9zaXRvcnkxMTkzNTI2Mzc=-flat-City.cs.html,0.6538461538461539,17,20486D-DevelopingASPNETMVCWebApplications-MDEwOlJlcG9zaXRvcnkxMTkzNTI2Mzc=-flat-DivisionResult_355.cs,20486D-DevelopingASPNETMVCWebApplications-MDEwOlJlcG9zaXRvcnkxMTkzNTI2Mzc=-flat-City.cs,1,11,10,1,10,9
161989,https://htmlpreview.github.io/?https://github.com/Christina96/boilerplate-sample-matches/blob/main/Csharp/20486D-DevelopingASPNETMVCWebApplications-MDEwOlJlcG9zaXRvcnkxMTkzNTI2Mzc=-flat-Customer_167.cs-ZXing.Net.Mobile-MDEwOlJlcG9zaXRvcnk2MTYwNjcz-flat-MobileBarcodeScanner.uwp.cs.html,0.1935483870967742,15,20486D-DevelopingASPNETMVCWebApplications-MDEwOlJlcG9zaXRvcnkxMTkzNTI2Mzc=-flat-Customer_167.cs,ZXing.Net.Mobile-MDEwOlJlcG9zaXRvcnk2MTYwNjcz-flat-MobileBarcodeScanner.uwp.cs,22,24,2,16,19,3
162251,https://htmlpreview.github.io/?https://github.com/Christina96/boilerplate-sample-matches/blob/main/Csharp/MudBlazor-MDEwOlJlcG9zaXRvcnkyODg0Mjg2NzY=-flat-KeyInterceptorOptions.cs-NetCoreServer-MDEwOlJlcG9zaXRvcnkxNjYxMjMxNjQ=-flat-TcpSession.cs.html,0.23972602739726026,21,MudBlazor-MDEwOlJlcG9zaXRvcnkyODg0Mjg2NzY=-flat-KeyInterceptorOptions.cs,NetCoreServer-MDEwOlJlcG9zaXRvcnkxNjYxMjMxNjQ=-flat-TcpSession.cs,6,8,2,25,28,3
162330,https://htmlpreview.github.io/?https://github.com/Christina96/boilerplate-sample-matches/blob/main/Csharp/runner-MDEwOlJlcG9zaXRvcnkxODQyODY4NzU=-flat-HookResponse.cs-runner-MDEwOlJlcG9zaXRvcnkxODQyODY4NzU=-flat-StepsRunner.cs.html,0.17142857142857143,12,runner-MDEwOlJlcG9zaXRvcnkxODQyODY4NzU=-flat-HookResponse.cs,runner-MDEwOlJlcG9zaXRvcnkxODQyODY4NzU=-flat-StepsRunner.cs,12,14,2,17,19,2
166793,https://htmlpreview.github.io/?https://github.com/Christina96/boilerplate-sample-matches/blob/main/Csharp/dotween-MDEwOlJlcG9zaXRvcnkzMjQ3NTE2Mg==-flat-Pooling.cs-runner-MDEwOlJlcG9zaXRvcnkxODQyODY4NzU=-flat-IOUtilL0.cs.html,0.03762935089369708,10,dotween-MDEwOlJlcG9zaXRvcnkzMjQ3NTE2Mg==-flat-Pooling.cs,runner-MDEwOlJlcG9zaXRvcnkxODQyODY4NzU=-flat-IOUtilL0.cs,23,24,1,454,461,7
167075,https://htmlpreview.github.io/?https://github.com/Christina96/boilerplate-sample-matches/blob/main/Csharp/npgsql-MDEwOlJlcG9zaXRvcnkyODgzNTc0-flat-StreamCommitMessage.cs-EarTrumpet-MDEwOlJlcG9zaXRvcnkzODkxOTcwMg==-flat-PartViewModelFactory.cs.html,0.30612244897959184,15,npgsql-MDEwOlJlcG9zaXRvcnkyODgzNTc0-flat-StreamCommitMessage.cs,EarTrumpet-MDEwOlJlcG9zaXRvcnkzODkxOTcwMg==-flat-PartViewModelFactory.cs,5,7,2,10,12,2
168481,https://htmlpreview.github.io/?https://github.com/Christina96/boilerplate-sample-matches/blob/main/Csharp/dotween-MDEwOlJlcG9zaXRvcnkzMjQ3NTE2Mg==-flat-OnWaypointChangedTests.cs-NetCoreServer-MDEwOlJlcG9zaXRvcnkxNjYxMjMxNjQ=-flat-UdpServer.cs.html,0.06997084548104957,12,dotween-MDEwOlJlcG9zaXRvcnkzMjQ3NTE2Mg==-flat-OnWaypointChangedTests.cs,NetCoreServer-MDEwOlJlcG9zaXRvcnkxNjYxMjMxNjQ=-flat-UdpServer.cs,106,112,6,125,133,8
169030,https://htmlpreview.github.io/?https://github.com/Christina96/boilerplate-sample-matches/blob/main/Csharp/runner-MDEwOlJlcG9zaXRvcnkxODQyODY4NzU=-flat-ResultMemory.cs-runner-MDEwOlJlcG9zaXRvcnkxODQyODY4NzU=-flat-ReferenceLink.cs.html,0.3508771929824561,10,runner-MDEwOlJlcG9zaXRvcnkxODQyODY4NzU=-flat-ResultMemory.cs,runner-MDEwOlJlcG9zaXRvcnkxODQyODY4NzU=-flat-ReferenceLink.cs,8,9,1,15,19,4
169233,https://htmlpreview.github.io/?https://github.com/Christina96/boilerplate-sample-matches/blob/main/Csharp/EarTrumpet-MDEwOlJlcG9zaXRvcnkzODkxOTcwMg==-flat-SettingsDialogViewModel.cs-NetCoreServer-MDEwOlJlcG9zaXRvcnkxNjYxMjMxNjQ=-flat-HttpClient.cs.html,0.11290322580645161,14,EarTrumpet-MDEwOlJlcG9zaXRvcnkzODkxOTcwMg==-flat-SettingsDialogViewModel.cs,NetCoreServer-MDEwOlJlcG9zaXRvcnkxNjYxMjMxNjQ=-flat-HttpClient.cs,6,7,1,13,14,1
169942,https://htmlpreview.github.io/?https://github.com/Christina96/boilerplate-sample-matches/blob/main/Csharp/20486D-DevelopingASPNETMVCWebApplications-MDEwOlJlcG9zaXRvcnkxMTkzNTI2Mzc=-flat-Photo_202.cs-MudBlazor-MDEwOlJlcG9zaXRvcnkyODg0Mjg2NzY=-flat-MudTimeline.razor.cs.html,0.15748031496062992,10,20486D-DevelopingASPNETMVCWebApplications-MDEwOlJlcG9zaXRvcnkxMTkzNTI2Mzc=-flat-Photo_202.cs,MudBlazor-MDEwOlJlcG9zaXRvcnkyODg0Mjg2NzY=-flat-MudTimeline.razor.cs,17,19,2,8,9,1
173366,https://htmlpreview.github.io/?https://github.com/Christina96/boilerplate-sample-matches/blob/main/Csharp/npgsql-MDEwOlJlcG9zaXRvcnkyODgzNTc0-flat-NumericTypeTests.cs-MudBlazor-MDEwOlJlcG9zaXRvcnkyODg0Mjg2NzY=-flat-SliderTests.cs.html,0.12375249500998003,10,npgsql-MDEwOlJlcG9zaXRvcnkyODgzNTc0-flat-NumericTypeTests.cs,MudBlazor-MDEwOlJlcG9zaXRvcnkyODg0Mjg2NzY=-flat-SliderTests.cs,52,61,9,218,224,6
173609,https://htmlpreview.github.io/?https://github.com/Christina96/boilerplate-sample-matches/blob/main/Csharp/runner-MDEwOlJlcG9zaXRvcnkxODQyODY4NzU=-flat-SetOutputFileCommandL0.cs-npgsql-MDEwOlJlcG9zaXRvcnkyODgzNTc0-flat-TransactionTests.cs.html,0.23410138248847925,16,runner-MDEwOlJlcG9zaXRvcnkxODQyODY4NzU=-flat-SetOutputFileCommandL0.cs,npgsql-MDEwOlJlcG9zaXRvcnkyODgzNTc0-flat-TransactionTests.cs,93,116,23,379,391,12
176683,https://htmlpreview.github.io/?https://github.com/Christina96/boilerplate-sample-matches/blob/main/Csharp/20486D-DevelopingASPNETMVCWebApplications-MDEwOlJlcG9zaXRvcnkxMTkzNTI2Mzc=-flat-City.cs-ZXing.Net.Mobile-MDEwOlJlcG9zaXRvcnk2MTYwNjcz-flat-ZxingActivity.android.cs.html,0.3522012578616352,28,20486D-DevelopingASPNETMVCWebApplications-MDEwOlJlcG9zaXRvcnkxMTkzNTI2Mzc=-flat-City.cs,ZXing.Net.Mobile-MDEwOlJlcG9zaXRvcnk2MTYwNjcz-flat-ZxingActivity.android.cs,9,12,3,44,47,3
176801,https://htmlpreview.github.io/?https://github.com/Christina96/boilerplate-sample-matches/blob/main/Csharp/Security-MDEwOlJlcG9zaXRvcnkxNzcyMzY5OQ==-flat-TokenExtensionTests.cs-MudBlazor-MDEwOlJlcG9zaXRvcnkyODg0Mjg2NzY=-flat-RegexMaskIPv6Tests.cs.html,0.1740976645435244,15,Security-MDEwOlJlcG9zaXRvcnkxNzcyMzY5OQ==-flat-TokenExtensionTests.cs,MudBlazor-MDEwOlJlcG9zaXRvcnkyODg0Mjg2NzY=-flat-RegexMaskIPv6Tests.cs,75,88,13,64,73,9
177556,https://htmlpreview.github.io/?https://github.com/Christina96/boilerplate-sample-matches/blob/main/Csharp/runner-MDEwOlJlcG9zaXRvcnkxODQyODY4NzU=-flat-CreateStepSummaryCommandL0.cs-MudBlazor-MDEwOlJlcG9zaXRvcnkyODg0Mjg2NzY=-flat-SelectTests.cs.html,0.14048257372654155,16,runner-MDEwOlJlcG9zaXRvcnkxODQyODY4NzU=-flat-CreateStepSummaryCommandL0.cs,MudBlazor-MDEwOlJlcG9zaXRvcnkyODg0Mjg2NzY=-flat-SelectTests.cs,58,64,6,71,78,7
180169,https://htmlpreview.github.io/?https://github.com/Christina96/boilerplate-sample-matches/blob/main/Csharp/Security-MDEwOlJlcG9zaXRvcnkxNzcyMzY5OQ==-flat-RemoteAuthenticationContext.cs-20486D-DevelopingASPNETMVCWebApplications-MDEwOlJlcG9zaXRvcnkxMTkzNTI2Mzc=-flat-Student_230.cs.html,0.35443037974683544,14,Security-MDEwOlJlcG9zaXRvcnkxNzcyMzY5OQ==-flat-RemoteAuthenticationContext.cs,20486D-DevelopingASPNETMVCWebApplications-MDEwOlJlcG9zaXRvcnkxMTkzNTI2Mzc=-flat-Student_230.cs,15,16,1,19,20,1
182532,https://htmlpreview.github.io/?https://github.com/Christina96/boilerplate-sample-matches/blob/main/Csharp/MudBlazor-MDEwOlJlcG9zaXRvcnkyODg0Mjg2NzY=-flat-RegexMaskIPv6Tests.cs-MudBlazor-MDEwOlJlcG9zaXRvcnkyODg0Mjg2NzY=-flat-BindingConverterTests.cs.html,0.2600408441116406,27,MudBlazor-MDEwOlJlcG9zaXRvcnkyODg0Mjg2NzY=-flat-RegexMaskIPv6Tests.cs,MudBlazor-MDEwOlJlcG9zaXRvcnkyODg0Mjg2NzY=-flat-BindingConverterTests.cs,113,127,14,117,125,8
183230,https://htmlpreview.github.io/?https://github.com/Christina96/boilerplate-sample-matches/blob/main/Csharp/EarTrumpet-MDEwOlJlcG9zaXRvcnkzODkxOTcwMg==-flat-EarTrumpetActionsAddon.cs-npgsql-MDEwOlJlcG9zaXRvcnkyODgzNTc0-flat-NpgsqlConnector.cs.html,0.19047619047619047,14,EarTrumpet-MDEwOlJlcG9zaXRvcnkzODkxOTcwMg==-flat-EarTrumpetActionsAddon.cs,npgsql-MDEwOlJlcG9zaXRvcnkyODgzNTc0-flat-NpgsqlConnector.cs,19,20,1,41,42,1
183311,https://htmlpreview.github.io/?https://github.com/Christina96/boilerplate-sample-matches/blob/main/Csharp/20486D-DevelopingASPNETMVCWebApplications-MDEwOlJlcG9zaXRvcnkxMTkzNTI2Mzc=-flat-Aquarium.cs-npgsql-MDEwOlJlcG9zaXRvcnkyODgzNTc0-flat-NpgsqlParameter.cs.html,0.3708609271523179,28,20486D-DevelopingASPNETMVCWebApplications-MDEwOlJlcG9zaXRvcnkxMTkzNTI2Mzc=-flat-Aquarium.cs,npgsql-MDEwOlJlcG9zaXRvcnkyODgzNTc0-flat-NpgsqlParameter.cs,11,14,3,30,33,3
183333,https://htmlpreview.github.io/?https://github.com/Christina96/boilerplate-sample-matches/blob/main/Csharp/runner-MDEwOlJlcG9zaXRvcnkxODQyODY4NzU=-flat-Resource.Designer.cs-runner-MDEwOlJlcG9zaXRvcnkxODQyODY4NzU=-flat-VssException.cs.html,0.10483870967741936,13,runner-MDEwOlJlcG9zaXRvcnkxODQyODY4NzU=-flat-Resource.Designer.cs,runner-MDEwOlJlcG9zaXRvcnkxODQyODY4NzU=-flat-VssException.cs,23,33,10,68,83,15
183388,https://htmlpreview.github.io/?https://github.com/Christina96/boilerplate-sample-matches/blob/main/Csharp/MudBlazor-MDEwOlJlcG9zaXRvcnkyODg0Mjg2NzY=-flat-MudTooltip.razor.cs-runner-MDEwOlJlcG9zaXRvcnkxODQyODY4NzU=-flat-AgentJobRequestMessage.cs.html,0.034129692832764506,10,MudBlazor-MDEwOlJlcG9zaXRvcnkyODg0Mjg2NzY=-flat-MudTooltip.razor.cs,runner-MDEwOlJlcG9zaXRvcnkxODQyODY4NzU=-flat-AgentJobRequestMessage.cs,27,28,1,114,120,6
183689,https://htmlpreview.github.io/?https://github.com/Christina96/boilerplate-sample-matches/blob/main/Csharp/MudBlazor-MDEwOlJlcG9zaXRvcnkyODg0Mjg2NzY=-flat-CellContext.cs-runner-MDEwOlJlcG9zaXRvcnkxODQyODY4NzU=-flat-ICheckExtension.cs.html,0.26666666666666666,14,MudBlazor-MDEwOlJlcG9zaXRvcnkyODg0Mjg2NzY=-flat-CellContext.cs,runner-MDEwOlJlcG9zaXRvcnkxODQyODY4NzU=-flat-ICheckExtension.cs,10,12,2,21,23,2
183947,https://htmlpreview.github.io/?https://github.com/Christina96/boilerplate-sample-matches/blob/main/Csharp/MudBlazor-MDEwOlJlcG9zaXRvcnkyODg0Mjg2NzY=-flat-MudBadge.razor.cs-MudBlazor-MDEwOlJlcG9zaXRvcnkyODg0Mjg2NzY=-flat-TextFieldTests.cs.html,0.02962962962962963,16,MudBlazor-MDEwOlJlcG9zaXRvcnkyODg0Mjg2NzY=-flat-MudBadge.razor.cs,MudBlazor-MDEwOlJlcG9zaXRvcnkyODg0Mjg2NzY=-flat-TextFieldTests.cs,21,31,10,446,455,9
183996,https://htmlpreview.github.io/?https://github.com/Christina96/boilerplate-sample-matches/blob/main/Csharp/runner-MDEwOlJlcG9zaXRvcnkxODQyODY4NzU=-flat-RunnerWebProxy.cs-Simple.Data-MDEwOlJlcG9zaXRvcnk4MTg3Njg=-flat-DynamicRecordTest.cs.html,0.2978723404255319,14,runner-MDEwOlJlcG9zaXRvcnkxODQyODY4NzU=-flat-RunnerWebProxy.cs,Simple.Data-MDEwOlJlcG9zaXRvcnk4MTg3Njg=-flat-DynamicRecordTest.cs,9,10,1,58,59,1
184079,https://htmlpreview.github.io/?https://github.com/Christina96/boilerplate-sample-matches/blob/main/Csharp/MudBlazor-MDEwOlJlcG9zaXRvcnkyODg0Mjg2NzY=-flat-Size.cs-runner-MDEwOlJlcG9zaXRvcnkxODQyODY4NzU=-flat-TaskAgentStatus.cs.html,0.8,10,MudBlazor-MDEwOlJlcG9zaXRvcnkyODg0Mjg2NzY=-flat-Size.cs,runner-MDEwOlJlcG9zaXRvcnkxODQyODY4NzU=-flat-TaskAgentStatus.cs,4,13,9,5,14,9
184321,https://htmlpreview.github.io/?https://github.com/Christina96/boilerplate-sample-matches/blob/main/Csharp/MudBlazor-MDEwOlJlcG9zaXRvcnkyODg0Mjg2NzY=-flat-ButtonsTests.cs-MudBlazor-MDEwOlJlcG9zaXRvcnkyODg0Mjg2NzY=-flat-DropZoneTests.cs.html,0.2886375875067313,12,MudBlazor-MDEwOlJlcG9zaXRvcnkyODg0Mjg2NzY=-flat-ButtonsTests.cs,MudBlazor-MDEwOlJlcG9zaXRvcnkyODg0Mjg2NzY=-flat-DropZoneTests.cs,86,97,11,136,143,7
184410,https://htmlpreview.github.io/?https://github.com/Christina96/boilerplate-sample-matches/blob/main/Csharp/Simple.Data-MDEwOlJlcG9zaXRvcnk4MTg3Njg=-flat-SimpleExpression.cs-runner-MDEwOlJlcG9zaXRvcnkxODQyODY4NzU=-flat-LexicalAnalyzer.cs.html,0.03766478342749529,10,Simple.Data-MDEwOlJlcG9zaXRvcnk4MTg3Njg=-flat-SimpleExpression.cs,runner-MDEwOlJlcG9zaXRvcnkxODQyODY4NzU=-flat-LexicalAnalyzer.cs,48,55,7,198,205,7
186643,https://htmlpreview.github.io/?https://github.com/Christina96/boilerplate-sample-matches/blob/main/Csharp/Simple.Data-MDEwOlJlcG9zaXRvcnk4MTg3Njg=-flat-TransactionTests.cs-npgsql-MDEwOlJlcG9zaXRvcnkyODgzNTc0-flat-TransactionTests.cs.html,0.08634772462077013,14,Simple.Data-MDEwOlJlcG9zaXRvcnk4MTg3Njg=-flat-TransactionTests.cs,npgsql-MDEwOlJlcG9zaXRvcnkyODgzNTc0-flat-TransactionTests.cs,43,52,9,128,136,8
189014,https://htmlpreview.github.io/?https://github.com/Christina96/boilerplate-sample-matches/blob/main/Csharp/20486D-DevelopingASPNETMVCWebApplications-MDEwOlJlcG9zaXRvcnkxMTkzNTI2Mzc=-flat-GroceryStore_69.cs-20486D-DevelopingASPNETMVCWebApplications-MDEwOlJlcG9zaXRvcnkxMTkzNTI2Mzc=-flat-EmployeeRequirements.cs.html,0.6575342465753424,24,20486D-DevelopingASPNETMVCWebApplications-MDEwOlJlcG9zaXRvcnkxMTkzNTI2Mzc=-flat-GroceryStore_69.cs,20486D-DevelopingASPNETMVCWebApplications-MDEwOlJlcG9zaXRvcnkxMTkzNTI2Mzc=-flat-EmployeeRequirements.cs,1,11,10,1,11,10
191596,https://htmlpreview.github.io/?https://github.com/Christina96/boilerplate-sample-matches/blob/main/Csharp/Security-MDEwOlJlcG9zaXRvcnkxNzcyMzY5OQ==-flat-DefaultAuthorizationServiceTests.cs-Security-MDEwOlJlcG9zaXRvcnkxNzcyMzY5OQ==-flat-CookieTests.cs.html,0.10234899328859061,10,Security-MDEwOlJlcG9zaXRvcnkxNzcyMzY5OQ==-flat-DefaultAuthorizationServiceTests.cs,Security-MDEwOlJlcG9zaXRvcnkxNzcyMzY5OQ==-flat-CookieTests.cs,842,851,9,1126,1135,9
192915,https://htmlpreview.github.io/?https://github.com/Christina96/boilerplate-sample-matches/blob/main/Csharp/MudBlazor-MDEwOlJlcG9zaXRvcnkyODg0Mjg2NzY=-flat-TypeIdentifierTests.cs-MudBlazor-MDEwOlJlcG9zaXRvcnkyODg0Mjg2NzY=-flat-MudColorTests.cs.html,0.07757575757575758,12,MudBlazor-MDEwOlJlcG9zaXRvcnkyODg0Mjg2NzY=-flat-TypeIdentifierTests.cs,MudBlazor-MDEwOlJlcG9zaXRvcnkyODg0Mjg2NzY=-flat-MudColorTests.cs,38,50,12,10,22,12
194459,https://htmlpreview.github.io/?https://github.com/Christina96/boilerplate-sample-matches/blob/main/Csharp/MudBlazor-MDEwOlJlcG9zaXRvcnkyODg0Mjg2NzY=-flat-MudStack.razor.cs-MudBlazor-MDEwOlJlcG9zaXRvcnkyODg0Mjg2NzY=-flat-MudBaseDatePicker.razor.cs.html,0.625,10,MudBlazor-MDEwOlJlcG9zaXRvcnkyODg0Mjg2NzY=-flat-MudStack.razor.cs,MudBlazor-MDEwOlJlcG9zaXRvcnkyODg0Mjg2NzY=-flat-MudBaseDatePicker.razor.cs,29,32,3,63,68,5
195519,https://htmlpreview.github.io/?https://github.com/Christina96/boilerplate-sample-matches/blob/main/Csharp/Simple.Data-MDEwOlJlcG9zaXRvcnk4MTg3Njg=-flat-DynamicRecordTest.cs-MudBlazor-MDEwOlJlcG9zaXRvcnkyODg0Mjg2NzY=-flat-MudRatingItem.razor.cs.html,0.1222707423580786,14,Simple.Data-MDEwOlJlcG9zaXRvcnk4MTg3Njg=-flat-DynamicRecordTest.cs,MudBlazor-MDEwOlJlcG9zaXRvcnkyODg0Mjg2NzY=-flat-MudRatingItem.razor.cs,58,59,1,24,25,1
195737,https://htmlpreview.github.io/?https://github.com/Christina96/boilerplate-sample-matches/blob/main/Csharp/20486D-DevelopingASPNETMVCWebApplications-MDEwOlJlcG9zaXRvcnkxMTkzNTI2Mzc=-flat-HomeController_40.cs-20486D-DevelopingASPNETMVCWebApplications-MDEwOlJlcG9zaXRvcnkxMTkzNTI2Mzc=-flat-AquariumController_61.cs.html,0.5567010309278351,43,20486D-DevelopingASPNETMVCWebApplications-MDEwOlJlcG9zaXRvcnkxMTkzNTI2Mzc=-flat-HomeController_40.cs,20486D-DevelopingASPNETMVCWebApplications-MDEwOlJlcG9zaXRvcnkxMTkzNTI2Mzc=-flat-AquariumController_61.cs,23,61,38,102,140,38
197687,https://htmlpreview.github.io/?https://github.com/Christina96/boilerplate-sample-matches/blob/main/Csharp/20486D-DevelopingASPNETMVCWebApplications-MDEwOlJlcG9zaXRvcnkxMTkzNTI2Mzc=-flat-Bakery.cs-runner-MDEwOlJlcG9zaXRvcnkxODQyODY4NzU=-flat-RunnerService.cs.html,0.08187134502923976,14,20486D-DevelopingASPNETMVCWebApplications-MDEwOlJlcG9zaXRvcnkxMTkzNTI2Mzc=-flat-Bakery.cs,runner-MDEwOlJlcG9zaXRvcnkxODQyODY4NzU=-flat-RunnerService.cs,17,18,1,19,20,1
198298,https://htmlpreview.github.io/?https://github.com/Christina96/boilerplate-sample-matches/blob/main/Csharp/MudBlazor-MDEwOlJlcG9zaXRvcnkyODg0Mjg2NzY=-flat-TableRowClickEventArgs.cs-runner-MDEwOlJlcG9zaXRvcnkxODQyODY4NzU=-flat-CommandLineParser.cs.html,0.13333333333333333,10,MudBlazor-MDEwOlJlcG9zaXRvcnkyODg0Mjg2NzY=-flat-TableRowClickEventArgs.cs,runner-MDEwOlJlcG9zaXRvcnkxODQyODY4NzU=-flat-CommandLineParser.cs,7,8,1,14,15,1
198944,https://htmlpreview.github.io/?https://github.com/Christina96/boilerplate-sample-matches/blob/main/Csharp/dotween-MDEwOlJlcG9zaXRvcnkzMjQ3NTE2Mg==-flat-Vector3PathTweenProperty.cs-MudBlazor-MDEwOlJlcG9zaXRvcnkyODg0Mjg2NzY=-flat-MudSkeleton.razor.cs.html,0.1694915254237288,10,dotween-MDEwOlJlcG9zaXRvcnkzMjQ3NTE2Mg==-flat-Vector3PathTweenProperty.cs,MudBlazor-MDEwOlJlcG9zaXRvcnkyODg0Mjg2NzY=-flat-MudSkeleton.razor.cs,6,9,3,25,28,3
199180,https://htmlpreview.github.io/?https://github.com/Christina96/boilerplate-sample-matches/blob/main/Csharp/runner-MDEwOlJlcG9zaXRvcnkxODQyODY4NzU=-flat-ActionManifestManagerL0.cs-Security-MDEwOlJlcG9zaXRvcnkxNzcyMzY5OQ==-flat-OpenIdConnectEventTests.cs.html,0.03664921465968586,11,runner-MDEwOlJlcG9zaXRvcnkxODQyODY4NzU=-flat-ActionManifestManagerL0.cs,Security-MDEwOlJlcG9zaXRvcnkxNzcyMzY5OQ==-flat-OpenIdConnectEventTests.cs,31,37,6,900,907,7
199938,https://htmlpreview.github.io/?https://github.com/Christina96/boilerplate-sample-matches/blob/main/Csharp/Security-MDEwOlJlcG9zaXRvcnkxNzcyMzY5OQ==-flat-AuthorizationResult.cs-20486D-DevelopingASPNETMVCWebApplications-MDEwOlJlcG9zaXRvcnkxMTkzNTI2Mzc=-flat-Person_436.cs.html,0.4745762711864407,14,Security-MDEwOlJlcG9zaXRvcnkxNzcyMzY5OQ==-flat-AuthorizationResult.cs,20486D-DevelopingASPNETMVCWebApplications-MDEwOlJlcG9zaXRvcnkxMTkzNTI2Mzc=-flat-Person_436.cs,8,9,1,9,10,1
199998,https://htmlpreview.github.io/?https://github.com/Christina96/boilerplate-sample-matches/blob/main/Csharp/Security-MDEwOlJlcG9zaXRvcnkxNzcyMzY5OQ==-flat-TestServerExtensions.cs-Security-MDEwOlJlcG9zaXRvcnkxNzcyMzY5OQ==-flat-JwtBearerTests.cs.html,0.0638002773925104,12,Security-MDEwOlJlcG9zaXRvcnkxNzcyMzY5OQ==-flat-TestServerExtensions.cs,Security-MDEwOlJlcG9zaXRvcnkxNzcyMzY5OQ==-flat-JwtBearerTests.cs,13,24,11,710,721,11
202146,https://htmlpreview.github.io/?https://github.com/Christina96/boilerplate-sample-matches/blob/main/Csharp/runner-MDEwOlJlcG9zaXRvcnkxODQyODY4NzU=-flat-IPatchOperation.cs-NetCoreServer-MDEwOlJlcG9zaXRvcnkxNjYxMjMxNjQ=-flat-HttpSession.cs.html,0.21428571428571427,15,runner-MDEwOlJlcG9zaXRvcnkxODQyODY4NzU=-flat-IPatchOperation.cs,NetCoreServer-MDEwOlJlcG9zaXRvcnkxNjYxMjMxNjQ=-flat-HttpSession.cs,6,8,2,12,14,2
202601,https://htmlpreview.github.io/?https://github.com/Christina96/boilerplate-sample-matches/blob/main/Csharp/EarTrumpet-MDEwOlJlcG9zaXRvcnkzODkxOTcwMg==-flat-PartViewModelFactory.cs-MudBlazor-MDEwOlJlcG9zaXRvcnkyODg0Mjg2NzY=-flat-MudBreadcrumbs.razor.cs.html,0.20588235294117646,14,EarTrumpet-MDEwOlJlcG9zaXRvcnkzODkxOTcwMg==-flat-PartViewModelFactory.cs,MudBlazor-MDEwOlJlcG9zaXRvcnkyODg0Mjg2NzY=-flat-MudBreadcrumbs.razor.cs,11,12,1,25,26,1
204268,https://htmlpreview.github.io/?https://github.com/Christina96/boilerplate-sample-matches/blob/main/Csharp/MudBlazor-MDEwOlJlcG9zaXRvcnkyODg0Mjg2NzY=-flat-SortingAssistentTests.cs-npgsql-MDEwOlJlcG9zaXRvcnkyODgzNTc0-flat-ReaderOldSchemaTests.cs.html,0.1534526854219949,10,MudBlazor-MDEwOlJlcG9zaXRvcnkyODg0Mjg2NzY=-flat-SortingAssistentTests.cs,npgsql-MDEwOlJlcG9zaXRvcnkyODgzNTc0-flat-ReaderOldSchemaTests.cs,30,36,6,51,59,8
204825,https://htmlpreview.github.io/?https://github.com/Christina96/boilerplate-sample-matches/blob/main/Csharp/20486D-DevelopingASPNETMVCWebApplications-MDEwOlJlcG9zaXRvcnkxMTkzNTI2Mzc=-flat-GroceryStore_86.cs-Security-MDEwOlJlcG9zaXRvcnkxNzcyMzY5OQ==-flat-OpenIdConnectEventTests.cs.html,0.03678929765886288,22,20486D-DevelopingASPNETMVCWebApplications-MDEwOlJlcG9zaXRvcnkxMTkzNTI2Mzc=-flat-GroceryStore_86.cs,Security-MDEwOlJlcG9zaXRvcnkxNzcyMzY5OQ==-flat-OpenIdConnectEventTests.cs,8,11,3,1011,1014,3
208048,https://htmlpreview.github.io/?https://github.com/Christina96/boilerplate-sample-matches/blob/main/Csharp/npgsql-MDEwOlJlcG9zaXRvcnkyODgzNTc0-flat-PostgresNotice.cs-runner-MDEwOlJlcG9zaXRvcnkxODQyODY4NzU=-flat-Handler.cs.html,0.5132743362831859,11,npgsql-MDEwOlJlcG9zaXRvcnkyODgzNTc0-flat-PostgresNotice.cs,runner-MDEwOlJlcG9zaXRvcnkxODQyODY4NzU=-flat-Handler.cs,9,10,1,31,32,1
208455,https://htmlpreview.github.io/?https://github.com/Christina96/boilerplate-sample-matches/blob/main/Csharp/MudBlazor-MDEwOlJlcG9zaXRvcnkyODg0Mjg2NzY=-flat-MudChip.razor.cs-npgsql-MDEwOlJlcG9zaXRvcnkyODgzNTc0-flat-CommandTests.cs.html,0.014675052410901468,14,MudBlazor-MDEwOlJlcG9zaXRvcnkyODg0Mjg2NzY=-flat-MudChip.razor.cs,npgsql-MDEwOlJlcG9zaXRvcnkyODgzNTc0-flat-CommandTests.cs,18,26,8,665,670,5
208822,https://htmlpreview.github.io/?https://github.com/Christina96/boilerplate-sample-matches/blob/main/Csharp/runner-MDEwOlJlcG9zaXRvcnkxODQyODY4NzU=-flat-FileContainerServer.cs-NetCoreServer-MDEwOlJlcG9zaXRvcnkxNjYxMjMxNjQ=-flat-ProtoTests.cs.html,0.09556313993174062,14,runner-MDEwOlJlcG9zaXRvcnkxODQyODY4NzU=-flat-FileContainerServer.cs,NetCoreServer-MDEwOlJlcG9zaXRvcnkxNjYxMjMxNjQ=-flat-ProtoTests.cs,531,532,1,169,170,1
210354,https://htmlpreview.github.io/?https://github.com/Christina96/boilerplate-sample-matches/blob/main/Csharp/npgsql-MDEwOlJlcG9zaXRvcnkyODgzNTc0-flat-ReadBufferTests.cs-npgsql-MDEwOlJlcG9zaXRvcnkyODgzNTc0-flat-MultipleHostsTests.cs.html,0.04945054945054945,16,npgsql-MDEwOlJlcG9zaXRvcnkyODgzNTc0-flat-ReadBufferTests.cs,npgsql-MDEwOlJlcG9zaXRvcnkyODgzNTc0-flat-MultipleHostsTests.cs,15,27,12,707,717,10
210565,https://htmlpreview.github.io/?https://github.com/Christina96/boilerplate-sample-matches/blob/main/Csharp/Simple.Data-MDEwOlJlcG9zaXRvcnk4MTg3Njg=-flat-StringExtensions.cs-runner-MDEwOlJlcG9zaXRvcnkxODQyODY4NzU=-flat-CommonResources.g.cs.html,0.2537313432835821,11,Simple.Data-MDEwOlJlcG9zaXRvcnk4MTg3Njg=-flat-StringExtensions.cs,runner-MDEwOlJlcG9zaXRvcnkxODQyODY4NzU=-flat-CommonResources.g.cs,41,50,9,17,29,12
212845,https://htmlpreview.github.io/?https://github.com/Christina96/boilerplate-sample-matches/blob/main/Csharp/20486D-DevelopingASPNETMVCWebApplications-MDEwOlJlcG9zaXRvcnkxMTkzNTI2Mzc=-flat-CupcakeContext.cs-Security-MDEwOlJlcG9zaXRvcnkxNzcyMzY5OQ==-flat-CookiePolicyOptions.cs.html,0.34146341463414637,14,20486D-DevelopingASPNETMVCWebApplications-MDEwOlJlcG9zaXRvcnkxMTkzNTI2Mzc=-flat-CupcakeContext.cs,Security-MDEwOlJlcG9zaXRvcnkxNzcyMzY5OQ==-flat-CookiePolicyOptions.cs,14,15,1,8,9,1
213268,https://htmlpreview.github.io/?https://github.com/Christina96/boilerplate-sample-matches/blob/main/Csharp/20486D-DevelopingASPNETMVCWebApplications-MDEwOlJlcG9zaXRvcnkxMTkzNTI2Mzc=-flat-User.cs-runner-MDEwOlJlcG9zaXRvcnkxODQyODY4NzU=-flat-AttributesQueryContext.cs.html,0.11627906976744186,10,20486D-DevelopingASPNETMVCWebApplications-MDEwOlJlcG9zaXRvcnkxMTkzNTI2Mzc=-flat-User.cs,runner-MDEwOlJlcG9zaXRvcnkxODQyODY4NzU=-flat-AttributesQueryContext.cs,11,13,2,53,55,2
213305,https://htmlpreview.github.io/?https://github.com/Christina96/boilerplate-sample-matches/blob/main/Csharp/EarTrumpet-MDEwOlJlcG9zaXRvcnkzODkxOTcwMg==-flat-SettingsSearchItemViewModel.cs-ZXing.Net.Mobile-MDEwOlJlcG9zaXRvcnk2MTYwNjcz-flat-IMobileBarcodeScanner.shared.cs.html,0.28708133971291866,30,EarTrumpet-MDEwOlJlcG9zaXRvcnkzODkxOTcwMg==-flat-SettingsSearchItemViewModel.cs,ZXing.Net.Mobile-MDEwOlJlcG9zaXRvcnk2MTYwNjcz-flat-IMobileBarcodeScanner.shared.cs,5,11,6,7,12,5
213731,https://htmlpreview.github.io/?https://github.com/Christina96/boilerplate-sample-matches/blob/main/Csharp/20486D-DevelopingASPNETMVCWebApplications-MDEwOlJlcG9zaXRvcnkxMTkzNTI2Mzc=-flat-Restaurant.cs-MudBlazor-MDEwOlJlcG9zaXRvcnkyODg0Mjg2NzY=-flat-ChartOptions.cs.html,0.7213114754098361,44,20486D-DevelopingASPNETMVCWebApplications-MDEwOlJlcG9zaXRvcnkxMTkzNTI2Mzc=-flat-Restaurant.cs,MudBlazor-MDEwOlJlcG9zaXRvcnkyODg0Mjg2NzY=-flat-ChartOptions.cs,6,14,8,2,10,8
216102,https://htmlpreview.github.io/?https://github.com/Christina96/boilerplate-sample-matches/blob/main/Csharp/npgsql-MDEwOlJlcG9zaXRvcnkyODgzNTc0-flat-NestedDataReaderTests.cs-Security-MDEwOlJlcG9zaXRvcnkxNzcyMzY5OQ==-flat-GoogleTests.cs.html,0.12527634487840825,10,npgsql-MDEwOlJlcG9zaXRvcnkyODgzNTc0-flat-NestedDataReaderTests.cs,Security-MDEwOlJlcG9zaXRvcnkxNzcyMzY5OQ==-flat-GoogleTests.cs,210,216,6,495,503,8
218085,https://htmlpreview.github.io/?https://github.com/Christina96/boilerplate-sample-matches/blob/main/Csharp/20486D-DevelopingASPNETMVCWebApplications-MDEwOlJlcG9zaXRvcnkxMTkzNTI2Mzc=-flat-IceCream_173.cs-MudBlazor-MDEwOlJlcG9zaXRvcnkyODg0Mjg2NzY=-flat-MudTimelineItem.razor.cs.html,0.34615384615384615,17,20486D-DevelopingASPNETMVCWebApplications-MDEwOlJlcG9zaXRvcnkxMTkzNTI2Mzc=-flat-IceCream_173.cs,MudBlazor-MDEwOlJlcG9zaXRvcnkyODg0Mjg2NzY=-flat-MudTimelineItem.razor.cs,12,16,4,34,38,4
219186,https://htmlpreview.github.io/?https://github.com/Christina96/boilerplate-sample-matches/blob/main/Csharp/MudBlazor-MDEwOlJlcG9zaXRvcnkyODg0Mjg2NzY=-flat-DocsViewExtension.cs-dotween-MDEwOlJlcG9zaXRvcnkzMjQ3NTE2Mg==-flat-SequenceCallbacks_53.cs.html,0.15483870967741936,12,MudBlazor-MDEwOlJlcG9zaXRvcnkyODg0Mjg2NzY=-flat-DocsViewExtension.cs,dotween-MDEwOlJlcG9zaXRvcnkzMjQ3NTE2Mg==-flat-SequenceCallbacks_53.cs,28,39,11,38,44,6
219259,https://htmlpreview.github.io/?https://github.com/Christina96/boilerplate-sample-matches/blob/main/Csharp/runner-MDEwOlJlcG9zaXRvcnkxODQyODY4NzU=-flat-CredentialData.cs-20486D-DevelopingASPNETMVCWebApplications-MDEwOlJlcG9zaXRvcnkxMTkzNTI2Mzc=-flat-GroceryStore_82.cs.html,0.52,13,runner-MDEwOlJlcG9zaXRvcnkxODQyODY4NzU=-flat-CredentialData.cs,20486D-DevelopingASPNETMVCWebApplications-MDEwOlJlcG9zaXRvcnkxMTkzNTI2Mzc=-flat-GroceryStore_82.cs,1,11,10,1,10,9
219730,https://htmlpreview.github.io/?https://github.com/Christina96/boilerplate-sample-matches/blob/main/Csharp/20486D-DevelopingASPNETMVCWebApplications-MDEwOlJlcG9zaXRvcnkxMTkzNTI2Mzc=-flat-Program_410.cs-20486D-DevelopingASPNETMVCWebApplications-MDEwOlJlcG9zaXRvcnkxMTkzNTI2Mzc=-flat-Program_408.cs.html,1.0,12,20486D-DevelopingASPNETMVCWebApplications-MDEwOlJlcG9zaXRvcnkxMTkzNTI2Mzc=-flat-Program_410.cs,20486D-DevelopingASPNETMVCWebApplications-MDEwOlJlcG9zaXRvcnkxMTkzNTI2Mzc=-flat-Program_408.cs,1,22,21,1,22,21
221600,https://htmlpreview.github.io/?https://github.com/Christina96/boilerplate-sample-matches/blob/main/Csharp/MudBlazor-MDEwOlJlcG9zaXRvcnkyODg0Mjg2NzY=-flat-MudRatingItem.razor.cs-MudBlazor-MDEwOlJlcG9zaXRvcnkyODg0Mjg2NzY=-flat-MudDataGrid.razor.cs.html,0.42159383033419023,22,MudBlazor-MDEwOlJlcG9zaXRvcnkyODg0Mjg2NzY=-flat-MudRatingItem.razor.cs,MudBlazor-MDEwOlJlcG9zaXRvcnkyODg0Mjg2NzY=-flat-MudDataGrid.razor.cs,24,27,3,135,138,3
222102,https://htmlpreview.github.io/?https://github.com/Christina96/boilerplate-sample-matches/blob/main/Csharp/MudBlazor-MDEwOlJlcG9zaXRvcnkyODg0Mjg2NzY=-flat-UserPreferences.cs-Security-MDEwOlJlcG9zaXRvcnkxNzcyMzY5OQ==-flat-JwtBearerChallengeContext.cs.html,0.45901639344262296,14,MudBlazor-MDEwOlJlcG9zaXRvcnkyODg0Mjg2NzY=-flat-UserPreferences.cs,Security-MDEwOlJlcG9zaXRvcnkxNzcyMzY5OQ==-flat-JwtBearerChallengeContext.cs,6,7,1,13,14,1
223521,https://htmlpreview.github.io/?https://github.com/Christina96/boilerplate-sample-matches/blob/main/Csharp/Security-MDEwOlJlcG9zaXRvcnkxNzcyMzY5OQ==-flat-JwtBearerOptions.cs-ZXing.Net.Mobile-MDEwOlJlcG9zaXRvcnk2MTYwNjcz-flat-ZXingScannerView.ios.cs.html,0.12824010914051842,33,Security-MDEwOlJlcG9zaXRvcnkxNzcyMzY5OQ==-flat-JwtBearerOptions.cs,ZXing.Net.Mobile-MDEwOlJlcG9zaXRvcnk2MTYwNjcz-flat-ZXingScannerView.ios.cs,13,19,6,492,496,4
223614,https://htmlpreview.github.io/?https://github.com/Christina96/boilerplate-sample-matches/blob/main/Csharp/MudBlazor-MDEwOlJlcG9zaXRvcnkyODg0Mjg2NzY=-flat-DrawerTest.cs-MudBlazor-MDEwOlJlcG9zaXRvcnkyODg0Mjg2NzY=-flat-TimePickerTests.cs.html,0.45041322314049587,42,MudBlazor-MDEwOlJlcG9zaXRvcnkyODg0Mjg2NzY=-flat-DrawerTest.cs,MudBlazor-MDEwOlJlcG9zaXRvcnkyODg0Mjg2NzY=-flat-TimePickerTests.cs,209,229,20,379,399,20
223659,https://htmlpreview.github.io/?https://github.com/Christina96/boilerplate-sample-matches/blob/main/Csharp/NetCoreServer-MDEwOlJlcG9zaXRvcnkxNjYxMjMxNjQ=-flat-HttpClient.cs-runner-MDEwOlJlcG9zaXRvcnkxODQyODY4NzU=-flat-CheckUtil.cs.html,0.04658901830282862,14,NetCoreServer-MDEwOlJlcG9zaXRvcnkxNjYxMjMxNjQ=-flat-HttpClient.cs,runner-MDEwOlJlcG9zaXRvcnkxODQyODY4NzU=-flat-CheckUtil.cs,16,29,13,23,29,6
223916,https://htmlpreview.github.io/?https://github.com/Christina96/boilerplate-sample-matches/blob/main/Csharp/npgsql-MDEwOlJlcG9zaXRvcnkyODgzNTc0-flat-LegacyTimestampHandler.cs-MudBlazor-MDEwOlJlcG9zaXRvcnkyODg0Mjg2NzY=-flat-MudField.razor.cs.html,0.09345794392523364,10,npgsql-MDEwOlJlcG9zaXRvcnkyODgzNTc0-flat-LegacyTimestampHandler.cs,MudBlazor-MDEwOlJlcG9zaXRvcnkyODg0Mjg2NzY=-flat-MudField.razor.cs,19,43,24,11,15,4
224069,https://htmlpreview.github.io/?https://github.com/Christina96/boilerplate-sample-matches/blob/main/Csharp/MudBlazor-MDEwOlJlcG9zaXRvcnkyODg0Mjg2NzY=-flat-LineChartTests.cs-NetCoreServer-MDEwOlJlcG9zaXRvcnkxNjYxMjMxNjQ=-flat-Program_25.cs.html,0.13131313131313133,13,MudBlazor-MDEwOlJlcG9zaXRvcnkyODg0Mjg2NzY=-flat-LineChartTests.cs,NetCoreServer-MDEwOlJlcG9zaXRvcnkxNjYxMjMxNjQ=-flat-Program_25.cs,54,61,7,102,109,7
224267,https://htmlpreview.github.io/?https://github.com/Christina96/boilerplate-sample-matches/blob/main/Csharp/runner-MDEwOlJlcG9zaXRvcnkxODQyODY4NzU=-flat-HookResponse.cs-Security-MDEwOlJlcG9zaXRvcnkxNzcyMzY5OQ==-flat-OpenIdConnectOptions.cs.html,0.4558139534883721,14,runner-MDEwOlJlcG9zaXRvcnkxODQyODY4NzU=-flat-HookResponse.cs,Security-MDEwOlJlcG9zaXRvcnkxNzcyMzY5OQ==-flat-OpenIdConnectOptions.cs,13,14,1,77,78,1
224562,https://htmlpreview.github.io/?https://github.com/Christina96/boilerplate-sample-matches/blob/main/Csharp/runner-MDEwOlJlcG9zaXRvcnkxODQyODY4NzU=-flat-VssApiResourceVersion.cs-runner-MDEwOlJlcG9zaXRvcnkxODQyODY4NzU=-flat-ServiceEndpoint.cs.html,0.18808777429467086,12,runner-MDEwOlJlcG9zaXRvcnkxODQyODY4NzU=-flat-VssApiResourceVersion.cs,runner-MDEwOlJlcG9zaXRvcnkxODQyODY4NzU=-flat-ServiceEndpoint.cs,34,39,5,36,44,8
224722,https://htmlpreview.github.io/?https://github.com/Christina96/boilerplate-sample-matches/blob/main/Csharp/runner-MDEwOlJlcG9zaXRvcnkxODQyODY4NzU=-flat-TemplateContext.cs-runner-MDEwOlJlcG9zaXRvcnkxODQyODY4NzU=-flat-StepsRunner.cs.html,0.1282051282051282,11,runner-MDEwOlJlcG9zaXRvcnkxODQyODY4NzU=-flat-TemplateContext.cs,runner-MDEwOlJlcG9zaXRvcnkxODQyODY4NzU=-flat-StepsRunner.cs,13,18,5,17,19,2
224855,https://htmlpreview.github.io/?https://github.com/Christina96/boilerplate-sample-matches/blob/main/Csharp/20486D-DevelopingASPNETMVCWebApplications-MDEwOlJlcG9zaXRvcnkxMTkzNTI2Mzc=-flat-Student_226.cs-20486D-DevelopingASPNETMVCWebApplications-MDEwOlJlcG9zaXRvcnkxMTkzNTI2Mzc=-flat-RegisterViewModel_316.cs.html,0.8947368421052632,32,20486D-DevelopingASPNETMVCWebApplications-MDEwOlJlcG9zaXRvcnkxMTkzNTI2Mzc=-flat-Student_226.cs,20486D-DevelopingASPNETMVCWebApplications-MDEwOlJlcG9zaXRvcnkxMTkzNTI2Mzc=-flat-RegisterViewModel_316.cs,11,19,8,12,20,8
226281,https://htmlpreview.github.io/?https://github.com/Christina96/boilerplate-sample-matches/blob/main/Csharp/MudBlazor-MDEwOlJlcG9zaXRvcnkyODg0Mjg2NzY=-flat-SortingAssistentTests.cs-runner-MDEwOlJlcG9zaXRvcnkxODQyODY4NzU=-flat-TemplateContext.cs.html,0.05952380952380952,10,MudBlazor-MDEwOlJlcG9zaXRvcnkyODg0Mjg2NzY=-flat-SortingAssistentTests.cs,runner-MDEwOlJlcG9zaXRvcnkxODQyODY4NzU=-flat-TemplateContext.cs,15,16,1,52,53,1
226881,https://htmlpreview.github.io/?https://github.com/Christina96/boilerplate-sample-matches/blob/main/Csharp/runner-MDEwOlJlcG9zaXRvcnkxODQyODY4NzU=-flat-Definition.cs-runner-MDEwOlJlcG9zaXRvcnkxODQyODY4NzU=-flat-VssHttpMessageHandlerTraceInfo.cs.html,0.19101123595505617,17,runner-MDEwOlJlcG9zaXRvcnkxODQyODY4NzU=-flat-Definition.cs,runner-MDEwOlJlcG9zaXRvcnkxODQyODY4NzU=-flat-VssHttpMessageHandlerTraceInfo.cs,50,52,2,9,11,2
227316,https://htmlpreview.github.io/?https://github.com/Christina96/boilerplate-sample-matches/blob/main/Csharp/MudBlazor-MDEwOlJlcG9zaXRvcnkyODg0Mjg2NzY=-flat-RegexMaskIPv6Tests.cs-runner-MDEwOlJlcG9zaXRvcnkxODQyODY4NzU=-flat-ActionManagerL0.cs.html,0.19616947185142194,14,MudBlazor-MDEwOlJlcG9zaXRvcnkyODg0Mjg2NzY=-flat-RegexMaskIPv6Tests.cs,runner-MDEwOlJlcG9zaXRvcnkxODQyODY4NzU=-flat-ActionManagerL0.cs,162,169,7,1201,1212,11
227361,https://htmlpreview.github.io/?https://github.com/Christina96/boilerplate-sample-matches/blob/main/Csharp/MudBlazor-MDEwOlJlcG9zaXRvcnkyODg0Mjg2NzY=-flat-MessageBoxTests.cs-npgsql-MDEwOlJlcG9zaXRvcnkyODgzNTc0-flat-AutoPrepareTests.cs.html,0.24776119402985075,16,MudBlazor-MDEwOlJlcG9zaXRvcnkyODg0Mjg2NzY=-flat-MessageBoxTests.cs,npgsql-MDEwOlJlcG9zaXRvcnkyODgzNTc0-flat-AutoPrepareTests.cs,61,69,8,114,126,12
229493,https://htmlpreview.github.io/?https://github.com/Christina96/boilerplate-sample-matches/blob/main/Csharp/Simple.Data-MDEwOlJlcG9zaXRvcnk4MTg3Njg=-flat-User.cs-EarTrumpet-MDEwOlJlcG9zaXRvcnkzODkxOTcwMg==-flat-EarTrumpetAddonManifest.cs.html,1.0,32,Simple.Data-MDEwOlJlcG9zaXRvcnk4MTg3Njg=-flat-User.cs,EarTrumpet-MDEwOlJlcG9zaXRvcnkzODkxOTcwMg==-flat-EarTrumpetAddonManifest.cs,2,10,8,2,10,8
230501,https://htmlpreview.github.io/?https://github.com/Christina96/boilerplate-sample-matches/blob/main/Csharp/20486D-DevelopingASPNETMVCWebApplications-MDEwOlJlcG9zaXRvcnkxMTkzNTI2Mzc=-flat-Restaurant.cs-MudBlazor-MDEwOlJlcG9zaXRvcnkyODg0Mjg2NzY=-flat-KeyInterceptorOptions.cs.html,0.704,44,20486D-DevelopingASPNETMVCWebApplications-MDEwOlJlcG9zaXRvcnkxMTkzNTI2Mzc=-flat-Restaurant.cs,MudBlazor-MDEwOlJlcG9zaXRvcnkyODg0Mjg2NzY=-flat-KeyInterceptorOptions.cs,9,16,7,13,20,7
232880,https://htmlpreview.github.io/?https://github.com/Christina96/boilerplate-sample-matches/blob/main/Csharp/runner-MDEwOlJlcG9zaXRvcnkxODQyODY4NzU=-flat-SequenceDefinition.cs-runner-MDEwOlJlcG9zaXRvcnkxODQyODY4NzU=-flat-OneOfDefinition.cs.html,0.22317596566523606,11,runner-MDEwOlJlcG9zaXRvcnkxODQyODY4NzU=-flat-SequenceDefinition.cs,runner-MDEwOlJlcG9zaXRvcnkxODQyODY4NzU=-flat-OneOfDefinition.cs,34,42,8,26,34,8
234060,https://htmlpreview.github.io/?https://github.com/Christina96/boilerplate-sample-matches/blob/main/Csharp/MudBlazor-MDEwOlJlcG9zaXRvcnkyODg0Mjg2NzY=-flat-ChartSeries.cs-Security-MDEwOlJlcG9zaXRvcnkxNzcyMzY5OQ==-flat-TestTransaction.cs.html,0.4266666666666667,16,MudBlazor-MDEwOlJlcG9zaXRvcnkyODg0Mjg2NzY=-flat-ChartSeries.cs,Security-MDEwOlJlcG9zaXRvcnkxNzcyMzY5OQ==-flat-TestTransaction.cs,2,6,4,6,10,4
234653,https://htmlpreview.github.io/?https://github.com/Christina96/boilerplate-sample-matches/blob/main/Csharp/dotween-MDEwOlJlcG9zaXRvcnkzMjQ3NTE2Mg==-flat-Path.cs-runner-MDEwOlJlcG9zaXRvcnkxODQyODY4NzU=-flat-NativeWindowsServiceHelper.cs.html,0.016216216216216217,12,dotween-MDEwOlJlcG9zaXRvcnkzMjQ3NTE2Mg==-flat-Path.cs,runner-MDEwOlJlcG9zaXRvcnkxODQyODY4NzU=-flat-NativeWindowsServiceHelper.cs,13,19,6,1063,1074,11
235445,https://htmlpreview.github.io/?https://github.com/Christina96/boilerplate-sample-matches/blob/main/Csharp/20486D-DevelopingASPNETMVCWebApplications-MDEwOlJlcG9zaXRvcnkxMTkzNTI2Mzc=-flat-ZooController_207.cs-Simple.Data-MDEwOlJlcG9zaXRvcnk4MTg3Njg=-flat-PluralizationTest.cs.html,0.1282051282051282,10,20486D-DevelopingASPNETMVCWebApplications-MDEwOlJlcG9zaXRvcnkxMTkzNTI2Mzc=-flat-ZooController_207.cs,Simple.Data-MDEwOlJlcG9zaXRvcnk4MTg3Njg=-flat-PluralizationTest.cs,43,51,8,78,86,8
235696,https://htmlpreview.github.io/?https://github.com/Christina96/boilerplate-sample-matches/blob/main/Csharp/MudBlazor-MDEwOlJlcG9zaXRvcnkyODg0Mjg2NzY=-flat-MudTimePicker.razor.cs-MudBlazor-MDEwOlJlcG9zaXRvcnkyODg0Mjg2NzY=-flat-MudPopover.razor.cs.html,0.296969696969697,49,MudBlazor-MDEwOlJlcG9zaXRvcnkyODg0Mjg2NzY=-flat-MudTimePicker.razor.cs,MudBlazor-MDEwOlJlcG9zaXRvcnkyODg0Mjg2NzY=-flat-MudPopover.razor.cs,56,73,17,45,60,15
238114,https://htmlpreview.github.io/?https://github.com/Christina96/boilerplate-sample-matches/blob/main/Csharp/Simple.Data-MDEwOlJlcG9zaXRvcnk4MTg3Njg=-flat-InMemoryTests.cs-MudBlazor-MDEwOlJlcG9zaXRvcnkyODg0Mjg2NzY=-flat-TableTests.cs.html,0.16525183927560838,12,Simple.Data-MDEwOlJlcG9zaXRvcnk4MTg3Njg=-flat-InMemoryTests.cs,MudBlazor-MDEwOlJlcG9zaXRvcnkyODg0Mjg2NzY=-flat-TableTests.cs,223,229,6,1283,1287,4
238267,https://htmlpreview.github.io/?https://github.com/Christina96/boilerplate-sample-matches/blob/main/Csharp/npgsql-MDEwOlJlcG9zaXRvcnkyODgzNTc0-flat-CommandTests.cs-npgsql-MDEwOlJlcG9zaXRvcnkyODgzNTc0-flat-ReaderTests.cs.html,0.41793987185805814,13,npgsql-MDEwOlJlcG9zaXRvcnkyODgzNTc0-flat-CommandTests.cs,npgsql-MDEwOlJlcG9zaXRvcnkyODgzNTc0-flat-ReaderTests.cs,482,491,9,579,587,8
239265,https://htmlpreview.github.io/?https://github.com/Christina96/boilerplate-sample-matches/blob/main/Csharp/NetCoreServer-MDEwOlJlcG9zaXRvcnkxNjYxMjMxNjQ=-flat-UdsTests.cs-MudBlazor-MDEwOlJlcG9zaXRvcnkyODg0Mjg2NzY=-flat-BreakpointServiceTests.cs.html,0.09163802978235967,12,NetCoreServer-MDEwOlJlcG9zaXRvcnkxNjYxMjMxNjQ=-flat-UdsTests.cs,MudBlazor-MDEwOlJlcG9zaXRvcnkyODg0Mjg2NzY=-flat-BreakpointServiceTests.cs,136,147,11,198,206,8
243585,https://htmlpreview.github.io/?https://github.com/Christina96/boilerplate-sample-matches/blob/main/Csharp/MudBlazor-MDEwOlJlcG9zaXRvcnkyODg0Mjg2NzY=-flat-RegexMaskIPv6Tests.cs-runner-MDEwOlJlcG9zaXRvcnkxODQyODY4NzU=-flat-CheckUtil.cs.html,0.3941798941798942,11,MudBlazor-MDEwOlJlcG9zaXRvcnkyODg0Mjg2NzY=-flat-RegexMaskIPv6Tests.cs,runner-MDEwOlJlcG9zaXRvcnkxODQyODY4NzU=-flat-CheckUtil.cs,173,177,4,159,164,5
243858,https://htmlpreview.github.io/?https://github.com/Christina96/boilerplate-sample-matches/blob/main/Csharp/npgsql-MDEwOlJlcG9zaXRvcnkyODgzNTc0-flat-Program_1.cs-NetCoreServer-MDEwOlJlcG9zaXRvcnkxNjYxMjMxNjQ=-flat-UdpServer.cs.html,0.1939799331103679,28,npgsql-MDEwOlJlcG9zaXRvcnkyODgzNTc0-flat-Program_1.cs,NetCoreServer-MDEwOlJlcG9zaXRvcnkxNjYxMjMxNjQ=-flat-UdpServer.cs,326,329,3,24,27,3
244813,https://htmlpreview.github.io/?https://github.com/Christina96/boilerplate-sample-matches/blob/main/Csharp/MudBlazor-MDEwOlJlcG9zaXRvcnkyODg0Mjg2NzY=-flat-FilterOptions.cs-Security-MDEwOlJlcG9zaXRvcnkxNzcyMzY5OQ==-flat-OpenIdConnectEvents.cs.html,0.25742574257425743,13,MudBlazor-MDEwOlJlcG9zaXRvcnkyODg0Mjg2NzY=-flat-FilterOptions.cs,Security-MDEwOlJlcG9zaXRvcnkxNzcyMzY5OQ==-flat-OpenIdConnectEvents.cs,2,7,5,4,8,4
245574,https://htmlpreview.github.io/?https://github.com/Christina96/boilerplate-sample-matches/blob/main/Csharp/20486D-DevelopingASPNETMVCWebApplications-MDEwOlJlcG9zaXRvcnkxMTkzNTI2Mzc=-flat-UnderwaterContext.cs-Security-MDEwOlJlcG9zaXRvcnkxNzcyMzY5OQ==-flat-AuthenticationHandler.cs.html,0.4827586206896552,14,20486D-DevelopingASPNETMVCWebApplications-MDEwOlJlcG9zaXRvcnkxMTkzNTI2Mzc=-flat-UnderwaterContext.cs,Security-MDEwOlJlcG9zaXRvcnkxNzcyMzY5OQ==-flat-AuthenticationHandler.cs,14,15,1,13,14,1
246111,https://htmlpreview.github.io/?https://github.com/Christina96/boilerplate-sample-matches/blob/main/Csharp/MudBlazor-MDEwOlJlcG9zaXRvcnkyODg0Mjg2NzY=-flat-AppbarButtons.razor.cs-ZXing.Net.Mobile-MDEwOlJlcG9zaXRvcnk2MTYwNjcz-flat-ZXingScannerView.ios.cs.html,0.030395136778115502,10,MudBlazor-MDEwOlJlcG9zaXRvcnkyODg0Mjg2NzY=-flat-AppbarButtons.razor.cs,ZXing.Net.Mobile-MDEwOlJlcG9zaXRvcnk2MTYwNjcz-flat-ZXingScannerView.ios.cs,14,18,4,45,49,4
246906,https://htmlpreview.github.io/?https://github.com/Christina96/boilerplate-sample-matches/blob/main/Csharp/dotween-MDEwOlJlcG9zaXRvcnkzMjQ3NTE2Mg==-flat-OnWaypointChangedTests.cs-MudBlazor-MDEwOlJlcG9zaXRvcnkyODg0Mjg2NzY=-flat-MudPicker.razor.cs.html,0.03861003861003861,10,dotween-MDEwOlJlcG9zaXRvcnkzMjQ3NTE2Mg==-flat-OnWaypointChangedTests.cs,MudBlazor-MDEwOlJlcG9zaXRvcnkyODg0Mjg2NzY=-flat-MudPicker.razor.cs,78,83,5,22,30,8
247699,https://htmlpreview.github.io/?https://github.com/Christina96/boilerplate-sample-matches/blob/main/Csharp/Simple.Data-MDEwOlJlcG9zaXRvcnk4MTg3Njg=-flat-SimpleRecordAsDictionaryTest.cs-MudBlazor-MDEwOlJlcG9zaXRvcnkyODg0Mjg2NzY=-flat-ProgressLinearTests.cs.html,0.1441717791411043,12,Simple.Data-MDEwOlJlcG9zaXRvcnk4MTg3Njg=-flat-SimpleRecordAsDictionaryTest.cs,MudBlazor-MDEwOlJlcG9zaXRvcnkyODg0Mjg2NzY=-flat-ProgressLinearTests.cs,148,157,9,144,156,12
249190,https://htmlpreview.github.io/?https://github.com/Christina96/boilerplate-sample-matches/blob/main/Csharp/MudBlazor-MDEwOlJlcG9zaXRvcnkyODg0Mjg2NzY=-flat-TableGroupData.cs-EarTrumpet-MDEwOlJlcG9zaXRvcnkzODkxOTcwMg==-flat-SettingsCategoryViewModel.cs.html,0.4,10,MudBlazor-MDEwOlJlcG9zaXRvcnkyODg0Mjg2NzY=-flat-TableGroupData.cs,EarTrumpet-MDEwOlJlcG9zaXRvcnkzODkxOTcwMg==-flat-SettingsCategoryViewModel.cs,13,16,3,12,22,10
249570,https://htmlpreview.github.io/?https://github.com/Christina96/boilerplate-sample-matches/blob/main/Csharp/MudBlazor-MDEwOlJlcG9zaXRvcnkyODg0Mjg2NzY=-flat-MudHidden.razor.cs-MudBlazor-MDEwOlJlcG9zaXRvcnkyODg0Mjg2NzY=-flat-MudExpansionPanel.razor.cs.html,0.5,26,MudBlazor-MDEwOlJlcG9zaXRvcnkyODg0Mjg2NzY=-flat-MudHidden.razor.cs,MudBlazor-MDEwOlJlcG9zaXRvcnkyODg0Mjg2NzY=-flat-MudExpansionPanel.razor.cs,13,19,6,27,34,7
251035,https://htmlpreview.github.io/?https://github.com/Christina96/boilerplate-sample-matches/blob/main/Csharp/MudBlazor-MDEwOlJlcG9zaXRvcnkyODg0Mjg2NzY=-flat-SubscriptionInfoTests.cs-runner-MDEwOlJlcG9zaXRvcnkxODQyODY4NzU=-flat-HostContextL0.cs.html,0.2648401826484018,10,MudBlazor-MDEwOlJlcG9zaXRvcnkyODg0Mjg2NzY=-flat-SubscriptionInfoTests.cs,runner-MDEwOlJlcG9zaXRvcnkxODQyODY4NzU=-flat-HostContextL0.cs,38,41,3,23,29,6
252401,https://htmlpreview.github.io/?https://github.com/Christina96/boilerplate-sample-matches/blob/main/Csharp/MudBlazor-MDEwOlJlcG9zaXRvcnkyODg0Mjg2NzY=-flat-BoundingClientRectTests.cs-NetCoreServer-MDEwOlJlcG9zaXRvcnkxNjYxMjMxNjQ=-flat-UdsClient.cs.html,0.03129890453834116,10,MudBlazor-MDEwOlJlcG9zaXRvcnkyODg0Mjg2NzY=-flat-BoundingClientRectTests.cs,NetCoreServer-MDEwOlJlcG9zaXRvcnkxNjYxMjMxNjQ=-flat-UdsClient.cs,27,33,6,59,68,9
252738,https://htmlpreview.github.io/?https://github.com/Christina96/boilerplate-sample-matches/blob/main/Csharp/20486D-DevelopingASPNETMVCWebApplications-MDEwOlJlcG9zaXRvcnkxMTkzNTI2Mzc=-flat-Program_459.cs-20486D-DevelopingASPNETMVCWebApplications-MDEwOlJlcG9zaXRvcnkxMTkzNTI2Mzc=-flat-Program_416.cs.html,1.0,12,20486D-DevelopingASPNETMVCWebApplications-MDEwOlJlcG9zaXRvcnkxMTkzNTI2Mzc=-flat-Program_459.cs,20486D-DevelopingASPNETMVCWebApplications-MDEwOlJlcG9zaXRvcnkxMTkzNTI2Mzc=-flat-Program_416.cs,1,22,21,1,22,21
254040,https://htmlpreview.github.io/?https://github.com/Christina96/boilerplate-sample-matches/blob/main/Csharp/runner-MDEwOlJlcG9zaXRvcnkxODQyODY4NzU=-flat-Definition.cs-NetCoreServer-MDEwOlJlcG9zaXRvcnkxNjYxMjMxNjQ=-flat-SslServer.cs.html,0.07538802660753881,17,runner-MDEwOlJlcG9zaXRvcnkxODQyODY4NzU=-flat-Definition.cs,NetCoreServer-MDEwOlJlcG9zaXRvcnkxNjYxMjMxNjQ=-flat-SslServer.cs,50,52,2,33,35,2
254942,https://htmlpreview.github.io/?https://github.com/Christina96/boilerplate-sample-matches/blob/main/Csharp/runner-MDEwOlJlcG9zaXRvcnkxODQyODY4NzU=-flat-VssHttpMessageHandlerTraceInfo.cs-npgsql-MDEwOlJlcG9zaXRvcnkyODgzNTc0-flat-NpgsqlParameterCollectionTests.cs.html,0.21120689655172414,21,runner-MDEwOlJlcG9zaXRvcnkxODQyODY4NzU=-flat-VssHttpMessageHandlerTraceInfo.cs,npgsql-MDEwOlJlcG9zaXRvcnkyODgzNTc0-flat-NpgsqlParameterCollectionTests.cs,13,15,2,240,242,2
256397,https://htmlpreview.github.io/?https://github.com/Christina96/boilerplate-sample-matches/blob/main/Csharp/Simple.Data-MDEwOlJlcG9zaXRvcnk4MTg3Njg=-flat-TransactionTest.cs-MudBlazor-MDEwOlJlcG9zaXRvcnkyODg0Mjg2NzY=-flat-FormTests.cs.html,0.11578541103820919,11,Simple.Data-MDEwOlJlcG9zaXRvcnk4MTg3Njg=-flat-TransactionTest.cs,MudBlazor-MDEwOlJlcG9zaXRvcnkyODg0Mjg2NzY=-flat-FormTests.cs,33,43,10,846,855,9
256435,https://htmlpreview.github.io/?https://github.com/Christina96/boilerplate-sample-matches/blob/main/Csharp/npgsql-MDEwOlJlcG9zaXRvcnkyODgzNTc0-flat-NpgsqlDataSource.cs-Security-MDEwOlJlcG9zaXRvcnkxNzcyMzY5OQ==-flat-RemoteAuthenticationOptions.cs.html,0.1925133689839572,18,npgsql-MDEwOlJlcG9zaXRvcnkyODgzNTc0-flat-NpgsqlDataSource.cs,Security-MDEwOlJlcG9zaXRvcnkxNzcyMzY5OQ==-flat-RemoteAuthenticationOptions.cs,27,29,2,40,42,2
257261,https://htmlpreview.github.io/?https://github.com/Christina96/boilerplate-sample-matches/blob/main/Csharp/20486D-DevelopingASPNETMVCWebApplications-MDEwOlJlcG9zaXRvcnkxMTkzNTI2Mzc=-flat-IceCreamContext_176.cs-runner-MDEwOlJlcG9zaXRvcnkxODQyODY4NzU=-flat-VssConnection.cs.html,0.05405405405405406,14,20486D-DevelopingASPNETMVCWebApplications-MDEwOlJlcG9zaXRvcnkxMTkzNTI2Mzc=-flat-IceCreamContext_176.cs,runner-MDEwOlJlcG9zaXRvcnkxODQyODY4NzU=-flat-VssConnection.cs,14,15,1,489,497,8
258061,https://htmlpreview.github.io/?https://github.com/Christina96/boilerplate-sample-matches/blob/main/Csharp/npgsql-MDEwOlJlcG9zaXRvcnkyODgzNTc0-flat-SecurityTests.cs-MudBlazor-MDEwOlJlcG9zaXRvcnkyODg0Mjg2NzY=-flat-BindingConverterTests.cs.html,0.03898635477582846,10,npgsql-MDEwOlJlcG9zaXRvcnkyODgzNTc0-flat-SecurityTests.cs,MudBlazor-MDEwOlJlcG9zaXRvcnkyODg0Mjg2NzY=-flat-BindingConverterTests.cs,383,389,6,112,115,3
258260,https://htmlpreview.github.io/?https://github.com/Christina96/boilerplate-sample-matches/blob/main/Csharp/20486D-DevelopingASPNETMVCWebApplications-MDEwOlJlcG9zaXRvcnkxMTkzNTI2Mzc=-flat-Program_459.cs-20486D-DevelopingASPNETMVCWebApplications-MDEwOlJlcG9zaXRvcnkxMTkzNTI2Mzc=-flat-Program_314.cs.html,1.0,12,20486D-DevelopingASPNETMVCWebApplications-MDEwOlJlcG9zaXRvcnkxMTkzNTI2Mzc=-flat-Program_459.cs,20486D-DevelopingASPNETMVCWebApplications-MDEwOlJlcG9zaXRvcnkxMTkzNTI2Mzc=-flat-Program_314.cs,1,22,21,1,22,21
258578,https://htmlpreview.github.io/?https://github.com/Christina96/boilerplate-sample-matches/blob/main/Csharp/MudBlazor-MDEwOlJlcG9zaXRvcnkyODg0Mjg2NzY=-flat-ToolTipTests.cs-npgsql-MDEwOlJlcG9zaXRvcnkyODgzNTc0-flat-TransactionTests.cs.html,0.20423183072677092,10,MudBlazor-MDEwOlJlcG9zaXRvcnkyODg0Mjg2NzY=-flat-ToolTipTests.cs,npgsql-MDEwOlJlcG9zaXRvcnkyODgzNTc0-flat-TransactionTests.cs,86,91,5,25,33,8
259063,https://htmlpreview.github.io/?https://github.com/Christina96/boilerplate-sample-matches/blob/main/Csharp/MudBlazor-MDEwOlJlcG9zaXRvcnkyODg0Mjg2NzY=-flat-LineChartTests.cs-NetCoreServer-MDEwOlJlcG9zaXRvcnkxNjYxMjMxNjQ=-flat-HttpsSession.cs.html,0.1414141414141414,14,MudBlazor-MDEwOlJlcG9zaXRvcnkyODg0Mjg2NzY=-flat-LineChartTests.cs,NetCoreServer-MDEwOlJlcG9zaXRvcnkxNjYxMjMxNjQ=-flat-HttpsSession.cs,47,57,10,16,29,13
261856,https://htmlpreview.github.io/?https://github.com/Christina96/boilerplate-sample-matches/blob/main/Csharp/20486D-DevelopingASPNETMVCWebApplications-MDEwOlJlcG9zaXRvcnkxMTkzNTI2Mzc=-flat-Shirt_375.cs-NetCoreServer-MDEwOlJlcG9zaXRvcnkxNjYxMjMxNjQ=-flat-UdpTests.cs.html,0.07220216606498195,10,20486D-DevelopingASPNETMVCWebApplications-MDEwOlJlcG9zaXRvcnkxMTkzNTI2Mzc=-flat-Shirt_375.cs,NetCoreServer-MDEwOlJlcG9zaXRvcnkxNjYxMjMxNjQ=-flat-UdpTests.cs,1,11,10,1,12,11
261973,https://htmlpreview.github.io/?https://github.com/Christina96/boilerplate-sample-matches/blob/main/Csharp/NetCoreServer-MDEwOlJlcG9zaXRvcnkxNjYxMjMxNjQ=-flat-Program_25.cs-MudBlazor-MDEwOlJlcG9zaXRvcnkyODg0Mjg2NzY=-flat-TreeViewTest.cs.html,0.0498960498960499,12,NetCoreServer-MDEwOlJlcG9zaXRvcnkxNjYxMjMxNjQ=-flat-Program_25.cs,MudBlazor-MDEwOlJlcG9zaXRvcnkyODg0Mjg2NzY=-flat-TreeViewTest.cs,98,105,7,132,136,4
263327,https://htmlpreview.github.io/?https://github.com/Christina96/boilerplate-sample-matches/blob/main/Csharp/MudBlazor-MDEwOlJlcG9zaXRvcnkyODg0Mjg2NzY=-flat-WebUnitsExtensionsTests.cs-NetCoreServer-MDEwOlJlcG9zaXRvcnkxNjYxMjMxNjQ=-flat-Program_47.cs.html,0.11627906976744186,10,MudBlazor-MDEwOlJlcG9zaXRvcnkyODg0Mjg2NzY=-flat-WebUnitsExtensionsTests.cs,NetCoreServer-MDEwOlJlcG9zaXRvcnkxNjYxMjMxNjQ=-flat-Program_47.cs,11,14,3,13,22,9
267415,https://htmlpreview.github.io/?https://github.com/Christina96/boilerplate-sample-matches/blob/main/Csharp/dotween-MDEwOlJlcG9zaXRvcnkzMjQ3NTE2Mg==-flat-GoEaseSinusoidal.cs-Simple.Data-MDEwOlJlcG9zaXRvcnk4MTg3Njg=-flat-OptimizedDictionaryIndex.cs.html,0.4166666666666667,10,dotween-MDEwOlJlcG9zaXRvcnkzMjQ3NTE2Mg==-flat-GoEaseSinusoidal.cs,Simple.Data-MDEwOlJlcG9zaXRvcnk4MTg3Njg=-flat-OptimizedDictionaryIndex.cs,8,17,9,29,38,9
267735,https://htmlpreview.github.io/?https://github.com/Christina96/boilerplate-sample-matches/blob/main/Csharp/Security-MDEwOlJlcG9zaXRvcnkxNzcyMzY5OQ==-flat-DeleteCookieContext.cs-runner-MDEwOlJlcG9zaXRvcnkxODQyODY4NzU=-flat-AgentJobRequestMessage.cs.html,0.08888888888888889,10,Security-MDEwOlJlcG9zaXRvcnkxNzcyMzY5OQ==-flat-DeleteCookieContext.cs,runner-MDEwOlJlcG9zaXRvcnkxODQyODY4NzU=-flat-AgentJobRequestMessage.cs,14,15,1,158,166,8
268170,https://htmlpreview.github.io/?https://github.com/Christina96/boilerplate-sample-matches/blob/main/Csharp/Security-MDEwOlJlcG9zaXRvcnkxNzcyMzY5OQ==-flat-WsFederationTest.cs-NetCoreServer-MDEwOlJlcG9zaXRvcnkxNjYxMjMxNjQ=-flat-SslTests.cs.html,0.02447980416156671,10,Security-MDEwOlJlcG9zaXRvcnkxNzcyMzY5OQ==-flat-WsFederationTest.cs,NetCoreServer-MDEwOlJlcG9zaXRvcnkxNjYxMjMxNjQ=-flat-SslTests.cs,322,343,21,88,97,9
268389,https://htmlpreview.github.io/?https://github.com/Christina96/boilerplate-sample-matches/blob/main/Csharp/Security-MDEwOlJlcG9zaXRvcnkxNzcyMzY5OQ==-flat-TicketSerializerTests.cs-Security-MDEwOlJlcG9zaXRvcnkxNzcyMzY5OQ==-flat-OpenIdConnectEventTests.cs.html,0.03514132925897632,11,Security-MDEwOlJlcG9zaXRvcnkxNzcyMzY5OQ==-flat-TicketSerializerTests.cs,Security-MDEwOlJlcG9zaXRvcnkxNzcyMzY5OQ==-flat-OpenIdConnectEventTests.cs,25,35,10,887,899,12
268924,https://htmlpreview.github.io/?https://github.com/Christina96/boilerplate-sample-matches/blob/main/Csharp/runner-MDEwOlJlcG9zaXRvcnkxODQyODY4NzU=-flat-IPatchOperation.cs-npgsql-MDEwOlJlcG9zaXRvcnkyODgzNTc0-flat-PgOutputReplicationOptions.cs.html,0.39097744360902253,26,runner-MDEwOlJlcG9zaXRvcnkxODQyODY4NzU=-flat-IPatchOperation.cs,npgsql-MDEwOlJlcG9zaXRvcnkyODgzNTc0-flat-PgOutputReplicationOptions.cs,6,11,5,28,34,6
269399,https://htmlpreview.github.io/?https://github.com/Christina96/boilerplate-sample-matches/blob/main/Csharp/MudBlazor-MDEwOlJlcG9zaXRvcnkyODg0Mjg2NzY=-flat-MudBaseBindableItemsControl.cs-dotween-MDEwOlJlcG9zaXRvcnkzMjQ3NTE2Mg==-flat-GoSpline.cs.html,0.10377358490566038,11,MudBlazor-MDEwOlJlcG9zaXRvcnkyODg0Mjg2NzY=-flat-MudBaseBindableItemsControl.cs,dotween-MDEwOlJlcG9zaXRvcnkzMjQ3NTE2Mg==-flat-GoSpline.cs,14,17,3,7,8,1
272117,https://htmlpreview.github.io/?https://github.com/Christina96/boilerplate-sample-matches/blob/main/Csharp/20486D-DevelopingASPNETMVCWebApplications-MDEwOlJlcG9zaXRvcnkxMTkzNTI2Mzc=-flat-Program_195.cs-20486D-DevelopingASPNETMVCWebApplications-MDEwOlJlcG9zaXRvcnkxMTkzNTI2Mzc=-flat-Program_152.cs.html,1.0,12,20486D-DevelopingASPNETMVCWebApplications-MDEwOlJlcG9zaXRvcnkxMTkzNTI2Mzc=-flat-Program_195.cs,20486D-DevelopingASPNETMVCWebApplications-MDEwOlJlcG9zaXRvcnkxMTkzNTI2Mzc=-flat-Program_152.cs,1,22,21,1,22,21
272385,https://htmlpreview.github.io/?https://github.com/Christina96/boilerplate-sample-matches/blob/main/Csharp/MudBlazor-MDEwOlJlcG9zaXRvcnkyODg0Mjg2NzY=-flat-TreeViewTest.cs-MudBlazor-MDEwOlJlcG9zaXRvcnkyODg0Mjg2NzY=-flat-DialogTests.cs.html,0.4218958611481976,32,MudBlazor-MDEwOlJlcG9zaXRvcnkyODg0Mjg2NzY=-flat-TreeViewTest.cs,MudBlazor-MDEwOlJlcG9zaXRvcnkyODg0Mjg2NzY=-flat-DialogTests.cs,52,67,15,131,146,15
272868,https://htmlpreview.github.io/?https://github.com/Christina96/boilerplate-sample-matches/blob/main/Csharp/Simple.Data-MDEwOlJlcG9zaXRvcnk4MTg3Njg=-flat-SchemaQualifiedTests.cs-runner-MDEwOlJlcG9zaXRvcnkxODQyODY4NzU=-flat-CommandLineParserL0.cs.html,0.13513513513513514,10,Simple.Data-MDEwOlJlcG9zaXRvcnk4MTg3Njg=-flat-SchemaQualifiedTests.cs,runner-MDEwOlJlcG9zaXRvcnkxODQyODY4NzU=-flat-CommandLineParserL0.cs,38,46,8,52,61,9
274387,https://htmlpreview.github.io/?https://github.com/Christina96/boilerplate-sample-matches/blob/main/Csharp/20486D-DevelopingASPNETMVCWebApplications-MDEwOlJlcG9zaXRvcnkxMTkzNTI2Mzc=-flat-ICounter_358.cs-ZXing.Net.Mobile-MDEwOlJlcG9zaXRvcnk2MTYwNjcz-flat-IMobileBarcodeScanner.shared.cs.html,0.11518324607329843,11,20486D-DevelopingASPNETMVCWebApplications-MDEwOlJlcG9zaXRvcnkxMTkzNTI2Mzc=-flat-ICounter_358.cs,ZXing.Net.Mobile-MDEwOlJlcG9zaXRvcnk2MTYwNjcz-flat-IMobileBarcodeScanner.shared.cs,1,9,8,1,8,7
274593,https://htmlpreview.github.io/?https://github.com/Christina96/boilerplate-sample-matches/blob/main/Csharp/MudBlazor-MDEwOlJlcG9zaXRvcnkyODg0Mjg2NzY=-flat-RegexMaskIPv6Tests.cs-MudBlazor-MDEwOlJlcG9zaXRvcnkyODg0Mjg2NzY=-flat-PopoverTests.cs.html,0.2509448223733938,17,MudBlazor-MDEwOlJlcG9zaXRvcnkyODg0Mjg2NzY=-flat-RegexMaskIPv6Tests.cs,MudBlazor-MDEwOlJlcG9zaXRvcnkyODg0Mjg2NzY=-flat-PopoverTests.cs,124,134,10,64,76,12
275630,https://htmlpreview.github.io/?https://github.com/Christina96/boilerplate-sample-matches/blob/main/Csharp/Security-MDEwOlJlcG9zaXRvcnkxNzcyMzY5OQ==-flat-OAuthTokenResponse.cs-NetCoreServer-MDEwOlJlcG9zaXRvcnkxNjYxMjMxNjQ=-flat-TcpSession.cs.html,0.14659685863874344,42,Security-MDEwOlJlcG9zaXRvcnkxNzcyMzY5OQ==-flat-OAuthTokenResponse.cs,NetCoreServer-MDEwOlJlcG9zaXRvcnkxNjYxMjMxNjQ=-flat-TcpSession.cs,27,32,5,18,23,5
277436,https://htmlpreview.github.io/?https://github.com/Christina96/boilerplate-sample-matches/blob/main/Csharp/20486D-DevelopingASPNETMVCWebApplications-MDEwOlJlcG9zaXRvcnkxMTkzNTI2Mzc=-flat-ICupcakeRepository.cs-MudBlazor-MDEwOlJlcG9zaXRvcnkyODg0Mjg2NzY=-flat-IResizeObserver.cs.html,0.7,14,20486D-DevelopingASPNETMVCWebApplications-MDEwOlJlcG9zaXRvcnkxMTkzNTI2Mzc=-flat-ICupcakeRepository.cs,MudBlazor-MDEwOlJlcG9zaXRvcnkyODg0Mjg2NzY=-flat-IResizeObserver.cs,8,15,7,9,16,7
277560,https://htmlpreview.github.io/?https://github.com/Christina96/boilerplate-sample-matches/blob/main/Csharp/Simple.Data-MDEwOlJlcG9zaXRvcnk4MTg3Njg=-flat-CastTask.cs-runner-MDEwOlJlcG9zaXRvcnkxODQyODY4NzU=-flat-VssHttpMessageHandlerTraceInfo.cs.html,0.358974358974359,28,Simple.Data-MDEwOlJlcG9zaXRvcnk4MTg3Njg=-flat-CastTask.cs,runner-MDEwOlJlcG9zaXRvcnkxODQyODY4NzU=-flat-VssHttpMessageHandlerTraceInfo.cs,22,25,3,9,12,3
279147,https://htmlpreview.github.io/?https://github.com/Christina96/boilerplate-sample-matches/blob/main/Csharp/dotween-MDEwOlJlcG9zaXRvcnkzMjQ3NTE2Mg==-flat-InvertedTweens.cs-runner-MDEwOlJlcG9zaXRvcnkxODQyODY4NzU=-flat-VssHttpClientBase.cs.html,0.02079002079002079,10,dotween-MDEwOlJlcG9zaXRvcnkzMjQ3NTE2Mg==-flat-InvertedTweens.cs,runner-MDEwOlJlcG9zaXRvcnkxODQyODY4NzU=-flat-VssHttpClientBase.cs,62,70,8,403,431,28
279262,https://htmlpreview.github.io/?https://github.com/Christina96/boilerplate-sample-matches/blob/main/Csharp/20486D-DevelopingASPNETMVCWebApplications-MDEwOlJlcG9zaXRvcnkxMTkzNTI2Mzc=-flat-CustomersProducts.cs-Simple.Data-MDEwOlJlcG9zaXRvcnk4MTg3Njg=-flat-MockDbCommand.cs.html,0.42105263157894735,11,20486D-DevelopingASPNETMVCWebApplications-MDEwOlJlcG9zaXRvcnkxMTkzNTI2Mzc=-flat-CustomersProducts.cs,Simple.Data-MDEwOlJlcG9zaXRvcnk4MTg3Njg=-flat-MockDbCommand.cs,11,12,1,53,54,1
280436,https://htmlpreview.github.io/?https://github.com/Christina96/boilerplate-sample-matches/blob/main/Csharp/NetCoreServer-MDEwOlJlcG9zaXRvcnkxNjYxMjMxNjQ=-flat-Program_29.cs-Simple.Data-MDEwOlJlcG9zaXRvcnk4MTg3Njg=-flat-BulkInsertTest.cs.html,0.07006369426751592,11,NetCoreServer-MDEwOlJlcG9zaXRvcnkxNjYxMjMxNjQ=-flat-Program_29.cs,Simple.Data-MDEwOlJlcG9zaXRvcnk4MTg3Njg=-flat-BulkInsertTest.cs,140,148,8,21,29,8
285155,https://htmlpreview.github.io/?https://github.com/Christina96/boilerplate-sample-matches/blob/main/Csharp/dotween-MDEwOlJlcG9zaXRvcnkzMjQ3NTE2Mg==-flat-Sequences_27.cs-MudBlazor-MDEwOlJlcG9zaXRvcnkyODg0Mjg2NzY=-flat-PopoverTests.cs.html,0.18570254724732949,25,dotween-MDEwOlJlcG9zaXRvcnkzMjQ3NTE2Mg==-flat-Sequences_27.cs,MudBlazor-MDEwOlJlcG9zaXRvcnkyODg0Mjg2NzY=-flat-PopoverTests.cs,53,61,8,733,747,14
285480,https://htmlpreview.github.io/?https://github.com/Christina96/boilerplate-sample-matches/blob/main/Csharp/runner-MDEwOlJlcG9zaXRvcnkxODQyODY4NzU=-flat-JobResources.cs-dotween-MDEwOlJlcG9zaXRvcnkzMjQ3NTE2Mg==-flat-Sequence.cs.html,0.046242774566473986,12,runner-MDEwOlJlcG9zaXRvcnkxODQyODY4NzU=-flat-JobResources.cs,dotween-MDEwOlJlcG9zaXRvcnkzMjQ3NTE2Mg==-flat-Sequence.cs,47,58,11,243,245,2
286589,https://htmlpreview.github.io/?https://github.com/Christina96/boilerplate-sample-matches/blob/main/Csharp/20486D-DevelopingASPNETMVCWebApplications-MDEwOlJlcG9zaXRvcnkxMTkzNTI2Mzc=-flat-Startup_0.cs-MudBlazor-MDEwOlJlcG9zaXRvcnkyODg0Mjg2NzY=-flat-ServiceCollectionExtensions.cs.html,0.12941176470588237,11,20486D-DevelopingASPNETMVCWebApplications-MDEwOlJlcG9zaXRvcnkxMTkzNTI2Mzc=-flat-Startup_0.cs,MudBlazor-MDEwOlJlcG9zaXRvcnkyODg0Mjg2NzY=-flat-ServiceCollectionExtensions.cs,24,43,19,162,172,10
287762,https://htmlpreview.github.io/?https://github.com/Christina96/boilerplate-sample-matches/blob/main/Csharp/20486D-DevelopingASPNETMVCWebApplications-MDEwOlJlcG9zaXRvcnkxMTkzNTI2Mzc=-flat-Person_122.cs-Security-MDEwOlJlcG9zaXRvcnkxNzcyMzY5OQ==-flat-DeleteCookieContext.cs.html,0.5054945054945055,23,20486D-DevelopingASPNETMVCWebApplications-MDEwOlJlcG9zaXRvcnkxMTkzNTI2Mzc=-flat-Person_122.cs,Security-MDEwOlJlcG9zaXRvcnkxNzcyMzY5OQ==-flat-DeleteCookieContext.cs,14,18,4,15,19,4
287923,https://htmlpreview.github.io/?https://github.com/Christina96/boilerplate-sample-matches/blob/main/Csharp/dotween-MDEwOlJlcG9zaXRvcnkzMjQ3NTE2Mg==-flat-DOTweenModuleUnityVersion.cs-dotween-MDEwOlJlcG9zaXRvcnkzMjQ3NTE2Mg==-flat-TweenExtensions.cs.html,0.2168284789644013,11,dotween-MDEwOlJlcG9zaXRvcnkzMjQ3NTE2Mg==-flat-DOTweenModuleUnityVersion.cs,dotween-MDEwOlJlcG9zaXRvcnkzMjQ3NTE2Mg==-flat-TweenExtensions.cs,80,87,7,226,233,7
288302,https://htmlpreview.github.io/?https://github.com/Christina96/boilerplate-sample-matches/blob/main/Csharp/runner-MDEwOlJlcG9zaXRvcnkxODQyODY4NzU=-flat-PipelineDirectoryManagerL0.cs-Security-MDEwOlJlcG9zaXRvcnkxNzcyMzY5OQ==-flat-SharedAuthenticationTests.cs.html,0.10101010101010101,12,runner-MDEwOlJlcG9zaXRvcnkxODQyODY4NzU=-flat-PipelineDirectoryManagerL0.cs,Security-MDEwOlJlcG9zaXRvcnkxNzcyMzY5OQ==-flat-SharedAuthenticationTests.cs,111,118,7,195,206,11
289239,https://htmlpreview.github.io/?https://github.com/Christina96/boilerplate-sample-matches/blob/main/Csharp/20486D-DevelopingASPNETMVCWebApplications-MDEwOlJlcG9zaXRvcnkxMTkzNTI2Mzc=-flat-Startup_151.cs-20486D-DevelopingASPNETMVCWebApplications-MDEwOlJlcG9zaXRvcnkxMTkzNTI2Mzc=-flat-Startup_26.cs.html,0.5116279069767442,11,20486D-DevelopingASPNETMVCWebApplications-MDEwOlJlcG9zaXRvcnkxMTkzNTI2Mzc=-flat-Startup_151.cs,20486D-DevelopingASPNETMVCWebApplications-MDEwOlJlcG9zaXRvcnkxMTkzNTI2Mzc=-flat-Startup_26.cs,18,30,12,22,34,12
289421,https://htmlpreview.github.io/?https://github.com/Christina96/boilerplate-sample-matches/blob/main/Csharp/runner-MDEwOlJlcG9zaXRvcnkxODQyODY4NzU=-flat-HandlerFactoryL0.cs-MudBlazor-MDEwOlJlcG9zaXRvcnkyODg0Mjg2NzY=-flat-ImageTests.cs.html,0.12359550561797752,11,runner-MDEwOlJlcG9zaXRvcnkxODQyODY4NzU=-flat-HandlerFactoryL0.cs,MudBlazor-MDEwOlJlcG9zaXRvcnkyODg0Mjg2NzY=-flat-ImageTests.cs,25,35,10,62,72,10
290140,https://htmlpreview.github.io/?https://github.com/Christina96/boilerplate-sample-matches/blob/main/Csharp/Security-MDEwOlJlcG9zaXRvcnkxNzcyMzY5OQ==-flat-TokenExtensionTests.cs-MudBlazor-MDEwOlJlcG9zaXRvcnkyODg0Mjg2NzY=-flat-BlockMaskTests.cs.html,0.24404761904761904,13,Security-MDEwOlJlcG9zaXRvcnkxNzcyMzY5OQ==-flat-TokenExtensionTests.cs,MudBlazor-MDEwOlJlcG9zaXRvcnkyODg0Mjg2NzY=-flat-BlockMaskTests.cs,93,103,10,116,122,6
290688,https://htmlpreview.github.io/?https://github.com/Christina96/boilerplate-sample-matches/blob/main/Csharp/npgsql-MDEwOlJlcG9zaXRvcnkyODgzNTc0-flat-TransactionTests.cs-MudBlazor-MDEwOlJlcG9zaXRvcnkyODg0Mjg2NzY=-flat-TableTests.cs.html,0.19075482738443533,11,npgsql-MDEwOlJlcG9zaXRvcnkyODgzNTc0-flat-TransactionTests.cs,MudBlazor-MDEwOlJlcG9zaXRvcnkyODg0Mjg2NzY=-flat-TableTests.cs,230,237,7,248,255,7
290843,https://htmlpreview.github.io/?https://github.com/Christina96/boilerplate-sample-matches/blob/main/Csharp/EarTrumpet-MDEwOlJlcG9zaXRvcnkzODkxOTcwMg==-flat-IAudioDeviceSessionComparer.cs-runner-MDEwOlJlcG9zaXRvcnkxODQyODY4NzU=-flat-PipelineStrings.g.cs.html,0.625,10,EarTrumpet-MDEwOlJlcG9zaXRvcnkzODkxOTcwMg==-flat-IAudioDeviceSessionComparer.cs,runner-MDEwOlJlcG9zaXRvcnkxODQyODY4NzU=-flat-PipelineStrings.g.cs,8,16,8,12,22,10
291087,https://htmlpreview.github.io/?https://github.com/Christina96/boilerplate-sample-matches/blob/main/Csharp/runner-MDEwOlJlcG9zaXRvcnkxODQyODY4NzU=-flat-RunnerJobRequestRef.cs-runner-MDEwOlJlcG9zaXRvcnkxODQyODY4NzU=-flat-ActionDownloadInfo.cs.html,0.5040650406504065,31,runner-MDEwOlJlcG9zaXRvcnkxODQyODY4NzU=-flat-RunnerJobRequestRef.cs,runner-MDEwOlJlcG9zaXRvcnkxODQyODY4NzU=-flat-ActionDownloadInfo.cs,1,12,11,1,13,12
293373,https://htmlpreview.github.io/?https://github.com/Christina96/boilerplate-sample-matches/blob/main/Csharp/Security-MDEwOlJlcG9zaXRvcnkxNzcyMzY5OQ==-flat-Program_9.cs-runner-MDEwOlJlcG9zaXRvcnkxODQyODY4NzU=-flat-IOUtil.cs.html,0.05361930294906166,10,Security-MDEwOlJlcG9zaXRvcnkxNzcyMzY5OQ==-flat-Program_9.cs,runner-MDEwOlJlcG9zaXRvcnkxODQyODY4NzU=-flat-IOUtil.cs,13,22,9,175,184,9
293485,https://htmlpreview.github.io/?https://github.com/Christina96/boilerplate-sample-matches/blob/main/Csharp/NetCoreServer-MDEwOlJlcG9zaXRvcnkxNjYxMjMxNjQ=-flat-Program_16.cs-NetCoreServer-MDEwOlJlcG9zaXRvcnkxNjYxMjMxNjQ=-flat-Program_11.cs.html,0.28888888888888886,15,NetCoreServer-MDEwOlJlcG9zaXRvcnkxNjYxMjMxNjQ=-flat-Program_16.cs,NetCoreServer-MDEwOlJlcG9zaXRvcnkxNjYxMjMxNjQ=-flat-Program_11.cs,59,70,11,73,84,11
293958,https://htmlpreview.github.io/?https://github.com/Christina96/boilerplate-sample-matches/blob/main/Csharp/Security-MDEwOlJlcG9zaXRvcnkxNzcyMzY5OQ==-flat-OAuthTests.cs-MudBlazor-MDEwOlJlcG9zaXRvcnkyODg0Mjg2NzY=-flat-CarouselTests.cs.html,0.09863013698630137,10,Security-MDEwOlJlcG9zaXRvcnkxNzcyMzY5OQ==-flat-OAuthTests.cs,MudBlazor-MDEwOlJlcG9zaXRvcnkyODg0Mjg2NzY=-flat-CarouselTests.cs,22,32,10,185,196,11
294518,https://htmlpreview.github.io/?https://github.com/Christina96/boilerplate-sample-matches/blob/main/Csharp/Security-MDEwOlJlcG9zaXRvcnkxNzcyMzY5OQ==-flat-PolicyAuthorizationResult.cs-runner-MDEwOlJlcG9zaXRvcnkxODQyODY4NzU=-flat-CredentialProvider.cs.html,0.20618556701030927,10,Security-MDEwOlJlcG9zaXRvcnkxNzcyMzY5OQ==-flat-PolicyAuthorizationResult.cs,runner-MDEwOlJlcG9zaXRvcnkxODQyODY4NzU=-flat-CredentialProvider.cs,6,7,1,10,11,1
294803,https://htmlpreview.github.io/?https://github.com/Christina96/boilerplate-sample-matches/blob/main/Csharp/20486D-DevelopingASPNETMVCWebApplications-MDEwOlJlcG9zaXRvcnkxMTkzNTI2Mzc=-flat-Program_109.cs-20486D-DevelopingASPNETMVCWebApplications-MDEwOlJlcG9zaXRvcnkxMTkzNTI2Mzc=-flat-Program_332.cs.html,1.0,12,20486D-DevelopingASPNETMVCWebApplications-MDEwOlJlcG9zaXRvcnkxMTkzNTI2Mzc=-flat-Program_109.cs,20486D-DevelopingASPNETMVCWebApplications-MDEwOlJlcG9zaXRvcnkxMTkzNTI2Mzc=-flat-Program_332.cs,1,22,21,1,24,23
294890,https://htmlpreview.github.io/?https://github.com/Christina96/boilerplate-sample-matches/blob/main/Csharp/MudBlazor-MDEwOlJlcG9zaXRvcnkyODg0Mjg2NzY=-flat-BlockMaskTests.cs-MudBlazor-MDEwOlJlcG9zaXRvcnkyODg0Mjg2NzY=-flat-TimePickerTests.cs.html,0.18879508825786645,11,MudBlazor-MDEwOlJlcG9zaXRvcnkyODg0Mjg2NzY=-flat-BlockMaskTests.cs,MudBlazor-MDEwOlJlcG9zaXRvcnkyODg0Mjg2NzY=-flat-TimePickerTests.cs,51,56,5,265,270,5
295168,https://htmlpreview.github.io/?https://github.com/Christina96/boilerplate-sample-matches/blob/main/Csharp/runner-MDEwOlJlcG9zaXRvcnkxODQyODY4NzU=-flat-RunnerGroup.cs-20486D-DevelopingASPNETMVCWebApplications-MDEwOlJlcG9zaXRvcnkxMTkzNTI2Mzc=-flat-Product_33.cs.html,0.6144578313253012,18,runner-MDEwOlJlcG9zaXRvcnkxODQyODY4NzU=-flat-RunnerGroup.cs,20486D-DevelopingASPNETMVCWebApplications-MDEwOlJlcG9zaXRvcnkxMTkzNTI2Mzc=-flat-Product_33.cs,29,41,12,22,26,4
296063,https://htmlpreview.github.io/?https://github.com/Christina96/boilerplate-sample-matches/blob/main/Csharp/MudBlazor-MDEwOlJlcG9zaXRvcnkyODg0Mjg2NzY=-flat-TableRowClickEventArgs.cs-runner-MDEwOlJlcG9zaXRvcnkxODQyODY4NzU=-flat-ICheckExtension.cs.html,0.5411764705882353,23,MudBlazor-MDEwOlJlcG9zaXRvcnkyODg0Mjg2NzY=-flat-TableRowClickEventArgs.cs,runner-MDEwOlJlcG9zaXRvcnkxODQyODY4NzU=-flat-ICheckExtension.cs,7,11,4,21,25,4
296496,https://htmlpreview.github.io/?https://github.com/Christina96/boilerplate-sample-matches/blob/main/Csharp/runner-MDEwOlJlcG9zaXRvcnkxODQyODY4NzU=-flat-VssApiResourceLocation.cs-MudBlazor-MDEwOlJlcG9zaXRvcnkyODg0Mjg2NzY=-flat-GitHubReleases.cs.html,0.21145374449339208,33,runner-MDEwOlJlcG9zaXRvcnkxODQyODY4NzU=-flat-VssApiResourceLocation.cs,MudBlazor-MDEwOlJlcG9zaXRvcnkyODg0Mjg2NzY=-flat-GitHubReleases.cs,10,18,8,6,14,8
296749,https://htmlpreview.github.io/?https://github.com/Christina96/boilerplate-sample-matches/blob/main/Csharp/runner-MDEwOlJlcG9zaXRvcnkxODQyODY4NzU=-flat-CredentialData.cs-runner-MDEwOlJlcG9zaXRvcnkxODQyODY4NzU=-flat-ThrottlingReportHandler.cs.html,0.23529411764705882,10,runner-MDEwOlJlcG9zaXRvcnkxODQyODY4NzU=-flat-CredentialData.cs,runner-MDEwOlJlcG9zaXRvcnkxODQyODY4NzU=-flat-ThrottlingReportHandler.cs,7,11,4,18,19,1
297703,https://htmlpreview.github.io/?https://github.com/Christina96/boilerplate-sample-matches/blob/main/Csharp/NetCoreServer-MDEwOlJlcG9zaXRvcnkxNjYxMjMxNjQ=-flat-Program_31.cs-runner-MDEwOlJlcG9zaXRvcnkxODQyODY4NzU=-flat-StepsRunnerL0.cs.html,0.024067388688327317,10,NetCoreServer-MDEwOlJlcG9zaXRvcnkxNjYxMjMxNjQ=-flat-Program_31.cs,runner-MDEwOlJlcG9zaXRvcnkxODQyODY4NzU=-flat-StepsRunnerL0.cs,114,119,5,494,499,5
298735,https://htmlpreview.github.io/?https://github.com/Christina96/boilerplate-sample-matches/blob/main/Csharp/Security-MDEwOlJlcG9zaXRvcnkxNzcyMzY5OQ==-flat-Startup_2.cs-MudBlazor-MDEwOlJlcG9zaXRvcnkyODg0Mjg2NzY=-flat-RatingTests.cs.html,0.09090909090909091,14,Security-MDEwOlJlcG9zaXRvcnkxNzcyMzY5OQ==-flat-Startup_2.cs,MudBlazor-MDEwOlJlcG9zaXRvcnkyODg0Mjg2NzY=-flat-RatingTests.cs,78,91,13,18,27,9
299346,https://htmlpreview.github.io/?https://github.com/Christina96/boilerplate-sample-matches/blob/main/Csharp/20486D-DevelopingASPNETMVCWebApplications-MDEwOlJlcG9zaXRvcnkxMTkzNTI2Mzc=-flat-Program_140.cs-20486D-DevelopingASPNETMVCWebApplications-MDEwOlJlcG9zaXRvcnkxMTkzNTI2Mzc=-flat-Program.cs.html,1.0,12,20486D-DevelopingASPNETMVCWebApplications-MDEwOlJlcG9zaXRvcnkxMTkzNTI2Mzc=-flat-Program_140.cs,20486D-DevelopingASPNETMVCWebApplications-MDEwOlJlcG9zaXRvcnkxMTkzNTI2Mzc=-flat-Program.cs,1,22,21,1,22,21
300125,https://htmlpreview.github.io/?https://github.com/Christina96/boilerplate-sample-matches/blob/main/Csharp/MudBlazor-MDEwOlJlcG9zaXRvcnkyODg0Mjg2NzY=-flat-DatePickerTests.cs-MudBlazor-MDEwOlJlcG9zaXRvcnkyODg0Mjg2NzY=-flat-FormTests.cs.html,0.4336569579288026,20,MudBlazor-MDEwOlJlcG9zaXRvcnkyODg0Mjg2NzY=-flat-DatePickerTests.cs,MudBlazor-MDEwOlJlcG9zaXRvcnkyODg0Mjg2NzY=-flat-FormTests.cs,435,445,10,218,232,14
303142,https://htmlpreview.github.io/?https://github.com/Christina96/boilerplate-sample-matches/blob/main/Csharp/20486D-DevelopingASPNETMVCWebApplications-MDEwOlJlcG9zaXRvcnkxMTkzNTI2Mzc=-flat-Bakery.cs-runner-MDEwOlJlcG9zaXRvcnkxODQyODY4NzU=-flat-Attributes.cs.html,0.23809523809523808,15,20486D-DevelopingASPNETMVCWebApplications-MDEwOlJlcG9zaXRvcnkxMTkzNTI2Mzc=-flat-Bakery.cs,runner-MDEwOlJlcG9zaXRvcnkxODQyODY4NzU=-flat-Attributes.cs,16,18,2,42,45,3
303488,https://htmlpreview.github.io/?https://github.com/Christina96/boilerplate-sample-matches/blob/main/Csharp/npgsql-MDEwOlJlcG9zaXRvcnkyODgzNTc0-flat-NestedDataReaderTests.cs-MudBlazor-MDEwOlJlcG9zaXRvcnkyODg0Mjg2NzY=-flat-ProgressLinearTests.cs.html,0.23434991974317818,24,npgsql-MDEwOlJlcG9zaXRvcnkyODgzNTc0-flat-NestedDataReaderTests.cs,MudBlazor-MDEwOlJlcG9zaXRvcnkyODg0Mjg2NzY=-flat-ProgressLinearTests.cs,48,66,18,17,29,12
303819,https://htmlpreview.github.io/?https://github.com/Christina96/boilerplate-sample-matches/blob/main/Csharp/Security-MDEwOlJlcG9zaXRvcnkxNzcyMzY5OQ==-flat-AccessToken.cs-runner-MDEwOlJlcG9zaXRvcnkxODQyODY4NzU=-flat-PatchOperationApplyingEventArgs.cs.html,0.8,16,Security-MDEwOlJlcG9zaXRvcnkxNzcyMzY5OQ==-flat-AccessToken.cs,runner-MDEwOlJlcG9zaXRvcnkxODQyODY4NzU=-flat-PatchOperationApplyingEventArgs.cs,5,8,3,11,14,3
306143,https://htmlpreview.github.io/?https://github.com/Christina96/boilerplate-sample-matches/blob/main/Csharp/Security-MDEwOlJlcG9zaXRvcnkxNzcyMzY5OQ==-flat-AccessDeniedContext.cs-ZXing.Net.Mobile-MDEwOlJlcG9zaXRvcnk2MTYwNjcz-flat-MobileBarcodeScanner.tizen.cs.html,0.2916666666666667,14,Security-MDEwOlJlcG9zaXRvcnkxNzcyMzY5OQ==-flat-AccessDeniedContext.cs,ZXing.Net.Mobile-MDEwOlJlcG9zaXRvcnk2MTYwNjcz-flat-MobileBarcodeScanner.tizen.cs,13,14,1,10,11,1
307173,https://htmlpreview.github.io/?https://github.com/Christina96/boilerplate-sample-matches/blob/main/Csharp/MudBlazor-MDEwOlJlcG9zaXRvcnkyODg0Mjg2NzY=-flat-MudMenuItem.razor.cs-runner-MDEwOlJlcG9zaXRvcnkxODQyODY4NzU=-flat-PackageMetadata.cs.html,0.3541666666666667,10,MudBlazor-MDEwOlJlcG9zaXRvcnkyODg0Mjg2NzY=-flat-MudMenuItem.razor.cs,runner-MDEwOlJlcG9zaXRvcnkxODQyODY4NzU=-flat-PackageMetadata.cs,9,11,2,9,16,7
308045,https://htmlpreview.github.io/?https://github.com/Christina96/boilerplate-sample-matches/blob/main/Csharp/npgsql-MDEwOlJlcG9zaXRvcnkyODgzNTc0-flat-AutoPrepareTests.cs-runner-MDEwOlJlcG9zaXRvcnkxODQyODY4NzU=-flat-ActionManifestManagerL0.cs.html,0.1478537360890302,12,npgsql-MDEwOlJlcG9zaXRvcnkyODgzNTc0-flat-AutoPrepareTests.cs,runner-MDEwOlJlcG9zaXRvcnkxODQyODY4NzU=-flat-ActionManifestManagerL0.cs,402,407,5,107,115,8
308049,https://htmlpreview.github.io/?https://github.com/Christina96/boilerplate-sample-matches/blob/main/Csharp/MudBlazor-MDEwOlJlcG9zaXRvcnkyODg0Mjg2NzY=-flat-BrowserWindowSize.cs-20486D-DevelopingASPNETMVCWebApplications-MDEwOlJlcG9zaXRvcnkxMTkzNTI2Mzc=-flat-Customer_167.cs.html,0.3595505617977528,16,MudBlazor-MDEwOlJlcG9zaXRvcnkyODg0Mjg2NzY=-flat-BrowserWindowSize.cs,20486D-DevelopingASPNETMVCWebApplications-MDEwOlJlcG9zaXRvcnkxMTkzNTI2Mzc=-flat-Customer_167.cs,6,9,3,23,26,3
308062,https://htmlpreview.github.io/?https://github.com/Christina96/boilerplate-sample-matches/blob/main/Csharp/MudBlazor-MDEwOlJlcG9zaXRvcnkyODg0Mjg2NzY=-flat-ToggleIconButtonTest.cs-npgsql-MDEwOlJlcG9zaXRvcnkyODgzNTc0-flat-CopyTests.cs.html,0.09113504556752279,10,MudBlazor-MDEwOlJlcG9zaXRvcnkyODg0Mjg2NzY=-flat-ToggleIconButtonTest.cs,npgsql-MDEwOlJlcG9zaXRvcnkyODgzNTc0-flat-CopyTests.cs,12,21,9,774,784,10
308952,https://htmlpreview.github.io/?https://github.com/Christina96/boilerplate-sample-matches/blob/main/Csharp/20486D-DevelopingASPNETMVCWebApplications-MDEwOlJlcG9zaXRvcnkxMTkzNTI2Mzc=-flat-LibraryContext_324.cs-runner-MDEwOlJlcG9zaXRvcnkxODQyODY4NzU=-flat-VssConnection.cs.html,0.05343511450381679,14,20486D-DevelopingASPNETMVCWebApplications-MDEwOlJlcG9zaXRvcnkxMTkzNTI2Mzc=-flat-LibraryContext_324.cs,runner-MDEwOlJlcG9zaXRvcnkxODQyODY4NzU=-flat-VssConnection.cs,16,17,1,489,497,8
309094,https://htmlpreview.github.io/?https://github.com/Christina96/boilerplate-sample-matches/blob/main/Csharp/NetCoreServer-MDEwOlJlcG9zaXRvcnkxNjYxMjMxNjQ=-flat-UdpServer.cs-NetCoreServer-MDEwOlJlcG9zaXRvcnkxNjYxMjMxNjQ=-flat-UdsClient.cs.html,0.5071174377224199,75,NetCoreServer-MDEwOlJlcG9zaXRvcnkxNjYxMjMxNjQ=-flat-UdpServer.cs,NetCoreServer-MDEwOlJlcG9zaXRvcnkxNjYxMjMxNjQ=-flat-UdsClient.cs,23,33,10,16,26,10
310732,https://htmlpreview.github.io/?https://github.com/Christina96/boilerplate-sample-matches/blob/main/Csharp/20486D-DevelopingASPNETMVCWebApplications-MDEwOlJlcG9zaXRvcnkxMTkzNTI2Mzc=-flat-Data_269.cs-20486D-DevelopingASPNETMVCWebApplications-MDEwOlJlcG9zaXRvcnkxMTkzNTI2Mzc=-flat-PersonProvider_447.cs.html,0.25316455696202533,10,20486D-DevelopingASPNETMVCWebApplications-MDEwOlJlcG9zaXRvcnkxMTkzNTI2Mzc=-flat-Data_269.cs,20486D-DevelopingASPNETMVCWebApplications-MDEwOlJlcG9zaXRvcnkxMTkzNTI2Mzc=-flat-PersonProvider_447.cs,1,9,8,1,9,8
312670,https://htmlpreview.github.io/?https://github.com/Christina96/boilerplate-sample-matches/blob/main/Csharp/npgsql-MDEwOlJlcG9zaXRvcnkyODgzNTc0-flat-RangeTests.cs-MudBlazor-MDEwOlJlcG9zaXRvcnkyODg0Mjg2NzY=-flat-ProgressLinearTests.cs.html,0.18512396694214875,16,npgsql-MDEwOlJlcG9zaXRvcnkyODgzNTc0-flat-RangeTests.cs,MudBlazor-MDEwOlJlcG9zaXRvcnkyODg0Mjg2NzY=-flat-ProgressLinearTests.cs,67,77,10,298,308,10
314323,https://htmlpreview.github.io/?https://github.com/Christina96/boilerplate-sample-matches/blob/main/Csharp/npgsql-MDEwOlJlcG9zaXRvcnkyODgzNTc0-flat-PostgresDatabaseInfo.cs-20486D-DevelopingASPNETMVCWebApplications-MDEwOlJlcG9zaXRvcnkxMTkzNTI2Mzc=-flat-Aquarium_59.cs.html,0.3225806451612903,15,npgsql-MDEwOlJlcG9zaXRvcnkyODgzNTc0-flat-PostgresDatabaseInfo.cs,20486D-DevelopingASPNETMVCWebApplications-MDEwOlJlcG9zaXRvcnkxMTkzNTI2Mzc=-flat-Aquarium_59.cs,32,34,2,11,13,2
316815,https://htmlpreview.github.io/?https://github.com/Christina96/boilerplate-sample-matches/blob/main/Csharp/MudBlazor-MDEwOlJlcG9zaXRvcnkyODg0Mjg2NzY=-flat-MudCardContent.razor.cs-20486D-DevelopingASPNETMVCWebApplications-MDEwOlJlcG9zaXRvcnkxMTkzNTI2Mzc=-flat-RegisterViewModel_316.cs.html,0.2564102564102564,10,MudBlazor-MDEwOlJlcG9zaXRvcnkyODg0Mjg2NzY=-flat-MudCardContent.razor.cs,20486D-DevelopingASPNETMVCWebApplications-MDEwOlJlcG9zaXRvcnkxMTkzNTI2Mzc=-flat-RegisterViewModel_316.cs,12,15,3,24,27,3
317623,https://htmlpreview.github.io/?https://github.com/Christina96/boilerplate-sample-matches/blob/main/Csharp/EarTrumpet-MDEwOlJlcG9zaXRvcnkzODkxOTcwMg==-flat-IAudioDeviceManager.cs-20486D-DevelopingASPNETMVCWebApplications-MDEwOlJlcG9zaXRvcnkxMTkzNTI2Mzc=-flat-LibraryContext.cs.html,0.3188405797101449,11,EarTrumpet-MDEwOlJlcG9zaXRvcnkzODkxOTcwMg==-flat-IAudioDeviceManager.cs,20486D-DevelopingASPNETMVCWebApplications-MDEwOlJlcG9zaXRvcnkxMTkzNTI2Mzc=-flat-LibraryContext.cs,9,10,1,15,16,1
318356,https://htmlpreview.github.io/?https://github.com/Christina96/boilerplate-sample-matches/blob/main/Csharp/Simple.Data-MDEwOlJlcG9zaXRvcnk4MTg3Njg=-flat-WhereClause.cs-Simple.Data-MDEwOlJlcG9zaXRvcnk4MTg3Njg=-flat-SkipClause.cs.html,1.0,13,Simple.Data-MDEwOlJlcG9zaXRvcnk4MTg3Njg=-flat-WhereClause.cs,Simple.Data-MDEwOlJlcG9zaXRvcnk4MTg3Njg=-flat-SkipClause.cs,2,15,13,2,15,13
319436,https://htmlpreview.github.io/?https://github.com/Christina96/boilerplate-sample-matches/blob/main/Csharp/MudBlazor-MDEwOlJlcG9zaXRvcnkyODg0Mjg2NzY=-flat-SvgPath.cs-MudBlazor-MDEwOlJlcG9zaXRvcnkyODg0Mjg2NzY=-flat-SvgText.cs.html,0.7441860465116279,16,MudBlazor-MDEwOlJlcG9zaXRvcnkyODg0Mjg2NzY=-flat-SvgPath.cs,MudBlazor-MDEwOlJlcG9zaXRvcnkyODg0Mjg2NzY=-flat-SvgText.cs,2,6,4,2,6,4
319850,https://htmlpreview.github.io/?https://github.com/Christina96/boilerplate-sample-matches/blob/main/Csharp/MudBlazor-MDEwOlJlcG9zaXRvcnkyODg0Mjg2NzY=-flat-SwipeTests.cs-MudBlazor-MDEwOlJlcG9zaXRvcnkyODg0Mjg2NzY=-flat-TimePickerTests.cs.html,0.07859531772575251,13,MudBlazor-MDEwOlJlcG9zaXRvcnkyODg0Mjg2NzY=-flat-SwipeTests.cs,MudBlazor-MDEwOlJlcG9zaXRvcnkyODg0Mjg2NzY=-flat-TimePickerTests.cs,35,40,5,51,56,5
320474,https://htmlpreview.github.io/?https://github.com/Christina96/boilerplate-sample-matches/blob/main/Csharp/Simple.Data-MDEwOlJlcG9zaXRvcnk4MTg3Njg=-flat-SqlObservableQueryRunner.cs-Security-MDEwOlJlcG9zaXRvcnkxNzcyMzY5OQ==-flat-AuthorizationOptions.cs.html,0.15942028985507245,11,Simple.Data-MDEwOlJlcG9zaXRvcnk4MTg3Njg=-flat-SqlObservableQueryRunner.cs,Security-MDEwOlJlcG9zaXRvcnkxNzcyMzY5OQ==-flat-AuthorizationOptions.cs,25,27,2,13,21,8
321135,https://htmlpreview.github.io/?https://github.com/Christina96/boilerplate-sample-matches/blob/main/Csharp/Simple.Data-MDEwOlJlcG9zaXRvcnk4MTg3Njg=-flat-DatabaseOpener.cs-Simple.Data-MDEwOlJlcG9zaXRvcnk4MTg3Njg=-flat-AdoAdapter.cs.html,0.06622516556291391,15,Simple.Data-MDEwOlJlcG9zaXRvcnk4MTg3Njg=-flat-DatabaseOpener.cs,Simple.Data-MDEwOlJlcG9zaXRvcnk4MTg3Njg=-flat-AdoAdapter.cs,16,31,15,135,153,18
321240,https://htmlpreview.github.io/?https://github.com/Christina96/boilerplate-sample-matches/blob/main/Csharp/runner-MDEwOlJlcG9zaXRvcnkxODQyODY4NzU=-flat-Handler.cs-npgsql-MDEwOlJlcG9zaXRvcnkyODgzNTc0-flat-DistributedTransactionTests.cs.html,0.040973111395646605,16,runner-MDEwOlJlcG9zaXRvcnkxODQyODY4NzU=-flat-Handler.cs,npgsql-MDEwOlJlcG9zaXRvcnkyODgzNTc0-flat-DistributedTransactionTests.cs,39,43,4,358,362,4
322383,https://htmlpreview.github.io/?https://github.com/Christina96/boilerplate-sample-matches/blob/main/Csharp/Simple.Data-MDEwOlJlcG9zaXRvcnk4MTg3Njg=-flat-WithTest.cs-MudBlazor-MDEwOlJlcG9zaXRvcnkyODg0Mjg2NzY=-flat-DialogTests.cs.html,0.16323417238749047,11,Simple.Data-MDEwOlJlcG9zaXRvcnk4MTg3Njg=-flat-WithTest.cs,MudBlazor-MDEwOlJlcG9zaXRvcnkyODg0Mjg2NzY=-flat-DialogTests.cs,140,154,14,207,215,8
323248,https://htmlpreview.github.io/?https://github.com/Christina96/boilerplate-sample-matches/blob/main/Csharp/npgsql-MDEwOlJlcG9zaXRvcnkyODgzNTc0-flat-TruncateMessage.cs-Security-MDEwOlJlcG9zaXRvcnkxNzcyMzY5OQ==-flat-OpenIdConnectEvents.cs.html,0.2542372881355932,15,npgsql-MDEwOlJlcG9zaXRvcnkyODgzNTc0-flat-TruncateMessage.cs,Security-MDEwOlJlcG9zaXRvcnkxNzcyMzY5OQ==-flat-OpenIdConnectEvents.cs,6,8,2,6,8,2
324235,https://htmlpreview.github.io/?https://github.com/Christina96/boilerplate-sample-matches/blob/main/Csharp/20486D-DevelopingASPNETMVCWebApplications-MDEwOlJlcG9zaXRvcnkxMTkzNTI2Mzc=-flat-Customer_172.cs-EarTrumpet-MDEwOlJlcG9zaXRvcnkzODkxOTcwMg==-flat-Manager.cs.html,0.11764705882352941,10,20486D-DevelopingASPNETMVCWebApplications-MDEwOlJlcG9zaXRvcnkxMTkzNTI2Mzc=-flat-Customer_172.cs,EarTrumpet-MDEwOlJlcG9zaXRvcnkzODkxOTcwMg==-flat-Manager.cs,1,10,9,1,16,15
324843,https://htmlpreview.github.io/?https://github.com/Christina96/boilerplate-sample-matches/blob/main/Csharp/runner-MDEwOlJlcG9zaXRvcnkxODQyODY4NzU=-flat-ProcessChannel.cs-dotween-MDEwOlJlcG9zaXRvcnkzMjQ3NTE2Mg==-flat-GoDummyPathEditor_151.cs.html,0.041407867494824016,10,runner-MDEwOlJlcG9zaXRvcnkxODQyODY4NzU=-flat-ProcessChannel.cs,dotween-MDEwOlJlcG9zaXRvcnkzMjQ3NTE2Mg==-flat-GoDummyPathEditor_151.cs,38,47,9,12,22,10
325119,https://htmlpreview.github.io/?https://github.com/Christina96/boilerplate-sample-matches/blob/main/Csharp/MudBlazor-MDEwOlJlcG9zaXRvcnkyODg0Mjg2NzY=-flat-MudMask.razor.cs-MudBlazor-MDEwOlJlcG9zaXRvcnkyODg0Mjg2NzY=-flat-MudChip.razor.cs.html,0.32666666666666666,17,MudBlazor-MDEwOlJlcG9zaXRvcnkyODg0Mjg2NzY=-flat-MudMask.razor.cs,MudBlazor-MDEwOlJlcG9zaXRvcnkyODg0Mjg2NzY=-flat-MudChip.razor.cs,19,30,11,17,28,11
325198,https://htmlpreview.github.io/?https://github.com/Christina96/boilerplate-sample-matches/blob/main/Csharp/dotween-MDEwOlJlcG9zaXRvcnkzMjQ3NTE2Mg==-flat-Shortcuts.cs-Simple.Data-MDEwOlJlcG9zaXRvcnk4MTg3Njg=-flat-TransactionTests.cs.html,0.14492753623188406,10,dotween-MDEwOlJlcG9zaXRvcnkzMjQ3NTE2Mg==-flat-Shortcuts.cs,Simple.Data-MDEwOlJlcG9zaXRvcnk4MTg3Njg=-flat-TransactionTests.cs,13,16,3,45,51,6
325504,https://htmlpreview.github.io/?https://github.com/Christina96/boilerplate-sample-matches/blob/main/Csharp/dotween-MDEwOlJlcG9zaXRvcnkzMjQ3NTE2Mg==-flat-Sequences_27.cs-MudBlazor-MDEwOlJlcG9zaXRvcnkyODg0Mjg2NzY=-flat-TableTests.cs.html,0.08887357905614882,27,dotween-MDEwOlJlcG9zaXRvcnkzMjQ3NTE2Mg==-flat-Sequences_27.cs,MudBlazor-MDEwOlJlcG9zaXRvcnkyODg0Mjg2NzY=-flat-TableTests.cs,82,103,21,164,172,8
326278,https://htmlpreview.github.io/?https://github.com/Christina96/boilerplate-sample-matches/blob/main/Csharp/MudBlazor-MDEwOlJlcG9zaXRvcnkyODg0Mjg2NzY=-flat-LoggerTests.cs-NetCoreServer-MDEwOlJlcG9zaXRvcnkxNjYxMjMxNjQ=-flat-HttpsSession.cs.html,0.1917808219178082,14,MudBlazor-MDEwOlJlcG9zaXRvcnkyODg0Mjg2NzY=-flat-LoggerTests.cs,NetCoreServer-MDEwOlJlcG9zaXRvcnkxNjYxMjMxNjQ=-flat-HttpsSession.cs,26,33,7,16,29,13
327041,https://htmlpreview.github.io/?https://github.com/Christina96/boilerplate-sample-matches/blob/main/Csharp/Simple.Data-MDEwOlJlcG9zaXRvcnk4MTg3Njg=-flat-DbImage.cs-runner-MDEwOlJlcG9zaXRvcnkxODQyODY4NzU=-flat-ExecutionContext.cs.html,0.06526806526806526,14,Simple.Data-MDEwOlJlcG9zaXRvcnk4MTg3Njg=-flat-DbImage.cs,runner-MDEwOlJlcG9zaXRvcnkxODQyODY4NzU=-flat-ExecutionContext.cs,9,10,1,46,47,1
327215,https://htmlpreview.github.io/?https://github.com/Christina96/boilerplate-sample-matches/blob/main/Csharp/runner-MDEwOlJlcG9zaXRvcnkxODQyODY4NzU=-flat-JobHookProvider.cs-Security-MDEwOlJlcG9zaXRvcnkxNzcyMzY5OQ==-flat-Startup_10.cs.html,0.09333333333333334,14,runner-MDEwOlJlcG9zaXRvcnkxODQyODY4NzU=-flat-JobHookProvider.cs,Security-MDEwOlJlcG9zaXRvcnkxNzcyMzY5OQ==-flat-Startup_10.cs,19,20,1,36,37,1
327349,https://htmlpreview.github.io/?https://github.com/Christina96/boilerplate-sample-matches/blob/main/Csharp/20486D-DevelopingASPNETMVCWebApplications-MDEwOlJlcG9zaXRvcnkxMTkzNTI2Mzc=-flat-DivisionResult_355.cs-20486D-DevelopingASPNETMVCWebApplications-MDEwOlJlcG9zaXRvcnkxMTkzNTI2Mzc=-flat-GroceryStore_69.cs.html,0.7555555555555555,17,20486D-DevelopingASPNETMVCWebApplications-MDEwOlJlcG9zaXRvcnkxMTkzNTI2Mzc=-flat-DivisionResult_355.cs,20486D-DevelopingASPNETMVCWebApplications-MDEwOlJlcG9zaXRvcnkxMTkzNTI2Mzc=-flat-GroceryStore_69.cs,1,11,10,1,10,9
328325,https://htmlpreview.github.io/?https://github.com/Christina96/boilerplate-sample-matches/blob/main/Csharp/runner-MDEwOlJlcG9zaXRvcnkxODQyODY4NzU=-flat-TaskOrchestrationOwner.cs-MudBlazor-MDEwOlJlcG9zaXRvcnkyODg0Mjg2NzY=-flat-NugetPackage.cs.html,0.1306122448979592,16,runner-MDEwOlJlcG9zaXRvcnkxODQyODY4NzU=-flat-TaskOrchestrationOwner.cs,MudBlazor-MDEwOlJlcG9zaXRvcnkyODg0Mjg2NzY=-flat-NugetPackage.cs,18,28,10,6,9,3
330441,https://htmlpreview.github.io/?https://github.com/Christina96/boilerplate-sample-matches/blob/main/Csharp/20486D-DevelopingASPNETMVCWebApplications-MDEwOlJlcG9zaXRvcnkxMTkzNTI2Mzc=-flat-IceCreamFlavorsCustomers_174.cs-20486D-DevelopingASPNETMVCWebApplications-MDEwOlJlcG9zaXRvcnkxMTkzNTI2Mzc=-flat-Product_25.cs.html,0.40336134453781514,24,20486D-DevelopingASPNETMVCWebApplications-MDEwOlJlcG9zaXRvcnkxMTkzNTI2Mzc=-flat-IceCreamFlavorsCustomers_174.cs,20486D-DevelopingASPNETMVCWebApplications-MDEwOlJlcG9zaXRvcnkxMTkzNTI2Mzc=-flat-Product_25.cs,1,11,10,1,15,14
330926,https://htmlpreview.github.io/?https://github.com/Christina96/boilerplate-sample-matches/blob/main/Csharp/Simple.Data-MDEwOlJlcG9zaXRvcnk4MTg3Njg=-flat-Database.Open.cs-runner-MDEwOlJlcG9zaXRvcnkxODQyODY4NzU=-flat-PropertiesCollection.cs.html,0.09404388714733543,15,Simple.Data-MDEwOlJlcG9zaXRvcnk4MTg3Njg=-flat-Database.Open.cs,runner-MDEwOlJlcG9zaXRvcnkxODQyODY4NzU=-flat-PropertiesCollection.cs,8,23,15,90,105,15
332676,https://htmlpreview.github.io/?https://github.com/Christina96/boilerplate-sample-matches/blob/main/Csharp/NetCoreServer-MDEwOlJlcG9zaXRvcnkxNjYxMjMxNjQ=-flat-UdpClient.cs-NetCoreServer-MDEwOlJlcG9zaXRvcnkxNjYxMjMxNjQ=-flat-TcpClient.cs.html,0.5455974842767296,143,NetCoreServer-MDEwOlJlcG9zaXRvcnkxNjYxMjMxNjQ=-flat-UdpClient.cs,NetCoreServer-MDEwOlJlcG9zaXRvcnkxNjYxMjMxNjQ=-flat-TcpClient.cs,1,38,37,1,39,38
333291,https://htmlpreview.github.io/?https://github.com/Christina96/boilerplate-sample-matches/blob/main/Csharp/EarTrumpet-MDEwOlJlcG9zaXRvcnkzODkxOTcwMg==-flat-SetVariableActionViewModel.cs-Security-MDEwOlJlcG9zaXRvcnkxNzcyMzY5OQ==-flat-TwitterTests.cs.html,0.06153846153846154,10,EarTrumpet-MDEwOlJlcG9zaXRvcnkzODkxOTcwMg==-flat-SetVariableActionViewModel.cs,Security-MDEwOlJlcG9zaXRvcnkxNzcyMzY5OQ==-flat-TwitterTests.cs,6,7,1,21,22,1
333583,https://htmlpreview.github.io/?https://github.com/Christina96/boilerplate-sample-matches/blob/main/Csharp/EarTrumpet-MDEwOlJlcG9zaXRvcnkzODkxOTcwMg==-flat-BrushValueParser.cs-Security-MDEwOlJlcG9zaXRvcnkxNzcyMzY5OQ==-flat-WsFederationHandler.cs.html,0.04377104377104377,13,EarTrumpet-MDEwOlJlcG9zaXRvcnkzODkxOTcwMg==-flat-BrushValueParser.cs,Security-MDEwOlJlcG9zaXRvcnkxNzcyMzY5OQ==-flat-WsFederationHandler.cs,74,81,7,250,257,7
333917,https://htmlpreview.github.io/?https://github.com/Christina96/boilerplate-sample-matches/blob/main/Csharp/MudBlazor-MDEwOlJlcG9zaXRvcnkyODg0Mjg2NzY=-flat-DialogResult.cs-EarTrumpet-MDEwOlJlcG9zaXRvcnkzODkxOTcwMg==-flat-IStreamWithVolumeControl.cs.html,0.41935483870967744,13,MudBlazor-MDEwOlJlcG9zaXRvcnkyODg0Mjg2NzY=-flat-DialogResult.cs,EarTrumpet-MDEwOlJlcG9zaXRvcnkzODkxOTcwMg==-flat-IStreamWithVolumeControl.cs,6,8,2,8,10,2
333957,https://htmlpreview.github.io/?https://github.com/Christina96/boilerplate-sample-matches/blob/main/Csharp/20486D-DevelopingASPNETMVCWebApplications-MDEwOlJlcG9zaXRvcnkxMTkzNTI2Mzc=-flat-Data_398.cs-20486D-DevelopingASPNETMVCWebApplications-MDEwOlJlcG9zaXRvcnkxMTkzNTI2Mzc=-flat-Photo_47.cs.html,0.18867924528301888,10,20486D-DevelopingASPNETMVCWebApplications-MDEwOlJlcG9zaXRvcnkxMTkzNTI2Mzc=-flat-Data_398.cs,20486D-DevelopingASPNETMVCWebApplications-MDEwOlJlcG9zaXRvcnkxMTkzNTI2Mzc=-flat-Photo_47.cs,1,9,8,1,14,13
334696,https://htmlpreview.github.io/?https://github.com/Christina96/boilerplate-sample-matches/blob/main/Csharp/20486D-DevelopingASPNETMVCWebApplications-MDEwOlJlcG9zaXRvcnkxMTkzNTI2Mzc=-flat-StoreContext.cs-EarTrumpet-MDEwOlJlcG9zaXRvcnkzODkxOTcwMg==-flat-FlyoutViewModel.cs.html,0.10714285714285714,21,20486D-DevelopingASPNETMVCWebApplications-MDEwOlJlcG9zaXRvcnkxMTkzNTI2Mzc=-flat-StoreContext.cs,EarTrumpet-MDEwOlJlcG9zaXRvcnkzODkxOTcwMg==-flat-FlyoutViewModel.cs,14,16,2,21,23,2
334702,https://htmlpreview.github.io/?https://github.com/Christina96/boilerplate-sample-matches/blob/main/Csharp/NetCoreServer-MDEwOlJlcG9zaXRvcnkxNjYxMjMxNjQ=-flat-SslTests.cs-MudBlazor-MDEwOlJlcG9zaXRvcnkyODg0Mjg2NzY=-flat-DateRangePickerTests.cs.html,0.07648494711147275,10,NetCoreServer-MDEwOlJlcG9zaXRvcnkxNjYxMjMxNjQ=-flat-SslTests.cs,MudBlazor-MDEwOlJlcG9zaXRvcnkyODg0Mjg2NzY=-flat-DateRangePickerTests.cs,262,271,9,120,123,3
334976,https://htmlpreview.github.io/?https://github.com/Christina96/boilerplate-sample-matches/blob/main/Csharp/dotween-MDEwOlJlcG9zaXRvcnkzMjQ3NTE2Mg==-flat-ShakeTweenProperty_119.cs-runner-MDEwOlJlcG9zaXRvcnkxODQyODY4NzU=-flat-ActionManagerL0.cs.html,0.013559322033898305,10,dotween-MDEwOlJlcG9zaXRvcnkzMjQ3NTE2Mg==-flat-ShakeTweenProperty_119.cs,runner-MDEwOlJlcG9zaXRvcnkxODQyODY4NzU=-flat-ActionManagerL0.cs,5,14,9,26,35,9
336668,https://htmlpreview.github.io/?https://github.com/Christina96/boilerplate-sample-matches/blob/main/Csharp/npgsql-MDEwOlJlcG9zaXRvcnkyODgzNTc0-flat-DataSourceTests.cs-npgsql-MDEwOlJlcG9zaXRvcnkyODgzNTc0-flat-CopyTests.cs.html,0.19727891156462585,10,npgsql-MDEwOlJlcG9zaXRvcnkyODgzNTc0-flat-DataSourceTests.cs,npgsql-MDEwOlJlcG9zaXRvcnkyODgzNTc0-flat-CopyTests.cs,237,244,7,466,475,9
337656,https://htmlpreview.github.io/?https://github.com/Christina96/boilerplate-sample-matches/blob/main/Csharp/20486D-DevelopingASPNETMVCWebApplications-MDEwOlJlcG9zaXRvcnkxMTkzNTI2Mzc=-flat-Person_122.cs-20486D-DevelopingASPNETMVCWebApplications-MDEwOlJlcG9zaXRvcnkxMTkzNTI2Mzc=-flat-Customer_201.cs.html,0.5137614678899083,10,20486D-DevelopingASPNETMVCWebApplications-MDEwOlJlcG9zaXRvcnkxMTkzNTI2Mzc=-flat-Person_122.cs,20486D-DevelopingASPNETMVCWebApplications-MDEwOlJlcG9zaXRvcnkxMTkzNTI2Mzc=-flat-Customer_201.cs,1,10,9,1,10,9
339206,https://htmlpreview.github.io/?https://github.com/Christina96/boilerplate-sample-matches/blob/main/Csharp/dotween-MDEwOlJlcG9zaXRvcnkzMjQ3NTE2Mg==-flat-Sequences_27.cs-MudBlazor-MDEwOlJlcG9zaXRvcnkyODg0Mjg2NzY=-flat-ToolTipTests.cs.html,0.24825174825174826,15,dotween-MDEwOlJlcG9zaXRvcnkzMjQ3NTE2Mg==-flat-Sequences_27.cs,MudBlazor-MDEwOlJlcG9zaXRvcnkyODg0Mjg2NzY=-flat-ToolTipTests.cs,56,61,5,19,26,7
341070,https://htmlpreview.github.io/?https://github.com/Christina96/boilerplate-sample-matches/blob/main/Csharp/20486D-DevelopingASPNETMVCWebApplications-MDEwOlJlcG9zaXRvcnkxMTkzNTI2Mzc=-flat-GroceryStore_69.cs-20486D-DevelopingASPNETMVCWebApplications-MDEwOlJlcG9zaXRvcnkxMTkzNTI2Mzc=-flat-Photo_206.cs.html,0.28169014084507044,10,20486D-DevelopingASPNETMVCWebApplications-MDEwOlJlcG9zaXRvcnkxMTkzNTI2Mzc=-flat-GroceryStore_69.cs,20486D-DevelopingASPNETMVCWebApplications-MDEwOlJlcG9zaXRvcnkxMTkzNTI2Mzc=-flat-Photo_206.cs,1,9,8,1,12,11
343377,https://htmlpreview.github.io/?https://github.com/Christina96/boilerplate-sample-matches/blob/main/Csharp/MudBlazor-MDEwOlJlcG9zaXRvcnkyODg0Mjg2NzY=-flat-CarouselTests.cs-MudBlazor-MDEwOlJlcG9zaXRvcnkyODg0Mjg2NzY=-flat-ResizeBasedServiceTests.cs.html,0.12207792207792208,11,MudBlazor-MDEwOlJlcG9zaXRvcnkyODg0Mjg2NzY=-flat-CarouselTests.cs,MudBlazor-MDEwOlJlcG9zaXRvcnkyODg0Mjg2NzY=-flat-ResizeBasedServiceTests.cs,144,151,7,175,185,10
343928,https://htmlpreview.github.io/?https://github.com/Christina96/boilerplate-sample-matches/blob/main/Csharp/dotween-MDEwOlJlcG9zaXRvcnkzMjQ3NTE2Mg==-flat-RectTransformConversionTests.cs-Security-MDEwOlJlcG9zaXRvcnkxNzcyMzY5OQ==-flat-SharedAuthenticationTests.cs.html,0.04066543438077634,11,dotween-MDEwOlJlcG9zaXRvcnkzMjQ3NTE2Mg==-flat-RectTransformConversionTests.cs,Security-MDEwOlJlcG9zaXRvcnkxNzcyMzY5OQ==-flat-SharedAuthenticationTests.cs,15,22,7,34,44,10
345225,https://htmlpreview.github.io/?https://github.com/Christina96/boilerplate-sample-matches/blob/main/Csharp/runner-MDEwOlJlcG9zaXRvcnkxODQyODY4NzU=-flat-JsonWebTokenValidationParameters.cs-ZXing.Net.Mobile-MDEwOlJlcG9zaXRvcnk2MTYwNjcz-flat-ZXingDefaultOverlayView.ios.cs.html,0.07905138339920949,10,runner-MDEwOlJlcG9zaXRvcnkxODQyODY4NzU=-flat-JsonWebTokenValidationParameters.cs,ZXing.Net.Mobile-MDEwOlJlcG9zaXRvcnk2MTYwNjcz-flat-ZXingDefaultOverlayView.ios.cs,1,14,13,1,22,21
346077,https://htmlpreview.github.io/?https://github.com/Christina96/boilerplate-sample-matches/blob/main/Csharp/MudBlazor-MDEwOlJlcG9zaXRvcnkyODg0Mjg2NzY=-flat-MudChart.razor.cs-MudBlazor-MDEwOlJlcG9zaXRvcnkyODg0Mjg2NzY=-flat-MudNavMenu.razor.cs.html,0.3418803418803419,10,MudBlazor-MDEwOlJlcG9zaXRvcnkyODg0Mjg2NzY=-flat-MudChart.razor.cs,MudBlazor-MDEwOlJlcG9zaXRvcnkyODg0Mjg2NzY=-flat-MudNavMenu.razor.cs,14,17,3,16,18,2
346923,https://htmlpreview.github.io/?https://github.com/Christina96/boilerplate-sample-matches/blob/main/Csharp/MudBlazor-MDEwOlJlcG9zaXRvcnkyODg0Mjg2NzY=-flat-DynamicTabsTests.cs-MudBlazor-MDEwOlJlcG9zaXRvcnkyODg0Mjg2NzY=-flat-TableTests.cs.html,0.06857546836337929,11,MudBlazor-MDEwOlJlcG9zaXRvcnkyODg0Mjg2NzY=-flat-DynamicTabsTests.cs,MudBlazor-MDEwOlJlcG9zaXRvcnkyODg0Mjg2NzY=-flat-TableTests.cs,78,82,4,320,325,5
347022,https://htmlpreview.github.io/?https://github.com/Christina96/boilerplate-sample-matches/blob/main/Csharp/Simple.Data-MDEwOlJlcG9zaXRvcnk4MTg3Njg=-flat-StringExtensions.cs-runner-MDEwOlJlcG9zaXRvcnkxODQyODY4NzU=-flat-IdentityDescriptor.cs.html,0.1483050847457627,12,Simple.Data-MDEwOlJlcG9zaXRvcnk4MTg3Njg=-flat-StringExtensions.cs,runner-MDEwOlJlcG9zaXRvcnkxODQyODY4NzU=-flat-IdentityDescriptor.cs,41,50,9,272,282,10
347880,https://htmlpreview.github.io/?https://github.com/Christina96/boilerplate-sample-matches/blob/main/Csharp/Simple.Data-MDEwOlJlcG9zaXRvcnk4MTg3Njg=-flat-SimpleExpressionTest.cs-npgsql-MDEwOlJlcG9zaXRvcnkyODgzNTc0-flat-DataAdapterTests.cs.html,0.07467532467532467,10,Simple.Data-MDEwOlJlcG9zaXRvcnk4MTg3Njg=-flat-SimpleExpressionTest.cs,npgsql-MDEwOlJlcG9zaXRvcnkyODgzNTc0-flat-DataAdapterTests.cs,56,65,9,157,166,9
348665,https://htmlpreview.github.io/?https://github.com/Christina96/boilerplate-sample-matches/blob/main/Csharp/MudBlazor-MDEwOlJlcG9zaXRvcnkyODg0Mjg2NzY=-flat-SwipeTests.cs-MudBlazor-MDEwOlJlcG9zaXRvcnkyODg0Mjg2NzY=-flat-PatternMaskTests.cs.html,0.0338409475465313,10,MudBlazor-MDEwOlJlcG9zaXRvcnkyODg0Mjg2NzY=-flat-SwipeTests.cs,MudBlazor-MDEwOlJlcG9zaXRvcnkyODg0Mjg2NzY=-flat-PatternMaskTests.cs,52,58,6,13,19,6
349502,https://htmlpreview.github.io/?https://github.com/Christina96/boilerplate-sample-matches/blob/main/Csharp/MudBlazor-MDEwOlJlcG9zaXRvcnkyODg0Mjg2NzY=-flat-MudDrawerContainer.razor.cs-20486D-DevelopingASPNETMVCWebApplications-MDEwOlJlcG9zaXRvcnkxMTkzNTI2Mzc=-flat-OrderTable.cs.html,0.2,10,MudBlazor-MDEwOlJlcG9zaXRvcnkyODg0Mjg2NzY=-flat-MudDrawerContainer.razor.cs,20486D-DevelopingASPNETMVCWebApplications-MDEwOlJlcG9zaXRvcnkxMTkzNTI2Mzc=-flat-OrderTable.cs,1,10,9,1,10,9
349969,https://htmlpreview.github.io/?https://github.com/Christina96/boilerplate-sample-matches/blob/main/Csharp/20486D-DevelopingASPNETMVCWebApplications-MDEwOlJlcG9zaXRvcnkxMTkzNTI2Mzc=-flat-LibraryContext.cs-runner-MDEwOlJlcG9zaXRvcnkxODQyODY4NzU=-flat-StepHost.cs.html,0.109375,14,20486D-DevelopingASPNETMVCWebApplications-MDEwOlJlcG9zaXRvcnkxMTkzNTI2Mzc=-flat-LibraryContext.cs,runner-MDEwOlJlcG9zaXRvcnkxODQyODY4NzU=-flat-StepHost.cs,15,16,1,37,38,1
350169,https://htmlpreview.github.io/?https://github.com/Christina96/boilerplate-sample-matches/blob/main/Csharp/MudBlazor-MDEwOlJlcG9zaXRvcnkyODg0Mjg2NzY=-flat-SplineInterpolator.cs-NetCoreServer-MDEwOlJlcG9zaXRvcnkxNjYxMjMxNjQ=-flat-TcpTests.cs.html,0.14906832298136646,36,MudBlazor-MDEwOlJlcG9zaXRvcnkyODg0Mjg2NzY=-flat-SplineInterpolator.cs,NetCoreServer-MDEwOlJlcG9zaXRvcnkxNjYxMjMxNjQ=-flat-TcpTests.cs,11,16,5,34,39,5
350376,https://htmlpreview.github.io/?https://github.com/Christina96/boilerplate-sample-matches/blob/main/Csharp/dotween-MDEwOlJlcG9zaXRvcnkzMjQ3NTE2Mg==-flat-PathOptions.cs-dotween-MDEwOlJlcG9zaXRvcnkzMjQ3NTE2Mg==-flat-TestScene.cs.html,0.11814345991561181,14,dotween-MDEwOlJlcG9zaXRvcnkzMjQ3NTE2Mg==-flat-PathOptions.cs,dotween-MDEwOlJlcG9zaXRvcnkzMjQ3NTE2Mg==-flat-TestScene.cs,17,31,14,12,26,14
