ID,Link,Tokens,File 1,File 2,Start 1,End 1,Detected Lines 1,Start 2,End 2,Detected Lines 2
0,https://htmlpreview.github.io/?https://github.com/Christina96/boilerplate-sample-matches/blob/main/csharp/npgsql-MDEwOlJlcG9zaXRvcnkyODgzNTc0-flat-TransactionTests.cs-npgsql-MDEwOlJlcG9zaXRvcnkyODgzNTc0-flat-TransactionTests.cs-0.html,21,npgsql-MDEwOlJlcG9zaXRvcnkyODgzNTc0-flat-TransactionTests.cs,npgsql-MDEwOlJlcG9zaXRvcnkyODgzNTc0-flat-TransactionTests.cs,324,325,1,540,541,1
1,https://htmlpreview.github.io/?https://github.com/Christina96/boilerplate-sample-matches/blob/main/csharp/runner-MDEwOlJlcG9zaXRvcnkxODQyODY4NzU=-flat-ProcessInvokerL0.cs-runner-MDEwOlJlcG9zaXRvcnkxODQyODY4NzU=-flat-ProcessInvokerL0.cs-1.html,32,runner-MDEwOlJlcG9zaXRvcnkxODQyODY4NzU=-flat-ProcessInvokerL0.cs,runner-MDEwOlJlcG9zaXRvcnkxODQyODY4NzU=-flat-ProcessInvokerL0.cs,278,279,1,280,281,1
2,https://htmlpreview.github.io/?https://github.com/Christina96/boilerplate-sample-matches/blob/main/csharp/npgsql-MDEwOlJlcG9zaXRvcnkyODgzNTc0-flat-TextHandler.cs-npgsql-MDEwOlJlcG9zaXRvcnkyODgzNTc0-flat-TextHandler.cs-2.html,30,npgsql-MDEwOlJlcG9zaXRvcnkyODgzNTc0-flat-TextHandler.cs,npgsql-MDEwOlJlcG9zaXRvcnkyODgzNTc0-flat-TextHandler.cs,188,192,4,197,201,4
3,https://htmlpreview.github.io/?https://github.com/Christina96/boilerplate-sample-matches/blob/main/csharp/dotween-MDEwOlJlcG9zaXRvcnkzMjQ3NTE2Mg==-flat-GoSplineCubicBezierSolver_69.cs-dotween-MDEwOlJlcG9zaXRvcnkzMjQ3NTE2Mg==-flat-GoSplineCatmullRomSolver_66.cs-3.html,14,dotween-MDEwOlJlcG9zaXRvcnkzMjQ3NTE2Mg==-flat-GoSplineCubicBezierSolver_69.cs,dotween-MDEwOlJlcG9zaXRvcnkzMjQ3NTE2Mg==-flat-GoSplineCatmullRomSolver_66.cs,8,13,5,8,13,5
4,https://htmlpreview.github.io/?https://github.com/Christina96/boilerplate-sample-matches/blob/main/csharp/npgsql-MDEwOlJlcG9zaXRvcnkyODgzNTc0-flat-NpgsqlCommand.cs-npgsql-MDEwOlJlcG9zaXRvcnkyODgzNTc0-flat-NpgsqlCommand.cs-4.html,17,npgsql-MDEwOlJlcG9zaXRvcnkyODgzNTc0-flat-NpgsqlCommand.cs,npgsql-MDEwOlJlcG9zaXRvcnkyODgzNTc0-flat-NpgsqlCommand.cs,654,656,2,694,696,2
5,https://htmlpreview.github.io/?https://github.com/Christina96/boilerplate-sample-matches/blob/main/csharp/Simple.Data-MDEwOlJlcG9zaXRvcnk4MTg3Njg=-flat-AdoAdapterQueryRunner.cs-Simple.Data-MDEwOlJlcG9zaXRvcnk4MTg3Njg=-flat-AdoAdapterQueryRunner.cs-5.html,18,Simple.Data-MDEwOlJlcG9zaXRvcnk4MTg3Njg=-flat-AdoAdapterQueryRunner.cs,Simple.Data-MDEwOlJlcG9zaXRvcnk4MTg3Njg=-flat-AdoAdapterQueryRunner.cs,109,112,3,180,183,3
6,https://htmlpreview.github.io/?https://github.com/Christina96/boilerplate-sample-matches/blob/main/csharp/runner-MDEwOlJlcG9zaXRvcnkxODQyODY4NzU=-flat-TemplateMemory.cs-runner-MDEwOlJlcG9zaXRvcnkxODQyODY4NzU=-flat-StepsContext.cs-6.html,14,runner-MDEwOlJlcG9zaXRvcnkxODQyODY4NzU=-flat-TemplateMemory.cs,runner-MDEwOlJlcG9zaXRvcnkxODQyODY4NzU=-flat-StepsContext.cs,203,206,3,71,74,3
7,https://htmlpreview.github.io/?https://github.com/Christina96/boilerplate-sample-matches/blob/main/csharp/NetCoreServer-MDEwOlJlcG9zaXRvcnkxNjYxMjMxNjQ=-flat-com.chronoxor.fbe.cs-NetCoreServer-MDEwOlJlcG9zaXRvcnkxNjYxMjMxNjQ=-flat-com.chronoxor.fbe.cs-7.html,410,NetCoreServer-MDEwOlJlcG9zaXRvcnkxNjYxMjMxNjQ=-flat-com.chronoxor.fbe.cs,NetCoreServer-MDEwOlJlcG9zaXRvcnkxNjYxMjMxNjQ=-flat-com.chronoxor.fbe.cs,1132,1199,67,1243,1310,67
8,https://htmlpreview.github.io/?https://github.com/Christina96/boilerplate-sample-matches/blob/main/csharp/dotween-MDEwOlJlcG9zaXRvcnkzMjQ3NTE2Mg==-flat-CustomRangePlugin_126.cs-dotween-MDEwOlJlcG9zaXRvcnkzMjQ3NTE2Mg==-flat-IntPlugin.cs-8.html,14,dotween-MDEwOlJlcG9zaXRvcnkzMjQ3NTE2Mg==-flat-CustomRangePlugin_126.cs,dotween-MDEwOlJlcG9zaXRvcnkzMjQ3NTE2Mg==-flat-IntPlugin.cs,16,17,1,17,18,1
9,https://htmlpreview.github.io/?https://github.com/Christina96/boilerplate-sample-matches/blob/main/csharp/npgsql-MDEwOlJlcG9zaXRvcnkyODgzNTc0-flat-NpgsqlTypes.cs-npgsql-MDEwOlJlcG9zaXRvcnkyODgzNTc0-flat-NpgsqlTypes.cs-9.html,111,npgsql-MDEwOlJlcG9zaXRvcnkyODgzNTc0-flat-NpgsqlTypes.cs,npgsql-MDEwOlJlcG9zaXRvcnkyODgzNTc0-flat-NpgsqlTypes.cs,155,168,13,225,238,13
10,https://htmlpreview.github.io/?https://github.com/Christina96/boilerplate-sample-matches/blob/main/csharp/npgsql-MDEwOlJlcG9zaXRvcnkyODgzNTc0-flat-IntervalHandler.cs-npgsql-MDEwOlJlcG9zaXRvcnkyODgzNTc0-flat-TimeTzHandler.cs-10.html,15,npgsql-MDEwOlJlcG9zaXRvcnkyODgzNTc0-flat-IntervalHandler.cs,npgsql-MDEwOlJlcG9zaXRvcnkyODgzNTc0-flat-TimeTzHandler.cs,73,74,1,26,27,1
11,https://htmlpreview.github.io/?https://github.com/Christina96/boilerplate-sample-matches/blob/main/csharp/EarTrumpet-MDEwOlJlcG9zaXRvcnkzODkxOTcwMg==-flat-AudioPolicyConfigFactory.cs-MudBlazor-MDEwOlJlcG9zaXRvcnkyODg0Mjg2NzY=-flat-Theme.cs-11.html,12,EarTrumpet-MDEwOlJlcG9zaXRvcnkzODkxOTcwMg==-flat-AudioPolicyConfigFactory.cs,MudBlazor-MDEwOlJlcG9zaXRvcnkyODg0Mjg2NzY=-flat-Theme.cs,5,10,5,7,12,5
12,https://htmlpreview.github.io/?https://github.com/Christina96/boilerplate-sample-matches/blob/main/csharp/NetCoreServer-MDEwOlJlcG9zaXRvcnkxNjYxMjMxNjQ=-flat-UdpServer.cs-NetCoreServer-MDEwOlJlcG9zaXRvcnkxNjYxMjMxNjQ=-flat-UdpClient.cs-12.html,41,NetCoreServer-MDEwOlJlcG9zaXRvcnkxNjYxMjMxNjQ=-flat-UdpServer.cs,NetCoreServer-MDEwOlJlcG9zaXRvcnkxNjYxMjMxNjQ=-flat-UdpClient.cs,202,210,8,234,242,8
13,https://htmlpreview.github.io/?https://github.com/Christina96/boilerplate-sample-matches/blob/main/csharp/NetCoreServer-MDEwOlJlcG9zaXRvcnkxNjYxMjMxNjQ=-flat-SslClient.cs-NetCoreServer-MDEwOlJlcG9zaXRvcnkxNjYxMjMxNjQ=-flat-SslSession.cs-13.html,57,NetCoreServer-MDEwOlJlcG9zaXRvcnkxNjYxMjMxNjQ=-flat-SslClient.cs,NetCoreServer-MDEwOlJlcG9zaXRvcnkxNjYxMjMxNjQ=-flat-SslSession.cs,479,498,19,329,348,19
14,https://htmlpreview.github.io/?https://github.com/Christina96/boilerplate-sample-matches/blob/main/csharp/NetCoreServer-MDEwOlJlcG9zaXRvcnkxNjYxMjMxNjQ=-flat-HttpsTests.cs-NetCoreServer-MDEwOlJlcG9zaXRvcnkxNjYxMjMxNjQ=-flat-HttpsTests.cs-14.html,22,NetCoreServer-MDEwOlJlcG9zaXRvcnkxNjYxMjMxNjQ=-flat-HttpsTests.cs,NetCoreServer-MDEwOlJlcG9zaXRvcnkxNjYxMjMxNjQ=-flat-HttpsTests.cs,111,113,2,106,108,2
15,https://htmlpreview.github.io/?https://github.com/Christina96/boilerplate-sample-matches/blob/main/csharp/EarTrumpet-MDEwOlJlcG9zaXRvcnkzODkxOTcwMg==-flat-TemporaryAppItemViewModel.cs-EarTrumpet-MDEwOlJlcG9zaXRvcnkzODkxOTcwMg==-flat-TemporaryAppItemViewModel.cs-15.html,36,EarTrumpet-MDEwOlJlcG9zaXRvcnkzODkxOTcwMg==-flat-TemporaryAppItemViewModel.cs,EarTrumpet-MDEwOlJlcG9zaXRvcnkzODkxOTcwMg==-flat-TemporaryAppItemViewModel.cs,20,33,13,36,49,13
16,https://htmlpreview.github.io/?https://github.com/Christina96/boilerplate-sample-matches/blob/main/csharp/MudBlazor-MDEwOlJlcG9zaXRvcnkyODg0Mjg2NzY=-flat-ResizeBasedServiceTests.cs-MudBlazor-MDEwOlJlcG9zaXRvcnkyODg0Mjg2NzY=-flat-BreakpointServiceTests.cs-16.html,113,MudBlazor-MDEwOlJlcG9zaXRvcnkyODg0Mjg2NzY=-flat-ResizeBasedServiceTests.cs,MudBlazor-MDEwOlJlcG9zaXRvcnkyODg0Mjg2NzY=-flat-BreakpointServiceTests.cs,279,297,18,308,326,18
17,https://htmlpreview.github.io/?https://github.com/Christina96/boilerplate-sample-matches/blob/main/csharp/MudBlazor-MDEwOlJlcG9zaXRvcnkyODg0Mjg2NzY=-flat-DataGridTests.cs-MudBlazor-MDEwOlJlcG9zaXRvcnkyODg0Mjg2NzY=-flat-DataGridTests.cs-17.html,19,MudBlazor-MDEwOlJlcG9zaXRvcnkyODg0Mjg2NzY=-flat-DataGridTests.cs,MudBlazor-MDEwOlJlcG9zaXRvcnkyODg0Mjg2NzY=-flat-DataGridTests.cs,1393,1396,3,1463,1466,3
18,https://htmlpreview.github.io/?https://github.com/Christina96/boilerplate-sample-matches/blob/main/csharp/dotween-MDEwOlJlcG9zaXRvcnkzMjQ3NTE2Mg==-flat-GoTweenConfig.cs-dotween-MDEwOlJlcG9zaXRvcnkzMjQ3NTE2Mg==-flat-GoTweenConfig_58.cs-18.html,1201,dotween-MDEwOlJlcG9zaXRvcnkzMjQ3NTE2Mg==-flat-GoTweenConfig.cs,dotween-MDEwOlJlcG9zaXRvcnkzMjQ3NTE2Mg==-flat-GoTweenConfig_58.cs,39,271,232,39,271,232
19,https://htmlpreview.github.io/?https://github.com/Christina96/boilerplate-sample-matches/blob/main/csharp/npgsql-MDEwOlJlcG9zaXRvcnkyODgzNTc0-flat-JsonTests.cs-npgsql-MDEwOlJlcG9zaXRvcnkyODgzNTc0-flat-JsonTests.cs-19.html,66,npgsql-MDEwOlJlcG9zaXRvcnkyODgzNTc0-flat-JsonTests.cs,npgsql-MDEwOlJlcG9zaXRvcnkyODgzNTc0-flat-JsonTests.cs,235,244,9,102,111,9
20,https://htmlpreview.github.io/?https://github.com/Christina96/boilerplate-sample-matches/blob/main/csharp/dotween-MDEwOlJlcG9zaXRvcnkzMjQ3NTE2Mg==-flat-Vector3Array_35.cs-dotween-MDEwOlJlcG9zaXRvcnkzMjQ3NTE2Mg==-flat-Vector3Array.cs-20.html,274,dotween-MDEwOlJlcG9zaXRvcnkzMjQ3NTE2Mg==-flat-Vector3Array_35.cs,dotween-MDEwOlJlcG9zaXRvcnkzMjQ3NTE2Mg==-flat-Vector3Array.cs,7,33,26,7,33,26
21,https://htmlpreview.github.io/?https://github.com/Christina96/boilerplate-sample-matches/blob/main/csharp/MudBlazor-MDEwOlJlcG9zaXRvcnkyODg0Mjg2NzY=-flat-MudBaseDatePicker.razor.cs-MudBlazor-MDEwOlJlcG9zaXRvcnkyODg0Mjg2NzY=-flat-MudBaseDatePicker.razor.cs-21.html,13,MudBlazor-MDEwOlJlcG9zaXRvcnkyODg0Mjg2NzY=-flat-MudBaseDatePicker.razor.cs,MudBlazor-MDEwOlJlcG9zaXRvcnkyODg0Mjg2NzY=-flat-MudBaseDatePicker.razor.cs,324,326,2,330,332,2
22,https://htmlpreview.github.io/?https://github.com/Christina96/boilerplate-sample-matches/blob/main/csharp/Security-MDEwOlJlcG9zaXRvcnkxNzcyMzY5OQ==-flat-MicrosoftAccountTests.cs-Security-MDEwOlJlcG9zaXRvcnkxNzcyMzY5OQ==-flat-GoogleTests.cs-22.html,45,Security-MDEwOlJlcG9zaXRvcnkxNzcyMzY5OQ==-flat-MicrosoftAccountTests.cs,Security-MDEwOlJlcG9zaXRvcnkxNzcyMzY5OQ==-flat-GoogleTests.cs,201,205,4,657,661,4
23,https://htmlpreview.github.io/?https://github.com/Christina96/boilerplate-sample-matches/blob/main/csharp/dotween-MDEwOlJlcG9zaXRvcnkzMjQ3NTE2Mg==-flat-TestScene.cs-dotween-MDEwOlJlcG9zaXRvcnkzMjQ3NTE2Mg==-flat-TestScene.cs-23.html,138,dotween-MDEwOlJlcG9zaXRvcnkzMjQ3NTE2Mg==-flat-TestScene.cs,dotween-MDEwOlJlcG9zaXRvcnkzMjQ3NTE2Mg==-flat-TestScene.cs,60,71,11,88,99,11
24,https://htmlpreview.github.io/?https://github.com/Christina96/boilerplate-sample-matches/blob/main/csharp/MudBlazor-MDEwOlJlcG9zaXRvcnkyODg0Mjg2NzY=-flat-PopoverTests.cs-MudBlazor-MDEwOlJlcG9zaXRvcnkyODg0Mjg2NzY=-flat-PopoverTests.cs-24.html,24,MudBlazor-MDEwOlJlcG9zaXRvcnkyODg0Mjg2NzY=-flat-PopoverTests.cs,MudBlazor-MDEwOlJlcG9zaXRvcnkyODg0Mjg2NzY=-flat-PopoverTests.cs,204,210,6,513,519,6
25,https://htmlpreview.github.io/?https://github.com/Christina96/boilerplate-sample-matches/blob/main/csharp/npgsql-MDEwOlJlcG9zaXRvcnkyODgzNTc0-flat-NpgsqlDataReader.cs-npgsql-MDEwOlJlcG9zaXRvcnkyODgzNTc0-flat-NpgsqlNestedDataReader.cs-25.html,73,npgsql-MDEwOlJlcG9zaXRvcnkyODgzNTc0-flat-NpgsqlDataReader.cs,npgsql-MDEwOlJlcG9zaXRvcnkyODgzNTc0-flat-NpgsqlNestedDataReader.cs,840,850,10,218,228,10
26,https://htmlpreview.github.io/?https://github.com/Christina96/boilerplate-sample-matches/blob/main/csharp/npgsql-MDEwOlJlcG9zaXRvcnkyODgzNTc0-flat-GlobalTypeMapper.cs-npgsql-MDEwOlJlcG9zaXRvcnkyODgzNTc0-flat-TypeMapper.cs-26.html,12,npgsql-MDEwOlJlcG9zaXRvcnkyODgzNTc0-flat-GlobalTypeMapper.cs,npgsql-MDEwOlJlcG9zaXRvcnkyODgzNTc0-flat-TypeMapper.cs,247,252,5,111,116,5
27,https://htmlpreview.github.io/?https://github.com/Christina96/boilerplate-sample-matches/blob/main/csharp/Security-MDEwOlJlcG9zaXRvcnkxNzcyMzY5OQ==-flat-ChunkingCookieManager_19.cs-Security-MDEwOlJlcG9zaXRvcnkxNzcyMzY5OQ==-flat-ChunkingCookieManager.cs-27.html,193,Security-MDEwOlJlcG9zaXRvcnkxNzcyMzY5OQ==-flat-ChunkingCookieManager_19.cs,Security-MDEwOlJlcG9zaXRvcnkxNzcyMzY5OQ==-flat-ChunkingCookieManager.cs,49,86,37,59,99,40
28,https://htmlpreview.github.io/?https://github.com/Christina96/boilerplate-sample-matches/blob/main/csharp/Security-MDEwOlJlcG9zaXRvcnkxNzcyMzY5OQ==-flat-CookieAuthenticationOptions.cs-Security-MDEwOlJlcG9zaXRvcnkxNzcyMzY5OQ==-flat-TwitterOptions.cs-28.html,16,Security-MDEwOlJlcG9zaXRvcnkxNzcyMzY5OQ==-flat-CookieAuthenticationOptions.cs,Security-MDEwOlJlcG9zaXRvcnkxNzcyMzY5OQ==-flat-TwitterOptions.cs,12,16,4,22,26,4
29,https://htmlpreview.github.io/?https://github.com/Christina96/boilerplate-sample-matches/blob/main/csharp/MudBlazor-MDEwOlJlcG9zaXRvcnkyODg0Mjg2NzY=-flat-MudAppBar.razor.cs-MudBlazor-MDEwOlJlcG9zaXRvcnkyODg0Mjg2NzY=-flat-MudField.razor.cs-29.html,13,MudBlazor-MDEwOlJlcG9zaXRvcnkyODg0Mjg2NzY=-flat-MudAppBar.razor.cs,MudBlazor-MDEwOlJlcG9zaXRvcnkyODg0Mjg2NzY=-flat-MudField.razor.cs,44,46,2,66,68,2
30,https://htmlpreview.github.io/?https://github.com/Christina96/boilerplate-sample-matches/blob/main/csharp/MudBlazor-MDEwOlJlcG9zaXRvcnkyODg0Mjg2NzY=-flat-TestContextExtensions.cs-MudBlazor-MDEwOlJlcG9zaXRvcnkyODg0Mjg2NzY=-flat-ApiDocsTests.cs-30.html,25,MudBlazor-MDEwOlJlcG9zaXRvcnkyODg0Mjg2NzY=-flat-TestContextExtensions.cs,MudBlazor-MDEwOlJlcG9zaXRvcnkyODg0Mjg2NzY=-flat-ApiDocsTests.cs,13,15,2,20,22,2
31,https://htmlpreview.github.io/?https://github.com/Christina96/boilerplate-sample-matches/blob/main/csharp/npgsql-MDEwOlJlcG9zaXRvcnkyODgzNTc0-flat-NpgsqlServiceCollectionExtensions.cs-npgsql-MDEwOlJlcG9zaXRvcnkyODgzNTc0-flat-NpgsqlServiceCollectionExtensions.cs-31.html,83,npgsql-MDEwOlJlcG9zaXRvcnkyODgzNTc0-flat-NpgsqlServiceCollectionExtensions.cs,npgsql-MDEwOlJlcG9zaXRvcnkyODgzNTc0-flat-NpgsqlServiceCollectionExtensions.cs,10,23,13,24,38,14
32,https://htmlpreview.github.io/?https://github.com/Christina96/boilerplate-sample-matches/blob/main/csharp/npgsql-MDEwOlJlcG9zaXRvcnkyODgzNTc0-flat-NpgsqlParameterCollectionTests.cs-npgsql-MDEwOlJlcG9zaXRvcnkyODgzNTc0-flat-NpgsqlParameterCollectionTests.cs-32.html,55,npgsql-MDEwOlJlcG9zaXRvcnkyODgzNTc0-flat-NpgsqlParameterCollectionTests.cs,npgsql-MDEwOlJlcG9zaXRvcnkyODgzNTc0-flat-NpgsqlParameterCollectionTests.cs,172,178,6,187,193,6
33,https://htmlpreview.github.io/?https://github.com/Christina96/boilerplate-sample-matches/blob/main/csharp/dotween-MDEwOlJlcG9zaXRvcnkzMjQ3NTE2Mg==-flat-LeanTween_56.cs-dotween-MDEwOlJlcG9zaXRvcnkzMjQ3NTE2Mg==-flat-LeanTween.cs-33.html,5142,dotween-MDEwOlJlcG9zaXRvcnkzMjQ3NTE2Mg==-flat-LeanTween_56.cs,dotween-MDEwOlJlcG9zaXRvcnkzMjQ3NTE2Mg==-flat-LeanTween.cs,37,811,774,37,811,774
34,https://htmlpreview.github.io/?https://github.com/Christina96/boilerplate-sample-matches/blob/main/csharp/npgsql-MDEwOlJlcG9zaXRvcnkyODgzNTc0-flat-ReadArray.cs-npgsql-MDEwOlJlcG9zaXRvcnkyODgzNTc0-flat-ReadArray.cs-34.html,35,npgsql-MDEwOlJlcG9zaXRvcnkyODgzNTc0-flat-ReadArray.cs,npgsql-MDEwOlJlcG9zaXRvcnkyODgzNTc0-flat-ReadArray.cs,31,35,4,47,51,4
35,https://htmlpreview.github.io/?https://github.com/Christina96/boilerplate-sample-matches/blob/main/csharp/MudBlazor-MDEwOlJlcG9zaXRvcnkyODg0Mjg2NzY=-flat-DialogParametersGeneric.cs-MudBlazor-MDEwOlJlcG9zaXRvcnkyODg0Mjg2NzY=-flat-DialogParametersGeneric.cs-35.html,23,MudBlazor-MDEwOlJlcG9zaXRvcnkyODg0Mjg2NzY=-flat-DialogParametersGeneric.cs,MudBlazor-MDEwOlJlcG9zaXRvcnkyODg0Mjg2NzY=-flat-DialogParametersGeneric.cs,21,25,4,30,34,4
36,https://htmlpreview.github.io/?https://github.com/Christina96/boilerplate-sample-matches/blob/main/csharp/20486D-DevelopingASPNETMVCWebApplications-MDEwOlJlcG9zaXRvcnkxMTkzNTI2Mzc=-flat-20181225114624_InitialCreate.cs-20486D-DevelopingASPNETMVCWebApplications-MDEwOlJlcG9zaXRvcnkxMTkzNTI2Mzc=-flat-20181225114624_InitialCreate.cs-36.html,28,20486D-DevelopingASPNETMVCWebApplications-MDEwOlJlcG9zaXRvcnkxMTkzNTI2Mzc=-flat-20181225114624_InitialCreate.cs,20486D-DevelopingASPNETMVCWebApplications-MDEwOlJlcG9zaXRvcnkxMTkzNTI2Mzc=-flat-20181225114624_InitialCreate.cs,51,54,3,59,62,3
37,https://htmlpreview.github.io/?https://github.com/Christina96/boilerplate-sample-matches/blob/main/csharp/npgsql-MDEwOlJlcG9zaXRvcnkyODgzNTc0-flat-ReaderOldSchemaTests.cs-npgsql-MDEwOlJlcG9zaXRvcnkyODgzNTc0-flat-ReaderOldSchemaTests.cs-37.html,48,npgsql-MDEwOlJlcG9zaXRvcnkyODgzNTc0-flat-ReaderOldSchemaTests.cs,npgsql-MDEwOlJlcG9zaXRvcnkyODgzNTc0-flat-ReaderOldSchemaTests.cs,81,84,3,51,54,3
38,https://htmlpreview.github.io/?https://github.com/Christina96/boilerplate-sample-matches/blob/main/csharp/npgsql-MDEwOlJlcG9zaXRvcnkyODgzNTc0-flat-NetTopologySuiteTests.cs-npgsql-MDEwOlJlcG9zaXRvcnkyODgzNTc0-flat-NetworkTypeTests.cs-38.html,13,npgsql-MDEwOlJlcG9zaXRvcnkyODgzNTc0-flat-NetTopologySuiteTests.cs,npgsql-MDEwOlJlcG9zaXRvcnkyODgzNTc0-flat-NetworkTypeTests.cs,161,163,2,37,39,2
39,https://htmlpreview.github.io/?https://github.com/Christina96/boilerplate-sample-matches/blob/main/csharp/runner-MDEwOlJlcG9zaXRvcnkxODQyODY4NzU=-flat-ServiceDefinition.cs-runner-MDEwOlJlcG9zaXRvcnkxODQyODY4NzU=-flat-VssJsonCollectionWrapper.cs-39.html,13,runner-MDEwOlJlcG9zaXRvcnkxODQyODY4NzU=-flat-ServiceDefinition.cs,runner-MDEwOlJlcG9zaXRvcnkxODQyODY4NzU=-flat-VssJsonCollectionWrapper.cs,80,86,6,85,91,6
40,https://htmlpreview.github.io/?https://github.com/Christina96/boilerplate-sample-matches/blob/main/csharp/MudBlazor-MDEwOlJlcG9zaXRvcnkyODg0Mjg2NzY=-flat-ResizeBasedServiceTests.cs-MudBlazor-MDEwOlJlcG9zaXRvcnkyODg0Mjg2NzY=-flat-ResizeBasedServiceTests.cs-40.html,15,MudBlazor-MDEwOlJlcG9zaXRvcnkyODg0Mjg2NzY=-flat-ResizeBasedServiceTests.cs,MudBlazor-MDEwOlJlcG9zaXRvcnkyODg0Mjg2NzY=-flat-ResizeBasedServiceTests.cs,324,326,2,208,210,2
41,https://htmlpreview.github.io/?https://github.com/Christina96/boilerplate-sample-matches/blob/main/csharp/npgsql-MDEwOlJlcG9zaXRvcnkyODgzNTc0-flat-ReadArray.cs-npgsql-MDEwOlJlcG9zaXRvcnkyODgzNTc0-flat-Insert.cs-41.html,12,npgsql-MDEwOlJlcG9zaXRvcnkyODgzNTc0-flat-ReadArray.cs,npgsql-MDEwOlJlcG9zaXRvcnkyODgzNTc0-flat-Insert.cs,22,24,2,7,9,2
42,https://htmlpreview.github.io/?https://github.com/Christina96/boilerplate-sample-matches/blob/main/csharp/MudBlazor-MDEwOlJlcG9zaXRvcnkyODg0Mjg2NzY=-flat-DataGridTests.cs-MudBlazor-MDEwOlJlcG9zaXRvcnkyODg0Mjg2NzY=-flat-DataGridTests.cs-42.html,18,MudBlazor-MDEwOlJlcG9zaXRvcnkyODg0Mjg2NzY=-flat-DataGridTests.cs,MudBlazor-MDEwOlJlcG9zaXRvcnkyODg0Mjg2NzY=-flat-DataGridTests.cs,2091,2093,2,2093,2095,2
43,https://htmlpreview.github.io/?https://github.com/Christina96/boilerplate-sample-matches/blob/main/csharp/dotween-MDEwOlJlcG9zaXRvcnkzMjQ3NTE2Mg==-flat-EnginesComparison.cs-dotween-MDEwOlJlcG9zaXRvcnkzMjQ3NTE2Mg==-flat-EnginesComparison_0.cs-43.html,36,dotween-MDEwOlJlcG9zaXRvcnkzMjQ3NTE2Mg==-flat-EnginesComparison.cs,dotween-MDEwOlJlcG9zaXRvcnkzMjQ3NTE2Mg==-flat-EnginesComparison_0.cs,99,102,3,99,102,3
44,https://htmlpreview.github.io/?https://github.com/Christina96/boilerplate-sample-matches/blob/main/csharp/runner-MDEwOlJlcG9zaXRvcnkxODQyODY4NzU=-flat-HostContext.cs-runner-MDEwOlJlcG9zaXRvcnkxODQyODY4NzU=-flat-HostContext.cs-44.html,12,runner-MDEwOlJlcG9zaXRvcnkxODQyODY4NzU=-flat-HostContext.cs,runner-MDEwOlJlcG9zaXRvcnkxODQyODY4NzU=-flat-HostContext.cs,466,468,2,462,464,2
45,https://htmlpreview.github.io/?https://github.com/Christina96/boilerplate-sample-matches/blob/main/csharp/dotween-MDEwOlJlcG9zaXRvcnkzMjQ3NTE2Mg==-flat-EnginesComparison.cs-dotween-MDEwOlJlcG9zaXRvcnkzMjQ3NTE2Mg==-flat-EnginesComparison_0.cs-45.html,498,dotween-MDEwOlJlcG9zaXRvcnkzMjQ3NTE2Mg==-flat-EnginesComparison.cs,dotween-MDEwOlJlcG9zaXRvcnkzMjQ3NTE2Mg==-flat-EnginesComparison_0.cs,29,102,73,29,102,73
46,https://htmlpreview.github.io/?https://github.com/Christina96/boilerplate-sample-matches/blob/main/csharp/runner-MDEwOlJlcG9zaXRvcnkxODQyODY4NzU=-flat-TypeExtensionMethods.cs-runner-MDEwOlJlcG9zaXRvcnkxODQyODY4NzU=-flat-TypeExtensionMethods.cs-46.html,25,runner-MDEwOlJlcG9zaXRvcnkxODQyODY4NzU=-flat-TypeExtensionMethods.cs,runner-MDEwOlJlcG9zaXRvcnkxODQyODY4NzU=-flat-TypeExtensionMethods.cs,184,188,4,196,200,4
47,https://htmlpreview.github.io/?https://github.com/Christina96/boilerplate-sample-matches/blob/main/csharp/npgsql-MDEwOlJlcG9zaXRvcnkyODgzNTc0-flat-NpgsqlBatchCommandCollection.cs-npgsql-MDEwOlJlcG9zaXRvcnkyODgzNTc0-flat-NpgsqlParameterCollection.cs-47.html,25,npgsql-MDEwOlJlcG9zaXRvcnkyODgzNTc0-flat-NpgsqlBatchCommandCollection.cs,npgsql-MDEwOlJlcG9zaXRvcnkyODgzNTc0-flat-NpgsqlParameterCollection.cs,55,61,6,445,451,6
48,https://htmlpreview.github.io/?https://github.com/Christina96/boilerplate-sample-matches/blob/main/csharp/npgsql-MDEwOlJlcG9zaXRvcnkyODgzNTc0-flat-NpgsqlDbColumn.cs-npgsql-MDEwOlJlcG9zaXRvcnkyODgzNTc0-flat-NpgsqlDbColumn.cs-48.html,17,npgsql-MDEwOlJlcG9zaXRvcnkyODgzNTc0-flat-NpgsqlDbColumn.cs,npgsql-MDEwOlJlcG9zaXRvcnkyODgzNTc0-flat-NpgsqlDbColumn.cs,52,55,3,22,25,3
49,https://htmlpreview.github.io/?https://github.com/Christina96/boilerplate-sample-matches/blob/main/csharp/runner-MDEwOlJlcG9zaXRvcnkxODQyODY4NzU=-flat-SelfUpdater.cs-runner-MDEwOlJlcG9zaXRvcnkxODQyODY4NzU=-flat-SelfUpdater.cs-49.html,63,runner-MDEwOlJlcG9zaXRvcnkxODQyODY4NzU=-flat-SelfUpdater.cs,runner-MDEwOlJlcG9zaXRvcnkxODQyODY4NzU=-flat-SelfUpdater.cs,770,785,15,794,809,15
50,https://htmlpreview.github.io/?https://github.com/Christina96/boilerplate-sample-matches/blob/main/csharp/EarTrumpet-MDEwOlJlcG9zaXRvcnkzODkxOTcwMg==-flat-EarTrumpetLegacySettingsPageViewModel.cs-EarTrumpet-MDEwOlJlcG9zaXRvcnkzODkxOTcwMg==-flat-EarTrumpetShortcutsPageViewModel.cs-50.html,12,EarTrumpet-MDEwOlJlcG9zaXRvcnkzODkxOTcwMg==-flat-EarTrumpetLegacySettingsPageViewModel.cs,EarTrumpet-MDEwOlJlcG9zaXRvcnkzODkxOTcwMg==-flat-EarTrumpetShortcutsPageViewModel.cs,11,13,2,17,19,2
51,https://htmlpreview.github.io/?https://github.com/Christina96/boilerplate-sample-matches/blob/main/csharp/runner-MDEwOlJlcG9zaXRvcnkxODQyODY4NzU=-flat-CommandLineParser.cs-runner-MDEwOlJlcG9zaXRvcnkxODQyODY4NzU=-flat-CredentialProvider.cs-51.html,22,runner-MDEwOlJlcG9zaXRvcnkxODQyODY4NzU=-flat-CommandLineParser.cs,runner-MDEwOlJlcG9zaXRvcnkxODQyODY4NzU=-flat-CredentialProvider.cs,36,38,2,34,36,2
52,https://htmlpreview.github.io/?https://github.com/Christina96/boilerplate-sample-matches/blob/main/csharp/runner-MDEwOlJlcG9zaXRvcnkxODQyODY4NzU=-flat-JobDispatcher.cs-runner-MDEwOlJlcG9zaXRvcnkxODQyODY4NzU=-flat-JobDispatcher.cs-52.html,19,runner-MDEwOlJlcG9zaXRvcnkxODQyODY4NzU=-flat-JobDispatcher.cs,runner-MDEwOlJlcG9zaXRvcnkxODQyODY4NzU=-flat-JobDispatcher.cs,658,665,7,862,869,7
53,https://htmlpreview.github.io/?https://github.com/Christina96/boilerplate-sample-matches/blob/main/csharp/dotween-MDEwOlJlcG9zaXRvcnkzMjQ3NTE2Mg==-flat-DOTweenProcessors.cs-ZXing.Net.Mobile-MDEwOlJlcG9zaXRvcnk2MTYwNjcz-flat-Performance.shared.cs-53.html,15,dotween-MDEwOlJlcG9zaXRvcnkzMjQ3NTE2Mg==-flat-DOTweenProcessors.cs,ZXing.Net.Mobile-MDEwOlJlcG9zaXRvcnk2MTYwNjcz-flat-Performance.shared.cs,14,15,1,19,21,2
54,https://htmlpreview.github.io/?https://github.com/Christina96/boilerplate-sample-matches/blob/main/csharp/Security-MDEwOlJlcG9zaXRvcnkxNzcyMzY5OQ==-flat-JwtBearerExtensions.cs-Security-MDEwOlJlcG9zaXRvcnkxNzcyMzY5OQ==-flat-CookieExtensions.cs-54.html,78,Security-MDEwOlJlcG9zaXRvcnkxNzcyMzY5OQ==-flat-JwtBearerExtensions.cs,Security-MDEwOlJlcG9zaXRvcnkxNzcyMzY5OQ==-flat-CookieExtensions.cs,15,22,7,17,24,7
55,https://htmlpreview.github.io/?https://github.com/Christina96/boilerplate-sample-matches/blob/main/csharp/runner-MDEwOlJlcG9zaXRvcnkxODQyODY4NzU=-flat-VssOAuthJwtBearerClientCredential.cs-runner-MDEwOlJlcG9zaXRvcnkxODQyODY4NzU=-flat-VssOAuthClientCredentialsGrant.cs-55.html,25,runner-MDEwOlJlcG9zaXRvcnkxODQyODY4NzU=-flat-VssOAuthJwtBearerClientCredential.cs,runner-MDEwOlJlcG9zaXRvcnkxODQyODY4NzU=-flat-VssOAuthClientCredentialsGrant.cs,31,34,3,11,14,3
56,https://htmlpreview.github.io/?https://github.com/Christina96/boilerplate-sample-matches/blob/main/csharp/Simple.Data-MDEwOlJlcG9zaXRvcnk4MTg3Njg=-flat-MockDataParameterCollection.cs-Simple.Data-MDEwOlJlcG9zaXRvcnk4MTg3Njg=-flat-MockDbConnection.cs-56.html,16,Simple.Data-MDEwOlJlcG9zaXRvcnk4MTg3Njg=-flat-MockDataParameterCollection.cs,Simple.Data-MDEwOlJlcG9zaXRvcnk4MTg3Njg=-flat-MockDbConnection.cs,29,33,4,27,31,4
57,https://htmlpreview.github.io/?https://github.com/Christina96/boilerplate-sample-matches/blob/main/csharp/dotween-MDEwOlJlcG9zaXRvcnkzMjQ3NTE2Mg==-flat-EaseCurves_31.cs-dotween-MDEwOlJlcG9zaXRvcnkzMjQ3NTE2Mg==-flat-EaseCurves.cs-57.html,493,dotween-MDEwOlJlcG9zaXRvcnkzMjQ3NTE2Mg==-flat-EaseCurves_31.cs,dotween-MDEwOlJlcG9zaXRvcnkzMjQ3NTE2Mg==-flat-EaseCurves.cs,27,67,40,29,69,40
58,https://htmlpreview.github.io/?https://github.com/Christina96/boilerplate-sample-matches/blob/main/csharp/npgsql-MDEwOlJlcG9zaXRvcnkyODgzNTc0-flat-PgPostmasterMock.cs-runner-MDEwOlJlcG9zaXRvcnkxODQyODY4NzU=-flat-TemplateEvaluator.cs-58.html,12,npgsql-MDEwOlJlcG9zaXRvcnkyODgzNTc0-flat-PgPostmasterMock.cs,runner-MDEwOlJlcG9zaXRvcnkxODQyODY4NzU=-flat-TemplateEvaluator.cs,97,101,4,343,347,4
59,https://htmlpreview.github.io/?https://github.com/Christina96/boilerplate-sample-matches/blob/main/csharp/dotween-MDEwOlJlcG9zaXRvcnkzMjQ3NTE2Mg==-flat-iTween_121.cs-dotween-MDEwOlJlcG9zaXRvcnkzMjQ3NTE2Mg==-flat-iTween.cs-59.html,66,dotween-MDEwOlJlcG9zaXRvcnkzMjQ3NTE2Mg==-flat-iTween_121.cs,dotween-MDEwOlJlcG9zaXRvcnkzMjQ3NTE2Mg==-flat-iTween.cs,1476,1484,8,1476,1484,8
60,https://htmlpreview.github.io/?https://github.com/Christina96/boilerplate-sample-matches/blob/main/csharp/ZXing.Net.Mobile-MDEwOlJlcG9zaXRvcnk2MTYwNjcz-flat-ZXingScannerControl.xaml.cs-ZXing.Net.Mobile-MDEwOlJlcG9zaXRvcnk2MTYwNjcz-flat-ZXingScannerControl.xaml.cs-60.html,20,ZXing.Net.Mobile-MDEwOlJlcG9zaXRvcnk2MTYwNjcz-flat-ZXingScannerControl.xaml.cs,ZXing.Net.Mobile-MDEwOlJlcG9zaXRvcnk2MTYwNjcz-flat-ZXingScannerControl.xaml.cs,163,167,4,130,134,4
61,https://htmlpreview.github.io/?https://github.com/Christina96/boilerplate-sample-matches/blob/main/csharp/npgsql-MDEwOlJlcG9zaXRvcnkyODgzNTc0-flat-NodaTimeTests.cs-npgsql-MDEwOlJlcG9zaXRvcnkyODgzNTc0-flat-NodaTimeTests.cs-61.html,16,npgsql-MDEwOlJlcG9zaXRvcnkyODgzNTc0-flat-NodaTimeTests.cs,npgsql-MDEwOlJlcG9zaXRvcnkyODgzNTc0-flat-NodaTimeTests.cs,386,394,8,429,444,15
62,https://htmlpreview.github.io/?https://github.com/Christina96/boilerplate-sample-matches/blob/main/csharp/MudBlazor-MDEwOlJlcG9zaXRvcnkyODg0Mjg2NzY=-flat-TypeNameHelper.cs-MudBlazor-MDEwOlJlcG9zaXRvcnkyODg0Mjg2NzY=-flat-TypeNameHelper.cs-62.html,14,MudBlazor-MDEwOlJlcG9zaXRvcnkyODg0Mjg2NzY=-flat-TypeNameHelper.cs,MudBlazor-MDEwOlJlcG9zaXRvcnkyODg0Mjg2NzY=-flat-TypeNameHelper.cs,130,132,2,136,138,2
63,https://htmlpreview.github.io/?https://github.com/Christina96/boilerplate-sample-matches/blob/main/csharp/Security-MDEwOlJlcG9zaXRvcnkxNzcyMzY5OQ==-flat-OpenIdConnectPostConfigureOptions.cs-Security-MDEwOlJlcG9zaXRvcnkxNzcyMzY5OQ==-flat-OAuthPostConfigureOptions.cs-63.html,21,Security-MDEwOlJlcG9zaXRvcnkxNzcyMzY5OQ==-flat-OpenIdConnectPostConfigureOptions.cs,Security-MDEwOlJlcG9zaXRvcnkxNzcyMzY5OQ==-flat-OAuthPostConfigureOptions.cs,26,28,2,29,31,2
64,https://htmlpreview.github.io/?https://github.com/Christina96/boilerplate-sample-matches/blob/main/csharp/runner-MDEwOlJlcG9zaXRvcnkxODQyODY4NzU=-flat-ConfigurationManagerL0.cs-runner-MDEwOlJlcG9zaXRvcnkxODQyODY4NzU=-flat-ConfigurationManagerL0.cs-64.html,15,runner-MDEwOlJlcG9zaXRvcnkxODQyODY4NzU=-flat-ConfigurationManagerL0.cs,runner-MDEwOlJlcG9zaXRvcnkxODQyODY4NzU=-flat-ConfigurationManagerL0.cs,132,134,2,268,270,2
65,https://htmlpreview.github.io/?https://github.com/Christina96/boilerplate-sample-matches/blob/main/csharp/runner-MDEwOlJlcG9zaXRvcnkxODQyODY4NzU=-flat-RawHttpClientBase.cs-runner-MDEwOlJlcG9zaXRvcnkxODQyODY4NzU=-flat-VssHttpClientBase.cs-65.html,112,runner-MDEwOlJlcG9zaXRvcnkxODQyODY4NzU=-flat-RawHttpClientBase.cs,runner-MDEwOlJlcG9zaXRvcnkxODQyODY4NzU=-flat-VssHttpClientBase.cs,144,168,24,630,654,24
66,https://htmlpreview.github.io/?https://github.com/Christina96/boilerplate-sample-matches/blob/main/csharp/MudBlazor-MDEwOlJlcG9zaXRvcnkyODg0Mjg2NzY=-flat-EventManager.cs-MudBlazor-MDEwOlJlcG9zaXRvcnkyODg0Mjg2NzY=-flat-MudDropZone.razor.cs-66.html,11,MudBlazor-MDEwOlJlcG9zaXRvcnkyODg0Mjg2NzY=-flat-EventManager.cs,MudBlazor-MDEwOlJlcG9zaXRvcnkyODg0Mjg2NzY=-flat-MudDropZone.razor.cs,138,142,4,320,324,4
67,https://htmlpreview.github.io/?https://github.com/Christina96/boilerplate-sample-matches/blob/main/csharp/MudBlazor-MDEwOlJlcG9zaXRvcnkyODg0Mjg2NzY=-flat-MudPagination.razor.cs-MudBlazor-MDEwOlJlcG9zaXRvcnkyODg0Mjg2NzY=-flat-MudPagination.razor.cs-67.html,44,MudBlazor-MDEwOlJlcG9zaXRvcnkyODg0Mjg2NzY=-flat-MudPagination.razor.cs,MudBlazor-MDEwOlJlcG9zaXRvcnkyODg0Mjg2NzY=-flat-MudPagination.razor.cs,44,57,13,55,68,13
68,https://htmlpreview.github.io/?https://github.com/Christina96/boilerplate-sample-matches/blob/main/csharp/npgsql-MDEwOlJlcG9zaXRvcnkyODgzNTc0-flat-CompositeHandlerTests.Read.cs-npgsql-MDEwOlJlcG9zaXRvcnkyODgzNTc0-flat-CompositeHandlerTests.Write.cs-68.html,36,npgsql-MDEwOlJlcG9zaXRvcnkyODgzNTc0-flat-CompositeHandlerTests.Read.cs,npgsql-MDEwOlJlcG9zaXRvcnkyODgzNTc0-flat-CompositeHandlerTests.Write.cs,8,14,6,8,14,6
69,https://htmlpreview.github.io/?https://github.com/Christina96/boilerplate-sample-matches/blob/main/csharp/npgsql-MDEwOlJlcG9zaXRvcnkyODgzNTc0-flat-PgOutputReplicationOptions.cs-npgsql-MDEwOlJlcG9zaXRvcnkyODgzNTc0-flat-TestDecodingOptions.cs-69.html,16,npgsql-MDEwOlJlcG9zaXRvcnkyODgzNTc0-flat-PgOutputReplicationOptions.cs,npgsql-MDEwOlJlcG9zaXRvcnkyODgzNTc0-flat-TestDecodingOptions.cs,29,31,2,21,23,2
70,https://htmlpreview.github.io/?https://github.com/Christina96/boilerplate-sample-matches/blob/main/csharp/Security-MDEwOlJlcG9zaXRvcnkxNzcyMzY5OQ==-flat-GoogleTests.cs-Security-MDEwOlJlcG9zaXRvcnkxNzcyMzY5OQ==-flat-OAuthTests.cs-70.html,28,Security-MDEwOlJlcG9zaXRvcnkxNzcyMzY5OQ==-flat-GoogleTests.cs,Security-MDEwOlJlcG9zaXRvcnkxNzcyMzY5OQ==-flat-OAuthTests.cs,382,385,3,245,248,3
71,https://htmlpreview.github.io/?https://github.com/Christina96/boilerplate-sample-matches/blob/main/csharp/dotween-MDEwOlJlcG9zaXRvcnkzMjQ3NTE2Mg==-flat-iTween_121.cs-dotween-MDEwOlJlcG9zaXRvcnkzMjQ3NTE2Mg==-flat-iTween.cs-71.html,12,dotween-MDEwOlJlcG9zaXRvcnkzMjQ3NTE2Mg==-flat-iTween_121.cs,dotween-MDEwOlJlcG9zaXRvcnkzMjQ3NTE2Mg==-flat-iTween.cs,1457,1459,2,1914,1916,2
72,https://htmlpreview.github.io/?https://github.com/Christina96/boilerplate-sample-matches/blob/main/csharp/NetCoreServer-MDEwOlJlcG9zaXRvcnkxNjYxMjMxNjQ=-flat-Program_15.cs-NetCoreServer-MDEwOlJlcG9zaXRvcnkxNjYxMjMxNjQ=-flat-Program_10.cs-72.html,305,NetCoreServer-MDEwOlJlcG9zaXRvcnkxNjYxMjMxNjQ=-flat-Program_15.cs,NetCoreServer-MDEwOlJlcG9zaXRvcnkxNjYxMjMxNjQ=-flat-Program_10.cs,17,71,54,15,69,54
73,https://htmlpreview.github.io/?https://github.com/Christina96/boilerplate-sample-matches/blob/main/csharp/dotween-MDEwOlJlcG9zaXRvcnkzMjQ3NTE2Mg==-flat-TweenEnginesComparisonInternal.cs-dotween-MDEwOlJlcG9zaXRvcnkzMjQ3NTE2Mg==-flat-TweenEnginesComparisonInternal_37.cs-73.html,12,dotween-MDEwOlJlcG9zaXRvcnkzMjQ3NTE2Mg==-flat-TweenEnginesComparisonInternal.cs,dotween-MDEwOlJlcG9zaXRvcnkzMjQ3NTE2Mg==-flat-TweenEnginesComparisonInternal_37.cs,507,508,1,91,92,1
74,https://htmlpreview.github.io/?https://github.com/Christina96/boilerplate-sample-matches/blob/main/csharp/dotween-MDEwOlJlcG9zaXRvcnkzMjQ3NTE2Mg==-flat-iTween_121.cs-dotween-MDEwOlJlcG9zaXRvcnkzMjQ3NTE2Mg==-flat-iTween.cs-74.html,15,dotween-MDEwOlJlcG9zaXRvcnkzMjQ3NTE2Mg==-flat-iTween_121.cs,dotween-MDEwOlJlcG9zaXRvcnkzMjQ3NTE2Mg==-flat-iTween.cs,1954,1957,3,1954,1957,3
75,https://htmlpreview.github.io/?https://github.com/Christina96/boilerplate-sample-matches/blob/main/csharp/npgsql-MDEwOlJlcG9zaXRvcnkyODgzNTc0-flat-ReaderOldSchemaTests.cs-npgsql-MDEwOlJlcG9zaXRvcnkyODgzNTc0-flat-ReaderNewSchemaTests.cs-75.html,22,npgsql-MDEwOlJlcG9zaXRvcnkyODgzNTc0-flat-ReaderOldSchemaTests.cs,npgsql-MDEwOlJlcG9zaXRvcnkyODgzNTc0-flat-ReaderNewSchemaTests.cs,63,65,2,197,199,2
76,https://htmlpreview.github.io/?https://github.com/Christina96/boilerplate-sample-matches/blob/main/csharp/dotween-MDEwOlJlcG9zaXRvcnkzMjQ3NTE2Mg==-flat-AbstractGoTween_98.cs-dotween-MDEwOlJlcG9zaXRvcnkzMjQ3NTE2Mg==-flat-AbstractGoTween_98.cs-76.html,19,dotween-MDEwOlJlcG9zaXRvcnkzMjQ3NTE2Mg==-flat-AbstractGoTween_98.cs,dotween-MDEwOlJlcG9zaXRvcnkzMjQ3NTE2Mg==-flat-AbstractGoTween_98.cs,68,74,6,80,86,6
77,https://htmlpreview.github.io/?https://github.com/Christina96/boilerplate-sample-matches/blob/main/csharp/npgsql-MDEwOlJlcG9zaXRvcnkyODgzNTc0-flat-ReplicationConnection.cs-npgsql-MDEwOlJlcG9zaXRvcnkyODgzNTc0-flat-ReplicationConnection.cs-77.html,18,npgsql-MDEwOlJlcG9zaXRvcnkyODgzNTc0-flat-ReplicationConnection.cs,npgsql-MDEwOlJlcG9zaXRvcnkyODgzNTc0-flat-ReplicationConnection.cs,293,294,1,294,295,1
78,https://htmlpreview.github.io/?https://github.com/Christina96/boilerplate-sample-matches/blob/main/csharp/20486D-DevelopingASPNETMVCWebApplications-MDEwOlJlcG9zaXRvcnkxMTkzNTI2Mzc=-flat-PersonProvider.cs-20486D-DevelopingASPNETMVCWebApplications-MDEwOlJlcG9zaXRvcnkxMTkzNTI2Mzc=-flat-PersonProvider_420.cs-78.html,17,20486D-DevelopingASPNETMVCWebApplications-MDEwOlJlcG9zaXRvcnkxMTkzNTI2Mzc=-flat-PersonProvider.cs,20486D-DevelopingASPNETMVCWebApplications-MDEwOlJlcG9zaXRvcnkxMTkzNTI2Mzc=-flat-PersonProvider_420.cs,24,25,1,30,31,1
79,https://htmlpreview.github.io/?https://github.com/Christina96/boilerplate-sample-matches/blob/main/csharp/NetCoreServer-MDEwOlJlcG9zaXRvcnkxNjYxMjMxNjQ=-flat-com.chronoxor.simple.cs-NetCoreServer-MDEwOlJlcG9zaXRvcnkxNjYxMjMxNjQ=-flat-com.chronoxor.simple.cs-79.html,797,NetCoreServer-MDEwOlJlcG9zaXRvcnkxNjYxMjMxNjQ=-flat-com.chronoxor.simple.cs,NetCoreServer-MDEwOlJlcG9zaXRvcnkxNjYxMjMxNjQ=-flat-com.chronoxor.simple.cs,1502,1581,79,1909,1988,79
80,https://htmlpreview.github.io/?https://github.com/Christina96/boilerplate-sample-matches/blob/main/csharp/Simple.Data-MDEwOlJlcG9zaXRvcnk4MTg3Njg=-flat-Table.cs-EarTrumpet-MDEwOlJlcG9zaXRvcnkzODkxOTcwMg==-flat-AudioDevice.cs-80.html,15,Simple.Data-MDEwOlJlcG9zaXRvcnk4MTg3Njg=-flat-Table.cs,EarTrumpet-MDEwOlJlcG9zaXRvcnkzODkxOTcwMg==-flat-AudioDevice.cs,28,30,2,36,38,2
81,https://htmlpreview.github.io/?https://github.com/Christina96/boilerplate-sample-matches/blob/main/csharp/runner-MDEwOlJlcG9zaXRvcnkxODQyODY4NzU=-flat-StepsRunner.cs-runner-MDEwOlJlcG9zaXRvcnkxODQyODY4NzU=-flat-CompositeActionHandler.cs-81.html,19,runner-MDEwOlJlcG9zaXRvcnkxODQyODY4NzU=-flat-StepsRunner.cs,runner-MDEwOlJlcG9zaXRvcnkxODQyODY4NzU=-flat-CompositeActionHandler.cs,262,264,2,367,369,2
82,https://htmlpreview.github.io/?https://github.com/Christina96/boilerplate-sample-matches/blob/main/csharp/ZXing.Net.Mobile-MDEwOlJlcG9zaXRvcnk2MTYwNjcz-flat-ZXingScannerWindow.tizen.cs-ZXing.Net.Mobile-MDEwOlJlcG9zaXRvcnk2MTYwNjcz-flat-ZXingMediaView.tizen.cs-82.html,17,ZXing.Net.Mobile-MDEwOlJlcG9zaXRvcnk2MTYwNjcz-flat-ZXingScannerWindow.tizen.cs,ZXing.Net.Mobile-MDEwOlJlcG9zaXRvcnk2MTYwNjcz-flat-ZXingMediaView.tizen.cs,11,14,3,30,33,3
83,https://htmlpreview.github.io/?https://github.com/Christina96/boilerplate-sample-matches/blob/main/csharp/runner-MDEwOlJlcG9zaXRvcnkxODQyODY4NzU=-flat-ActionManagerL0.cs-runner-MDEwOlJlcG9zaXRvcnkxODQyODY4NzU=-flat-ActionManagerL0.cs-83.html,40,runner-MDEwOlJlcG9zaXRvcnkxODQyODY4NzU=-flat-ActionManagerL0.cs,runner-MDEwOlJlcG9zaXRvcnkxODQyODY4NzU=-flat-ActionManagerL0.cs,1865,1873,8,1883,1891,8
84,https://htmlpreview.github.io/?https://github.com/Christina96/boilerplate-sample-matches/blob/main/csharp/npgsql-MDEwOlJlcG9zaXRvcnkyODgzNTc0-flat-BatchTests.cs-npgsql-MDEwOlJlcG9zaXRvcnkyODgzNTc0-flat-BatchTests.cs-84.html,65,npgsql-MDEwOlJlcG9zaXRvcnkyODgzNTc0-flat-BatchTests.cs,npgsql-MDEwOlJlcG9zaXRvcnkyODgzNTc0-flat-BatchTests.cs,196,205,9,210,219,9
85,https://htmlpreview.github.io/?https://github.com/Christina96/boilerplate-sample-matches/blob/main/csharp/npgsql-MDEwOlJlcG9zaXRvcnkyODgzNTc0-flat-CommonLogicalReplicationTests.cs-npgsql-MDEwOlJlcG9zaXRvcnkyODgzNTc0-flat-CommonLogicalReplicationTests.cs-85.html,73,npgsql-MDEwOlJlcG9zaXRvcnkyODgzNTc0-flat-CommonLogicalReplicationTests.cs,npgsql-MDEwOlJlcG9zaXRvcnkyODgzNTc0-flat-CommonLogicalReplicationTests.cs,86,93,7,103,110,7
86,https://htmlpreview.github.io/?https://github.com/Christina96/boilerplate-sample-matches/blob/main/csharp/npgsql-MDEwOlJlcG9zaXRvcnkyODgzNTc0-flat-FunctionTests.cs-npgsql-MDEwOlJlcG9zaXRvcnkyODgzNTc0-flat-FunctionTests.cs-86.html,13,npgsql-MDEwOlJlcG9zaXRvcnkyODgzNTc0-flat-FunctionTests.cs,npgsql-MDEwOlJlcG9zaXRvcnkyODgzNTc0-flat-FunctionTests.cs,111,114,3,116,119,3
87,https://htmlpreview.github.io/?https://github.com/Christina96/boilerplate-sample-matches/blob/main/csharp/npgsql-MDEwOlJlcG9zaXRvcnkyODgzNTc0-flat-NpgsqlParameterCollectionTests.cs-npgsql-MDEwOlJlcG9zaXRvcnkyODgzNTc0-flat-NpgsqlParameterCollectionTests.cs-87.html,21,npgsql-MDEwOlJlcG9zaXRvcnkyODgzNTc0-flat-NpgsqlParameterCollectionTests.cs,npgsql-MDEwOlJlcG9zaXRvcnkyODgzNTc0-flat-NpgsqlParameterCollectionTests.cs,202,203,1,204,205,1
88,https://htmlpreview.github.io/?https://github.com/Christina96/boilerplate-sample-matches/blob/main/csharp/npgsql-MDEwOlJlcG9zaXRvcnkyODgzNTc0-flat-TestBase.cs-npgsql-MDEwOlJlcG9zaXRvcnkyODgzNTc0-flat-TestBase.cs-88.html,24,npgsql-MDEwOlJlcG9zaXRvcnkyODgzNTc0-flat-TestBase.cs,npgsql-MDEwOlJlcG9zaXRvcnkyODgzNTc0-flat-TestBase.cs,61,66,5,43,48,5
89,https://htmlpreview.github.io/?https://github.com/Christina96/boilerplate-sample-matches/blob/main/csharp/dotween-MDEwOlJlcG9zaXRvcnkzMjQ3NTE2Mg==-flat-LeanTween_56.cs-dotween-MDEwOlJlcG9zaXRvcnkzMjQ3NTE2Mg==-flat-LeanTween.cs-89.html,959,dotween-MDEwOlJlcG9zaXRvcnkzMjQ3NTE2Mg==-flat-LeanTween_56.cs,dotween-MDEwOlJlcG9zaXRvcnkzMjQ3NTE2Mg==-flat-LeanTween.cs,689,811,122,689,811,122
90,https://htmlpreview.github.io/?https://github.com/Christina96/boilerplate-sample-matches/blob/main/csharp/npgsql-MDEwOlJlcG9zaXRvcnkyODgzNTc0-flat-NpgsqlBatchCommand.cs-MudBlazor-MDEwOlJlcG9zaXRvcnkyODg0Mjg2NzY=-flat-MudNumericField.razor.cs-90.html,15,npgsql-MDEwOlJlcG9zaXRvcnkyODgzNTc0-flat-NpgsqlBatchCommand.cs,MudBlazor-MDEwOlJlcG9zaXRvcnkyODg0Mjg2NzY=-flat-MudNumericField.razor.cs,24,25,1,293,294,1
91,https://htmlpreview.github.io/?https://github.com/Christina96/boilerplate-sample-matches/blob/main/csharp/dotween-MDEwOlJlcG9zaXRvcnkzMjQ3NTE2Mg==-flat-PositionTweenProperty.cs-dotween-MDEwOlJlcG9zaXRvcnkzMjQ3NTE2Mg==-flat-PositionTweenProperty_93.cs-91.html,12,dotween-MDEwOlJlcG9zaXRvcnkzMjQ3NTE2Mg==-flat-PositionTweenProperty.cs,dotween-MDEwOlJlcG9zaXRvcnkzMjQ3NTE2Mg==-flat-PositionTweenProperty_93.cs,44,48,4,36,40,4
92,https://htmlpreview.github.io/?https://github.com/Christina96/boilerplate-sample-matches/blob/main/csharp/dotween-MDEwOlJlcG9zaXRvcnkzMjQ3NTE2Mg==-flat-LeanTween_56.cs-dotween-MDEwOlJlcG9zaXRvcnkzMjQ3NTE2Mg==-flat-LeanTween.cs-92.html,12,dotween-MDEwOlJlcG9zaXRvcnkzMjQ3NTE2Mg==-flat-LeanTween_56.cs,dotween-MDEwOlJlcG9zaXRvcnkzMjQ3NTE2Mg==-flat-LeanTween.cs,1185,1186,1,1185,1186,1
93,https://htmlpreview.github.io/?https://github.com/Christina96/boilerplate-sample-matches/blob/main/csharp/npgsql-MDEwOlJlcG9zaXRvcnkyODgzNTc0-flat-NpgsqlDataReader.cs-npgsql-MDEwOlJlcG9zaXRvcnkyODgzNTc0-flat-NpgsqlNestedDataReader.cs-93.html,16,npgsql-MDEwOlJlcG9zaXRvcnkyODgzNTc0-flat-NpgsqlDataReader.cs,npgsql-MDEwOlJlcG9zaXRvcnkyODgzNTc0-flat-NpgsqlNestedDataReader.cs,896,898,2,134,136,2
94,https://htmlpreview.github.io/?https://github.com/Christina96/boilerplate-sample-matches/blob/main/csharp/dotween-MDEwOlJlcG9zaXRvcnkzMjQ3NTE2Mg==-flat-EaseCurves_31.cs-dotween-MDEwOlJlcG9zaXRvcnkzMjQ3NTE2Mg==-flat-EaseCurves.cs-94.html,339,dotween-MDEwOlJlcG9zaXRvcnkzMjQ3NTE2Mg==-flat-EaseCurves_31.cs,dotween-MDEwOlJlcG9zaXRvcnkzMjQ3NTE2Mg==-flat-EaseCurves.cs,39,67,28,41,69,28
95,https://htmlpreview.github.io/?https://github.com/Christina96/boilerplate-sample-matches/blob/main/csharp/dotween-MDEwOlJlcG9zaXRvcnkzMjQ3NTE2Mg==-flat-TweenManager_146.cs-dotween-MDEwOlJlcG9zaXRvcnkzMjQ3NTE2Mg==-flat-TweenManager_146.cs-95.html,15,dotween-MDEwOlJlcG9zaXRvcnkzMjQ3NTE2Mg==-flat-TweenManager_146.cs,dotween-MDEwOlJlcG9zaXRvcnkzMjQ3NTE2Mg==-flat-TweenManager_146.cs,742,745,3,794,797,3
96,https://htmlpreview.github.io/?https://github.com/Christina96/boilerplate-sample-matches/blob/main/csharp/npgsql-MDEwOlJlcG9zaXRvcnkyODgzNTc0-flat-TextHandler.cs-Simple.Data-MDEwOlJlcG9zaXRvcnk4MTg3Njg=-flat-AdoAdapterInserter.cs-96.html,21,npgsql-MDEwOlJlcG9zaXRvcnkyODgzNTc0-flat-TextHandler.cs,Simple.Data-MDEwOlJlcG9zaXRvcnk4MTg3Njg=-flat-AdoAdapterInserter.cs,201,203,2,49,51,2
97,https://htmlpreview.github.io/?https://github.com/Christina96/boilerplate-sample-matches/blob/main/csharp/dotween-MDEwOlJlcG9zaXRvcnkzMjQ3NTE2Mg==-flat-GoSpline.cs-dotween-MDEwOlJlcG9zaXRvcnkzMjQ3NTE2Mg==-flat-GoSpline_65.cs-97.html,395,dotween-MDEwOlJlcG9zaXRvcnkzMjQ3NTE2Mg==-flat-GoSpline.cs,dotween-MDEwOlJlcG9zaXRvcnkzMjQ3NTE2Mg==-flat-GoSpline_65.cs,72,153,81,72,153,81
98,https://htmlpreview.github.io/?https://github.com/Christina96/boilerplate-sample-matches/blob/main/csharp/runner-MDEwOlJlcG9zaXRvcnkxODQyODY4NzU=-flat-ContainerActionHandler.cs-runner-MDEwOlJlcG9zaXRvcnkxODQyODY4NzU=-flat-ContainerActionHandler.cs-98.html,15,runner-MDEwOlJlcG9zaXRvcnkxODQyODY4NzU=-flat-ContainerActionHandler.cs,runner-MDEwOlJlcG9zaXRvcnkxODQyODY4NzU=-flat-ContainerActionHandler.cs,164,165,1,162,163,1
99,https://htmlpreview.github.io/?https://github.com/Christina96/boilerplate-sample-matches/blob/main/csharp/npgsql-MDEwOlJlcG9zaXRvcnkyODgzNTc0-flat-GlobalTypeMapper.cs-npgsql-MDEwOlJlcG9zaXRvcnkyODgzNTc0-flat-GlobalTypeMapper.cs-99.html,36,npgsql-MDEwOlJlcG9zaXRvcnkyODgzNTc0-flat-GlobalTypeMapper.cs,npgsql-MDEwOlJlcG9zaXRvcnkyODgzNTc0-flat-GlobalTypeMapper.cs,38,49,11,79,90,11
100,https://htmlpreview.github.io/?https://github.com/Christina96/boilerplate-sample-matches/blob/main/csharp/runner-MDEwOlJlcG9zaXRvcnkxODQyODY4NzU=-flat-VssResponseContext.cs-runner-MDEwOlJlcG9zaXRvcnkxODQyODY4NzU=-flat-JobServerQueue.cs-100.html,21,runner-MDEwOlJlcG9zaXRvcnkxODQyODY4NzU=-flat-VssResponseContext.cs,runner-MDEwOlJlcG9zaXRvcnkxODQyODY4NzU=-flat-JobServerQueue.cs,23,26,3,481,484,3
101,https://htmlpreview.github.io/?https://github.com/Christina96/boilerplate-sample-matches/blob/main/csharp/runner-MDEwOlJlcG9zaXRvcnkxODQyODY4NzU=-flat-TaskAgentHttpClientBase.cs-runner-MDEwOlJlcG9zaXRvcnkxODQyODY4NzU=-flat-PipelinesHttpClientBase.cs-101.html,15,runner-MDEwOlJlcG9zaXRvcnkxODQyODY4NzU=-flat-TaskAgentHttpClientBase.cs,runner-MDEwOlJlcG9zaXRvcnkxODQyODY4NzU=-flat-PipelinesHttpClientBase.cs,284,287,3,80,83,3
102,https://htmlpreview.github.io/?https://github.com/Christina96/boilerplate-sample-matches/blob/main/csharp/ZXing.Net.Mobile-MDEwOlJlcG9zaXRvcnk2MTYwNjcz-flat-HomeViewController.cs-ZXing.Net.Mobile-MDEwOlJlcG9zaXRvcnk2MTYwNjcz-flat-MainActivity.cs-102.html,17,ZXing.Net.Mobile-MDEwOlJlcG9zaXRvcnk2MTYwNjcz-flat-HomeViewController.cs,ZXing.Net.Mobile-MDEwOlJlcG9zaXRvcnk2MTYwNjcz-flat-MainActivity.cs,92,95,3,99,102,3
103,https://htmlpreview.github.io/?https://github.com/Christina96/boilerplate-sample-matches/blob/main/csharp/runner-MDEwOlJlcG9zaXRvcnkxODQyODY4NzU=-flat-PropertiesCollection.cs-runner-MDEwOlJlcG9zaXRvcnkxODQyODY4NzU=-flat-PropertiesCollection.cs-103.html,42,runner-MDEwOlJlcG9zaXRvcnkxODQyODY4NzU=-flat-PropertiesCollection.cs,runner-MDEwOlJlcG9zaXRvcnkxODQyODY4NzU=-flat-PropertiesCollection.cs,180,184,4,195,199,4
104,https://htmlpreview.github.io/?https://github.com/Christina96/boilerplate-sample-matches/blob/main/csharp/NetCoreServer-MDEwOlJlcG9zaXRvcnkxNjYxMjMxNjQ=-flat-com.chronoxor.fbe.cs-NetCoreServer-MDEwOlJlcG9zaXRvcnkxNjYxMjMxNjQ=-flat-com.chronoxor.fbe.cs-104.html,224,NetCoreServer-MDEwOlJlcG9zaXRvcnkxNjYxMjMxNjQ=-flat-com.chronoxor.fbe.cs,NetCoreServer-MDEwOlJlcG9zaXRvcnkxNjYxMjMxNjQ=-flat-com.chronoxor.fbe.cs,1204,1231,27,1315,1342,27
105,https://htmlpreview.github.io/?https://github.com/Christina96/boilerplate-sample-matches/blob/main/csharp/dotween-MDEwOlJlcG9zaXRvcnkzMjQ3NTE2Mg==-flat-ShakePunch.cs-dotween-MDEwOlJlcG9zaXRvcnkzMjQ3NTE2Mg==-flat-ShakePunch_30.cs-105.html,339,dotween-MDEwOlJlcG9zaXRvcnkzMjQ3NTE2Mg==-flat-ShakePunch.cs,dotween-MDEwOlJlcG9zaXRvcnkzMjQ3NTE2Mg==-flat-ShakePunch_30.cs,25,75,50,23,73,50
106,https://htmlpreview.github.io/?https://github.com/Christina96/boilerplate-sample-matches/blob/main/csharp/runner-MDEwOlJlcG9zaXRvcnkxODQyODY4NzU=-flat-MappingToken.cs-MudBlazor-MDEwOlJlcG9zaXRvcnkyODg0Mjg2NzY=-flat-MudDebouncedInput.cs-106.html,13,runner-MDEwOlJlcG9zaXRvcnkxODQyODY4NzU=-flat-MappingToken.cs,MudBlazor-MDEwOlJlcG9zaXRvcnkyODg0Mjg2NzY=-flat-MudDebouncedInput.cs,178,182,4,56,60,4
107,https://htmlpreview.github.io/?https://github.com/Christina96/boilerplate-sample-matches/blob/main/csharp/runner-MDEwOlJlcG9zaXRvcnkxODQyODY4NzU=-flat-ArtifactJsonConverter.cs-runner-MDEwOlJlcG9zaXRvcnkxODQyODY4NzU=-flat-CreateArtifactParametersJsonConverter.cs-107.html,37,runner-MDEwOlJlcG9zaXRvcnkxODQyODY4NzU=-flat-ArtifactJsonConverter.cs,runner-MDEwOlJlcG9zaXRvcnkxODQyODY4NzU=-flat-CreateArtifactParametersJsonConverter.cs,12,26,14,12,26,14
108,https://htmlpreview.github.io/?https://github.com/Christina96/boilerplate-sample-matches/blob/main/csharp/Security-MDEwOlJlcG9zaXRvcnkxNzcyMzY5OQ==-flat-WsFederationExtensions.cs-Security-MDEwOlJlcG9zaXRvcnkxNzcyMzY5OQ==-flat-OpenIdConnectExtensions.cs-108.html,19,Security-MDEwOlJlcG9zaXRvcnkxNzcyMzY5OQ==-flat-WsFederationExtensions.cs,Security-MDEwOlJlcG9zaXRvcnkxNzcyMzY5OQ==-flat-OpenIdConnectExtensions.cs,19,22,3,19,22,3
109,https://htmlpreview.github.io/?https://github.com/Christina96/boilerplate-sample-matches/blob/main/csharp/Simple.Data-MDEwOlJlcG9zaXRvcnk4MTg3Njg=-flat-BulkInsertTest.cs-Simple.Data-MDEwOlJlcG9zaXRvcnk4MTg3Njg=-flat-BulkInsertTest.cs-109.html,13,Simple.Data-MDEwOlJlcG9zaXRvcnk4MTg3Njg=-flat-BulkInsertTest.cs,Simple.Data-MDEwOlJlcG9zaXRvcnk4MTg3Njg=-flat-BulkInsertTest.cs,24,25,1,39,40,1
110,https://htmlpreview.github.io/?https://github.com/Christina96/boilerplate-sample-matches/blob/main/csharp/NetCoreServer-MDEwOlJlcG9zaXRvcnkxNjYxMjMxNjQ=-flat-Program_27.cs-NetCoreServer-MDEwOlJlcG9zaXRvcnkxNjYxMjMxNjQ=-flat-Program_31.cs-110.html,64,NetCoreServer-MDEwOlJlcG9zaXRvcnkxNjYxMjMxNjQ=-flat-Program_27.cs,NetCoreServer-MDEwOlJlcG9zaXRvcnkxNjYxMjMxNjQ=-flat-Program_31.cs,132,144,12,113,125,12
111,https://htmlpreview.github.io/?https://github.com/Christina96/boilerplate-sample-matches/blob/main/csharp/runner-MDEwOlJlcG9zaXRvcnkxODQyODY4NzU=-flat-JobEvent.cs-runner-MDEwOlJlcG9zaXRvcnkxODQyODY4NzU=-flat-JobEvent.cs-111.html,20,runner-MDEwOlJlcG9zaXRvcnkxODQyODY4NzU=-flat-JobEvent.cs,runner-MDEwOlJlcG9zaXRvcnkxODQyODY4NzU=-flat-JobEvent.cs,86,93,7,74,80,6
112,https://htmlpreview.github.io/?https://github.com/Christina96/boilerplate-sample-matches/blob/main/csharp/npgsql-MDEwOlJlcG9zaXRvcnkyODgzNTc0-flat-CommandTests.cs-npgsql-MDEwOlJlcG9zaXRvcnkyODgzNTc0-flat-ReaderTests.cs-112.html,16,npgsql-MDEwOlJlcG9zaXRvcnkyODgzNTc0-flat-CommandTests.cs,npgsql-MDEwOlJlcG9zaXRvcnkyODgzNTc0-flat-ReaderTests.cs,743,751,8,776,788,12
113,https://htmlpreview.github.io/?https://github.com/Christina96/boilerplate-sample-matches/blob/main/csharp/Security-MDEwOlJlcG9zaXRvcnkxNzcyMzY5OQ==-flat-WsFederationTest.cs-Security-MDEwOlJlcG9zaXRvcnkxNzcyMzY5OQ==-flat-WsFederationTest.cs-113.html,18,Security-MDEwOlJlcG9zaXRvcnkxNzcyMzY5OQ==-flat-WsFederationTest.cs,Security-MDEwOlJlcG9zaXRvcnkxNzcyMzY5OQ==-flat-WsFederationTest.cs,195,196,1,203,204,1
114,https://htmlpreview.github.io/?https://github.com/Christina96/boilerplate-sample-matches/blob/main/csharp/ZXing.Net.Mobile-MDEwOlJlcG9zaXRvcnk2MTYwNjcz-flat-MobileBarcodeScanner.android.cs-ZXing.Net.Mobile-MDEwOlJlcG9zaXRvcnk2MTYwNjcz-flat-MainPage.xaml_1.cs-114.html,16,ZXing.Net.Mobile-MDEwOlJlcG9zaXRvcnk2MTYwNjcz-flat-MobileBarcodeScanner.android.cs,ZXing.Net.Mobile-MDEwOlJlcG9zaXRvcnk2MTYwNjcz-flat-MainPage.xaml_1.cs,49,51,2,29,31,2
115,https://htmlpreview.github.io/?https://github.com/Christina96/boilerplate-sample-matches/blob/main/csharp/runner-MDEwOlJlcG9zaXRvcnkxODQyODY4NzU=-flat-MessageListener.cs-runner-MDEwOlJlcG9zaXRvcnkxODQyODY4NzU=-flat-BrokerMessageListener.cs-115.html,20,runner-MDEwOlJlcG9zaXRvcnkxODQyODY4NzU=-flat-MessageListener.cs,runner-MDEwOlJlcG9zaXRvcnkxODQyODY4NzU=-flat-BrokerMessageListener.cs,269,274,5,140,145,5
116,https://htmlpreview.github.io/?https://github.com/Christina96/boilerplate-sample-matches/blob/main/csharp/dotween-MDEwOlJlcG9zaXRvcnkzMjQ3NTE2Mg==-flat-Pooling.cs-dotween-MDEwOlJlcG9zaXRvcnkzMjQ3NTE2Mg==-flat-Pooling.cs-116.html,38,dotween-MDEwOlJlcG9zaXRvcnkzMjQ3NTE2Mg==-flat-Pooling.cs,dotween-MDEwOlJlcG9zaXRvcnkzMjQ3NTE2Mg==-flat-Pooling.cs,101,104,3,87,90,3
117,https://htmlpreview.github.io/?https://github.com/Christina96/boilerplate-sample-matches/blob/main/csharp/dotween-MDEwOlJlcG9zaXRvcnkzMjQ3NTE2Mg==-flat-GoSmoothedQuaternion_87.cs-dotween-MDEwOlJlcG9zaXRvcnkzMjQ3NTE2Mg==-flat-GoSmoothedVector3.cs-117.html,69,dotween-MDEwOlJlcG9zaXRvcnkzMjQ3NTE2Mg==-flat-GoSmoothedQuaternion_87.cs,dotween-MDEwOlJlcG9zaXRvcnkzMjQ3NTE2Mg==-flat-GoSmoothedVector3.cs,20,36,16,20,36,16
118,https://htmlpreview.github.io/?https://github.com/Christina96/boilerplate-sample-matches/blob/main/csharp/EarTrumpet-MDEwOlJlcG9zaXRvcnkzODkxOTcwMg==-flat-HotkeyData.cs-Simple.Data-MDEwOlJlcG9zaXRvcnk4MTg3Njg=-flat-ConcreteTypeCreatorTest.cs-118.html,13,EarTrumpet-MDEwOlJlcG9zaXRvcnkzODkxOTcwMg==-flat-HotkeyData.cs,Simple.Data-MDEwOlJlcG9zaXRvcnk4MTg3Njg=-flat-ConcreteTypeCreatorTest.cs,14,17,3,88,91,3
119,https://htmlpreview.github.io/?https://github.com/Christina96/boilerplate-sample-matches/blob/main/csharp/dotween-MDEwOlJlcG9zaXRvcnkzMjQ3NTE2Mg==-flat-LeanTween.cs-dotween-MDEwOlJlcG9zaXRvcnkzMjQ3NTE2Mg==-flat-LeanTween.cs-119.html,57,dotween-MDEwOlJlcG9zaXRvcnkzMjQ3NTE2Mg==-flat-LeanTween.cs,dotween-MDEwOlJlcG9zaXRvcnkzMjQ3NTE2Mg==-flat-LeanTween.cs,1753,1758,5,1761,1766,5
120,https://htmlpreview.github.io/?https://github.com/Christina96/boilerplate-sample-matches/blob/main/csharp/dotween-MDEwOlJlcG9zaXRvcnkzMjQ3NTE2Mg==-flat-iTween_121.cs-dotween-MDEwOlJlcG9zaXRvcnkzMjQ3NTE2Mg==-flat-iTween.cs-120.html,2592,dotween-MDEwOlJlcG9zaXRvcnkzMjQ3NTE2Mg==-flat-iTween_121.cs,dotween-MDEwOlJlcG9zaXRvcnkzMjQ3NTE2Mg==-flat-iTween.cs,1154,1426,272,1154,1426,272
121,https://htmlpreview.github.io/?https://github.com/Christina96/boilerplate-sample-matches/blob/main/csharp/dotween-MDEwOlJlcG9zaXRvcnkzMjQ3NTE2Mg==-flat-AbstractTweenProperty_74.cs-dotween-MDEwOlJlcG9zaXRvcnkzMjQ3NTE2Mg==-flat-AbstractTweenProperty.cs-121.html,13,dotween-MDEwOlJlcG9zaXRvcnkzMjQ3NTE2Mg==-flat-AbstractTweenProperty_74.cs,dotween-MDEwOlJlcG9zaXRvcnkzMjQ3NTE2Mg==-flat-AbstractTweenProperty.cs,29,32,3,29,32,3
122,https://htmlpreview.github.io/?https://github.com/Christina96/boilerplate-sample-matches/blob/main/csharp/dotween-MDEwOlJlcG9zaXRvcnkzMjQ3NTE2Mg==-flat-iTween_121.cs-dotween-MDEwOlJlcG9zaXRvcnkzMjQ3NTE2Mg==-flat-iTween.cs-122.html,20,dotween-MDEwOlJlcG9zaXRvcnkzMjQ3NTE2Mg==-flat-iTween_121.cs,dotween-MDEwOlJlcG9zaXRvcnkzMjQ3NTE2Mg==-flat-iTween.cs,1932,1936,4,2016,2020,4
123,https://htmlpreview.github.io/?https://github.com/Christina96/boilerplate-sample-matches/blob/main/csharp/EarTrumpet-MDEwOlJlcG9zaXRvcnkzODkxOTcwMg==-flat-ResourceLoader.cs-EarTrumpet-MDEwOlJlcG9zaXRvcnkzODkxOTcwMg==-flat-ResourceLoader.cs-123.html,16,EarTrumpet-MDEwOlJlcG9zaXRvcnkzODkxOTcwMg==-flat-ResourceLoader.cs,EarTrumpet-MDEwOlJlcG9zaXRvcnkzODkxOTcwMg==-flat-ResourceLoader.cs,18,21,3,25,28,3
124,https://htmlpreview.github.io/?https://github.com/Christina96/boilerplate-sample-matches/blob/main/csharp/dotween-MDEwOlJlcG9zaXRvcnkzMjQ3NTE2Mg==-flat-Basics.cs-dotween-MDEwOlJlcG9zaXRvcnkzMjQ3NTE2Mg==-flat-Basics_22.cs-124.html,636,dotween-MDEwOlJlcG9zaXRvcnkzMjQ3NTE2Mg==-flat-Basics.cs,dotween-MDEwOlJlcG9zaXRvcnkzMjQ3NTE2Mg==-flat-Basics_22.cs,35,89,54,31,85,54
125,https://htmlpreview.github.io/?https://github.com/Christina96/boilerplate-sample-matches/blob/main/csharp/npgsql-MDEwOlJlcG9zaXRvcnkyODgzNTc0-flat-NpgsqlTsQuery.cs-npgsql-MDEwOlJlcG9zaXRvcnkyODgzNTc0-flat-NpgsqlTsQuery.cs-125.html,19,npgsql-MDEwOlJlcG9zaXRvcnkyODgzNTc0-flat-NpgsqlTsQuery.cs,npgsql-MDEwOlJlcG9zaXRvcnkyODgzNTc0-flat-NpgsqlTsQuery.cs,360,364,4,439,443,4
126,https://htmlpreview.github.io/?https://github.com/Christina96/boilerplate-sample-matches/blob/main/csharp/dotween-MDEwOlJlcG9zaXRvcnkzMjQ3NTE2Mg==-flat-LeanTween_56.cs-dotween-MDEwOlJlcG9zaXRvcnkzMjQ3NTE2Mg==-flat-LeanTween_56.cs-126.html,23,dotween-MDEwOlJlcG9zaXRvcnkzMjQ3NTE2Mg==-flat-LeanTween_56.cs,dotween-MDEwOlJlcG9zaXRvcnkzMjQ3NTE2Mg==-flat-LeanTween_56.cs,1560,1562,2,1524,1526,2
127,https://htmlpreview.github.io/?https://github.com/Christina96/boilerplate-sample-matches/blob/main/csharp/Security-MDEwOlJlcG9zaXRvcnkxNzcyMzY5OQ==-flat-TestSettings.cs-Security-MDEwOlJlcG9zaXRvcnkxNzcyMzY5OQ==-flat-TestSettings.cs-127.html,17,Security-MDEwOlJlcG9zaXRvcnkxNzcyMzY5OQ==-flat-TestSettings.cs,Security-MDEwOlJlcG9zaXRvcnkxNzcyMzY5OQ==-flat-TestSettings.cs,183,185,2,186,188,2
128,https://htmlpreview.github.io/?https://github.com/Christina96/boilerplate-sample-matches/blob/main/csharp/ZXing.Net.Mobile-MDEwOlJlcG9zaXRvcnk2MTYwNjcz-flat-MobileBarcodeScanningOptions.shared.cs-ZXing.Net.Mobile-MDEwOlJlcG9zaXRvcnk2MTYwNjcz-flat-MobileBarcodeScanningOptions.shared.cs-128.html,16,ZXing.Net.Mobile-MDEwOlJlcG9zaXRvcnk2MTYwNjcz-flat-MobileBarcodeScanningOptions.shared.cs,ZXing.Net.Mobile-MDEwOlJlcG9zaXRvcnk2MTYwNjcz-flat-MobileBarcodeScanningOptions.shared.cs,53,55,2,47,49,2
129,https://htmlpreview.github.io/?https://github.com/Christina96/boilerplate-sample-matches/blob/main/csharp/npgsql-MDEwOlJlcG9zaXRvcnkyODgzNTc0-flat-PostgresDatabaseInfo.cs-npgsql-MDEwOlJlcG9zaXRvcnkyODgzNTc0-flat-PostgresDatabaseInfo.cs-129.html,17,npgsql-MDEwOlJlcG9zaXRvcnkyODgzNTc0-flat-PostgresDatabaseInfo.cs,npgsql-MDEwOlJlcG9zaXRvcnkyODgzNTc0-flat-PostgresDatabaseInfo.cs,80,85,5,85,95,10
130,https://htmlpreview.github.io/?https://github.com/Christina96/boilerplate-sample-matches/blob/main/csharp/Simple.Data-MDEwOlJlcG9zaXRvcnk4MTg3Njg=-flat-SchemaQualifiedTests.cs-Simple.Data-MDEwOlJlcG9zaXRvcnk4MTg3Njg=-flat-UpdateTests.cs-130.html,14,Simple.Data-MDEwOlJlcG9zaXRvcnk4MTg3Njg=-flat-SchemaQualifiedTests.cs,Simple.Data-MDEwOlJlcG9zaXRvcnk4MTg3Njg=-flat-UpdateTests.cs,29,30,1,82,83,1
131,https://htmlpreview.github.io/?https://github.com/Christina96/boilerplate-sample-matches/blob/main/csharp/runner-MDEwOlJlcG9zaXRvcnkxODQyODY4NzU=-flat-TemplateMemory.cs-runner-MDEwOlJlcG9zaXRvcnkxODQyODY4NzU=-flat-TemplateReader.cs-131.html,13,runner-MDEwOlJlcG9zaXRvcnkxODQyODY4NzU=-flat-TemplateMemory.cs,runner-MDEwOlJlcG9zaXRvcnkxODQyODY4NzU=-flat-TemplateReader.cs,152,155,3,463,466,3
132,https://htmlpreview.github.io/?https://github.com/Christina96/boilerplate-sample-matches/blob/main/csharp/Security-MDEwOlJlcG9zaXRvcnkxNzcyMzY5OQ==-flat-Startup_14.cs-Security-MDEwOlJlcG9zaXRvcnkxNzcyMzY5OQ==-flat-OpenIdConnectEventTests.cs-132.html,14,Security-MDEwOlJlcG9zaXRvcnkxNzcyMzY5OQ==-flat-Startup_14.cs,Security-MDEwOlJlcG9zaXRvcnkxNzcyMzY5OQ==-flat-OpenIdConnectEventTests.cs,42,45,3,1120,1123,3
133,https://htmlpreview.github.io/?https://github.com/Christina96/boilerplate-sample-matches/blob/main/csharp/npgsql-MDEwOlJlcG9zaXRvcnkyODgzNTc0-flat-TestBase.cs-npgsql-MDEwOlJlcG9zaXRvcnkyODgzNTc0-flat-TestBase.cs-133.html,30,npgsql-MDEwOlJlcG9zaXRvcnkyODgzNTc0-flat-TestBase.cs,npgsql-MDEwOlJlcG9zaXRvcnkyODgzNTc0-flat-TestBase.cs,66,71,5,48,53,5
134,https://htmlpreview.github.io/?https://github.com/Christina96/boilerplate-sample-matches/blob/main/csharp/runner-MDEwOlJlcG9zaXRvcnkxODQyODY4NzU=-flat-TemplateWriter.cs-runner-MDEwOlJlcG9zaXRvcnkxODQyODY4NzU=-flat-TemplateWriter.cs-134.html,13,runner-MDEwOlJlcG9zaXRvcnkxODQyODY4NzU=-flat-TemplateWriter.cs,runner-MDEwOlJlcG9zaXRvcnkxODQyODY4NzU=-flat-TemplateWriter.cs,48,50,2,38,40,2
135,https://htmlpreview.github.io/?https://github.com/Christina96/boilerplate-sample-matches/blob/main/csharp/runner-MDEwOlJlcG9zaXRvcnkxODQyODY4NzU=-flat-ContainerOperationProvider.cs-runner-MDEwOlJlcG9zaXRvcnkxODQyODY4NzU=-flat-ContainerOperationProvider.cs-135.html,14,runner-MDEwOlJlcG9zaXRvcnkxODQyODY4NzU=-flat-ContainerOperationProvider.cs,runner-MDEwOlJlcG9zaXRvcnkxODQyODY4NzU=-flat-ContainerOperationProvider.cs,67,68,1,204,205,1
136,https://htmlpreview.github.io/?https://github.com/Christina96/boilerplate-sample-matches/blob/main/csharp/runner-MDEwOlJlcG9zaXRvcnkxODQyODY4NzU=-flat-ExecutionContext.cs-runner-MDEwOlJlcG9zaXRvcnkxODQyODY4NzU=-flat-ExecutionContext.cs-136.html,21,runner-MDEwOlJlcG9zaXRvcnkxODQyODY4NzU=-flat-ExecutionContext.cs,runner-MDEwOlJlcG9zaXRvcnkxODQyODY4NzU=-flat-ExecutionContext.cs,431,433,2,438,440,2
137,https://htmlpreview.github.io/?https://github.com/Christina96/boilerplate-sample-matches/blob/main/csharp/Simple.Data-MDEwOlJlcG9zaXRvcnk4MTg3Njg=-flat-EnumerableExtensions.cs-Simple.Data-MDEwOlJlcG9zaXRvcnk4MTg3Njg=-flat-EnumerableExtensions.cs-137.html,16,Simple.Data-MDEwOlJlcG9zaXRvcnk4MTg3Njg=-flat-EnumerableExtensions.cs,Simple.Data-MDEwOlJlcG9zaXRvcnk4MTg3Njg=-flat-EnumerableExtensions.cs,26,30,4,40,44,4
138,https://htmlpreview.github.io/?https://github.com/Christina96/boilerplate-sample-matches/blob/main/csharp/MudBlazor-MDEwOlJlcG9zaXRvcnkyODg0Mjg2NzY=-flat-PatternMask.cs-MudBlazor-MDEwOlJlcG9zaXRvcnkyODg0Mjg2NzY=-flat-DateMask.cs-138.html,20,MudBlazor-MDEwOlJlcG9zaXRvcnkyODg0Mjg2NzY=-flat-PatternMask.cs,MudBlazor-MDEwOlJlcG9zaXRvcnkyODg0Mjg2NzY=-flat-DateMask.cs,194,198,4,194,198,4
139,https://htmlpreview.github.io/?https://github.com/Christina96/boilerplate-sample-matches/blob/main/csharp/dotween-MDEwOlJlcG9zaXRvcnkzMjQ3NTE2Mg==-flat-ShapeTweens.cs-dotween-MDEwOlJlcG9zaXRvcnkzMjQ3NTE2Mg==-flat-DOTweenSettings.cs-139.html,16,dotween-MDEwOlJlcG9zaXRvcnkzMjQ3NTE2Mg==-flat-ShapeTweens.cs,dotween-MDEwOlJlcG9zaXRvcnkzMjQ3NTE2Mg==-flat-DOTweenSettings.cs,48,51,3,23,26,3
140,https://htmlpreview.github.io/?https://github.com/Christina96/boilerplate-sample-matches/blob/main/csharp/npgsql-MDEwOlJlcG9zaXRvcnkyODgzNTc0-flat-DataAdapterTests.cs-npgsql-MDEwOlJlcG9zaXRvcnkyODgzNTc0-flat-DataAdapterTests.cs-140.html,70,npgsql-MDEwOlJlcG9zaXRvcnkyODgzNTc0-flat-DataAdapterTests.cs,npgsql-MDEwOlJlcG9zaXRvcnkyODgzNTc0-flat-DataAdapterTests.cs,52,56,4,221,225,4
141,https://htmlpreview.github.io/?https://github.com/Christina96/boilerplate-sample-matches/blob/main/csharp/dotween-MDEwOlJlcG9zaXRvcnkzMjQ3NTE2Mg==-flat-iTween_121.cs-dotween-MDEwOlJlcG9zaXRvcnkzMjQ3NTE2Mg==-flat-iTween.cs-141.html,84,dotween-MDEwOlJlcG9zaXRvcnkzMjQ3NTE2Mg==-flat-iTween_121.cs,dotween-MDEwOlJlcG9zaXRvcnkzMjQ3NTE2Mg==-flat-iTween.cs,443,456,13,515,528,13
142,https://htmlpreview.github.io/?https://github.com/Christina96/boilerplate-sample-matches/blob/main/csharp/npgsql-MDEwOlJlcG9zaXRvcnkyODgzNTc0-flat-BatchTests.cs-npgsql-MDEwOlJlcG9zaXRvcnkyODgzNTc0-flat-ConnectionTests.cs-142.html,16,npgsql-MDEwOlJlcG9zaXRvcnkyODgzNTc0-flat-BatchTests.cs,npgsql-MDEwOlJlcG9zaXRvcnkyODgzNTc0-flat-ConnectionTests.cs,677,680,3,1320,1323,3
143,https://htmlpreview.github.io/?https://github.com/Christina96/boilerplate-sample-matches/blob/main/csharp/dotween-MDEwOlJlcG9zaXRvcnkzMjQ3NTE2Mg==-flat-LeanTween_56.cs-dotween-MDEwOlJlcG9zaXRvcnkzMjQ3NTE2Mg==-flat-LeanTween.cs-143.html,219,dotween-MDEwOlJlcG9zaXRvcnkzMjQ3NTE2Mg==-flat-LeanTween_56.cs,dotween-MDEwOlJlcG9zaXRvcnkzMjQ3NTE2Mg==-flat-LeanTween.cs,2536,2560,24,2536,2560,24
144,https://htmlpreview.github.io/?https://github.com/Christina96/boilerplate-sample-matches/blob/main/csharp/MudBlazor-MDEwOlJlcG9zaXRvcnkyODg0Mjg2NzY=-flat-PopoverServiceTests.cs-MudBlazor-MDEwOlJlcG9zaXRvcnkyODg0Mjg2NzY=-flat-BatchPeriodicQueueTests.cs-144.html,14,MudBlazor-MDEwOlJlcG9zaXRvcnkyODg0Mjg2NzY=-flat-PopoverServiceTests.cs,MudBlazor-MDEwOlJlcG9zaXRvcnkyODg0Mjg2NzY=-flat-BatchPeriodicQueueTests.cs,345,350,5,40,45,5
145,https://htmlpreview.github.io/?https://github.com/Christina96/boilerplate-sample-matches/blob/main/csharp/20486D-DevelopingASPNETMVCWebApplications-MDEwOlJlcG9zaXRvcnkxMTkzNTI2Mzc=-flat-ProductController_290.cs-20486D-DevelopingASPNETMVCWebApplications-MDEwOlJlcG9zaXRvcnkxMTkzNTI2Mzc=-flat-Details_263.cs-145.html,14,20486D-DevelopingASPNETMVCWebApplications-MDEwOlJlcG9zaXRvcnkxMTkzNTI2Mzc=-flat-ProductController_290.cs,20486D-DevelopingASPNETMVCWebApplications-MDEwOlJlcG9zaXRvcnkxMTkzNTI2Mzc=-flat-Details_263.cs,14,18,4,12,16,4
146,https://htmlpreview.github.io/?https://github.com/Christina96/boilerplate-sample-matches/blob/main/csharp/runner-MDEwOlJlcG9zaXRvcnkxODQyODY4NzU=-flat-PipelineContextDataJsonConverter.cs-runner-MDEwOlJlcG9zaXRvcnkxODQyODY4NzU=-flat-TemplateTokenJsonConverter.cs-146.html,16,runner-MDEwOlJlcG9zaXRvcnkxODQyODY4NzU=-flat-PipelineContextDataJsonConverter.cs,runner-MDEwOlJlcG9zaXRvcnkxODQyODY4NzU=-flat-TemplateTokenJsonConverter.cs,25,30,5,25,30,5
147,https://htmlpreview.github.io/?https://github.com/Christina96/boilerplate-sample-matches/blob/main/csharp/MudBlazor-MDEwOlJlcG9zaXRvcnkyODg0Mjg2NzY=-flat-MudColorPicker.razor.cs-MudBlazor-MDEwOlJlcG9zaXRvcnkyODg0Mjg2NzY=-flat-DocsLayout.razor.cs-147.html,13,MudBlazor-MDEwOlJlcG9zaXRvcnkyODg0Mjg2NzY=-flat-MudColorPicker.razor.cs,MudBlazor-MDEwOlJlcG9zaXRvcnkyODg0Mjg2NzY=-flat-DocsLayout.razor.cs,329,332,3,11,14,3
148,https://htmlpreview.github.io/?https://github.com/Christina96/boilerplate-sample-matches/blob/main/csharp/runner-MDEwOlJlcG9zaXRvcnkxODQyODY4NzU=-flat-PipelineTemplateConverter.cs-runner-MDEwOlJlcG9zaXRvcnkxODQyODY4NzU=-flat-PipelineTemplateConverter.cs-148.html,16,runner-MDEwOlJlcG9zaXRvcnkxODQyODY4NzU=-flat-PipelineTemplateConverter.cs,runner-MDEwOlJlcG9zaXRvcnkxODQyODY4NzU=-flat-PipelineTemplateConverter.cs,307,309,2,298,300,2
149,https://htmlpreview.github.io/?https://github.com/Christina96/boilerplate-sample-matches/blob/main/csharp/runner-MDEwOlJlcG9zaXRvcnkxODQyODY4NzU=-flat-RawHttpMessageHandler.cs-runner-MDEwOlJlcG9zaXRvcnkxODQyODY4NzU=-flat-VssHttpMessageHandler.cs-149.html,199,runner-MDEwOlJlcG9zaXRvcnkxODQyODY4NzU=-flat-RawHttpMessageHandler.cs,runner-MDEwOlJlcG9zaXRvcnkxODQyODY4NzU=-flat-VssHttpMessageHandler.cs,236,296,60,396,456,60
150,https://htmlpreview.github.io/?https://github.com/Christina96/boilerplate-sample-matches/blob/main/csharp/MudBlazor-MDEwOlJlcG9zaXRvcnkyODg0Mjg2NzY=-flat-MudSnackbarElement.razor.cs-MudBlazor-MDEwOlJlcG9zaXRvcnkyODg0Mjg2NzY=-flat-HeaderCell.razor.cs-150.html,14,MudBlazor-MDEwOlJlcG9zaXRvcnkyODg0Mjg2NzY=-flat-MudSnackbarElement.razor.cs,MudBlazor-MDEwOlJlcG9zaXRvcnkyODg0Mjg2NzY=-flat-HeaderCell.razor.cs,30,34,4,358,362,4
151,https://htmlpreview.github.io/?https://github.com/Christina96/boilerplate-sample-matches/blob/main/csharp/MudBlazor-MDEwOlJlcG9zaXRvcnkyODg0Mjg2NzY=-flat-TimelineTests.cs-npgsql-MDEwOlJlcG9zaXRvcnkyODgzNTc0-flat-DistributedTransactionTests.cs-151.html,14,MudBlazor-MDEwOlJlcG9zaXRvcnkyODg0Mjg2NzY=-flat-TimelineTests.cs,npgsql-MDEwOlJlcG9zaXRvcnkyODgzNTc0-flat-DistributedTransactionTests.cs,34,35,1,259,260,1
152,https://htmlpreview.github.io/?https://github.com/Christina96/boilerplate-sample-matches/blob/main/csharp/runner-MDEwOlJlcG9zaXRvcnkxODQyODY4NzU=-flat-VssHttpClientBase.cs-Security-MDEwOlJlcG9zaXRvcnkxNzcyMzY5OQ==-flat-RemoteAuthenticationContext.cs-152.html,12,runner-MDEwOlJlcG9zaXRvcnkxODQyODY4NzU=-flat-VssHttpClientBase.cs,Security-MDEwOlJlcG9zaXRvcnkxNzcyMzY5OQ==-flat-RemoteAuthenticationContext.cs,45,49,4,8,12,4
153,https://htmlpreview.github.io/?https://github.com/Christina96/boilerplate-sample-matches/blob/main/csharp/dotween-MDEwOlJlcG9zaXRvcnkzMjQ3NTE2Mg==-flat-LeanTween.cs-dotween-MDEwOlJlcG9zaXRvcnkzMjQ3NTE2Mg==-flat-LeanTween_56.cs-153.html,66,dotween-MDEwOlJlcG9zaXRvcnkzMjQ3NTE2Mg==-flat-LeanTween.cs,dotween-MDEwOlJlcG9zaXRvcnkzMjQ3NTE2Mg==-flat-LeanTween_56.cs,2087,2090,3,2087,2090,3
154,https://htmlpreview.github.io/?https://github.com/Christina96/boilerplate-sample-matches/blob/main/csharp/Simple.Data-MDEwOlJlcG9zaXRvcnk4MTg3Njg=-flat-QueryTest_31.cs-Simple.Data-MDEwOlJlcG9zaXRvcnk4MTg3Njg=-flat-OrderDetailTests.cs-154.html,35,Simple.Data-MDEwOlJlcG9zaXRvcnk4MTg3Njg=-flat-QueryTest_31.cs,Simple.Data-MDEwOlJlcG9zaXRvcnk4MTg3Njg=-flat-OrderDetailTests.cs,7,12,5,11,16,5
155,https://htmlpreview.github.io/?https://github.com/Christina96/boilerplate-sample-matches/blob/main/csharp/runner-MDEwOlJlcG9zaXRvcnkxODQyODY4NzU=-flat-PipelineDirectoryManager.cs-runner-MDEwOlJlcG9zaXRvcnkxODQyODY4NzU=-flat-Interfaces.cs-155.html,13,runner-MDEwOlJlcG9zaXRvcnkxODQyODY4NzU=-flat-PipelineDirectoryManager.cs,runner-MDEwOlJlcG9zaXRvcnkxODQyODY4NzU=-flat-Interfaces.cs,13,17,4,43,47,4
156,https://htmlpreview.github.io/?https://github.com/Christina96/boilerplate-sample-matches/blob/main/csharp/dotween-MDEwOlJlcG9zaXRvcnkzMjQ3NTE2Mg==-flat-GoSplineCatmullRomSolver_66.cs-dotween-MDEwOlJlcG9zaXRvcnkzMjQ3NTE2Mg==-flat-GoSplineCatmullRomSolver.cs-156.html,162,dotween-MDEwOlJlcG9zaXRvcnkzMjQ3NTE2Mg==-flat-GoSplineCatmullRomSolver_66.cs,dotween-MDEwOlJlcG9zaXRvcnkzMjQ3NTE2Mg==-flat-GoSplineCatmullRomSolver.cs,34,54,20,34,54,20
157,https://htmlpreview.github.io/?https://github.com/Christina96/boilerplate-sample-matches/blob/main/csharp/Security-MDEwOlJlcG9zaXRvcnkxNzcyMzY5OQ==-flat-LoggingExtensions_17.cs-Security-MDEwOlJlcG9zaXRvcnkxNzcyMzY5OQ==-flat-LoggingExtensions_28.cs-157.html,21,Security-MDEwOlJlcG9zaXRvcnkxNzcyMzY5OQ==-flat-LoggingExtensions_17.cs,Security-MDEwOlJlcG9zaXRvcnkxNzcyMzY5OQ==-flat-LoggingExtensions_28.cs,18,22,4,168,172,4
158,https://htmlpreview.github.io/?https://github.com/Christina96/boilerplate-sample-matches/blob/main/csharp/MudBlazor-MDEwOlJlcG9zaXRvcnkyODg0Mjg2NzY=-flat-MudDropContainer.razor.cs-ZXing.Net.Mobile-MDEwOlJlcG9zaXRvcnk2MTYwNjcz-flat-CameraAnalyzer.android.cs-158.html,12,MudBlazor-MDEwOlJlcG9zaXRvcnkyODg0Mjg2NzY=-flat-MudDropContainer.razor.cs,ZXing.Net.Mobile-MDEwOlJlcG9zaXRvcnk2MTYwNjcz-flat-CameraAnalyzer.android.cs,161,163,2,93,95,2
159,https://htmlpreview.github.io/?https://github.com/Christina96/boilerplate-sample-matches/blob/main/csharp/NetCoreServer-MDEwOlJlcG9zaXRvcnkxNjYxMjMxNjQ=-flat-Program_10.cs-NetCoreServer-MDEwOlJlcG9zaXRvcnkxNjYxMjMxNjQ=-flat-Program_32.cs-159.html,16,NetCoreServer-MDEwOlJlcG9zaXRvcnkxNjYxMjMxNjQ=-flat-Program_10.cs,NetCoreServer-MDEwOlJlcG9zaXRvcnkxNjYxMjMxNjQ=-flat-Program_32.cs,28,32,4,27,31,4
160,https://htmlpreview.github.io/?https://github.com/Christina96/boilerplate-sample-matches/blob/main/csharp/npgsql-MDEwOlJlcG9zaXRvcnkyODgzNTc0-flat-NpgsqlDataReader.cs-npgsql-MDEwOlJlcG9zaXRvcnkyODgzNTc0-flat-NpgsqlNestedDataReader.cs-160.html,51,npgsql-MDEwOlJlcG9zaXRvcnkyODgzNTc0-flat-NpgsqlDataReader.cs,npgsql-MDEwOlJlcG9zaXRvcnkyODgzNTc0-flat-NpgsqlNestedDataReader.cs,831,834,3,121,124,3
161,https://htmlpreview.github.io/?https://github.com/Christina96/boilerplate-sample-matches/blob/main/csharp/dotween-MDEwOlJlcG9zaXRvcnkzMjQ3NTE2Mg==-flat-GoTween_59.cs-dotween-MDEwOlJlcG9zaXRvcnkzMjQ3NTE2Mg==-flat-GoTween.cs-161.html,242,dotween-MDEwOlJlcG9zaXRvcnkzMjQ3NTE2Mg==-flat-GoTween_59.cs,dotween-MDEwOlJlcG9zaXRvcnkzMjQ3NTE2Mg==-flat-GoTween.cs,147,200,53,147,200,53
162,https://htmlpreview.github.io/?https://github.com/Christina96/boilerplate-sample-matches/blob/main/csharp/20486D-DevelopingASPNETMVCWebApplications-MDEwOlJlcG9zaXRvcnkxMTkzNTI2Mzc=-flat-IceCreamContext_68.cs-20486D-DevelopingASPNETMVCWebApplications-MDEwOlJlcG9zaXRvcnkxMTkzNTI2Mzc=-flat-IceCreamContext.cs-162.html,15,20486D-DevelopingASPNETMVCWebApplications-MDEwOlJlcG9zaXRvcnkxMTkzNTI2Mzc=-flat-IceCreamContext_68.cs,20486D-DevelopingASPNETMVCWebApplications-MDEwOlJlcG9zaXRvcnkxMTkzNTI2Mzc=-flat-IceCreamContext.cs,33,38,5,41,46,5
163,https://htmlpreview.github.io/?https://github.com/Christina96/boilerplate-sample-matches/blob/main/csharp/runner-MDEwOlJlcG9zaXRvcnkxODQyODY4NzU=-flat-WrappedException.cs-runner-MDEwOlJlcG9zaXRvcnkxODQyODY4NzU=-flat-WrappedException.cs-163.html,16,runner-MDEwOlJlcG9zaXRvcnkxODQyODY4NzU=-flat-WrappedException.cs,runner-MDEwOlJlcG9zaXRvcnkxODQyODY4NzU=-flat-WrappedException.cs,31,33,2,39,41,2
164,https://htmlpreview.github.io/?https://github.com/Christina96/boilerplate-sample-matches/blob/main/csharp/Security-MDEwOlJlcG9zaXRvcnkxNzcyMzY5OQ==-flat-CookieTests.cs-Security-MDEwOlJlcG9zaXRvcnkxNzcyMzY5OQ==-flat-JwtBearerTests.cs-164.html,14,Security-MDEwOlJlcG9zaXRvcnkxNzcyMzY5OQ==-flat-CookieTests.cs,Security-MDEwOlJlcG9zaXRvcnkxNzcyMzY5OQ==-flat-JwtBearerTests.cs,1121,1124,3,142,145,3
165,https://htmlpreview.github.io/?https://github.com/Christina96/boilerplate-sample-matches/blob/main/csharp/Security-MDEwOlJlcG9zaXRvcnkxNzcyMzY5OQ==-flat-Startup_8.cs-Security-MDEwOlJlcG9zaXRvcnkxNzcyMzY5OQ==-flat-Startup.cs-165.html,163,Security-MDEwOlJlcG9zaXRvcnkxNzcyMzY5OQ==-flat-Startup_8.cs,Security-MDEwOlJlcG9zaXRvcnkxNzcyMzY5OQ==-flat-Startup.cs,107,133,26,215,241,26
166,https://htmlpreview.github.io/?https://github.com/Christina96/boilerplate-sample-matches/blob/main/csharp/runner-MDEwOlJlcG9zaXRvcnkxODQyODY4NzU=-flat-TemplateConstants.cs-runner-MDEwOlJlcG9zaXRvcnkxODQyODY4NzU=-flat-ExpressionConstants.cs-166.html,14,runner-MDEwOlJlcG9zaXRvcnkxODQyODY4NzU=-flat-TemplateConstants.cs,runner-MDEwOlJlcG9zaXRvcnkxODQyODY4NzU=-flat-ExpressionConstants.cs,27,29,2,47,49,2
167,https://htmlpreview.github.io/?https://github.com/Christina96/boilerplate-sample-matches/blob/main/csharp/Simple.Data-MDEwOlJlcG9zaXRvcnk4MTg3Njg=-flat-ForUpdateClause.cs-Security-MDEwOlJlcG9zaXRvcnkxNzcyMzY5OQ==-flat-DefaultAuthorizationServiceTests.cs-167.html,12,Simple.Data-MDEwOlJlcG9zaXRvcnk4MTg3Njg=-flat-ForUpdateClause.cs,Security-MDEwOlJlcG9zaXRvcnkxNzcyMzY5OQ==-flat-DefaultAuthorizationServiceTests.cs,6,10,4,524,528,4
168,https://htmlpreview.github.io/?https://github.com/Christina96/boilerplate-sample-matches/blob/main/csharp/npgsql-MDEwOlJlcG9zaXRvcnkyODgzNTc0-flat-NpgsqlConnector.OldAuth.cs-npgsql-MDEwOlJlcG9zaXRvcnkyODgzNTc0-flat-NpgsqlConnector.OldAuth.cs-168.html,17,npgsql-MDEwOlJlcG9zaXRvcnkyODgzNTc0-flat-NpgsqlConnector.OldAuth.cs,npgsql-MDEwOlJlcG9zaXRvcnkyODgzNTc0-flat-NpgsqlConnector.OldAuth.cs,46,50,4,50,54,4
169,https://htmlpreview.github.io/?https://github.com/Christina96/boilerplate-sample-matches/blob/main/csharp/Security-MDEwOlJlcG9zaXRvcnkxNzcyMzY5OQ==-flat-ClaimsAuthorizationRequirement.cs-Security-MDEwOlJlcG9zaXRvcnkxNzcyMzY5OQ==-flat-JwtBearerTests.cs-169.html,13,Security-MDEwOlJlcG9zaXRvcnkxNzcyMzY5OQ==-flat-ClaimsAuthorizationRequirement.cs,Security-MDEwOlJlcG9zaXRvcnkxNzcyMzY5OQ==-flat-JwtBearerTests.cs,9,11,2,613,615,2
170,https://htmlpreview.github.io/?https://github.com/Christina96/boilerplate-sample-matches/blob/main/csharp/dotween-MDEwOlJlcG9zaXRvcnkzMjQ3NTE2Mg==-flat-GoSmoothedVector3.cs-dotween-MDEwOlJlcG9zaXRvcnkzMjQ3NTE2Mg==-flat-GoSmoothedVector3_88.cs-170.html,102,dotween-MDEwOlJlcG9zaXRvcnkzMjQ3NTE2Mg==-flat-GoSmoothedVector3.cs,dotween-MDEwOlJlcG9zaXRvcnkzMjQ3NTE2Mg==-flat-GoSmoothedVector3_88.cs,49,80,31,49,80,31
171,https://htmlpreview.github.io/?https://github.com/Christina96/boilerplate-sample-matches/blob/main/csharp/npgsql-MDEwOlJlcG9zaXRvcnkyODgzNTc0-flat-SqlQueryParser.cs-npgsql-MDEwOlJlcG9zaXRvcnkyODgzNTc0-flat-SqlQueryParser.cs-171.html,17,npgsql-MDEwOlJlcG9zaXRvcnkyODgzNTc0-flat-SqlQueryParser.cs,npgsql-MDEwOlJlcG9zaXRvcnkyODgzNTc0-flat-SqlQueryParser.cs,209,213,4,323,327,4
172,https://htmlpreview.github.io/?https://github.com/Christina96/boilerplate-sample-matches/blob/main/csharp/dotween-MDEwOlJlcG9zaXRvcnkzMjQ3NTE2Mg==-flat-GoSpline.cs-dotween-MDEwOlJlcG9zaXRvcnkzMjQ3NTE2Mg==-flat-GoSpline_65.cs-172.html,556,dotween-MDEwOlJlcG9zaXRvcnkzMjQ3NTE2Mg==-flat-GoSpline.cs,dotween-MDEwOlJlcG9zaXRvcnkzMjQ3NTE2Mg==-flat-GoSpline_65.cs,47,153,106,47,153,106
173,https://htmlpreview.github.io/?https://github.com/Christina96/boilerplate-sample-matches/blob/main/csharp/NetCoreServer-MDEwOlJlcG9zaXRvcnkxNjYxMjMxNjQ=-flat-HttpRequest.cs-NetCoreServer-MDEwOlJlcG9zaXRvcnkxNjYxMjMxNjQ=-flat-HttpResponse.cs-173.html,93,NetCoreServer-MDEwOlJlcG9zaXRvcnkxNjYxMjMxNjQ=-flat-HttpRequest.cs,NetCoreServer-MDEwOlJlcG9zaXRvcnkxNjYxMjMxNjQ=-flat-HttpResponse.cs,471,489,18,519,537,18
174,https://htmlpreview.github.io/?https://github.com/Christina96/boilerplate-sample-matches/blob/main/csharp/dotween-MDEwOlJlcG9zaXRvcnkzMjQ3NTE2Mg==-flat-LeanTween.cs-dotween-MDEwOlJlcG9zaXRvcnkzMjQ3NTE2Mg==-flat-LeanTween.cs-174.html,66,dotween-MDEwOlJlcG9zaXRvcnkzMjQ3NTE2Mg==-flat-LeanTween.cs,dotween-MDEwOlJlcG9zaXRvcnkzMjQ3NTE2Mg==-flat-LeanTween.cs,823,826,3,843,846,3
175,https://htmlpreview.github.io/?https://github.com/Christina96/boilerplate-sample-matches/blob/main/csharp/dotween-MDEwOlJlcG9zaXRvcnkzMjQ3NTE2Mg==-flat-AbstractGoTween_98.cs-dotween-MDEwOlJlcG9zaXRvcnkzMjQ3NTE2Mg==-flat-AbstractGoTween.cs-175.html,442,dotween-MDEwOlJlcG9zaXRvcnkzMjQ3NTE2Mg==-flat-AbstractGoTween_98.cs,dotween-MDEwOlJlcG9zaXRvcnkzMjQ3NTE2Mg==-flat-AbstractGoTween.cs,151,239,88,151,239,88
176,https://htmlpreview.github.io/?https://github.com/Christina96/boilerplate-sample-matches/blob/main/csharp/dotween-MDEwOlJlcG9zaXRvcnkzMjQ3NTE2Mg==-flat-GoTweenConfig_58.cs-dotween-MDEwOlJlcG9zaXRvcnkzMjQ3NTE2Mg==-flat-GoTweenConfig_58.cs-176.html,24,dotween-MDEwOlJlcG9zaXRvcnkzMjQ3NTE2Mg==-flat-GoTweenConfig_58.cs,dotween-MDEwOlJlcG9zaXRvcnkzMjQ3NTE2Mg==-flat-GoTweenConfig_58.cs,79,83,4,33,37,4
177,https://htmlpreview.github.io/?https://github.com/Christina96/boilerplate-sample-matches/blob/main/csharp/dotween-MDEwOlJlcG9zaXRvcnkzMjQ3NTE2Mg==-flat-TweenEnginesComparisonInternal.cs-dotween-MDEwOlJlcG9zaXRvcnkzMjQ3NTE2Mg==-flat-TweenEnginesComparisonInternal_37.cs-177.html,2221,dotween-MDEwOlJlcG9zaXRvcnkzMjQ3NTE2Mg==-flat-TweenEnginesComparisonInternal.cs,dotween-MDEwOlJlcG9zaXRvcnkzMjQ3NTE2Mg==-flat-TweenEnginesComparisonInternal_37.cs,318,596,278,318,596,278
178,https://htmlpreview.github.io/?https://github.com/Christina96/boilerplate-sample-matches/blob/main/csharp/runner-MDEwOlJlcG9zaXRvcnkxODQyODY4NzU=-flat-VssHttpClientBase.cs-runner-MDEwOlJlcG9zaXRvcnkxODQyODY4NzU=-flat-ServiceDefinition.cs-178.html,12,runner-MDEwOlJlcG9zaXRvcnkxODQyODY4NzU=-flat-VssHttpClientBase.cs,runner-MDEwOlJlcG9zaXRvcnkxODQyODY4NzU=-flat-ServiceDefinition.cs,699,702,3,317,320,3
179,https://htmlpreview.github.io/?https://github.com/Christina96/boilerplate-sample-matches/blob/main/csharp/ZXing.Net.Mobile-MDEwOlJlcG9zaXRvcnk2MTYwNjcz-flat-IScannerView.shared.cs-ZXing.Net.Mobile-MDEwOlJlcG9zaXRvcnk2MTYwNjcz-flat-IMobileBarcodeScanner.shared.cs-179.html,12,ZXing.Net.Mobile-MDEwOlJlcG9zaXRvcnk2MTYwNjcz-flat-IScannerView.shared.cs,ZXing.Net.Mobile-MDEwOlJlcG9zaXRvcnk2MTYwNjcz-flat-IMobileBarcodeScanner.shared.cs,10,12,2,20,22,2
180,https://htmlpreview.github.io/?https://github.com/Christina96/boilerplate-sample-matches/blob/main/csharp/dotween-MDEwOlJlcG9zaXRvcnkzMjQ3NTE2Mg==-flat-Tweener.cs-dotween-MDEwOlJlcG9zaXRvcnkzMjQ3NTE2Mg==-flat-Tween.cs-180.html,13,dotween-MDEwOlJlcG9zaXRvcnkzMjQ3NTE2Mg==-flat-Tweener.cs,dotween-MDEwOlJlcG9zaXRvcnkzMjQ3NTE2Mg==-flat-Tween.cs,136,137,1,180,181,1
181,https://htmlpreview.github.io/?https://github.com/Christina96/boilerplate-sample-matches/blob/main/csharp/npgsql-MDEwOlJlcG9zaXRvcnkyODgzNTc0-flat-NpgsqlParameterCollectionTests.cs-npgsql-MDEwOlJlcG9zaXRvcnkyODgzNTc0-flat-NpgsqlParameterCollectionTests.cs-181.html,17,npgsql-MDEwOlJlcG9zaXRvcnkyODgzNTc0-flat-NpgsqlParameterCollectionTests.cs,npgsql-MDEwOlJlcG9zaXRvcnkyODgzNTc0-flat-NpgsqlParameterCollectionTests.cs,64,66,2,107,109,2
182,https://htmlpreview.github.io/?https://github.com/Christina96/boilerplate-sample-matches/blob/main/csharp/dotween-MDEwOlJlcG9zaXRvcnkzMjQ3NTE2Mg==-flat-GoTween_59.cs-dotween-MDEwOlJlcG9zaXRvcnkzMjQ3NTE2Mg==-flat-GoTween.cs-182.html,328,dotween-MDEwOlJlcG9zaXRvcnkzMjQ3NTE2Mg==-flat-GoTween_59.cs,dotween-MDEwOlJlcG9zaXRvcnkzMjQ3NTE2Mg==-flat-GoTween.cs,125,200,75,125,200,75
183,https://htmlpreview.github.io/?https://github.com/Christina96/boilerplate-sample-matches/blob/main/csharp/MudBlazor-MDEwOlJlcG9zaXRvcnkyODg0Mjg2NzY=-flat-ResizeObserverTests.cs-MudBlazor-MDEwOlJlcG9zaXRvcnkyODg0Mjg2NzY=-flat-ResizeObserverTests.cs-183.html,20,MudBlazor-MDEwOlJlcG9zaXRvcnkyODg0Mjg2NzY=-flat-ResizeObserverTests.cs,MudBlazor-MDEwOlJlcG9zaXRvcnkyODg0Mjg2NzY=-flat-ResizeObserverTests.cs,118,121,3,161,164,3
184,https://htmlpreview.github.io/?https://github.com/Christina96/boilerplate-sample-matches/blob/main/csharp/Simple.Data-MDEwOlJlcG9zaXRvcnk4MTg3Njg=-flat-ObjectReference.cs-Simple.Data-MDEwOlJlcG9zaXRvcnk4MTg3Njg=-flat-FunctionReference.cs-184.html,15,Simple.Data-MDEwOlJlcG9zaXRvcnk4MTg3Njg=-flat-ObjectReference.cs,Simple.Data-MDEwOlJlcG9zaXRvcnk4MTg3Njg=-flat-FunctionReference.cs,146,148,2,115,117,2
185,https://htmlpreview.github.io/?https://github.com/Christina96/boilerplate-sample-matches/blob/main/csharp/dotween-MDEwOlJlcG9zaXRvcnkzMjQ3NTE2Mg==-flat-ElasticDragAndRelease_41.cs-dotween-MDEwOlJlcG9zaXRvcnkzMjQ3NTE2Mg==-flat-ElasticDragAndRelease.cs-185.html,80,dotween-MDEwOlJlcG9zaXRvcnkzMjQ3NTE2Mg==-flat-ElasticDragAndRelease_41.cs,dotween-MDEwOlJlcG9zaXRvcnkzMjQ3NTE2Mg==-flat-ElasticDragAndRelease.cs,16,24,8,16,24,8
186,https://htmlpreview.github.io/?https://github.com/Christina96/boilerplate-sample-matches/blob/main/csharp/MudBlazor-MDEwOlJlcG9zaXRvcnkyODg0Mjg2NzY=-flat-MainLayout.razor.cs-MudBlazor-MDEwOlJlcG9zaXRvcnkyODg0Mjg2NzY=-flat-MudSnackbarProvider.razor.cs-186.html,12,MudBlazor-MDEwOlJlcG9zaXRvcnkyODg0Mjg2NzY=-flat-MainLayout.razor.cs,MudBlazor-MDEwOlJlcG9zaXRvcnkyODg0Mjg2NzY=-flat-MudSnackbarProvider.razor.cs,37,40,3,40,43,3
187,https://htmlpreview.github.io/?https://github.com/Christina96/boilerplate-sample-matches/blob/main/csharp/NetCoreServer-MDEwOlJlcG9zaXRvcnkxNjYxMjMxNjQ=-flat-HttpRequest.cs-NetCoreServer-MDEwOlJlcG9zaXRvcnkxNjYxMjMxNjQ=-flat-HttpResponse.cs-187.html,121,NetCoreServer-MDEwOlJlcG9zaXRvcnkxNjYxMjMxNjQ=-flat-HttpRequest.cs,NetCoreServer-MDEwOlJlcG9zaXRvcnkxNjYxMjMxNjQ=-flat-HttpResponse.cs,348,364,16,495,511,16
188,https://htmlpreview.github.io/?https://github.com/Christina96/boilerplate-sample-matches/blob/main/csharp/ZXing.Net.Mobile-MDEwOlJlcG9zaXRvcnk2MTYwNjcz-flat-ZXingScannerView.ios.cs-ZXing.Net.Mobile-MDEwOlJlcG9zaXRvcnk2MTYwNjcz-flat-ZXingScannerView.ios.cs-188.html,17,ZXing.Net.Mobile-MDEwOlJlcG9zaXRvcnk2MTYwNjcz-flat-ZXingScannerView.ios.cs,ZXing.Net.Mobile-MDEwOlJlcG9zaXRvcnk2MTYwNjcz-flat-ZXingScannerView.ios.cs,272,275,3,266,269,3
189,https://htmlpreview.github.io/?https://github.com/Christina96/boilerplate-sample-matches/blob/main/csharp/runner-MDEwOlJlcG9zaXRvcnkxODQyODY4NzU=-flat-SystemdControlManager.cs-runner-MDEwOlJlcG9zaXRvcnkxODQyODY4NzU=-flat-OsxServiceControlManager.cs-189.html,12,runner-MDEwOlJlcG9zaXRvcnkxODQyODY4NzU=-flat-SystemdControlManager.cs,runner-MDEwOlJlcG9zaXRvcnkxODQyODY4NzU=-flat-OsxServiceControlManager.cs,40,45,5,41,46,5
190,https://htmlpreview.github.io/?https://github.com/Christina96/boilerplate-sample-matches/blob/main/csharp/NetCoreServer-MDEwOlJlcG9zaXRvcnkxNjYxMjMxNjQ=-flat-UdsServer.cs-NetCoreServer-MDEwOlJlcG9zaXRvcnkxNjYxMjMxNjQ=-flat-SslServer.cs-190.html,14,NetCoreServer-MDEwOlJlcG9zaXRvcnkxNjYxMjMxNjQ=-flat-UdsServer.cs,NetCoreServer-MDEwOlJlcG9zaXRvcnkxNjYxMjMxNjQ=-flat-SslServer.cs,103,105,2,124,126,2
191,https://htmlpreview.github.io/?https://github.com/Christina96/boilerplate-sample-matches/blob/main/csharp/npgsql-MDEwOlJlcG9zaXRvcnkyODgzNTc0-flat-NpgsqlConnection.cs-npgsql-MDEwOlJlcG9zaXRvcnkyODgzNTc0-flat-NpgsqlConnection.cs-191.html,13,npgsql-MDEwOlJlcG9zaXRvcnkyODgzNTc0-flat-NpgsqlConnection.cs,npgsql-MDEwOlJlcG9zaXRvcnkyODgzNTc0-flat-NpgsqlConnection.cs,448,450,2,451,453,2
192,https://htmlpreview.github.io/?https://github.com/Christina96/boilerplate-sample-matches/blob/main/csharp/NetCoreServer-MDEwOlJlcG9zaXRvcnkxNjYxMjMxNjQ=-flat-UdpServer.cs-NetCoreServer-MDEwOlJlcG9zaXRvcnkxNjYxMjMxNjQ=-flat-UdpClient.cs-192.html,67,NetCoreServer-MDEwOlJlcG9zaXRvcnkxNjYxMjMxNjQ=-flat-UdpServer.cs,NetCoreServer-MDEwOlJlcG9zaXRvcnkxNjYxMjMxNjQ=-flat-UdpClient.cs,288,299,11,321,332,11
193,https://htmlpreview.github.io/?https://github.com/Christina96/boilerplate-sample-matches/blob/main/csharp/npgsql-MDEwOlJlcG9zaXRvcnkyODgzNTc0-flat-NpgsqlBinaryExporter.cs-npgsql-MDEwOlJlcG9zaXRvcnkyODgzNTc0-flat-NpgsqlBinaryImporter.cs-193.html,15,npgsql-MDEwOlJlcG9zaXRvcnkyODgzNTc0-flat-NpgsqlBinaryExporter.cs,npgsql-MDEwOlJlcG9zaXRvcnkyODgzNTc0-flat-NpgsqlBinaryImporter.cs,275,280,5,323,328,5
194,https://htmlpreview.github.io/?https://github.com/Christina96/boilerplate-sample-matches/blob/main/csharp/Security-MDEwOlJlcG9zaXRvcnkxNzcyMzY5OQ==-flat-CookiePolicyTests.cs-Security-MDEwOlJlcG9zaXRvcnkxNzcyMzY5OQ==-flat-CookiePolicyTests.cs-194.html,15,Security-MDEwOlJlcG9zaXRvcnkxNzcyMzY5OQ==-flat-CookiePolicyTests.cs,Security-MDEwOlJlcG9zaXRvcnkxNzcyMzY5OQ==-flat-CookiePolicyTests.cs,356,357,1,319,320,1
195,https://htmlpreview.github.io/?https://github.com/Christina96/boilerplate-sample-matches/blob/main/csharp/dotween-MDEwOlJlcG9zaXRvcnkzMjQ3NTE2Mg==-flat-iTween_121.cs-dotween-MDEwOlJlcG9zaXRvcnkzMjQ3NTE2Mg==-flat-iTween.cs-195.html,155,dotween-MDEwOlJlcG9zaXRvcnkzMjQ3NTE2Mg==-flat-iTween_121.cs,dotween-MDEwOlJlcG9zaXRvcnkzMjQ3NTE2Mg==-flat-iTween.cs,1047,1057,10,2780,2790,10
196,https://htmlpreview.github.io/?https://github.com/Christina96/boilerplate-sample-matches/blob/main/csharp/dotween-MDEwOlJlcG9zaXRvcnkzMjQ3NTE2Mg==-flat-iTween_121.cs-dotween-MDEwOlJlcG9zaXRvcnkzMjQ3NTE2Mg==-flat-iTween.cs-196.html,934,dotween-MDEwOlJlcG9zaXRvcnkzMjQ3NTE2Mg==-flat-iTween_121.cs,dotween-MDEwOlJlcG9zaXRvcnkzMjQ3NTE2Mg==-flat-iTween.cs,693,874,181,693,874,181
197,https://htmlpreview.github.io/?https://github.com/Christina96/boilerplate-sample-matches/blob/main/csharp/ZXing.Net.Mobile-MDEwOlJlcG9zaXRvcnk2MTYwNjcz-flat-MobileBarcodeScanner.ios.cs-ZXing.Net.Mobile-MDEwOlJlcG9zaXRvcnk2MTYwNjcz-flat-MobileBarcodeScanner.ios.cs-197.html,55,ZXing.Net.Mobile-MDEwOlJlcG9zaXRvcnk2MTYwNjcz-flat-MobileBarcodeScanner.ios.cs,ZXing.Net.Mobile-MDEwOlJlcG9zaXRvcnk2MTYwNjcz-flat-MobileBarcodeScanner.ios.cs,31,38,7,82,89,7
198,https://htmlpreview.github.io/?https://github.com/Christina96/boilerplate-sample-matches/blob/main/csharp/runner-MDEwOlJlcG9zaXRvcnkxODQyODY4NzU=-flat-IdentityDescriptor.cs-runner-MDEwOlJlcG9zaXRvcnkxODQyODY4NzU=-flat-ConnectionData.cs-198.html,12,runner-MDEwOlJlcG9zaXRvcnkxODQyODY4NzU=-flat-IdentityDescriptor.cs,runner-MDEwOlJlcG9zaXRvcnkxODQyODY4NzU=-flat-ConnectionData.cs,155,160,5,116,121,5
199,https://htmlpreview.github.io/?https://github.com/Christina96/boilerplate-sample-matches/blob/main/csharp/dotween-MDEwOlJlcG9zaXRvcnkzMjQ3NTE2Mg==-flat-Go_61.cs-dotween-MDEwOlJlcG9zaXRvcnkzMjQ3NTE2Mg==-flat-Go.cs-199.html,1186,dotween-MDEwOlJlcG9zaXRvcnkzMjQ3NTE2Mg==-flat-Go_61.cs,dotween-MDEwOlJlcG9zaXRvcnkzMjQ3NTE2Mg==-flat-Go.cs,25,246,221,25,246,221
200,https://htmlpreview.github.io/?https://github.com/Christina96/boilerplate-sample-matches/blob/main/csharp/npgsql-MDEwOlJlcG9zaXRvcnkyODgzNTc0-flat-NpgsqlSlimDataSourceBuilder.cs-npgsql-MDEwOlJlcG9zaXRvcnkyODgzNTc0-flat-NpgsqlSlimDataSourceBuilder.cs-200.html,20,npgsql-MDEwOlJlcG9zaXRvcnkyODgzNTc0-flat-NpgsqlSlimDataSourceBuilder.cs,npgsql-MDEwOlJlcG9zaXRvcnkyODgzNTc0-flat-NpgsqlSlimDataSourceBuilder.cs,86,87,1,89,90,1
201,https://htmlpreview.github.io/?https://github.com/Christina96/boilerplate-sample-matches/blob/main/csharp/NetCoreServer-MDEwOlJlcG9zaXRvcnkxNjYxMjMxNjQ=-flat-Program_2.cs-NetCoreServer-MDEwOlJlcG9zaXRvcnkxNjYxMjMxNjQ=-flat-Program_36.cs-201.html,18,NetCoreServer-MDEwOlJlcG9zaXRvcnkxNjYxMjMxNjQ=-flat-Program_2.cs,NetCoreServer-MDEwOlJlcG9zaXRvcnkxNjYxMjMxNjQ=-flat-Program_36.cs,20,23,3,25,28,3
202,https://htmlpreview.github.io/?https://github.com/Christina96/boilerplate-sample-matches/blob/main/csharp/runner-MDEwOlJlcG9zaXRvcnkxODQyODY4NzU=-flat-JobServer.cs-runner-MDEwOlJlcG9zaXRvcnkxODQyODY4NzU=-flat-ResultsServer.cs-202.html,13,runner-MDEwOlJlcG9zaXRvcnkxODQyODY4NzU=-flat-JobServer.cs,runner-MDEwOlJlcG9zaXRvcnkxODQyODY4NzU=-flat-ResultsServer.cs,123,126,3,104,107,3
203,https://htmlpreview.github.io/?https://github.com/Christina96/boilerplate-sample-matches/blob/main/csharp/dotween-MDEwOlJlcG9zaXRvcnkzMjQ3NTE2Mg==-flat-ColorTweenProperty.cs-dotween-MDEwOlJlcG9zaXRvcnkzMjQ3NTE2Mg==-flat-Vector3TweenProperty_78.cs-203.html,176,dotween-MDEwOlJlcG9zaXRvcnkzMjQ3NTE2Mg==-flat-ColorTweenProperty.cs,dotween-MDEwOlJlcG9zaXRvcnkzMjQ3NTE2Mg==-flat-Vector3TweenProperty_78.cs,7,38,31,7,38,31
204,https://htmlpreview.github.io/?https://github.com/Christina96/boilerplate-sample-matches/blob/main/csharp/dotween-MDEwOlJlcG9zaXRvcnkzMjQ3NTE2Mg==-flat-AbstractTweenProperty_74.cs-dotween-MDEwOlJlcG9zaXRvcnkzMjQ3NTE2Mg==-flat-AbstractTweenProperty.cs-204.html,160,dotween-MDEwOlJlcG9zaXRvcnkzMjQ3NTE2Mg==-flat-AbstractTweenProperty_74.cs,dotween-MDEwOlJlcG9zaXRvcnkzMjQ3NTE2Mg==-flat-AbstractTweenProperty.cs,24,54,30,24,54,30
205,https://htmlpreview.github.io/?https://github.com/Christina96/boilerplate-sample-matches/blob/main/csharp/NetCoreServer-MDEwOlJlcG9zaXRvcnkxNjYxMjMxNjQ=-flat-WsClient.cs-NetCoreServer-MDEwOlJlcG9zaXRvcnkxNjYxMjMxNjQ=-flat-WssClient.cs-205.html,15,NetCoreServer-MDEwOlJlcG9zaXRvcnkxNjYxMjMxNjQ=-flat-WsClient.cs,NetCoreServer-MDEwOlJlcG9zaXRvcnkxNjYxMjMxNjQ=-flat-WssClient.cs,198,204,6,198,204,6
206,https://htmlpreview.github.io/?https://github.com/Christina96/boilerplate-sample-matches/blob/main/csharp/runner-MDEwOlJlcG9zaXRvcnkxODQyODY4NzU=-flat-Format.cs-runner-MDEwOlJlcG9zaXRvcnkxODQyODY4NzU=-flat-Format.cs-206.html,15,runner-MDEwOlJlcG9zaXRvcnkxODQyODY4NzU=-flat-Format.cs,runner-MDEwOlJlcG9zaXRvcnkxODQyODY4NzU=-flat-Format.cs,71,76,5,91,96,5
207,https://htmlpreview.github.io/?https://github.com/Christina96/boilerplate-sample-matches/blob/main/csharp/NetCoreServer-MDEwOlJlcG9zaXRvcnkxNjYxMjMxNjQ=-flat-SslServer.cs-NetCoreServer-MDEwOlJlcG9zaXRvcnkxNjYxMjMxNjQ=-flat-HttpRequest.cs-207.html,13,NetCoreServer-MDEwOlJlcG9zaXRvcnkxNjYxMjMxNjQ=-flat-SslServer.cs,NetCoreServer-MDEwOlJlcG9zaXRvcnkxNjYxMjMxNjQ=-flat-HttpRequest.cs,29,30,1,22,23,1
208,https://htmlpreview.github.io/?https://github.com/Christina96/boilerplate-sample-matches/blob/main/csharp/runner-MDEwOlJlcG9zaXRvcnkxODQyODY4NzU=-flat-PipelineContextDataJsonConverter.cs-runner-MDEwOlJlcG9zaXRvcnkxODQyODY4NzU=-flat-ResourceProperties.cs-208.html,15,runner-MDEwOlJlcG9zaXRvcnkxODQyODY4NzU=-flat-PipelineContextDataJsonConverter.cs,runner-MDEwOlJlcG9zaXRvcnkxODQyODY4NzU=-flat-ResourceProperties.cs,92,95,3,213,216,3
209,https://htmlpreview.github.io/?https://github.com/Christina96/boilerplate-sample-matches/blob/main/csharp/Simple.Data-MDEwOlJlcG9zaXRvcnk4MTg3Njg=-flat-AdoAdapterQueryRunner.cs-Simple.Data-MDEwOlJlcG9zaXRvcnk4MTg3Njg=-flat-AdoAdapterQueryRunner.cs-209.html,41,Simple.Data-MDEwOlJlcG9zaXRvcnk4MTg3Njg=-flat-AdoAdapterQueryRunner.cs,Simple.Data-MDEwOlJlcG9zaXRvcnk4MTg3Njg=-flat-AdoAdapterQueryRunner.cs,181,185,4,190,195,5
210,https://htmlpreview.github.io/?https://github.com/Christina96/boilerplate-sample-matches/blob/main/csharp/MudBlazor-MDEwOlJlcG9zaXRvcnkyODg0Mjg2NzY=-flat-CheckBoxTests.cs-MudBlazor-MDEwOlJlcG9zaXRvcnkyODg0Mjg2NzY=-flat-SwitchTests.cs-210.html,22,MudBlazor-MDEwOlJlcG9zaXRvcnkyODg0Mjg2NzY=-flat-CheckBoxTests.cs,MudBlazor-MDEwOlJlcG9zaXRvcnkyODg0Mjg2NzY=-flat-SwitchTests.cs,218,219,1,58,59,1
211,https://htmlpreview.github.io/?https://github.com/Christina96/boilerplate-sample-matches/blob/main/csharp/MudBlazor-MDEwOlJlcG9zaXRvcnkyODg0Mjg2NzY=-flat-Cell.cs-runner-MDEwOlJlcG9zaXRvcnkxODQyODY4NzU=-flat-ScriptHandler.cs-211.html,12,MudBlazor-MDEwOlJlcG9zaXRvcnkyODg0Mjg2NzY=-flat-Cell.cs,runner-MDEwOlJlcG9zaXRvcnkxODQyODY4NzU=-flat-ScriptHandler.cs,95,99,4,205,209,4
212,https://htmlpreview.github.io/?https://github.com/Christina96/boilerplate-sample-matches/blob/main/csharp/Simple.Data-MDEwOlJlcG9zaXRvcnk4MTg3Njg=-flat-FindTest.cs-Simple.Data-MDEwOlJlcG9zaXRvcnk4MTg3Njg=-flat-TransactionTest.cs-212.html,15,Simple.Data-MDEwOlJlcG9zaXRvcnk4MTg3Njg=-flat-FindTest.cs,Simple.Data-MDEwOlJlcG9zaXRvcnk4MTg3Njg=-flat-TransactionTest.cs,25,26,1,35,36,1
213,https://htmlpreview.github.io/?https://github.com/Christina96/boilerplate-sample-matches/blob/main/csharp/MudBlazor-MDEwOlJlcG9zaXRvcnkyODg0Mjg2NzY=-flat-EventManager.cs-MudBlazor-MDEwOlJlcG9zaXRvcnkyODg0Mjg2NzY=-flat-ScrollSpy.cs-213.html,14,MudBlazor-MDEwOlJlcG9zaXRvcnkyODg0Mjg2NzY=-flat-EventManager.cs,MudBlazor-MDEwOlJlcG9zaXRvcnkyODg0Mjg2NzY=-flat-ScrollSpy.cs,40,43,3,32,35,3
214,https://htmlpreview.github.io/?https://github.com/Christina96/boilerplate-sample-matches/blob/main/csharp/runner-MDEwOlJlcG9zaXRvcnkxODQyODY4NzU=-flat-RunnerService.cs-dotween-MDEwOlJlcG9zaXRvcnkzMjQ3NTE2Mg==-flat-DOTweenComponentInspector.cs-214.html,13,runner-MDEwOlJlcG9zaXRvcnkxODQyODY4NzU=-flat-RunnerService.cs,dotween-MDEwOlJlcG9zaXRvcnkzMjQ3NTE2Mg==-flat-DOTweenComponentInspector.cs,55,57,2,78,80,2
215,https://htmlpreview.github.io/?https://github.com/Christina96/boilerplate-sample-matches/blob/main/csharp/runner-MDEwOlJlcG9zaXRvcnkxODQyODY4NzU=-flat-ActionRunner.cs-MudBlazor-MDEwOlJlcG9zaXRvcnkyODg0Mjg2NzY=-flat-MudComponentFactory.cs-215.html,13,runner-MDEwOlJlcG9zaXRvcnkxODQyODY4NzU=-flat-ActionRunner.cs,MudBlazor-MDEwOlJlcG9zaXRvcnkyODg0Mjg2NzY=-flat-MudComponentFactory.cs,258,260,2,44,46,2
216,https://htmlpreview.github.io/?https://github.com/Christina96/boilerplate-sample-matches/blob/main/csharp/runner-MDEwOlJlcG9zaXRvcnkxODQyODY4NzU=-flat-JobRunner.cs-Security-MDEwOlJlcG9zaXRvcnkxNzcyMzY5OQ==-flat-CookieConsentTests.cs-216.html,13,runner-MDEwOlJlcG9zaXRvcnkxODQyODY4NzU=-flat-JobRunner.cs,Security-MDEwOlJlcG9zaXRvcnkxNzcyMzY5OQ==-flat-CookieConsentTests.cs,260,261,1,303,304,1
217,https://htmlpreview.github.io/?https://github.com/Christina96/boilerplate-sample-matches/blob/main/csharp/runner-MDEwOlJlcG9zaXRvcnkxODQyODY4NzU=-flat-XmlUtility.cs-runner-MDEwOlJlcG9zaXRvcnkxODQyODY4NzU=-flat-XmlUtility.cs-217.html,14,runner-MDEwOlJlcG9zaXRvcnkxODQyODY4NzU=-flat-XmlUtility.cs,runner-MDEwOlJlcG9zaXRvcnkxODQyODY4NzU=-flat-XmlUtility.cs,357,359,2,369,371,2
218,https://htmlpreview.github.io/?https://github.com/Christina96/boilerplate-sample-matches/blob/main/csharp/npgsql-MDEwOlJlcG9zaXRvcnkyODgzNTc0-flat-RangeTests.cs-npgsql-MDEwOlJlcG9zaXRvcnkyODgzNTc0-flat-RangeTests.cs-218.html,21,npgsql-MDEwOlJlcG9zaXRvcnkyODgzNTc0-flat-RangeTests.cs,npgsql-MDEwOlJlcG9zaXRvcnkyODgzNTc0-flat-RangeTests.cs,75,76,1,74,75,1
219,https://htmlpreview.github.io/?https://github.com/Christina96/boilerplate-sample-matches/blob/main/csharp/runner-MDEwOlJlcG9zaXRvcnkxODQyODY4NzU=-flat-ContainerActionHandler.cs-EarTrumpet-MDEwOlJlcG9zaXRvcnkzODkxOTcwMg==-flat-WindowAnimationLibrary.cs-219.html,17,runner-MDEwOlJlcG9zaXRvcnkxODQyODY4NzU=-flat-ContainerActionHandler.cs,EarTrumpet-MDEwOlJlcG9zaXRvcnkzODkxOTcwMg==-flat-WindowAnimationLibrary.cs,102,105,3,150,153,3
220,https://htmlpreview.github.io/?https://github.com/Christina96/boilerplate-sample-matches/blob/main/csharp/MudBlazor-MDEwOlJlcG9zaXRvcnkyODg0Mjg2NzY=-flat-PopoverServiceTests.cs-runner-MDEwOlJlcG9zaXRvcnkxODQyODY4NzU=-flat-ActionManager.cs-220.html,13,MudBlazor-MDEwOlJlcG9zaXRvcnkyODg0Mjg2NzY=-flat-PopoverServiceTests.cs,runner-MDEwOlJlcG9zaXRvcnkxODQyODY4NzU=-flat-ActionManager.cs,322,323,1,144,145,1
221,https://htmlpreview.github.io/?https://github.com/Christina96/boilerplate-sample-matches/blob/main/csharp/npgsql-MDEwOlJlcG9zaXRvcnkyODgzNTc0-flat-Int32Handler.cs-npgsql-MDEwOlJlcG9zaXRvcnkyODgzNTc0-flat-Int32Handler.cs-221.html,14,npgsql-MDEwOlJlcG9zaXRvcnkyODgzNTc0-flat-Int32Handler.cs,npgsql-MDEwOlJlcG9zaXRvcnkyODgzNTc0-flat-Int32Handler.cs,43,46,3,33,36,3
222,https://htmlpreview.github.io/?https://github.com/Christina96/boilerplate-sample-matches/blob/main/csharp/npgsql-MDEwOlJlcG9zaXRvcnkyODgzNTc0-flat-TypeMapper.cs-npgsql-MDEwOlJlcG9zaXRvcnkyODgzNTc0-flat-GlobalTypeMapper.cs-222.html,31,npgsql-MDEwOlJlcG9zaXRvcnkyODgzNTc0-flat-TypeMapper.cs,npgsql-MDEwOlJlcG9zaXRvcnkyODgzNTc0-flat-GlobalTypeMapper.cs,410,413,3,205,208,3
223,https://htmlpreview.github.io/?https://github.com/Christina96/boilerplate-sample-matches/blob/main/csharp/20486D-DevelopingASPNETMVCWebApplications-MDEwOlJlcG9zaXRvcnkxMTkzNTI2Mzc=-flat-20180801110420_AddCupcakeCaloricValue.cs-20486D-DevelopingASPNETMVCWebApplications-MDEwOlJlcG9zaXRvcnkxMTkzNTI2Mzc=-flat-20180801110420_AddCupcakeCaloricValue.cs-223.html,13,20486D-DevelopingASPNETMVCWebApplications-MDEwOlJlcG9zaXRvcnkxMTkzNTI2Mzc=-flat-20180801110420_AddCupcakeCaloricValue.cs,20486D-DevelopingASPNETMVCWebApplications-MDEwOlJlcG9zaXRvcnkxMTkzNTI2Mzc=-flat-20180801110420_AddCupcakeCaloricValue.cs,28,31,3,34,37,3
224,https://htmlpreview.github.io/?https://github.com/Christina96/boilerplate-sample-matches/blob/main/csharp/MudBlazor-MDEwOlJlcG9zaXRvcnkyODg0Mjg2NzY=-flat-FormTests.cs-MudBlazor-MDEwOlJlcG9zaXRvcnkyODg0Mjg2NzY=-flat-FormTests.cs-224.html,20,MudBlazor-MDEwOlJlcG9zaXRvcnkyODg0Mjg2NzY=-flat-FormTests.cs,MudBlazor-MDEwOlJlcG9zaXRvcnkyODg0Mjg2NzY=-flat-FormTests.cs,115,117,2,119,121,2
225,https://htmlpreview.github.io/?https://github.com/Christina96/boilerplate-sample-matches/blob/main/csharp/MudBlazor-MDEwOlJlcG9zaXRvcnkyODg0Mjg2NzY=-flat-AggregateDefinitionTests.cs-MudBlazor-MDEwOlJlcG9zaXRvcnkyODg0Mjg2NzY=-flat-AggregateDefinitionTests.cs-225.html,73,MudBlazor-MDEwOlJlcG9zaXRvcnkyODg0Mjg2NzY=-flat-AggregateDefinitionTests.cs,MudBlazor-MDEwOlJlcG9zaXRvcnkyODg0Mjg2NzY=-flat-AggregateDefinitionTests.cs,42,51,9,53,62,9
226,https://htmlpreview.github.io/?https://github.com/Christina96/boilerplate-sample-matches/blob/main/csharp/npgsql-MDEwOlJlcG9zaXRvcnkyODgzNTc0-flat-MultirangeHandler.cs-npgsql-MDEwOlJlcG9zaXRvcnkyODgzNTc0-flat-RangeHandler.cs-226.html,15,npgsql-MDEwOlJlcG9zaXRvcnkyODgzNTc0-flat-MultirangeHandler.cs,npgsql-MDEwOlJlcG9zaXRvcnkyODgzNTc0-flat-RangeHandler.cs,37,38,1,90,91,1
227,https://htmlpreview.github.io/?https://github.com/Christina96/boilerplate-sample-matches/blob/main/csharp/dotween-MDEwOlJlcG9zaXRvcnkzMjQ3NTE2Mg==-flat-iTween_121.cs-dotween-MDEwOlJlcG9zaXRvcnkzMjQ3NTE2Mg==-flat-iTween.cs-227.html,1114,dotween-MDEwOlJlcG9zaXRvcnkzMjQ3NTE2Mg==-flat-iTween_121.cs,dotween-MDEwOlJlcG9zaXRvcnkzMjQ3NTE2Mg==-flat-iTween.cs,5,196,191,5,196,191
228,https://htmlpreview.github.io/?https://github.com/Christina96/boilerplate-sample-matches/blob/main/csharp/MudBlazor-MDEwOlJlcG9zaXRvcnkyODg0Mjg2NzY=-flat-MudImage.razor.cs-MudBlazor-MDEwOlJlcG9zaXRvcnkyODg0Mjg2NzY=-flat-MudImage.razor.cs-228.html,13,MudBlazor-MDEwOlJlcG9zaXRvcnkyODg0Mjg2NzY=-flat-MudImage.razor.cs,MudBlazor-MDEwOlJlcG9zaXRvcnkyODg0Mjg2NzY=-flat-MudImage.razor.cs,29,31,2,26,28,2
229,https://htmlpreview.github.io/?https://github.com/Christina96/boilerplate-sample-matches/blob/main/csharp/npgsql-MDEwOlJlcG9zaXRvcnkyODgzNTc0-flat-CommandTests.cs-npgsql-MDEwOlJlcG9zaXRvcnkyODgzNTc0-flat-CommandTests.cs-229.html,15,npgsql-MDEwOlJlcG9zaXRvcnkyODgzNTc0-flat-CommandTests.cs,npgsql-MDEwOlJlcG9zaXRvcnkyODgzNTc0-flat-CommandTests.cs,962,963,1,986,987,1
230,https://htmlpreview.github.io/?https://github.com/Christina96/boilerplate-sample-matches/blob/main/csharp/ZXing.Net.Mobile-MDEwOlJlcG9zaXRvcnk2MTYwNjcz-flat-MobileBarcodeScanner.ios.cs-ZXing.Net.Mobile-MDEwOlJlcG9zaXRvcnk2MTYwNjcz-flat-MobileBarcodeScanner.ios.cs-230.html,32,ZXing.Net.Mobile-MDEwOlJlcG9zaXRvcnk2MTYwNjcz-flat-MobileBarcodeScanner.ios.cs,ZXing.Net.Mobile-MDEwOlJlcG9zaXRvcnk2MTYwNjcz-flat-MobileBarcodeScanner.ios.cs,33,38,5,84,89,5
231,https://htmlpreview.github.io/?https://github.com/Christina96/boilerplate-sample-matches/blob/main/csharp/npgsql-MDEwOlJlcG9zaXRvcnkyODgzNTc0-flat-NpgsqlDataReader.cs-npgsql-MDEwOlJlcG9zaXRvcnkyODgzNTc0-flat-ReplicationValue.cs-231.html,13,npgsql-MDEwOlJlcG9zaXRvcnkyODgzNTc0-flat-NpgsqlDataReader.cs,npgsql-MDEwOlJlcG9zaXRvcnkyODgzNTc0-flat-ReplicationValue.cs,1148,1150,2,75,77,2
232,https://htmlpreview.github.io/?https://github.com/Christina96/boilerplate-sample-matches/blob/main/csharp/20486D-DevelopingASPNETMVCWebApplications-MDEwOlJlcG9zaXRvcnkxMTkzNTI2Mzc=-flat-UnderwaterContextModelSnapshot.cs-20486D-DevelopingASPNETMVCWebApplications-MDEwOlJlcG9zaXRvcnkxMTkzNTI2Mzc=-flat-CupcakeContextModelSnapshot.cs-232.html,79,20486D-DevelopingASPNETMVCWebApplications-MDEwOlJlcG9zaXRvcnkxMTkzNTI2Mzc=-flat-UnderwaterContextModelSnapshot.cs,20486D-DevelopingASPNETMVCWebApplications-MDEwOlJlcG9zaXRvcnkxMTkzNTI2Mzc=-flat-CupcakeContextModelSnapshot.cs,10,24,14,10,25,15
233,https://htmlpreview.github.io/?https://github.com/Christina96/boilerplate-sample-matches/blob/main/csharp/EarTrumpet-MDEwOlJlcG9zaXRvcnkzODkxOTcwMg==-flat-ActionProcessor.cs-EarTrumpet-MDEwOlJlcG9zaXRvcnkzODkxOTcwMg==-flat-ActionProcessor.cs-233.html,13,EarTrumpet-MDEwOlJlcG9zaXRvcnkzODkxOTcwMg==-flat-ActionProcessor.cs,EarTrumpet-MDEwOlJlcG9zaXRvcnkzODkxOTcwMg==-flat-ActionProcessor.cs,70,75,5,101,106,5
234,https://htmlpreview.github.io/?https://github.com/Christina96/boilerplate-sample-matches/blob/main/csharp/npgsql-MDEwOlJlcG9zaXRvcnkyODgzNTc0-flat-CompositeTests.cs-npgsql-MDEwOlJlcG9zaXRvcnkyODgzNTc0-flat-CompositeTests.cs-234.html,33,npgsql-MDEwOlJlcG9zaXRvcnkyODgzNTc0-flat-CompositeTests.cs,npgsql-MDEwOlJlcG9zaXRvcnkyODgzNTc0-flat-CompositeTests.cs,120,124,4,114,118,4
235,https://htmlpreview.github.io/?https://github.com/Christina96/boilerplate-sample-matches/blob/main/csharp/dotween-MDEwOlJlcG9zaXRvcnkzMjQ3NTE2Mg==-flat-RuntimeChanges_4.cs-dotween-MDEwOlJlcG9zaXRvcnkzMjQ3NTE2Mg==-flat-TweenEnginesComparisonInternal.cs-235.html,12,dotween-MDEwOlJlcG9zaXRvcnkzMjQ3NTE2Mg==-flat-RuntimeChanges_4.cs,dotween-MDEwOlJlcG9zaXRvcnkzMjQ3NTE2Mg==-flat-TweenEnginesComparisonInternal.cs,22,23,1,82,83,1
236,https://htmlpreview.github.io/?https://github.com/Christina96/boilerplate-sample-matches/blob/main/csharp/Simple.Data-MDEwOlJlcG9zaXRvcnk4MTg3Njg=-flat-InMemoryTests.cs-Simple.Data-MDEwOlJlcG9zaXRvcnk4MTg3Njg=-flat-InMemoryTests.cs-236.html,19,Simple.Data-MDEwOlJlcG9zaXRvcnk4MTg3Njg=-flat-InMemoryTests.cs,Simple.Data-MDEwOlJlcG9zaXRvcnk4MTg3Njg=-flat-InMemoryTests.cs,27,29,2,107,109,2
237,https://htmlpreview.github.io/?https://github.com/Christina96/boilerplate-sample-matches/blob/main/csharp/runner-MDEwOlJlcG9zaXRvcnkxODQyODY4NzU=-flat-VssCommonConstants.cs-runner-MDEwOlJlcG9zaXRvcnkxODQyODY4NzU=-flat-VssCommonConstants.cs-237.html,35,runner-MDEwOlJlcG9zaXRvcnkxODQyODY4NzU=-flat-VssCommonConstants.cs,runner-MDEwOlJlcG9zaXRvcnkxODQyODY4NzU=-flat-VssCommonConstants.cs,91,96,5,97,102,5
238,https://htmlpreview.github.io/?https://github.com/Christina96/boilerplate-sample-matches/blob/main/csharp/dotween-MDEwOlJlcG9zaXRvcnkzMjQ3NTE2Mg==-flat-iTween_121.cs-dotween-MDEwOlJlcG9zaXRvcnkzMjQ3NTE2Mg==-flat-iTween.cs-238.html,14,dotween-MDEwOlJlcG9zaXRvcnkzMjQ3NTE2Mg==-flat-iTween_121.cs,dotween-MDEwOlJlcG9zaXRvcnkzMjQ3NTE2Mg==-flat-iTween.cs,1564,1565,1,1556,1557,1
239,https://htmlpreview.github.io/?https://github.com/Christina96/boilerplate-sample-matches/blob/main/csharp/MudBlazor-MDEwOlJlcG9zaXRvcnkyODg0Mjg2NzY=-flat-MudCollapse.razor.cs-ZXing.Net.Mobile-MDEwOlJlcG9zaXRvcnk2MTYwNjcz-flat-ZXingScannerCamera.tizen.cs-239.html,12,MudBlazor-MDEwOlJlcG9zaXRvcnkyODg0Mjg2NzY=-flat-MudCollapse.razor.cs,ZXing.Net.Mobile-MDEwOlJlcG9zaXRvcnk2MTYwNjcz-flat-ZXingScannerCamera.tizen.cs,46,47,1,95,96,1
240,https://htmlpreview.github.io/?https://github.com/Christina96/boilerplate-sample-matches/blob/main/csharp/runner-MDEwOlJlcG9zaXRvcnkxODQyODY4NzU=-flat-VssConnection.cs-runner-MDEwOlJlcG9zaXRvcnkxODQyODY4NzU=-flat-RawConnection.cs-240.html,210,runner-MDEwOlJlcG9zaXRvcnkxODQyODY4NzU=-flat-VssConnection.cs,runner-MDEwOlJlcG9zaXRvcnkxODQyODY4NzU=-flat-RawConnection.cs,247,287,40,88,128,40
241,https://htmlpreview.github.io/?https://github.com/Christina96/boilerplate-sample-matches/blob/main/csharp/runner-MDEwOlJlcG9zaXRvcnkxODQyODY4NzU=-flat-TemplateEvaluator.cs-runner-MDEwOlJlcG9zaXRvcnkxODQyODY4NzU=-flat-TemplateReader.cs-241.html,22,runner-MDEwOlJlcG9zaXRvcnkxODQyODY4NzU=-flat-TemplateEvaluator.cs,runner-MDEwOlJlcG9zaXRvcnkxODQyODY4NzU=-flat-TemplateReader.cs,303,308,5,363,368,5
242,https://htmlpreview.github.io/?https://github.com/Christina96/boilerplate-sample-matches/blob/main/csharp/Security-MDEwOlJlcG9zaXRvcnkxNzcyMzY5OQ==-flat-AuthPropertiesTokenCache.cs-EarTrumpet-MDEwOlJlcG9zaXRvcnkzODkxOTcwMg==-flat-EarTrumpetActionViewModel.cs-242.html,15,Security-MDEwOlJlcG9zaXRvcnkxNzcyMzY5OQ==-flat-AuthPropertiesTokenCache.cs,EarTrumpet-MDEwOlJlcG9zaXRvcnkzODkxOTcwMg==-flat-EarTrumpetActionViewModel.cs,45,47,2,174,176,2
243,https://htmlpreview.github.io/?https://github.com/Christina96/boilerplate-sample-matches/blob/main/csharp/EarTrumpet-MDEwOlJlcG9zaXRvcnkzODkxOTcwMg==-flat-WindowAnimationLibrary.cs-EarTrumpet-MDEwOlJlcG9zaXRvcnkzODkxOTcwMg==-flat-WindowAnimationLibrary.cs-243.html,63,EarTrumpet-MDEwOlJlcG9zaXRvcnkzODkxOTcwMg==-flat-WindowAnimationLibrary.cs,EarTrumpet-MDEwOlJlcG9zaXRvcnkzODkxOTcwMg==-flat-WindowAnimationLibrary.cs,32,42,10,109,118,9
244,https://htmlpreview.github.io/?https://github.com/Christina96/boilerplate-sample-matches/blob/main/csharp/Simple.Data-MDEwOlJlcG9zaXRvcnk4MTg3Njg=-flat-ExpressionFormatter.cs-Simple.Data-MDEwOlJlcG9zaXRvcnk4MTg3Njg=-flat-ExpressionFormatter.cs-244.html,18,Simple.Data-MDEwOlJlcG9zaXRvcnk4MTg3Njg=-flat-ExpressionFormatter.cs,Simple.Data-MDEwOlJlcG9zaXRvcnk4MTg3Njg=-flat-ExpressionFormatter.cs,31,33,2,27,29,2
245,https://htmlpreview.github.io/?https://github.com/Christina96/boilerplate-sample-matches/blob/main/csharp/Simple.Data-MDEwOlJlcG9zaXRvcnk4MTg3Njg=-flat-UpdateTest.cs-Simple.Data-MDEwOlJlcG9zaXRvcnk4MTg3Njg=-flat-InsertTest.cs-245.html,14,Simple.Data-MDEwOlJlcG9zaXRvcnk4MTg3Njg=-flat-UpdateTest.cs,Simple.Data-MDEwOlJlcG9zaXRvcnk4MTg3Njg=-flat-InsertTest.cs,242,245,3,51,53,2
246,https://htmlpreview.github.io/?https://github.com/Christina96/boilerplate-sample-matches/blob/main/csharp/dotween-MDEwOlJlcG9zaXRvcnkzMjQ3NTE2Mg==-flat-OnWaypointChangedTests.cs-dotween-MDEwOlJlcG9zaXRvcnkzMjQ3NTE2Mg==-flat-OnWaypointChangedTests.cs-246.html,196,dotween-MDEwOlJlcG9zaXRvcnkzMjQ3NTE2Mg==-flat-OnWaypointChangedTests.cs,dotween-MDEwOlJlcG9zaXRvcnkzMjQ3NTE2Mg==-flat-OnWaypointChangedTests.cs,96,114,18,116,134,18
247,https://htmlpreview.github.io/?https://github.com/Christina96/boilerplate-sample-matches/blob/main/csharp/EarTrumpet-MDEwOlJlcG9zaXRvcnkzODkxOTcwMg==-flat-SettingsWindow.xaml.cs-EarTrumpet-MDEwOlJlcG9zaXRvcnkzODkxOTcwMg==-flat-FullWindow.xaml.cs-247.html,15,EarTrumpet-MDEwOlJlcG9zaXRvcnkzODkxOTcwMg==-flat-SettingsWindow.xaml.cs,EarTrumpet-MDEwOlJlcG9zaXRvcnkzODkxOTcwMg==-flat-FullWindow.xaml.cs,13,14,1,15,16,1
248,https://htmlpreview.github.io/?https://github.com/Christina96/boilerplate-sample-matches/blob/main/csharp/EarTrumpet-MDEwOlJlcG9zaXRvcnkzODkxOTcwMg==-flat-VolumeSlider.cs-EarTrumpet-MDEwOlJlcG9zaXRvcnkzODkxOTcwMg==-flat-VolumeSlider.cs-248.html,62,EarTrumpet-MDEwOlJlcG9zaXRvcnkzODkxOTcwMg==-flat-VolumeSlider.cs,EarTrumpet-MDEwOlJlcG9zaXRvcnkzODkxOTcwMg==-flat-VolumeSlider.cs,12,17,5,19,24,5
249,https://htmlpreview.github.io/?https://github.com/Christina96/boilerplate-sample-matches/blob/main/csharp/npgsql-MDEwOlJlcG9zaXRvcnkyODgzNTc0-flat-CompositeHandler.cs-npgsql-MDEwOlJlcG9zaXRvcnkyODgzNTc0-flat-GeoJSONHandler.cs-249.html,14,npgsql-MDEwOlJlcG9zaXRvcnkyODgzNTc0-flat-CompositeHandler.cs,npgsql-MDEwOlJlcG9zaXRvcnkyODgzNTc0-flat-GeoJSONHandler.cs,59,61,2,86,88,2
250,https://htmlpreview.github.io/?https://github.com/Christina96/boilerplate-sample-matches/blob/main/csharp/dotween-MDEwOlJlcG9zaXRvcnkzMjQ3NTE2Mg==-flat-GoDummyPathEditor.cs-dotween-MDEwOlJlcG9zaXRvcnkzMjQ3NTE2Mg==-flat-GoDummyPathEditor_122.cs-250.html,1691,dotween-MDEwOlJlcG9zaXRvcnkzMjQ3NTE2Mg==-flat-GoDummyPathEditor.cs,dotween-MDEwOlJlcG9zaXRvcnkzMjQ3NTE2Mg==-flat-GoDummyPathEditor_122.cs,104,356,252,104,356,252
251,https://htmlpreview.github.io/?https://github.com/Christina96/boilerplate-sample-matches/blob/main/csharp/runner-MDEwOlJlcG9zaXRvcnkxODQyODY4NzU=-flat-TestHostContext.cs-runner-MDEwOlJlcG9zaXRvcnkxODQyODY4NzU=-flat-HostContext.cs-251.html,28,runner-MDEwOlJlcG9zaXRvcnkxODQyODY4NzU=-flat-TestHostContext.cs,runner-MDEwOlJlcG9zaXRvcnkxODQyODY4NzU=-flat-HostContext.cs,244,252,8,330,338,8
252,https://htmlpreview.github.io/?https://github.com/Christina96/boilerplate-sample-matches/blob/main/csharp/runner-MDEwOlJlcG9zaXRvcnkxODQyODY4NzU=-flat-JsonWebToken.cs-runner-MDEwOlJlcG9zaXRvcnkxODQyODY4NzU=-flat-JsonWebToken.cs-252.html,16,runner-MDEwOlJlcG9zaXRvcnkxODQyODY4NzU=-flat-JsonWebToken.cs,runner-MDEwOlJlcG9zaXRvcnkxODQyODY4NzU=-flat-JsonWebToken.cs,424,430,6,413,419,6
253,https://htmlpreview.github.io/?https://github.com/Christina96/boilerplate-sample-matches/blob/main/csharp/MudBlazor-MDEwOlJlcG9zaXRvcnkyODg0Mjg2NzY=-flat-RegexMask.cs-MudBlazor-MDEwOlJlcG9zaXRvcnkyODg0Mjg2NzY=-flat-PatternMask.cs-253.html,46,MudBlazor-MDEwOlJlcG9zaXRvcnkyODg0Mjg2NzY=-flat-RegexMask.cs,MudBlazor-MDEwOlJlcG9zaXRvcnkyODg0Mjg2NzY=-flat-PatternMask.cs,51,62,11,68,79,11
254,https://htmlpreview.github.io/?https://github.com/Christina96/boilerplate-sample-matches/blob/main/csharp/ZXing.Net.Mobile-MDEwOlJlcG9zaXRvcnk2MTYwNjcz-flat-ZXingBarcodeImageViewRenderer.ios.cs-npgsql-MDEwOlJlcG9zaXRvcnkyODgzNTc0-flat-DbColumnSchemaGenerator.cs-254.html,16,ZXing.Net.Mobile-MDEwOlJlcG9zaXRvcnk2MTYwNjcz-flat-ZXingBarcodeImageViewRenderer.ios.cs,npgsql-MDEwOlJlcG9zaXRvcnkyODgzNTc0-flat-DbColumnSchemaGenerator.cs,53,55,2,217,219,2
255,https://htmlpreview.github.io/?https://github.com/Christina96/boilerplate-sample-matches/blob/main/csharp/MudBlazor-MDEwOlJlcG9zaXRvcnkyODg0Mjg2NzY=-flat-MudPopoverHandler.cs-npgsql-MDEwOlJlcG9zaXRvcnkyODgzNTc0-flat-TransactionTests.cs-255.html,16,MudBlazor-MDEwOlJlcG9zaXRvcnkyODg0Mjg2NzY=-flat-MudPopoverHandler.cs,npgsql-MDEwOlJlcG9zaXRvcnkyODgzNTc0-flat-TransactionTests.cs,72,78,6,436,442,6
256,https://htmlpreview.github.io/?https://github.com/Christina96/boilerplate-sample-matches/blob/main/csharp/dotween-MDEwOlJlcG9zaXRvcnkzMjQ3NTE2Mg==-flat-CustomPluginExampleBrain_128.cs-dotween-MDEwOlJlcG9zaXRvcnkzMjQ3NTE2Mg==-flat-CustomPluginExampleBrain.cs-256.html,15,dotween-MDEwOlJlcG9zaXRvcnkzMjQ3NTE2Mg==-flat-CustomPluginExampleBrain_128.cs,dotween-MDEwOlJlcG9zaXRvcnkzMjQ3NTE2Mg==-flat-CustomPluginExampleBrain.cs,16,18,2,16,18,2
257,https://htmlpreview.github.io/?https://github.com/Christina96/boilerplate-sample-matches/blob/main/csharp/npgsql-MDEwOlJlcG9zaXRvcnkyODgzNTc0-flat-BugTests.cs-npgsql-MDEwOlJlcG9zaXRvcnkyODgzNTc0-flat-MultipleHostsTests.cs-257.html,13,npgsql-MDEwOlJlcG9zaXRvcnkyODgzNTc0-flat-BugTests.cs,npgsql-MDEwOlJlcG9zaXRvcnkyODgzNTc0-flat-MultipleHostsTests.cs,331,333,2,672,674,2
258,https://htmlpreview.github.io/?https://github.com/Christina96/boilerplate-sample-matches/blob/main/csharp/runner-MDEwOlJlcG9zaXRvcnkxODQyODY4NzU=-flat-ContainerHookManager.cs-runner-MDEwOlJlcG9zaXRvcnkxODQyODY4NzU=-flat-ContainerHookManager.cs-258.html,15,runner-MDEwOlJlcG9zaXRvcnkxODQyODY4NzU=-flat-ContainerHookManager.cs,runner-MDEwOlJlcG9zaXRvcnkxODQyODY4NzU=-flat-ContainerHookManager.cs,79,83,4,103,107,4
259,https://htmlpreview.github.io/?https://github.com/Christina96/boilerplate-sample-matches/blob/main/csharp/dotween-MDEwOlJlcG9zaXRvcnkzMjQ3NTE2Mg==-flat-Ids.cs-dotween-MDEwOlJlcG9zaXRvcnkzMjQ3NTE2Mg==-flat-Ids_20.cs-259.html,238,dotween-MDEwOlJlcG9zaXRvcnkzMjQ3NTE2Mg==-flat-Ids.cs,dotween-MDEwOlJlcG9zaXRvcnkzMjQ3NTE2Mg==-flat-Ids_20.cs,14,45,31,14,45,31
260,https://htmlpreview.github.io/?https://github.com/Christina96/boilerplate-sample-matches/blob/main/csharp/MudBlazor-MDEwOlJlcG9zaXRvcnkyODg0Mjg2NzY=-flat-Outlined.cs-MudBlazor-MDEwOlJlcG9zaXRvcnkyODg0Mjg2NzY=-flat-Sharp.cs-260.html,22,MudBlazor-MDEwOlJlcG9zaXRvcnkyODg0Mjg2NzY=-flat-Outlined.cs,MudBlazor-MDEwOlJlcG9zaXRvcnkyODg0Mjg2NzY=-flat-Sharp.cs,1177,1179,2,394,396,2
261,https://htmlpreview.github.io/?https://github.com/Christina96/boilerplate-sample-matches/blob/main/csharp/runner-MDEwOlJlcG9zaXRvcnkxODQyODY4NzU=-flat-SaveStateFileCommandL0.cs-runner-MDEwOlJlcG9zaXRvcnkxODQyODY4NzU=-flat-SetOutputFileCommandL0.cs-261.html,15,runner-MDEwOlJlcG9zaXRvcnkxODQyODY4NzU=-flat-SaveStateFileCommandL0.cs,runner-MDEwOlJlcG9zaXRvcnkxODQyODY4NzU=-flat-SetOutputFileCommandL0.cs,96,100,4,96,100,4
262,https://htmlpreview.github.io/?https://github.com/Christina96/boilerplate-sample-matches/blob/main/csharp/runner-MDEwOlJlcG9zaXRvcnkxODQyODY4NzU=-flat-SetEnvFileCommandL0.cs-runner-MDEwOlJlcG9zaXRvcnkxODQyODY4NzU=-flat-PipelineDirectoryManagerL0.cs-262.html,13,runner-MDEwOlJlcG9zaXRvcnkxODQyODY4NzU=-flat-SetEnvFileCommandL0.cs,runner-MDEwOlJlcG9zaXRvcnkxODQyODY4NzU=-flat-PipelineDirectoryManagerL0.cs,371,373,2,145,148,3
263,https://htmlpreview.github.io/?https://github.com/Christina96/boilerplate-sample-matches/blob/main/csharp/Security-MDEwOlJlcG9zaXRvcnkxNzcyMzY5OQ==-flat-DefaultAuthorizationServiceTests.cs-Security-MDEwOlJlcG9zaXRvcnkxNzcyMzY5OQ==-flat-DefaultAuthorizationServiceTests.cs-263.html,22,Security-MDEwOlJlcG9zaXRvcnkxNzcyMzY5OQ==-flat-DefaultAuthorizationServiceTests.cs,Security-MDEwOlJlcG9zaXRvcnkxNzcyMzY5OQ==-flat-DefaultAuthorizationServiceTests.cs,725,726,1,737,738,1
264,https://htmlpreview.github.io/?https://github.com/Christina96/boilerplate-sample-matches/blob/main/csharp/runner-MDEwOlJlcG9zaXRvcnkxODQyODY4NzU=-flat-IssuedToken.cs-npgsql-MDEwOlJlcG9zaXRvcnkyODgzNTc0-flat-NpgsqlTypes.cs-264.html,12,runner-MDEwOlJlcG9zaXRvcnkxODQyODY4NzU=-flat-IssuedToken.cs,npgsql-MDEwOlJlcG9zaXRvcnkyODgzNTc0-flat-NpgsqlTypes.cs,60,61,1,324,325,1
265,https://htmlpreview.github.io/?https://github.com/Christina96/boilerplate-sample-matches/blob/main/csharp/Simple.Data-MDEwOlJlcG9zaXRvcnk4MTg3Njg=-flat-InMemoryAdapterIAdapterWithTransactions.cs-Simple.Data-MDEwOlJlcG9zaXRvcnk4MTg3Njg=-flat-BeginTransactionWithIsolataionLevelTest.cs-265.html,16,Simple.Data-MDEwOlJlcG9zaXRvcnk4MTg3Njg=-flat-InMemoryAdapterIAdapterWithTransactions.cs,Simple.Data-MDEwOlJlcG9zaXRvcnk4MTg3Njg=-flat-BeginTransactionWithIsolataionLevelTest.cs,37,40,3,43,46,3
266,https://htmlpreview.github.io/?https://github.com/Christina96/boilerplate-sample-matches/blob/main/csharp/NetCoreServer-MDEwOlJlcG9zaXRvcnkxNjYxMjMxNjQ=-flat-HttpClient.cs-NetCoreServer-MDEwOlJlcG9zaXRvcnkxNjYxMjMxNjQ=-flat-HttpsClient.cs-266.html,18,NetCoreServer-MDEwOlJlcG9zaXRvcnkxNjYxMjMxNjQ=-flat-HttpClient.cs,NetCoreServer-MDEwOlJlcG9zaXRvcnkxNjYxMjMxNjQ=-flat-HttpsClient.cs,116,117,1,116,117,1
267,https://htmlpreview.github.io/?https://github.com/Christina96/boilerplate-sample-matches/blob/main/csharp/dotween-MDEwOlJlcG9zaXRvcnkzMjQ3NTE2Mg==-flat-iTween_121.cs-dotween-MDEwOlJlcG9zaXRvcnkzMjQ3NTE2Mg==-flat-iTween.cs-267.html,246,dotween-MDEwOlJlcG9zaXRvcnkzMjQ3NTE2Mg==-flat-iTween_121.cs,dotween-MDEwOlJlcG9zaXRvcnkzMjQ3NTE2Mg==-flat-iTween.cs,1937,1957,20,1937,1957,20
268,https://htmlpreview.github.io/?https://github.com/Christina96/boilerplate-sample-matches/blob/main/csharp/Security-MDEwOlJlcG9zaXRvcnkxNzcyMzY5OQ==-flat-WsFederationHandler.cs-Security-MDEwOlJlcG9zaXRvcnkxNzcyMzY5OQ==-flat-OpenIdConnectHandler.cs-268.html,40,Security-MDEwOlJlcG9zaXRvcnkxNzcyMzY5OQ==-flat-WsFederationHandler.cs,Security-MDEwOlJlcG9zaXRvcnkxNzcyMzY5OQ==-flat-OpenIdConnectHandler.cs,62,70,8,264,272,8
269,https://htmlpreview.github.io/?https://github.com/Christina96/boilerplate-sample-matches/blob/main/csharp/MudBlazor-MDEwOlJlcG9zaXRvcnkyODg0Mjg2NzY=-flat-MudColorPicker.razor.cs-MudBlazor-MDEwOlJlcG9zaXRvcnkyODg0Mjg2NzY=-flat-MudColorPicker.razor.cs-269.html,12,MudBlazor-MDEwOlJlcG9zaXRvcnkyODg0Mjg2NzY=-flat-MudColorPicker.razor.cs,MudBlazor-MDEwOlJlcG9zaXRvcnkyODg0Mjg2NzY=-flat-MudColorPicker.razor.cs,247,251,4,220,224,4
270,https://htmlpreview.github.io/?https://github.com/Christina96/boilerplate-sample-matches/blob/main/csharp/npgsql-MDEwOlJlcG9zaXRvcnkyODgzNTc0-flat-RangeHandler.cs-npgsql-MDEwOlJlcG9zaXRvcnkyODgzNTc0-flat-RangeHandler.cs-270.html,33,npgsql-MDEwOlJlcG9zaXRvcnkyODgzNTc0-flat-RangeHandler.cs,npgsql-MDEwOlJlcG9zaXRvcnkyODgzNTc0-flat-RangeHandler.cs,107,108,1,108,109,1
271,https://htmlpreview.github.io/?https://github.com/Christina96/boilerplate-sample-matches/blob/main/csharp/dotween-MDEwOlJlcG9zaXRvcnkzMjQ3NTE2Mg==-flat-iTween.cs-dotween-MDEwOlJlcG9zaXRvcnkzMjQ3NTE2Mg==-flat-iTween_121.cs-271.html,19,dotween-MDEwOlJlcG9zaXRvcnkzMjQ3NTE2Mg==-flat-iTween.cs,dotween-MDEwOlJlcG9zaXRvcnkzMjQ3NTE2Mg==-flat-iTween_121.cs,1262,1266,4,1168,1172,4
272,https://htmlpreview.github.io/?https://github.com/Christina96/boilerplate-sample-matches/blob/main/csharp/runner-MDEwOlJlcG9zaXRvcnkxODQyODY4NzU=-flat-PipelineTemplateEvaluator.cs-runner-MDEwOlJlcG9zaXRvcnkxODQyODY4NzU=-flat-PipelineTemplateEvaluator.cs-272.html,24,runner-MDEwOlJlcG9zaXRvcnkxODQyODY4NzU=-flat-PipelineTemplateEvaluator.cs,runner-MDEwOlJlcG9zaXRvcnkxODQyODY4NzU=-flat-PipelineTemplateEvaluator.cs,159,162,3,42,45,3
273,https://htmlpreview.github.io/?https://github.com/Christina96/boilerplate-sample-matches/blob/main/csharp/npgsql-MDEwOlJlcG9zaXRvcnkyODgzNTc0-flat-NpgsqlConnection.cs-Simple.Data-MDEwOlJlcG9zaXRvcnk4MTg3Njg=-flat-BulkInserterHelper.cs-273.html,12,npgsql-MDEwOlJlcG9zaXRvcnkyODgzNTc0-flat-NpgsqlConnection.cs,Simple.Data-MDEwOlJlcG9zaXRvcnk4MTg3Njg=-flat-BulkInserterHelper.cs,928,931,3,75,78,3
274,https://htmlpreview.github.io/?https://github.com/Christina96/boilerplate-sample-matches/blob/main/csharp/EarTrumpet-MDEwOlJlcG9zaXRvcnkzODkxOTcwMg==-flat-ImportExportPageViewModel.cs-EarTrumpet-MDEwOlJlcG9zaXRvcnkzODkxOTcwMg==-flat-ImportExportPageViewModel.cs-274.html,26,EarTrumpet-MDEwOlJlcG9zaXRvcnkzODkxOTcwMg==-flat-ImportExportPageViewModel.cs,EarTrumpet-MDEwOlJlcG9zaXRvcnkzODkxOTcwMg==-flat-ImportExportPageViewModel.cs,27,33,6,46,52,6
275,https://htmlpreview.github.io/?https://github.com/Christina96/boilerplate-sample-matches/blob/main/csharp/npgsql-MDEwOlJlcG9zaXRvcnkyODgzNTc0-flat-SystemTextJsonTypeHandlerResolverFactory.cs-npgsql-MDEwOlJlcG9zaXRvcnkyODgzNTc0-flat-JsonNetTypeHandlerResolverFactory.cs-275.html,24,npgsql-MDEwOlJlcG9zaXRvcnkyODgzNTc0-flat-SystemTextJsonTypeHandlerResolverFactory.cs,npgsql-MDEwOlJlcG9zaXRvcnkyODgzNTc0-flat-JsonNetTypeHandlerResolverFactory.cs,32,34,2,33,35,2
276,https://htmlpreview.github.io/?https://github.com/Christina96/boilerplate-sample-matches/blob/main/csharp/npgsql-MDEwOlJlcG9zaXRvcnkyODgzNTc0-flat-SystemTransactionTests.cs-npgsql-MDEwOlJlcG9zaXRvcnkyODgzNTc0-flat-DistributedTransactionTests.cs-276.html,46,npgsql-MDEwOlJlcG9zaXRvcnkyODgzNTc0-flat-SystemTransactionTests.cs,npgsql-MDEwOlJlcG9zaXRvcnkyODgzNTc0-flat-DistributedTransactionTests.cs,380,390,10,491,501,10
277,https://htmlpreview.github.io/?https://github.com/Christina96/boilerplate-sample-matches/blob/main/csharp/dotween-MDEwOlJlcG9zaXRvcnkzMjQ3NTE2Mg==-flat-iTween_121.cs-dotween-MDEwOlJlcG9zaXRvcnkzMjQ3NTE2Mg==-flat-iTween.cs-277.html,1448,dotween-MDEwOlJlcG9zaXRvcnkzMjQ3NTE2Mg==-flat-iTween_121.cs,dotween-MDEwOlJlcG9zaXRvcnkzMjQ3NTE2Mg==-flat-iTween.cs,3234,3379,145,3234,3379,145
278,https://htmlpreview.github.io/?https://github.com/Christina96/boilerplate-sample-matches/blob/main/csharp/runner-MDEwOlJlcG9zaXRvcnkxODQyODY4NzU=-flat-TaskAgentJobRequest.cs-runner-MDEwOlJlcG9zaXRvcnkxODQyODY4NzU=-flat-TaskAgentJobRequest.cs-278.html,35,runner-MDEwOlJlcG9zaXRvcnkxODQyODY4NzU=-flat-TaskAgentJobRequest.cs,runner-MDEwOlJlcG9zaXRvcnkxODQyODY4NzU=-flat-TaskAgentJobRequest.cs,160,169,9,184,193,9
279,https://htmlpreview.github.io/?https://github.com/Christina96/boilerplate-sample-matches/blob/main/csharp/MudBlazor-MDEwOlJlcG9zaXRvcnkyODg0Mjg2NzY=-flat-MudDropZone.razor.cs-MudBlazor-MDEwOlJlcG9zaXRvcnkyODg0Mjg2NzY=-flat-MudDropZone.razor.cs-279.html,16,MudBlazor-MDEwOlJlcG9zaXRvcnkyODg0Mjg2NzY=-flat-MudDropZone.razor.cs,MudBlazor-MDEwOlJlcG9zaXRvcnkyODg0Mjg2NzY=-flat-MudDropZone.razor.cs,101,105,4,130,134,4
280,https://htmlpreview.github.io/?https://github.com/Christina96/boilerplate-sample-matches/blob/main/csharp/MudBlazor-MDEwOlJlcG9zaXRvcnkyODg0Mjg2NzY=-flat-DatePickerTests.cs-npgsql-MDEwOlJlcG9zaXRvcnkyODgzNTc0-flat-TypeMapperTests.cs-280.html,14,MudBlazor-MDEwOlJlcG9zaXRvcnkyODg0Mjg2NzY=-flat-DatePickerTests.cs,npgsql-MDEwOlJlcG9zaXRvcnkyODgzNTc0-flat-TypeMapperTests.cs,706,708,2,79,81,2
281,https://htmlpreview.github.io/?https://github.com/Christina96/boilerplate-sample-matches/blob/main/csharp/NetCoreServer-MDEwOlJlcG9zaXRvcnkxNjYxMjMxNjQ=-flat-TcpServer.cs-NetCoreServer-MDEwOlJlcG9zaXRvcnkxNjYxMjMxNjQ=-flat-UdsServer.cs-281.html,636,NetCoreServer-MDEwOlJlcG9zaXRvcnkxNjYxMjMxNjQ=-flat-TcpServer.cs,NetCoreServer-MDEwOlJlcG9zaXRvcnkxNjYxMjMxNjQ=-flat-UdsServer.cs,75,189,114,56,170,114
282,https://htmlpreview.github.io/?https://github.com/Christina96/boilerplate-sample-matches/blob/main/csharp/NetCoreServer-MDEwOlJlcG9zaXRvcnkxNjYxMjMxNjQ=-flat-TcpClient.cs-NetCoreServer-MDEwOlJlcG9zaXRvcnkxNjYxMjMxNjQ=-flat-UdsSession.cs-282.html,236,NetCoreServer-MDEwOlJlcG9zaXRvcnkxNjYxMjMxNjQ=-flat-TcpClient.cs,NetCoreServer-MDEwOlJlcG9zaXRvcnkxNjYxMjMxNjQ=-flat-UdsSession.cs,458,506,48,331,379,48
283,https://htmlpreview.github.io/?https://github.com/Christina96/boilerplate-sample-matches/blob/main/csharp/Simple.Data-MDEwOlJlcG9zaXRvcnk4MTg3Njg=-flat-EnumerableExtensions.cs-Simple.Data-MDEwOlJlcG9zaXRvcnk4MTg3Njg=-flat-EnumerableExtensions.cs-283.html,30,Simple.Data-MDEwOlJlcG9zaXRvcnk4MTg3Njg=-flat-EnumerableExtensions.cs,Simple.Data-MDEwOlJlcG9zaXRvcnk4MTg3Njg=-flat-EnumerableExtensions.cs,10,12,2,16,18,2
284,https://htmlpreview.github.io/?https://github.com/Christina96/boilerplate-sample-matches/blob/main/csharp/dotween-MDEwOlJlcG9zaXRvcnkzMjQ3NTE2Mg==-flat-LeanTween_56.cs-dotween-MDEwOlJlcG9zaXRvcnkzMjQ3NTE2Mg==-flat-LeanTween.cs-284.html,13,dotween-MDEwOlJlcG9zaXRvcnkzMjQ3NTE2Mg==-flat-LeanTween_56.cs,dotween-MDEwOlJlcG9zaXRvcnkzMjQ3NTE2Mg==-flat-LeanTween.cs,372,375,3,372,375,3
285,https://htmlpreview.github.io/?https://github.com/Christina96/boilerplate-sample-matches/blob/main/csharp/ZXing.Net.Mobile-MDEwOlJlcG9zaXRvcnk2MTYwNjcz-flat-HomePage.cs-ZXing.Net.Mobile-MDEwOlJlcG9zaXRvcnk2MTYwNjcz-flat-HomePage.cs-285.html,56,ZXing.Net.Mobile-MDEwOlJlcG9zaXRvcnk2MTYwNjcz-flat-HomePage.cs,ZXing.Net.Mobile-MDEwOlJlcG9zaXRvcnk2MTYwNjcz-flat-HomePage.cs,34,47,13,67,80,13
286,https://htmlpreview.github.io/?https://github.com/Christina96/boilerplate-sample-matches/blob/main/csharp/npgsql-MDEwOlJlcG9zaXRvcnkyODgzNTc0-flat-MiscTypeTests.cs-npgsql-MDEwOlJlcG9zaXRvcnkyODgzNTc0-flat-BugTests.cs-286.html,19,npgsql-MDEwOlJlcG9zaXRvcnkyODgzNTc0-flat-MiscTypeTests.cs,npgsql-MDEwOlJlcG9zaXRvcnkyODgzNTc0-flat-BugTests.cs,200,201,1,231,232,1
287,https://htmlpreview.github.io/?https://github.com/Christina96/boilerplate-sample-matches/blob/main/csharp/npgsql-MDEwOlJlcG9zaXRvcnkyODgzNTc0-flat-MiscTypeTests.cs-npgsql-MDEwOlJlcG9zaXRvcnkyODgzNTc0-flat-MiscTypeTests.cs-287.html,75,npgsql-MDEwOlJlcG9zaXRvcnkyODgzNTc0-flat-MiscTypeTests.cs,npgsql-MDEwOlJlcG9zaXRvcnkyODgzNTc0-flat-MiscTypeTests.cs,105,111,6,89,95,6
288,https://htmlpreview.github.io/?https://github.com/Christina96/boilerplate-sample-matches/blob/main/csharp/dotween-MDEwOlJlcG9zaXRvcnkzMjQ3NTE2Mg==-flat-PathWaypointReached.cs-dotween-MDEwOlJlcG9zaXRvcnkzMjQ3NTE2Mg==-flat-TweenDelegate.cs-288.html,15,dotween-MDEwOlJlcG9zaXRvcnkzMjQ3NTE2Mg==-flat-PathWaypointReached.cs,dotween-MDEwOlJlcG9zaXRvcnkzMjQ3NTE2Mg==-flat-TweenDelegate.cs,15,18,3,8,11,3
289,https://htmlpreview.github.io/?https://github.com/Christina96/boilerplate-sample-matches/blob/main/csharp/Security-MDEwOlJlcG9zaXRvcnkxNzcyMzY5OQ==-flat-OpenIdConnectEventTests.cs-Security-MDEwOlJlcG9zaXRvcnkxNzcyMzY5OQ==-flat-OpenIdConnectEventTests.cs-289.html,36,Security-MDEwOlJlcG9zaXRvcnkxNzcyMzY5OQ==-flat-OpenIdConnectEventTests.cs,Security-MDEwOlJlcG9zaXRvcnkxNzcyMzY5OQ==-flat-OpenIdConnectEventTests.cs,751,758,7,607,614,7
290,https://htmlpreview.github.io/?https://github.com/Christina96/boilerplate-sample-matches/blob/main/csharp/npgsql-MDEwOlJlcG9zaXRvcnkyODgzNTc0-flat-MoneyTests.cs-npgsql-MDEwOlJlcG9zaXRvcnkyODgzNTc0-flat-NumericTests.cs-290.html,12,npgsql-MDEwOlJlcG9zaXRvcnkyODgzNTc0-flat-MoneyTests.cs,npgsql-MDEwOlJlcG9zaXRvcnkyODgzNTc0-flat-NumericTests.cs,23,25,2,145,147,2
291,https://htmlpreview.github.io/?https://github.com/Christina96/boilerplate-sample-matches/blob/main/csharp/dotween-MDEwOlJlcG9zaXRvcnkzMjQ3NTE2Mg==-flat-iTween_121.cs-dotween-MDEwOlJlcG9zaXRvcnkzMjQ3NTE2Mg==-flat-iTween.cs-291.html,53,dotween-MDEwOlJlcG9zaXRvcnkzMjQ3NTE2Mg==-flat-iTween_121.cs,dotween-MDEwOlJlcG9zaXRvcnkzMjQ3NTE2Mg==-flat-iTween.cs,264,272,8,264,272,8
292,https://htmlpreview.github.io/?https://github.com/Christina96/boilerplate-sample-matches/blob/main/csharp/runner-MDEwOlJlcG9zaXRvcnkxODQyODY4NzU=-flat-ActionCommandL0.cs-runner-MDEwOlJlcG9zaXRvcnkxODQyODY4NzU=-flat-ActionCommandL0.cs-292.html,353,runner-MDEwOlJlcG9zaXRvcnkxODQyODY4NzU=-flat-ActionCommandL0.cs,runner-MDEwOlJlcG9zaXRvcnkxODQyODY4NzU=-flat-ActionCommandL0.cs,18,69,51,86,136,50
293,https://htmlpreview.github.io/?https://github.com/Christina96/boilerplate-sample-matches/blob/main/csharp/npgsql-MDEwOlJlcG9zaXRvcnkyODgzNTc0-flat-ConnectionTests.cs-npgsql-MDEwOlJlcG9zaXRvcnkyODgzNTc0-flat-NotificationTests.cs-293.html,14,npgsql-MDEwOlJlcG9zaXRvcnkyODgzNTc0-flat-ConnectionTests.cs,npgsql-MDEwOlJlcG9zaXRvcnkyODgzNTc0-flat-NotificationTests.cs,789,792,3,65,68,3
294,https://htmlpreview.github.io/?https://github.com/Christina96/boilerplate-sample-matches/blob/main/csharp/runner-MDEwOlJlcG9zaXRvcnkxODQyODY4NzU=-flat-ActionManager.cs-runner-MDEwOlJlcG9zaXRvcnkxODQyODY4NzU=-flat-ActionManager.cs-294.html,18,runner-MDEwOlJlcG9zaXRvcnkxODQyODY4NzU=-flat-ActionManager.cs,runner-MDEwOlJlcG9zaXRvcnkxODQyODY4NzU=-flat-ActionManager.cs,1014,1015,1,844,845,1
295,https://htmlpreview.github.io/?https://github.com/Christina96/boilerplate-sample-matches/blob/main/csharp/dotween-MDEwOlJlcG9zaXRvcnkzMjQ3NTE2Mg==-flat-GoTween_59.cs-dotween-MDEwOlJlcG9zaXRvcnkzMjQ3NTE2Mg==-flat-GoTween.cs-295.html,259,dotween-MDEwOlJlcG9zaXRvcnkzMjQ3NTE2Mg==-flat-GoTween_59.cs,dotween-MDEwOlJlcG9zaXRvcnkzMjQ3NTE2Mg==-flat-GoTween.cs,143,200,57,143,200,57
296,https://htmlpreview.github.io/?https://github.com/Christina96/boilerplate-sample-matches/blob/main/csharp/EarTrumpet-MDEwOlJlcG9zaXRvcnkzODkxOTcwMg==-flat-FlyoutViewModel.cs-EarTrumpet-MDEwOlJlcG9zaXRvcnkzODkxOTcwMg==-flat-FlyoutViewModel.cs-296.html,19,EarTrumpet-MDEwOlJlcG9zaXRvcnkzODkxOTcwMg==-flat-FlyoutViewModel.cs,EarTrumpet-MDEwOlJlcG9zaXRvcnkzODkxOTcwMg==-flat-FlyoutViewModel.cs,62,66,4,161,165,4
297,https://htmlpreview.github.io/?https://github.com/Christina96/boilerplate-sample-matches/blob/main/csharp/npgsql-MDEwOlJlcG9zaXRvcnkyODgzNTc0-flat-ByteaTests.cs-npgsql-MDEwOlJlcG9zaXRvcnkyODgzNTc0-flat-NodaTimeInfinityTests.cs-297.html,13,npgsql-MDEwOlJlcG9zaXRvcnkyODgzNTc0-flat-ByteaTests.cs,npgsql-MDEwOlJlcG9zaXRvcnkyODgzNTc0-flat-NodaTimeInfinityTests.cs,171,172,1,175,176,1
298,https://htmlpreview.github.io/?https://github.com/Christina96/boilerplate-sample-matches/blob/main/csharp/Simple.Data-MDEwOlJlcG9zaXRvcnk4MTg3Njg=-flat-DictionaryQueryRunnerTest.cs-Simple.Data-MDEwOlJlcG9zaXRvcnk4MTg3Njg=-flat-DictionaryQueryRunnerTest.cs-298.html,18,Simple.Data-MDEwOlJlcG9zaXRvcnk4MTg3Njg=-flat-DictionaryQueryRunnerTest.cs,Simple.Data-MDEwOlJlcG9zaXRvcnk4MTg3Njg=-flat-DictionaryQueryRunnerTest.cs,297,301,4,289,293,4
299,https://htmlpreview.github.io/?https://github.com/Christina96/boilerplate-sample-matches/blob/main/csharp/NetCoreServer-MDEwOlJlcG9zaXRvcnkxNjYxMjMxNjQ=-flat-HttpRequest.cs-NetCoreServer-MDEwOlJlcG9zaXRvcnkxNjYxMjMxNjQ=-flat-HttpResponse.cs-299.html,14,NetCoreServer-MDEwOlJlcG9zaXRvcnkxNjYxMjMxNjQ=-flat-HttpRequest.cs,NetCoreServer-MDEwOlJlcG9zaXRvcnkxNjYxMjMxNjQ=-flat-HttpResponse.cs,63,66,3,115,118,3
300,https://htmlpreview.github.io/?https://github.com/Christina96/boilerplate-sample-matches/blob/main/csharp/MudBlazor-MDEwOlJlcG9zaXRvcnkyODg0Mjg2NzY=-flat-FormTests.cs-MudBlazor-MDEwOlJlcG9zaXRvcnkyODg0Mjg2NzY=-flat-FormTests.cs-300.html,38,MudBlazor-MDEwOlJlcG9zaXRvcnkyODg0Mjg2NzY=-flat-FormTests.cs,MudBlazor-MDEwOlJlcG9zaXRvcnkyODg0Mjg2NzY=-flat-FormTests.cs,858,861,3,892,895,3
301,https://htmlpreview.github.io/?https://github.com/Christina96/boilerplate-sample-matches/blob/main/csharp/runner-MDEwOlJlcG9zaXRvcnkxODQyODY4NzU=-flat-NativeWindowsServiceHelper.cs-runner-MDEwOlJlcG9zaXRvcnkxODQyODY4NzU=-flat-NativeWindowsServiceHelper.cs-301.html,16,runner-MDEwOlJlcG9zaXRvcnkxODQyODY4NzU=-flat-NativeWindowsServiceHelper.cs,runner-MDEwOlJlcG9zaXRvcnkxODQyODY4NzU=-flat-NativeWindowsServiceHelper.cs,1072,1075,3,1068,1071,3
302,https://htmlpreview.github.io/?https://github.com/Christina96/boilerplate-sample-matches/blob/main/csharp/npgsql-MDEwOlJlcG9zaXRvcnkyODgzNTc0-flat-TimestampTzHandler.cs-npgsql-MDEwOlJlcG9zaXRvcnkyODgzNTc0-flat-TimestampTzHandler_9.cs-302.html,33,npgsql-MDEwOlJlcG9zaXRvcnkyODgzNTc0-flat-TimestampTzHandler.cs,npgsql-MDEwOlJlcG9zaXRvcnkyODgzNTc0-flat-TimestampTzHandler_9.cs,54,60,6,64,70,6
303,https://htmlpreview.github.io/?https://github.com/Christina96/boilerplate-sample-matches/blob/main/csharp/EarTrumpet-MDEwOlJlcG9zaXRvcnkzODkxOTcwMg==-flat-EarTrumpetAboutPageViewModel.cs-EarTrumpet-MDEwOlJlcG9zaXRvcnkzODkxOTcwMg==-flat-EarTrumpetAboutPageViewModel.cs-303.html,13,EarTrumpet-MDEwOlJlcG9zaXRvcnkzODkxOTcwMg==-flat-EarTrumpetAboutPageViewModel.cs,EarTrumpet-MDEwOlJlcG9zaXRvcnkzODkxOTcwMg==-flat-EarTrumpetAboutPageViewModel.cs,45,46,1,44,45,1
304,https://htmlpreview.github.io/?https://github.com/Christina96/boilerplate-sample-matches/blob/main/csharp/Security-MDEwOlJlcG9zaXRvcnkxNzcyMzY5OQ==-flat-Startup_6.cs-Security-MDEwOlJlcG9zaXRvcnkxNzcyMzY5OQ==-flat-Startup_12.cs-304.html,18,Security-MDEwOlJlcG9zaXRvcnkxNzcyMzY5OQ==-flat-Startup_6.cs,Security-MDEwOlJlcG9zaXRvcnkxNzcyMzY5OQ==-flat-Startup_12.cs,37,39,2,34,36,2
305,https://htmlpreview.github.io/?https://github.com/Christina96/boilerplate-sample-matches/blob/main/csharp/dotween-MDEwOlJlcG9zaXRvcnkzMjQ3NTE2Mg==-flat-QuaternionPlugin.cs-runner-MDEwOlJlcG9zaXRvcnkxODQyODY4NzU=-flat-NativeWindowsServiceHelper.cs-305.html,12,dotween-MDEwOlJlcG9zaXRvcnkzMjQ3NTE2Mg==-flat-QuaternionPlugin.cs,runner-MDEwOlJlcG9zaXRvcnkxODQyODY4NzU=-flat-NativeWindowsServiceHelper.cs,86,89,3,475,478,3
306,https://htmlpreview.github.io/?https://github.com/Christina96/boilerplate-sample-matches/blob/main/csharp/npgsql-MDEwOlJlcG9zaXRvcnkyODgzNTc0-flat-ConnectionTests.cs-npgsql-MDEwOlJlcG9zaXRvcnkyODgzNTc0-flat-ConnectionTests.cs-306.html,32,npgsql-MDEwOlJlcG9zaXRvcnkyODgzNTc0-flat-ConnectionTests.cs,npgsql-MDEwOlJlcG9zaXRvcnkyODgzNTc0-flat-ConnectionTests.cs,299,305,6,314,320,6
307,https://htmlpreview.github.io/?https://github.com/Christina96/boilerplate-sample-matches/blob/main/csharp/runner-MDEwOlJlcG9zaXRvcnkxODQyODY4NzU=-flat-SelfUpdater.cs-runner-MDEwOlJlcG9zaXRvcnkxODQyODY4NzU=-flat-WhichUtilL0.cs-307.html,14,runner-MDEwOlJlcG9zaXRvcnkxODQyODY4NzU=-flat-SelfUpdater.cs,runner-MDEwOlJlcG9zaXRvcnkxODQyODY4NzU=-flat-WhichUtilL0.cs,460,461,1,18,19,1
308,https://htmlpreview.github.io/?https://github.com/Christina96/boilerplate-sample-matches/blob/main/csharp/npgsql-MDEwOlJlcG9zaXRvcnkyODgzNTc0-flat-CommonLogicalReplicationTests.cs-npgsql-MDEwOlJlcG9zaXRvcnkyODgzNTc0-flat-PgOutputReplicationTests.cs-308.html,15,npgsql-MDEwOlJlcG9zaXRvcnkyODgzNTc0-flat-CommonLogicalReplicationTests.cs,npgsql-MDEwOlJlcG9zaXRvcnkyODgzNTc0-flat-PgOutputReplicationTests.cs,116,118,2,1092,1094,2
309,https://htmlpreview.github.io/?https://github.com/Christina96/boilerplate-sample-matches/blob/main/csharp/runner-MDEwOlJlcG9zaXRvcnkxODQyODY4NzU=-flat-LocationServerMapCache.cs-runner-MDEwOlJlcG9zaXRvcnkxODQyODY4NzU=-flat-LocationServerMapCache.cs-309.html,13,runner-MDEwOlJlcG9zaXRvcnkxODQyODY4NzU=-flat-LocationServerMapCache.cs,runner-MDEwOlJlcG9zaXRvcnkxODQyODY4NzU=-flat-LocationServerMapCache.cs,95,96,1,138,139,1
310,https://htmlpreview.github.io/?https://github.com/Christina96/boilerplate-sample-matches/blob/main/csharp/dotween-MDEwOlJlcG9zaXRvcnkzMjQ3NTE2Mg==-flat-GoTweenConfig_58.cs-dotween-MDEwOlJlcG9zaXRvcnkzMjQ3NTE2Mg==-flat-GoTweenConfig.cs-310.html,24,dotween-MDEwOlJlcG9zaXRvcnkzMjQ3NTE2Mg==-flat-GoTweenConfig_58.cs,dotween-MDEwOlJlcG9zaXRvcnkzMjQ3NTE2Mg==-flat-GoTweenConfig.cs,79,83,4,91,95,4
311,https://htmlpreview.github.io/?https://github.com/Christina96/boilerplate-sample-matches/blob/main/csharp/NetCoreServer-MDEwOlJlcG9zaXRvcnkxNjYxMjMxNjQ=-flat-WssClient.cs-NetCoreServer-MDEwOlJlcG9zaXRvcnkxNjYxMjMxNjQ=-flat-WsClient.cs-311.html,1759,NetCoreServer-MDEwOlJlcG9zaXRvcnkxNjYxMjMxNjQ=-flat-WssClient.cs,NetCoreServer-MDEwOlJlcG9zaXRvcnkxNjYxMjMxNjQ=-flat-WsClient.cs,16,164,148,16,164,148
312,https://htmlpreview.github.io/?https://github.com/Christina96/boilerplate-sample-matches/blob/main/csharp/MudBlazor-MDEwOlJlcG9zaXRvcnkyODg0Mjg2NzY=-flat-MudFormComponent.cs-MudBlazor-MDEwOlJlcG9zaXRvcnkyODg0Mjg2NzY=-flat-ExpressionExtensions.cs-312.html,18,MudBlazor-MDEwOlJlcG9zaXRvcnkyODg0Mjg2NzY=-flat-MudFormComponent.cs,MudBlazor-MDEwOlJlcG9zaXRvcnkyODg0Mjg2NzY=-flat-ExpressionExtensions.cs,443,444,1,26,27,1
313,https://htmlpreview.github.io/?https://github.com/Christina96/boilerplate-sample-matches/blob/main/csharp/npgsql-MDEwOlJlcG9zaXRvcnkyODgzNTc0-flat-ByteaTests.cs-npgsql-MDEwOlJlcG9zaXRvcnkyODgzNTc0-flat-CopyTests.cs-313.html,15,npgsql-MDEwOlJlcG9zaXRvcnkyODgzNTc0-flat-ByteaTests.cs,npgsql-MDEwOlJlcG9zaXRvcnkyODgzNTc0-flat-CopyTests.cs,20,21,1,380,381,1
314,https://htmlpreview.github.io/?https://github.com/Christina96/boilerplate-sample-matches/blob/main/csharp/runner-MDEwOlJlcG9zaXRvcnkxODQyODY4NzU=-flat-TemplateUnraveler.cs-runner-MDEwOlJlcG9zaXRvcnkxODQyODY4NzU=-flat-TemplateUnraveler.cs-314.html,49,runner-MDEwOlJlcG9zaXRvcnkxODQyODY4NzU=-flat-TemplateUnraveler.cs,runner-MDEwOlJlcG9zaXRvcnkxODQyODY4NzU=-flat-TemplateUnraveler.cs,623,633,10,821,831,10
315,https://htmlpreview.github.io/?https://github.com/Christina96/boilerplate-sample-matches/blob/main/csharp/npgsql-MDEwOlJlcG9zaXRvcnkyODgzNTc0-flat-ReaderNewSchemaTests.cs-npgsql-MDEwOlJlcG9zaXRvcnkyODgzNTc0-flat-ReaderOldSchemaTests.cs-315.html,23,npgsql-MDEwOlJlcG9zaXRvcnkyODgzNTc0-flat-ReaderNewSchemaTests.cs,npgsql-MDEwOlJlcG9zaXRvcnkyODgzNTc0-flat-ReaderOldSchemaTests.cs,267,271,4,15,23,8
316,https://htmlpreview.github.io/?https://github.com/Christina96/boilerplate-sample-matches/blob/main/csharp/Simple.Data-MDEwOlJlcG9zaXRvcnk4MTg3Njg=-flat-SimpleResultSet.cs-Simple.Data-MDEwOlJlcG9zaXRvcnk4MTg3Njg=-flat-SimpleResultSet.cs-316.html,13,Simple.Data-MDEwOlJlcG9zaXRvcnk4MTg3Njg=-flat-SimpleResultSet.cs,Simple.Data-MDEwOlJlcG9zaXRvcnk4MTg3Njg=-flat-SimpleResultSet.cs,123,125,2,99,101,2
317,https://htmlpreview.github.io/?https://github.com/Christina96/boilerplate-sample-matches/blob/main/csharp/NetCoreServer-MDEwOlJlcG9zaXRvcnkxNjYxMjMxNjQ=-flat-HttpsTests.cs-NetCoreServer-MDEwOlJlcG9zaXRvcnkxNjYxMjMxNjQ=-flat-HttpsTests.cs-317.html,22,NetCoreServer-MDEwOlJlcG9zaXRvcnkxNjYxMjMxNjQ=-flat-HttpsTests.cs,NetCoreServer-MDEwOlJlcG9zaXRvcnkxNjYxMjMxNjQ=-flat-HttpsTests.cs,109,111,2,111,113,2
318,https://htmlpreview.github.io/?https://github.com/Christina96/boilerplate-sample-matches/blob/main/csharp/dotween-MDEwOlJlcG9zaXRvcnkzMjQ3NTE2Mg==-flat-EnginesComparison.cs-dotween-MDEwOlJlcG9zaXRvcnkzMjQ3NTE2Mg==-flat-EnginesComparison_0.cs-318.html,1151,dotween-MDEwOlJlcG9zaXRvcnkzMjQ3NTE2Mg==-flat-EnginesComparison.cs,dotween-MDEwOlJlcG9zaXRvcnkzMjQ3NTE2Mg==-flat-EnginesComparison_0.cs,186,316,130,186,316,130
319,https://htmlpreview.github.io/?https://github.com/Christina96/boilerplate-sample-matches/blob/main/csharp/npgsql-MDEwOlJlcG9zaXRvcnkyODgzNTc0-flat-LTxtQueryHandler.cs-npgsql-MDEwOlJlcG9zaXRvcnkyODgzNTc0-flat-LTreeHandler.cs-319.html,26,npgsql-MDEwOlJlcG9zaXRvcnkyODgzNTc0-flat-LTxtQueryHandler.cs,npgsql-MDEwOlJlcG9zaXRvcnkyODgzNTc0-flat-LTreeHandler.cs,34,37,3,27,30,3
320,https://htmlpreview.github.io/?https://github.com/Christina96/boilerplate-sample-matches/blob/main/csharp/npgsql-MDEwOlJlcG9zaXRvcnkyODgzNTc0-flat-NpgsqlDataSourceBuilder.cs-npgsql-MDEwOlJlcG9zaXRvcnkyODgzNTc0-flat-NpgsqlSlimDataSourceBuilder.cs-320.html,26,npgsql-MDEwOlJlcG9zaXRvcnkyODgzNTc0-flat-NpgsqlDataSourceBuilder.cs,npgsql-MDEwOlJlcG9zaXRvcnkyODgzNTc0-flat-NpgsqlSlimDataSourceBuilder.cs,84,89,5,208,213,5
321,https://htmlpreview.github.io/?https://github.com/Christina96/boilerplate-sample-matches/blob/main/csharp/20486D-DevelopingASPNETMVCWebApplications-MDEwOlJlcG9zaXRvcnkxMTkzNTI2Mzc=-flat-ProductContext_289.cs-20486D-DevelopingASPNETMVCWebApplications-MDEwOlJlcG9zaXRvcnkxMTkzNTI2Mzc=-flat-ProductContext_22.cs-321.html,15,20486D-DevelopingASPNETMVCWebApplications-MDEwOlJlcG9zaXRvcnkxMTkzNTI2Mzc=-flat-ProductContext_289.cs,20486D-DevelopingASPNETMVCWebApplications-MDEwOlJlcG9zaXRvcnkxMTkzNTI2Mzc=-flat-ProductContext_22.cs,30,34,4,22,26,4
322,https://htmlpreview.github.io/?https://github.com/Christina96/boilerplate-sample-matches/blob/main/csharp/Security-MDEwOlJlcG9zaXRvcnkxNzcyMzY5OQ==-flat-OpenIdConnectChallengeTests.cs-Security-MDEwOlJlcG9zaXRvcnkxNzcyMzY5OQ==-flat-CookieTests.cs-322.html,12,Security-MDEwOlJlcG9zaXRvcnkxNzcyMzY5OQ==-flat-OpenIdConnectChallengeTests.cs,Security-MDEwOlJlcG9zaXRvcnkxNzcyMzY5OQ==-flat-CookieTests.cs,144,147,3,424,427,3
323,https://htmlpreview.github.io/?https://github.com/Christina96/boilerplate-sample-matches/blob/main/csharp/dotween-MDEwOlJlcG9zaXRvcnkzMjQ3NTE2Mg==-flat-GoSplineCatmullRomSolver_66.cs-dotween-MDEwOlJlcG9zaXRvcnkzMjQ3NTE2Mg==-flat-GoSplineCatmullRomSolver.cs-323.html,316,dotween-MDEwOlJlcG9zaXRvcnkzMjQ3NTE2Mg==-flat-GoSplineCatmullRomSolver_66.cs,dotween-MDEwOlJlcG9zaXRvcnkzMjQ3NTE2Mg==-flat-GoSplineCatmullRomSolver.cs,21,54,33,21,54,33
324,https://htmlpreview.github.io/?https://github.com/Christina96/boilerplate-sample-matches/blob/main/csharp/runner-MDEwOlJlcG9zaXRvcnkxODQyODY4NzU=-flat-VssConnection.cs-runner-MDEwOlJlcG9zaXRvcnkxODQyODY4NzU=-flat-RawConnection.cs-324.html,21,runner-MDEwOlJlcG9zaXRvcnkxODQyODY4NzU=-flat-VssConnection.cs,runner-MDEwOlJlcG9zaXRvcnkxODQyODY4NzU=-flat-RawConnection.cs,278,287,9,119,128,9
325,https://htmlpreview.github.io/?https://github.com/Christina96/boilerplate-sample-matches/blob/main/csharp/MudBlazor-MDEwOlJlcG9zaXRvcnkyODg0Mjg2NzY=-flat-RegexMaskIPv4Tests.cs-MudBlazor-MDEwOlJlcG9zaXRvcnkyODg0Mjg2NzY=-flat-RegexMaskIPv4Tests.cs-325.html,16,MudBlazor-MDEwOlJlcG9zaXRvcnkyODg0Mjg2NzY=-flat-RegexMaskIPv4Tests.cs,MudBlazor-MDEwOlJlcG9zaXRvcnkyODg0Mjg2NzY=-flat-RegexMaskIPv4Tests.cs,110,112,2,139,141,2
326,https://htmlpreview.github.io/?https://github.com/Christina96/boilerplate-sample-matches/blob/main/csharp/npgsql-MDEwOlJlcG9zaXRvcnkyODgzNTc0-flat-GeoJSONHandler.cs-npgsql-MDEwOlJlcG9zaXRvcnkyODgzNTc0-flat-GeoJSONHandler.cs-326.html,25,npgsql-MDEwOlJlcG9zaXRvcnkyODgzNTc0-flat-GeoJSONHandler.cs,npgsql-MDEwOlJlcG9zaXRvcnkyODgzNTc0-flat-GeoJSONHandler.cs,364,368,4,403,407,4
327,https://htmlpreview.github.io/?https://github.com/Christina96/boilerplate-sample-matches/blob/main/csharp/runner-MDEwOlJlcG9zaXRvcnkxODQyODY4NzU=-flat-EvaluationResult.cs-runner-MDEwOlJlcG9zaXRvcnkxODQyODY4NzU=-flat-LocationCacheManager.cs-327.html,12,runner-MDEwOlJlcG9zaXRvcnkxODQyODY4NzU=-flat-EvaluationResult.cs,runner-MDEwOlJlcG9zaXRvcnkxODQyODY4NzU=-flat-LocationCacheManager.cs,194,198,4,452,454,2
328,https://htmlpreview.github.io/?https://github.com/Christina96/boilerplate-sample-matches/blob/main/csharp/Security-MDEwOlJlcG9zaXRvcnkxNzcyMzY5OQ==-flat-OpenIdConnectEventTests.cs-Security-MDEwOlJlcG9zaXRvcnkxNzcyMzY5OQ==-flat-JwtBearerTests.cs-328.html,26,Security-MDEwOlJlcG9zaXRvcnkxNzcyMzY5OQ==-flat-OpenIdConnectEventTests.cs,Security-MDEwOlJlcG9zaXRvcnkxNzcyMzY5OQ==-flat-JwtBearerTests.cs,682,684,2,163,165,2
329,https://htmlpreview.github.io/?https://github.com/Christina96/boilerplate-sample-matches/blob/main/csharp/Security-MDEwOlJlcG9zaXRvcnkxNzcyMzY5OQ==-flat-JwtBearerTests.cs-Security-MDEwOlJlcG9zaXRvcnkxNzcyMzY5OQ==-flat-JwtBearerTests.cs-329.html,35,Security-MDEwOlJlcG9zaXRvcnkxNzcyMzY5OQ==-flat-JwtBearerTests.cs,Security-MDEwOlJlcG9zaXRvcnkxNzcyMzY5OQ==-flat-JwtBearerTests.cs,62,65,3,92,95,3
330,https://htmlpreview.github.io/?https://github.com/Christina96/boilerplate-sample-matches/blob/main/csharp/dotween-MDEwOlJlcG9zaXRvcnkzMjQ3NTE2Mg==-flat-ColorPlugin.cs-dotween-MDEwOlJlcG9zaXRvcnkzMjQ3NTE2Mg==-flat-Vector4Plugin.cs-330.html,21,dotween-MDEwOlJlcG9zaXRvcnkzMjQ3NTE2Mg==-flat-ColorPlugin.cs,dotween-MDEwOlJlcG9zaXRvcnkzMjQ3NTE2Mg==-flat-Vector4Plugin.cs,76,78,2,149,151,2
331,https://htmlpreview.github.io/?https://github.com/Christina96/boilerplate-sample-matches/blob/main/csharp/Security-MDEwOlJlcG9zaXRvcnkxNzcyMzY5OQ==-flat-Startup_10.cs-Security-MDEwOlJlcG9zaXRvcnkxNzcyMzY5OQ==-flat-Startup.cs-331.html,71,Security-MDEwOlJlcG9zaXRvcnkxNzcyMzY5OQ==-flat-Startup_10.cs,Security-MDEwOlJlcG9zaXRvcnkxNzcyMzY5OQ==-flat-Startup.cs,20,32,12,26,38,12
332,https://htmlpreview.github.io/?https://github.com/Christina96/boilerplate-sample-matches/blob/main/csharp/NetCoreServer-MDEwOlJlcG9zaXRvcnkxNjYxMjMxNjQ=-flat-UdpServer.cs-NetCoreServer-MDEwOlJlcG9zaXRvcnkxNjYxMjMxNjQ=-flat-UdpClient.cs-332.html,48,NetCoreServer-MDEwOlJlcG9zaXRvcnkxNjYxMjMxNjQ=-flat-UdpServer.cs,NetCoreServer-MDEwOlJlcG9zaXRvcnkxNjYxMjMxNjQ=-flat-UdpClient.cs,302,313,11,335,346,11
333,https://htmlpreview.github.io/?https://github.com/Christina96/boilerplate-sample-matches/blob/main/csharp/runner-MDEwOlJlcG9zaXRvcnkxODQyODY4NzU=-flat-TrackingConfig.cs-runner-MDEwOlJlcG9zaXRvcnkxODQyODY4NzU=-flat-TrackingConfig.cs-333.html,52,runner-MDEwOlJlcG9zaXRvcnkxODQyODY4NzU=-flat-TrackingConfig.cs,runner-MDEwOlJlcG9zaXRvcnkxODQyODY4NzU=-flat-TrackingConfig.cs,23,38,15,80,95,15
334,https://htmlpreview.github.io/?https://github.com/Christina96/boilerplate-sample-matches/blob/main/csharp/Security-MDEwOlJlcG9zaXRvcnkxNzcyMzY5OQ==-flat-GoogleTests.cs-MudBlazor-MDEwOlJlcG9zaXRvcnkyODg0Mjg2NzY=-flat-FormTests.cs-334.html,12,Security-MDEwOlJlcG9zaXRvcnkxNzcyMzY5OQ==-flat-GoogleTests.cs,MudBlazor-MDEwOlJlcG9zaXRvcnkyODg0Mjg2NzY=-flat-FormTests.cs,407,409,2,1041,1042,1
335,https://htmlpreview.github.io/?https://github.com/Christina96/boilerplate-sample-matches/blob/main/csharp/MudBlazor-MDEwOlJlcG9zaXRvcnkyODg0Mjg2NzY=-flat-FileUploadTests.cs-MudBlazor-MDEwOlJlcG9zaXRvcnkyODg0Mjg2NzY=-flat-LoggerTests.cs-335.html,36,MudBlazor-MDEwOlJlcG9zaXRvcnkyODg0Mjg2NzY=-flat-FileUploadTests.cs,MudBlazor-MDEwOlJlcG9zaXRvcnkyODg0Mjg2NzY=-flat-LoggerTests.cs,28,30,2,23,25,2
336,https://htmlpreview.github.io/?https://github.com/Christina96/boilerplate-sample-matches/blob/main/csharp/runner-MDEwOlJlcG9zaXRvcnkxODQyODY4NzU=-flat-VssHttpEventSource.cs-runner-MDEwOlJlcG9zaXRvcnkxODQyODY4NzU=-flat-VssHttpEventSource.cs-336.html,18,runner-MDEwOlJlcG9zaXRvcnkxODQyODY4NzU=-flat-VssHttpEventSource.cs,runner-MDEwOlJlcG9zaXRvcnkxODQyODY4NzU=-flat-VssHttpEventSource.cs,53,57,4,707,711,4
337,https://htmlpreview.github.io/?https://github.com/Christina96/boilerplate-sample-matches/blob/main/csharp/npgsql-MDEwOlJlcG9zaXRvcnkyODgzNTc0-flat-Prepare.cs-npgsql-MDEwOlJlcG9zaXRvcnkyODgzNTc0-flat-ReadColumns.cs-337.html,56,npgsql-MDEwOlJlcG9zaXRvcnkyODgzNTc0-flat-Prepare.cs,npgsql-MDEwOlJlcG9zaXRvcnkyODgzNTc0-flat-ReadColumns.cs,79,86,7,42,50,8
338,https://htmlpreview.github.io/?https://github.com/Christina96/boilerplate-sample-matches/blob/main/csharp/runner-MDEwOlJlcG9zaXRvcnkxODQyODY4NzU=-flat-ActionsRunServer.cs-runner-MDEwOlJlcG9zaXRvcnkxODQyODY4NzU=-flat-RunServer.cs-338.html,18,runner-MDEwOlJlcG9zaXRvcnkxODQyODY4NzU=-flat-ActionsRunServer.cs,runner-MDEwOlJlcG9zaXRvcnkxODQyODY4NzU=-flat-RunServer.cs,34,37,3,50,53,3
339,https://htmlpreview.github.io/?https://github.com/Christina96/boilerplate-sample-matches/blob/main/csharp/MudBlazor-MDEwOlJlcG9zaXRvcnkyODg0Mjg2NzY=-flat-ResizeObserverTests.cs-runner-MDEwOlJlcG9zaXRvcnkxODQyODY4NzU=-flat-JobExtension.cs-339.html,20,MudBlazor-MDEwOlJlcG9zaXRvcnkyODg0Mjg2NzY=-flat-ResizeObserverTests.cs,runner-MDEwOlJlcG9zaXRvcnkxODQyODY4NzU=-flat-JobExtension.cs,33,35,2,50,52,2
340,https://htmlpreview.github.io/?https://github.com/Christina96/boilerplate-sample-matches/blob/main/csharp/MudBlazor-MDEwOlJlcG9zaXRvcnkyODg0Mjg2NzY=-flat-TableTests.cs-MudBlazor-MDEwOlJlcG9zaXRvcnkyODg0Mjg2NzY=-flat-TableTests.cs-340.html,26,MudBlazor-MDEwOlJlcG9zaXRvcnkyODg0Mjg2NzY=-flat-TableTests.cs,MudBlazor-MDEwOlJlcG9zaXRvcnkyODg0Mjg2NzY=-flat-TableTests.cs,256,257,1,172,173,1
341,https://htmlpreview.github.io/?https://github.com/Christina96/boilerplate-sample-matches/blob/main/csharp/EarTrumpet-MDEwOlJlcG9zaXRvcnkzODkxOTcwMg==-flat-IAudioDeviceSession.cs-runner-MDEwOlJlcG9zaXRvcnkxODQyODY4NzU=-flat-ExecutionContext.cs-341.html,15,EarTrumpet-MDEwOlJlcG9zaXRvcnkzODkxOTcwMg==-flat-IAudioDeviceSession.cs,runner-MDEwOlJlcG9zaXRvcnkxODQyODY4NzU=-flat-ExecutionContext.cs,8,10,2,57,59,2
342,https://htmlpreview.github.io/?https://github.com/Christina96/boilerplate-sample-matches/blob/main/csharp/runner-MDEwOlJlcG9zaXRvcnkxODQyODY4NzU=-flat-SetEnvFileCommandL0.cs-runner-MDEwOlJlcG9zaXRvcnkxODQyODY4NzU=-flat-SetOutputFileCommandL0.cs-342.html,26,runner-MDEwOlJlcG9zaXRvcnkxODQyODY4NzU=-flat-SetEnvFileCommandL0.cs,runner-MDEwOlJlcG9zaXRvcnkxODQyODY4NzU=-flat-SetOutputFileCommandL0.cs,381,385,4,383,387,4
343,https://htmlpreview.github.io/?https://github.com/Christina96/boilerplate-sample-matches/blob/main/csharp/runner-MDEwOlJlcG9zaXRvcnkxODQyODY4NzU=-flat-ActionStep.cs-runner-MDEwOlJlcG9zaXRvcnkxODQyODY4NzU=-flat-Resource.cs-343.html,12,runner-MDEwOlJlcG9zaXRvcnkxODQyODY4NzU=-flat-ActionStep.cs,runner-MDEwOlJlcG9zaXRvcnkxODQyODY4NzU=-flat-Resource.cs,20,21,1,16,17,1
344,https://htmlpreview.github.io/?https://github.com/Christina96/boilerplate-sample-matches/blob/main/csharp/runner-MDEwOlJlcG9zaXRvcnkxODQyODY4NzU=-flat-DockerCommandManager.cs-runner-MDEwOlJlcG9zaXRvcnkxODQyODY4NzU=-flat-DockerCommandManager.cs-344.html,20,runner-MDEwOlJlcG9zaXRvcnkxODQyODY4NzU=-flat-DockerCommandManager.cs,runner-MDEwOlJlcG9zaXRvcnkxODQyODY4NzU=-flat-DockerCommandManager.cs,152,154,2,199,201,2
345,https://htmlpreview.github.io/?https://github.com/Christina96/boilerplate-sample-matches/blob/main/csharp/dotween-MDEwOlJlcG9zaXRvcnkzMjQ3NTE2Mg==-flat-LeanTween_56.cs-dotween-MDEwOlJlcG9zaXRvcnkzMjQ3NTE2Mg==-flat-LeanTween.cs-345.html,4905,dotween-MDEwOlJlcG9zaXRvcnkzMjQ3NTE2Mg==-flat-LeanTween_56.cs,dotween-MDEwOlJlcG9zaXRvcnkzMjQ3NTE2Mg==-flat-LeanTween.cs,77,811,734,77,811,734
346,https://htmlpreview.github.io/?https://github.com/Christina96/boilerplate-sample-matches/blob/main/csharp/Simple.Data-MDEwOlJlcG9zaXRvcnk4MTg3Njg=-flat-SelectClauseHandler.cs-Simple.Data-MDEwOlJlcG9zaXRvcnk4MTg3Njg=-flat-SelectClauseHandler.cs-346.html,27,Simple.Data-MDEwOlJlcG9zaXRvcnk4MTg3Njg=-flat-SelectClauseHandler.cs,Simple.Data-MDEwOlJlcG9zaXRvcnk4MTg3Njg=-flat-SelectClauseHandler.cs,54,57,3,64,67,3
347,https://htmlpreview.github.io/?https://github.com/Christina96/boilerplate-sample-matches/blob/main/csharp/NetCoreServer-MDEwOlJlcG9zaXRvcnkxNjYxMjMxNjQ=-flat-com.chronoxor.simple.cs-NetCoreServer-MDEwOlJlcG9zaXRvcnkxNjYxMjMxNjQ=-flat-com.chronoxor.simple.cs-347.html,262,NetCoreServer-MDEwOlJlcG9zaXRvcnkxNjYxMjMxNjQ=-flat-com.chronoxor.simple.cs,NetCoreServer-MDEwOlJlcG9zaXRvcnkxNjYxMjMxNjQ=-flat-com.chronoxor.simple.cs,821,857,36,208,244,36
348,https://htmlpreview.github.io/?https://github.com/Christina96/boilerplate-sample-matches/blob/main/csharp/npgsql-MDEwOlJlcG9zaXRvcnkyODgzNTc0-flat-NpgsqlConnector.FrontendMessages.cs-npgsql-MDEwOlJlcG9zaXRvcnkyODgzNTc0-flat-NpgsqlConnector.FrontendMessages.cs-348.html,51,npgsql-MDEwOlJlcG9zaXRvcnkyODgzNTc0-flat-NpgsqlConnector.FrontendMessages.cs,npgsql-MDEwOlJlcG9zaXRvcnkyODgzNTc0-flat-NpgsqlConnector.FrontendMessages.cs,27,36,9,218,227,9
349,https://htmlpreview.github.io/?https://github.com/Christina96/boilerplate-sample-matches/blob/main/csharp/npgsql-MDEwOlJlcG9zaXRvcnkyODgzNTc0-flat-PgOutputAsyncEnumerable.cs-npgsql-MDEwOlJlcG9zaXRvcnkyODgzNTc0-flat-PgOutputAsyncEnumerable.cs-349.html,13,npgsql-MDEwOlJlcG9zaXRvcnkyODgzNTc0-flat-PgOutputAsyncEnumerable.cs,npgsql-MDEwOlJlcG9zaXRvcnkyODgzNTc0-flat-PgOutputAsyncEnumerable.cs,318,321,3,280,283,3
350,https://htmlpreview.github.io/?https://github.com/Christina96/boilerplate-sample-matches/blob/main/csharp/MudBlazor-MDEwOlJlcG9zaXRvcnkyODg0Mjg2NzY=-flat-MudNumericField.razor.cs-MudBlazor-MDEwOlJlcG9zaXRvcnkyODg0Mjg2NzY=-flat-MudNumericField.razor.cs-350.html,12,MudBlazor-MDEwOlJlcG9zaXRvcnkyODg0Mjg2NzY=-flat-MudNumericField.razor.cs,MudBlazor-MDEwOlJlcG9zaXRvcnkyODg0Mjg2NzY=-flat-MudNumericField.razor.cs,83,84,1,84,85,1
351,https://htmlpreview.github.io/?https://github.com/Christina96/boilerplate-sample-matches/blob/main/csharp/NetCoreServer-MDEwOlJlcG9zaXRvcnkxNjYxMjMxNjQ=-flat-ProtoTests.cs-NetCoreServer-MDEwOlJlcG9zaXRvcnkxNjYxMjMxNjQ=-flat-Program_35.cs-351.html,57,NetCoreServer-MDEwOlJlcG9zaXRvcnkxNjYxMjMxNjQ=-flat-ProtoTests.cs,NetCoreServer-MDEwOlJlcG9zaXRvcnkxNjYxMjMxNjQ=-flat-Program_35.cs,64,71,7,64,71,7
352,https://htmlpreview.github.io/?https://github.com/Christina96/boilerplate-sample-matches/blob/main/csharp/dotween-MDEwOlJlcG9zaXRvcnkzMjQ3NTE2Mg==-flat-GoDummyPathEditor.cs-dotween-MDEwOlJlcG9zaXRvcnkzMjQ3NTE2Mg==-flat-GoDummyPathEditor_122.cs-352.html,1229,dotween-MDEwOlJlcG9zaXRvcnkzMjQ3NTE2Mg==-flat-GoDummyPathEditor.cs,dotween-MDEwOlJlcG9zaXRvcnkzMjQ3NTE2Mg==-flat-GoDummyPathEditor_122.cs,176,356,180,176,356,180
353,https://htmlpreview.github.io/?https://github.com/Christina96/boilerplate-sample-matches/blob/main/csharp/MudBlazor-MDEwOlJlcG9zaXRvcnkyODg0Mjg2NzY=-flat-PopoverTests.cs-npgsql-MDEwOlJlcG9zaXRvcnkyODgzNTc0-flat-AutoPrepareTests.cs-353.html,19,MudBlazor-MDEwOlJlcG9zaXRvcnkyODg0Mjg2NzY=-flat-PopoverTests.cs,npgsql-MDEwOlJlcG9zaXRvcnkyODgzNTc0-flat-AutoPrepareTests.cs,324,325,1,357,358,1
354,https://htmlpreview.github.io/?https://github.com/Christina96/boilerplate-sample-matches/blob/main/csharp/npgsql-MDEwOlJlcG9zaXRvcnkyODgzNTc0-flat-CommonLogicalReplicationTests.cs-npgsql-MDEwOlJlcG9zaXRvcnkyODgzNTc0-flat-CommonLogicalReplicationTests.cs-354.html,27,npgsql-MDEwOlJlcG9zaXRvcnkyODgzNTc0-flat-CommonLogicalReplicationTests.cs,npgsql-MDEwOlJlcG9zaXRvcnkyODgzNTc0-flat-CommonLogicalReplicationTests.cs,33,34,1,35,36,1
355,https://htmlpreview.github.io/?https://github.com/Christina96/boilerplate-sample-matches/blob/main/csharp/dotween-MDEwOlJlcG9zaXRvcnkzMjQ3NTE2Mg==-flat-RuntimeChanges_4.cs-dotween-MDEwOlJlcG9zaXRvcnkzMjQ3NTE2Mg==-flat-RuntimeChanges.cs-355.html,232,dotween-MDEwOlJlcG9zaXRvcnkzMjQ3NTE2Mg==-flat-RuntimeChanges_4.cs,dotween-MDEwOlJlcG9zaXRvcnkzMjQ3NTE2Mg==-flat-RuntimeChanges.cs,47,76,29,47,76,29
356,https://htmlpreview.github.io/?https://github.com/Christina96/boilerplate-sample-matches/blob/main/csharp/runner-MDEwOlJlcG9zaXRvcnkxODQyODY4NzU=-flat-ExecutionContextL0.cs-runner-MDEwOlJlcG9zaXRvcnkxODQyODY4NzU=-flat-ExecutionContextL0.cs-356.html,33,runner-MDEwOlJlcG9zaXRvcnkxODQyODY4NzU=-flat-ExecutionContextL0.cs,runner-MDEwOlJlcG9zaXRvcnkxODQyODY4NzU=-flat-ExecutionContextL0.cs,843,849,6,261,267,6
357,https://htmlpreview.github.io/?https://github.com/Christina96/boilerplate-sample-matches/blob/main/csharp/dotween-MDEwOlJlcG9zaXRvcnkzMjQ3NTE2Mg==-flat-CatmullRomDecoder.cs-dotween-MDEwOlJlcG9zaXRvcnkzMjQ3NTE2Mg==-flat-CubicBezierDecoder.cs-357.html,82,dotween-MDEwOlJlcG9zaXRvcnkzMjQ3NTE2Mg==-flat-CatmullRomDecoder.cs,dotween-MDEwOlJlcG9zaXRvcnkzMjQ3NTE2Mg==-flat-CubicBezierDecoder.cs,59,71,12,88,100,12
358,https://htmlpreview.github.io/?https://github.com/Christina96/boilerplate-sample-matches/blob/main/csharp/Simple.Data-MDEwOlJlcG9zaXRvcnk4MTg3Njg=-flat-SimpleListAsListTest.cs-Simple.Data-MDEwOlJlcG9zaXRvcnk4MTg3Njg=-flat-ProcedureTest.cs-358.html,28,Simple.Data-MDEwOlJlcG9zaXRvcnk4MTg3Njg=-flat-SimpleListAsListTest.cs,Simple.Data-MDEwOlJlcG9zaXRvcnk4MTg3Njg=-flat-ProcedureTest.cs,57,63,6,42,48,6
359,https://htmlpreview.github.io/?https://github.com/Christina96/boilerplate-sample-matches/blob/main/csharp/20486D-DevelopingASPNETMVCWebApplications-MDEwOlJlcG9zaXRvcnkxMTkzNTI2Mzc=-flat-AnimalsController.cs-20486D-DevelopingASPNETMVCWebApplications-MDEwOlJlcG9zaXRvcnkxMTkzNTI2Mzc=-flat-ShirtController.cs-359.html,13,20486D-DevelopingASPNETMVCWebApplications-MDEwOlJlcG9zaXRvcnkxMTkzNTI2Mzc=-flat-AnimalsController.cs,20486D-DevelopingASPNETMVCWebApplications-MDEwOlJlcG9zaXRvcnkxMTkzNTI2Mzc=-flat-ShirtController.cs,17,19,2,21,23,2
360,https://htmlpreview.github.io/?https://github.com/Christina96/boilerplate-sample-matches/blob/main/csharp/runner-MDEwOlJlcG9zaXRvcnkxODQyODY4NzU=-flat-ActionCommandManager.cs-Security-MDEwOlJlcG9zaXRvcnkxNzcyMzY5OQ==-flat-RemoteAuthenticationHandler.cs-360.html,13,runner-MDEwOlJlcG9zaXRvcnkxODQyODY4NzU=-flat-ActionCommandManager.cs,Security-MDEwOlJlcG9zaXRvcnkxNzcyMzY5OQ==-flat-RemoteAuthenticationHandler.cs,236,237,1,97,98,1
361,https://htmlpreview.github.io/?https://github.com/Christina96/boilerplate-sample-matches/blob/main/csharp/npgsql-MDEwOlJlcG9zaXRvcnkyODgzNTc0-flat-NpgsqlBinaryImporter.cs-npgsql-MDEwOlJlcG9zaXRvcnkyODgzNTc0-flat-NpgsqlRawCopyStream.cs-361.html,29,npgsql-MDEwOlJlcG9zaXRvcnkyODgzNTc0-flat-NpgsqlBinaryImporter.cs,npgsql-MDEwOlJlcG9zaXRvcnkyODgzNTc0-flat-NpgsqlRawCopyStream.cs,60,68,8,74,82,8
362,https://htmlpreview.github.io/?https://github.com/Christina96/boilerplate-sample-matches/blob/main/csharp/ZXing.Net.Mobile-MDEwOlJlcG9zaXRvcnk2MTYwNjcz-flat-BitmapRenderer.ios.cs-ZXing.Net.Mobile-MDEwOlJlcG9zaXRvcnk2MTYwNjcz-flat-BitmapRenderer.macos.cs-362.html,16,ZXing.Net.Mobile-MDEwOlJlcG9zaXRvcnk2MTYwNjcz-flat-BitmapRenderer.ios.cs,ZXing.Net.Mobile-MDEwOlJlcG9zaXRvcnk2MTYwNjcz-flat-BitmapRenderer.macos.cs,5,10,5,5,10,5
363,https://htmlpreview.github.io/?https://github.com/Christina96/boilerplate-sample-matches/blob/main/csharp/20486D-DevelopingASPNETMVCWebApplications-MDEwOlJlcG9zaXRvcnkxMTkzNTI2Mzc=-flat-Startup_201.cs-20486D-DevelopingASPNETMVCWebApplications-MDEwOlJlcG9zaXRvcnkxMTkzNTI2Mzc=-flat-Startup_210.cs-363.html,41,20486D-DevelopingASPNETMVCWebApplications-MDEwOlJlcG9zaXRvcnkxMTkzNTI2Mzc=-flat-Startup_201.cs,20486D-DevelopingASPNETMVCWebApplications-MDEwOlJlcG9zaXRvcnkxMTkzNTI2Mzc=-flat-Startup_210.cs,23,29,6,24,30,6
364,https://htmlpreview.github.io/?https://github.com/Christina96/boilerplate-sample-matches/blob/main/csharp/ZXing.Net.Mobile-MDEwOlJlcG9zaXRvcnk2MTYwNjcz-flat-ScanPage.xaml.cs-ZXing.Net.Mobile-MDEwOlJlcG9zaXRvcnk2MTYwNjcz-flat-ScanPage.xaml.cs-364.html,24,ZXing.Net.Mobile-MDEwOlJlcG9zaXRvcnk2MTYwNjcz-flat-ScanPage.xaml.cs,ZXing.Net.Mobile-MDEwOlJlcG9zaXRvcnk2MTYwNjcz-flat-ScanPage.xaml.cs,76,84,8,81,89,8
365,https://htmlpreview.github.io/?https://github.com/Christina96/boilerplate-sample-matches/blob/main/csharp/dotween-MDEwOlJlcG9zaXRvcnkzMjQ3NTE2Mg==-flat-Go_61.cs-dotween-MDEwOlJlcG9zaXRvcnkzMjQ3NTE2Mg==-flat-Go.cs-365.html,179,dotween-MDEwOlJlcG9zaXRvcnkzMjQ3NTE2Mg==-flat-Go_61.cs,dotween-MDEwOlJlcG9zaXRvcnkzMjQ3NTE2Mg==-flat-Go.cs,212,246,34,212,246,34
366,https://htmlpreview.github.io/?https://github.com/Christina96/boilerplate-sample-matches/blob/main/csharp/dotween-MDEwOlJlcG9zaXRvcnkzMjQ3NTE2Mg==-flat-OnDestroyIssue.cs-dotween-MDEwOlJlcG9zaXRvcnkzMjQ3NTE2Mg==-flat-OnDestroyIssue.cs-366.html,18,dotween-MDEwOlJlcG9zaXRvcnkzMjQ3NTE2Mg==-flat-OnDestroyIssue.cs,dotween-MDEwOlJlcG9zaXRvcnkzMjQ3NTE2Mg==-flat-OnDestroyIssue.cs,20,23,3,32,35,3
367,https://htmlpreview.github.io/?https://github.com/Christina96/boilerplate-sample-matches/blob/main/csharp/MudBlazor-MDEwOlJlcG9zaXRvcnkyODg0Mjg2NzY=-flat-DiscordApiClient.cs-MudBlazor-MDEwOlJlcG9zaXRvcnkyODg0Mjg2NzY=-flat-NugetApiClient.cs-367.html,26,MudBlazor-MDEwOlJlcG9zaXRvcnkyODg0Mjg2NzY=-flat-DiscordApiClient.cs,MudBlazor-MDEwOlJlcG9zaXRvcnkyODg0Mjg2NzY=-flat-NugetApiClient.cs,19,24,5,20,25,5
368,https://htmlpreview.github.io/?https://github.com/Christina96/boilerplate-sample-matches/blob/main/csharp/NetCoreServer-MDEwOlJlcG9zaXRvcnkxNjYxMjMxNjQ=-flat-WsSession.cs-NetCoreServer-MDEwOlJlcG9zaXRvcnkxNjYxMjMxNjQ=-flat-WsClient.cs-368.html,415,NetCoreServer-MDEwOlJlcG9zaXRvcnkxNjYxMjMxNjQ=-flat-WsSession.cs,NetCoreServer-MDEwOlJlcG9zaXRvcnkxNjYxMjMxNjQ=-flat-WsClient.cs,201,262,61,220,281,61
369,https://htmlpreview.github.io/?https://github.com/Christina96/boilerplate-sample-matches/blob/main/csharp/dotween-MDEwOlJlcG9zaXRvcnkzMjQ3NTE2Mg==-flat-LeanTween_56.cs-dotween-MDEwOlJlcG9zaXRvcnkzMjQ3NTE2Mg==-flat-LeanTween.cs-369.html,3811,dotween-MDEwOlJlcG9zaXRvcnkzMjQ3NTE2Mg==-flat-LeanTween_56.cs,dotween-MDEwOlJlcG9zaXRvcnkzMjQ3NTE2Mg==-flat-LeanTween.cs,276,811,535,276,811,535
370,https://htmlpreview.github.io/?https://github.com/Christina96/boilerplate-sample-matches/blob/main/csharp/dotween-MDEwOlJlcG9zaXRvcnkzMjQ3NTE2Mg==-flat-TweenManager_146.cs-EarTrumpet-MDEwOlJlcG9zaXRvcnkzODkxOTcwMg==-flat-ActionsCategoryViewModel.cs-370.html,12,dotween-MDEwOlJlcG9zaXRvcnkzMjQ3NTE2Mg==-flat-TweenManager_146.cs,EarTrumpet-MDEwOlJlcG9zaXRvcnkzODkxOTcwMg==-flat-ActionsCategoryViewModel.cs,635,637,2,23,25,2
371,https://htmlpreview.github.io/?https://github.com/Christina96/boilerplate-sample-matches/blob/main/csharp/dotween-MDEwOlJlcG9zaXRvcnkzMjQ3NTE2Mg==-flat-LeanTween_56.cs-dotween-MDEwOlJlcG9zaXRvcnkzMjQ3NTE2Mg==-flat-LeanTween.cs-371.html,15,dotween-MDEwOlJlcG9zaXRvcnkzMjQ3NTE2Mg==-flat-LeanTween_56.cs,dotween-MDEwOlJlcG9zaXRvcnkzMjQ3NTE2Mg==-flat-LeanTween.cs,2465,2466,1,2465,2466,1
372,https://htmlpreview.github.io/?https://github.com/Christina96/boilerplate-sample-matches/blob/main/csharp/dotween-MDEwOlJlcG9zaXRvcnkzMjQ3NTE2Mg==-flat-GoDummyPathEditor.cs-dotween-MDEwOlJlcG9zaXRvcnkzMjQ3NTE2Mg==-flat-GoDummyPathEditor_122.cs-372.html,652,dotween-MDEwOlJlcG9zaXRvcnkzMjQ3NTE2Mg==-flat-GoDummyPathEditor.cs,dotween-MDEwOlJlcG9zaXRvcnkzMjQ3NTE2Mg==-flat-GoDummyPathEditor_122.cs,255,356,101,255,356,101
373,https://htmlpreview.github.io/?https://github.com/Christina96/boilerplate-sample-matches/blob/main/csharp/dotween-MDEwOlJlcG9zaXRvcnkzMjQ3NTE2Mg==-flat-iTween_121.cs-dotween-MDEwOlJlcG9zaXRvcnkzMjQ3NTE2Mg==-flat-iTween.cs-373.html,969,dotween-MDEwOlJlcG9zaXRvcnkzMjQ3NTE2Mg==-flat-iTween_121.cs,dotween-MDEwOlJlcG9zaXRvcnkzMjQ3NTE2Mg==-flat-iTween.cs,29,196,167,29,196,167
374,https://htmlpreview.github.io/?https://github.com/Christina96/boilerplate-sample-matches/blob/main/csharp/dotween-MDEwOlJlcG9zaXRvcnkzMjQ3NTE2Mg==-flat-PathWaypointReached_2.cs-dotween-MDEwOlJlcG9zaXRvcnkzMjQ3NTE2Mg==-flat-PathWaypointReached.cs-374.html,369,dotween-MDEwOlJlcG9zaXRvcnkzMjQ3NTE2Mg==-flat-PathWaypointReached_2.cs,dotween-MDEwOlJlcG9zaXRvcnkzMjQ3NTE2Mg==-flat-PathWaypointReached.cs,6,46,40,6,46,40
375,https://htmlpreview.github.io/?https://github.com/Christina96/boilerplate-sample-matches/blob/main/csharp/Simple.Data-MDEwOlJlcG9zaXRvcnk4MTg3Njg=-flat-Adapter.cs-Simple.Data-MDEwOlJlcG9zaXRvcnk4MTg3Njg=-flat-Adapter.cs-375.html,49,Simple.Data-MDEwOlJlcG9zaXRvcnk4MTg3Njg=-flat-Adapter.cs,Simple.Data-MDEwOlJlcG9zaXRvcnk4MTg3Njg=-flat-Adapter.cs,80,89,9,350,359,9
376,https://htmlpreview.github.io/?https://github.com/Christina96/boilerplate-sample-matches/blob/main/csharp/Simple.Data-MDEwOlJlcG9zaXRvcnk4MTg3Njg=-flat-Adapter.cs-Simple.Data-MDEwOlJlcG9zaXRvcnk4MTg3Njg=-flat-Adapter.cs-376.html,14,Simple.Data-MDEwOlJlcG9zaXRvcnk4MTg3Njg=-flat-Adapter.cs,Simple.Data-MDEwOlJlcG9zaXRvcnk4MTg3Njg=-flat-Adapter.cs,245,248,3,226,229,3
377,https://htmlpreview.github.io/?https://github.com/Christina96/boilerplate-sample-matches/blob/main/csharp/npgsql-MDEwOlJlcG9zaXRvcnkyODgzNTc0-flat-ReaderTests.cs-npgsql-MDEwOlJlcG9zaXRvcnkyODgzNTc0-flat-ReaderTests.cs-377.html,24,npgsql-MDEwOlJlcG9zaXRvcnkyODgzNTc0-flat-ReaderTests.cs,npgsql-MDEwOlJlcG9zaXRvcnkyODgzNTc0-flat-ReaderTests.cs,494,496,2,1225,1227,2
378,https://htmlpreview.github.io/?https://github.com/Christina96/boilerplate-sample-matches/blob/main/csharp/ZXing.Net.Mobile-MDEwOlJlcG9zaXRvcnk2MTYwNjcz-flat-ZXingScannerPage.shared.cs-ZXing.Net.Mobile-MDEwOlJlcG9zaXRvcnk2MTYwNjcz-flat-ZXingBarcodeImageView.shared.cs-378.html,20,ZXing.Net.Mobile-MDEwOlJlcG9zaXRvcnk2MTYwNjcz-flat-ZXingScannerPage.shared.cs,ZXing.Net.Mobile-MDEwOlJlcG9zaXRvcnk2MTYwNjcz-flat-ZXingBarcodeImageView.shared.cs,138,141,3,16,19,3
379,https://htmlpreview.github.io/?https://github.com/Christina96/boilerplate-sample-matches/blob/main/csharp/MudBlazor-MDEwOlJlcG9zaXRvcnkyODg0Mjg2NzY=-flat-AmericanStatesController.cs-MudBlazor-MDEwOlJlcG9zaXRvcnkyODg0Mjg2NzY=-flat-AmericanStatesController_16.cs-379.html,40,MudBlazor-MDEwOlJlcG9zaXRvcnkyODg0Mjg2NzY=-flat-AmericanStatesController.cs,MudBlazor-MDEwOlJlcG9zaXRvcnkyODg0Mjg2NzY=-flat-AmericanStatesController_16.cs,16,25,9,12,21,9
380,https://htmlpreview.github.io/?https://github.com/Christina96/boilerplate-sample-matches/blob/main/csharp/Security-MDEwOlJlcG9zaXRvcnkxNzcyMzY5OQ==-flat-DefaultAuthorizationServiceTests.cs-Security-MDEwOlJlcG9zaXRvcnkxNzcyMzY5OQ==-flat-DefaultAuthorizationServiceTests.cs-380.html,15,Security-MDEwOlJlcG9zaXRvcnkxNzcyMzY5OQ==-flat-DefaultAuthorizationServiceTests.cs,Security-MDEwOlJlcG9zaXRvcnkxNzcyMzY5OQ==-flat-DefaultAuthorizationServiceTests.cs,244,248,4,159,163,4
381,https://htmlpreview.github.io/?https://github.com/Christina96/boilerplate-sample-matches/blob/main/csharp/Simple.Data-MDEwOlJlcG9zaXRvcnk4MTg3Njg=-flat-Database.cs-Simple.Data-MDEwOlJlcG9zaXRvcnk4MTg3Njg=-flat-Database.cs-381.html,20,Simple.Data-MDEwOlJlcG9zaXRvcnk4MTg3Njg=-flat-Database.cs,Simple.Data-MDEwOlJlcG9zaXRvcnk4MTg3Njg=-flat-Database.cs,57,61,4,64,68,4
382,https://htmlpreview.github.io/?https://github.com/Christina96/boilerplate-sample-matches/blob/main/csharp/npgsql-MDEwOlJlcG9zaXRvcnkyODgzNTc0-flat-RangeTypeMappingResolver.cs-npgsql-MDEwOlJlcG9zaXRvcnkyODgzNTc0-flat-BuiltInTypeMappingResolver.cs-382.html,16,npgsql-MDEwOlJlcG9zaXRvcnkyODgzNTc0-flat-RangeTypeMappingResolver.cs,npgsql-MDEwOlJlcG9zaXRvcnkyODgzNTc0-flat-BuiltInTypeMappingResolver.cs,46,47,1,181,182,1
383,https://htmlpreview.github.io/?https://github.com/Christina96/boilerplate-sample-matches/blob/main/csharp/dotween-MDEwOlJlcG9zaXRvcnkzMjQ3NTE2Mg==-flat-RuntimeChanges_4.cs-dotween-MDEwOlJlcG9zaXRvcnkzMjQ3NTE2Mg==-flat-RuntimeChanges.cs-383.html,249,dotween-MDEwOlJlcG9zaXRvcnkzMjQ3NTE2Mg==-flat-RuntimeChanges_4.cs,dotween-MDEwOlJlcG9zaXRvcnkzMjQ3NTE2Mg==-flat-RuntimeChanges.cs,45,76,31,45,76,31
