ID,Link,Tokens,File 1,File 2,Start 1,End 1,Detected Lines 1,Start 2,End 2,Detected Lines 2
0,https://htmlpreview.github.io/?https://github.com/Christina96/boilerplate-sample-matches/blob/main/Java/motan-MDEwOlJlcG9zaXRvcnk1NjY3OTUyMQ==-flat-NettyDecoder.java-motan-MDEwOlJlcG9zaXRvcnk1NjY3OTUyMQ==-flat-NettyDecoder_12.java-0.html,43,motan-MDEwOlJlcG9zaXRvcnk1NjY3OTUyMQ==-flat-NettyDecoder.java,motan-MDEwOlJlcG9zaXRvcnk1NjY3OTUyMQ==-flat-NettyDecoder_12.java,94,99,5,108,113,5
1,https://htmlpreview.github.io/?https://github.com/Christina96/boilerplate-sample-matches/blob/main/Java/motan-MDEwOlJlcG9zaXRvcnk1NjY3OTUyMQ==-flat-UserProto.java-motan-MDEwOlJlcG9zaXRvcnk1NjY3OTUyMQ==-flat-RouteGuideProto.java-1.html,84,motan-MDEwOlJlcG9zaXRvcnk1NjY3OTUyMQ==-flat-UserProto.java,motan-MDEwOlJlcG9zaXRvcnk1NjY3OTUyMQ==-flat-RouteGuideProto.java,1593,1607,14,74,88,14
2,https://htmlpreview.github.io/?https://github.com/Christina96/boilerplate-sample-matches/blob/main/Java/jedis-MDEwOlJlcG9zaXRvcnk3MTU2MDU=-flat-SearchWithParamsTest.java-jedis-MDEwOlJlcG9zaXRvcnk3MTU2MDU=-flat-SearchWithParamsTest.java-2.html,33,jedis-MDEwOlJlcG9zaXRvcnk3MTU2MDU=-flat-SearchWithParamsTest.java,jedis-MDEwOlJlcG9zaXRvcnk3MTU2MDU=-flat-SearchWithParamsTest.java,214,217,3,227,230,3
3,https://htmlpreview.github.io/?https://github.com/Christina96/boilerplate-sample-matches/blob/main/Java/jedis-MDEwOlJlcG9zaXRvcnk3MTU2MDU=-flat-StreamsCommandsTest.java-jedis-MDEwOlJlcG9zaXRvcnk3MTU2MDU=-flat-StreamsCommandsTest.java-3.html,18,jedis-MDEwOlJlcG9zaXRvcnk3MTU2MDU=-flat-StreamsCommandsTest.java,jedis-MDEwOlJlcG9zaXRvcnk3MTU2MDU=-flat-StreamsCommandsTest.java,625,626,1,623,624,1
4,https://htmlpreview.github.io/?https://github.com/Christina96/boilerplate-sample-matches/blob/main/Java/jedis-MDEwOlJlcG9zaXRvcnk3MTU2MDU=-flat-CommandObjects.java-jedis-MDEwOlJlcG9zaXRvcnk3MTU2MDU=-flat-CommandObjects.java-4.html,20,jedis-MDEwOlJlcG9zaXRvcnk3MTU2MDU=-flat-CommandObjects.java,jedis-MDEwOlJlcG9zaXRvcnk3MTU2MDU=-flat-CommandObjects.java,2128,2129,1,2086,2087,1
5,https://htmlpreview.github.io/?https://github.com/Christina96/boilerplate-sample-matches/blob/main/Java/motan-MDEwOlJlcG9zaXRvcnk1NjY3OTUyMQ==-flat-FailbackRegistry.java-motan-MDEwOlJlcG9zaXRvcnk1NjY3OTUyMQ==-flat-FailbackRegistry.java-5.html,25,motan-MDEwOlJlcG9zaXRvcnk1NjY3OTUyMQ==-flat-FailbackRegistry.java,motan-MDEwOlJlcG9zaXRvcnk1NjY3OTUyMQ==-flat-FailbackRegistry.java,80,84,4,96,100,4
6,https://htmlpreview.github.io/?https://github.com/Christina96/boilerplate-sample-matches/blob/main/Java/motan-MDEwOlJlcG9zaXRvcnk1NjY3OTUyMQ==-flat-NettyHttpRequestHandler.java-motan-MDEwOlJlcG9zaXRvcnk1NjY3OTUyMQ==-flat-NettyHttpRequestHandler_3.java-6.html,37,motan-MDEwOlJlcG9zaXRvcnk1NjY3OTUyMQ==-flat-NettyHttpRequestHandler.java,motan-MDEwOlJlcG9zaXRvcnk1NjY3OTUyMQ==-flat-NettyHttpRequestHandler_3.java,46,51,5,20,25,5
7,https://htmlpreview.github.io/?https://github.com/Christina96/boilerplate-sample-matches/blob/main/Java/ribbon-MDEwOlJlcG9zaXRvcnk3NjE2MTU4-flat-SecureGetTest.java-ribbon-MDEwOlJlcG9zaXRvcnk3NjE2MTU4-flat-SecureGetTest.java-7.html,18,ribbon-MDEwOlJlcG9zaXRvcnk3NjE2MTU4-flat-SecureGetTest.java,ribbon-MDEwOlJlcG9zaXRvcnk3NjE2MTU4-flat-SecureGetTest.java,131,135,4,154,173,19
8,https://htmlpreview.github.io/?https://github.com/Christina96/boilerplate-sample-matches/blob/main/Java/jedis-MDEwOlJlcG9zaXRvcnk3MTU2MDU=-flat-BuilderFactory.java-jedis-MDEwOlJlcG9zaXRvcnk3MTU2MDU=-flat-BuilderFactory.java-8.html,35,jedis-MDEwOlJlcG9zaXRvcnk3MTU2MDU=-flat-BuilderFactory.java,jedis-MDEwOlJlcG9zaXRvcnk3MTU2MDU=-flat-BuilderFactory.java,344,347,3,605,608,3
9,https://htmlpreview.github.io/?https://github.com/Christina96/boilerplate-sample-matches/blob/main/Java/jedis-MDEwOlJlcG9zaXRvcnk3MTU2MDU=-flat-JedisClusterTest.java-jedis-MDEwOlJlcG9zaXRvcnk3MTU2MDU=-flat-JedisClusterTest.java-9.html,16,jedis-MDEwOlJlcG9zaXRvcnk3MTU2MDU=-flat-JedisClusterTest.java,jedis-MDEwOlJlcG9zaXRvcnk3MTU2MDU=-flat-JedisClusterTest.java,182,185,3,188,191,3
10,https://htmlpreview.github.io/?https://github.com/Christina96/boilerplate-sample-matches/blob/main/Java/motan-MDEwOlJlcG9zaXRvcnk1NjY3OTUyMQ==-flat-UserAttentions.java-motan-MDEwOlJlcG9zaXRvcnk1NjY3OTUyMQ==-flat-UserAttentions.java-10.html,36,motan-MDEwOlJlcG9zaXRvcnk1NjY3OTUyMQ==-flat-UserAttentions.java,motan-MDEwOlJlcG9zaXRvcnk1NjY3OTUyMQ==-flat-UserAttentions.java,43,51,8,61,69,8
11,https://htmlpreview.github.io/?https://github.com/Christina96/boilerplate-sample-matches/blob/main/Java/Essentials-MDEwOlJlcG9zaXRvcnkxNzczNzU0-flat-Commandnuke.java-Essentials-MDEwOlJlcG9zaXRvcnkxNzczNzU0-flat-Commandtpall.java-11.html,20,Essentials-MDEwOlJlcG9zaXRvcnkxNzczNzU0-flat-Commandnuke.java,Essentials-MDEwOlJlcG9zaXRvcnkxNzczNzU0-flat-Commandtpall.java,42,44,2,32,34,2
12,https://htmlpreview.github.io/?https://github.com/Christina96/boilerplate-sample-matches/blob/main/Java/jedis-MDEwOlJlcG9zaXRvcnk3MTU2MDU=-flat-JedisPubSubBase.java-jedis-MDEwOlJlcG9zaXRvcnk3MTU2MDU=-flat-JedisShardedPubSubBase.java-12.html,51,jedis-MDEwOlJlcG9zaXRvcnk3MTU2MDU=-flat-JedisPubSubBase.java,jedis-MDEwOlJlcG9zaXRvcnk3MTU2MDU=-flat-JedisShardedPubSubBase.java,63,73,10,39,49,10
13,https://htmlpreview.github.io/?https://github.com/Christina96/boilerplate-sample-matches/blob/main/Java/Mybatis-PageHelper-MDEwOlJlcG9zaXRvcnkyMDY1MTY3Mg==-flat-FirebirdDialect.java-Mybatis-PageHelper-MDEwOlJlcG9zaXRvcnkyMDY1MTY3Mg==-flat-MySqlRowBoundsDialect.java-13.html,19,Mybatis-PageHelper-MDEwOlJlcG9zaXRvcnkyMDY1MTY3Mg==-flat-FirebirdDialect.java,Mybatis-PageHelper-MDEwOlJlcG9zaXRvcnkyMDY1MTY3Mg==-flat-MySqlRowBoundsDialect.java,23,26,3,20,23,3
14,https://htmlpreview.github.io/?https://github.com/Christina96/boilerplate-sample-matches/blob/main/Java/BungeeCord-MDEwOlJlcG9zaXRvcnk2MDg0MjEw-flat-SeenMessages.java-BungeeCord-MDEwOlJlcG9zaXRvcnk2MDg0MjEw-flat-ChatChain.java-14.html,14,BungeeCord-MDEwOlJlcG9zaXRvcnk2MDg0MjEw-flat-SeenMessages.java,BungeeCord-MDEwOlJlcG9zaXRvcnk2MDg0MjEw-flat-ChatChain.java,6,10,4,9,13,4
15,https://htmlpreview.github.io/?https://github.com/Christina96/boilerplate-sample-matches/blob/main/Java/jedis-MDEwOlJlcG9zaXRvcnk3MTU2MDU=-flat-SearchQuickstartExample.java-jedis-MDEwOlJlcG9zaXRvcnk3MTU2MDU=-flat-SearchQuickstartExample.java-15.html,22,jedis-MDEwOlJlcG9zaXRvcnk3MTU2MDU=-flat-SearchQuickstartExample.java,jedis-MDEwOlJlcG9zaXRvcnk3MTU2MDU=-flat-SearchQuickstartExample.java,74,83,9,57,66,9
16,https://htmlpreview.github.io/?https://github.com/Christina96/boilerplate-sample-matches/blob/main/Java/google-api-java-client-samples-MDEwOlJlcG9zaXRvcnkyOTc0OTA1Mg==-flat-GetAllAdClients_13.java-google-api-java-client-samples-MDEwOlJlcG9zaXRvcnkyOTc0OTA1Mg==-flat-GetAllAdClientsForHost.java-16.html,79,google-api-java-client-samples-MDEwOlJlcG9zaXRvcnkyOTc0OTA1Mg==-flat-GetAllAdClients_13.java,google-api-java-client-samples-MDEwOlJlcG9zaXRvcnkyOTc0OTA1Mg==-flat-GetAllAdClientsForHost.java,6,18,12,6,17,11
17,https://htmlpreview.github.io/?https://github.com/Christina96/boilerplate-sample-matches/blob/main/Java/motan-MDEwOlJlcG9zaXRvcnk1NjY3OTUyMQ==-flat-TestRestful.java-motan-MDEwOlJlcG9zaXRvcnk1NjY3OTUyMQ==-flat-TestServletCotainerRestful.java-17.html,50,motan-MDEwOlJlcG9zaXRvcnk1NjY3OTUyMQ==-flat-TestRestful.java,motan-MDEwOlJlcG9zaXRvcnk1NjY3OTUyMQ==-flat-TestServletCotainerRestful.java,27,33,6,56,62,6
18,https://htmlpreview.github.io/?https://github.com/Christina96/boilerplate-sample-matches/blob/main/Java/Essentials-MDEwOlJlcG9zaXRvcnkxNzczNzU0-flat-Commandessentials.java-ribbon-MDEwOlJlcG9zaXRvcnk3NjE2MTU4-flat-EurekaNotificationServerListUpdater.java-18.html,15,Essentials-MDEwOlJlcG9zaXRvcnkxNzczNzU0-flat-Commandessentials.java,ribbon-MDEwOlJlcG9zaXRvcnk3NjE2MTU4-flat-EurekaNotificationServerListUpdater.java,250,253,3,135,138,3
19,https://htmlpreview.github.io/?https://github.com/Christina96/boilerplate-sample-matches/blob/main/Java/ribbon-MDEwOlJlcG9zaXRvcnk3NjE2MTU4-flat-LoadBalancerContext.java-ribbon-MDEwOlJlcG9zaXRvcnk3NjE2MTU4-flat-AbstractLoadBalancerAwareClient.java-19.html,18,ribbon-MDEwOlJlcG9zaXRvcnk3NjE2MTU4-flat-LoadBalancerContext.java,ribbon-MDEwOlJlcG9zaXRvcnk3NjE2MTU4-flat-AbstractLoadBalancerAwareClient.java,447,451,4,85,89,4
20,https://htmlpreview.github.io/?https://github.com/Christina96/boilerplate-sample-matches/blob/main/Java/motan-MDEwOlJlcG9zaXRvcnk1NjY3OTUyMQ==-flat-URL.java-motan-MDEwOlJlcG9zaXRvcnk1NjY3OTUyMQ==-flat-URL.java-20.html,26,motan-MDEwOlJlcG9zaXRvcnk1NjY3OTUyMQ==-flat-URL.java,motan-MDEwOlJlcG9zaXRvcnk1NjY3OTUyMQ==-flat-URL.java,352,354,2,354,356,2
21,https://htmlpreview.github.io/?https://github.com/Christina96/boilerplate-sample-matches/blob/main/Java/jedis-MDEwOlJlcG9zaXRvcnk3MTU2MDU=-flat-JedisPooled.java-jedis-MDEwOlJlcG9zaXRvcnk3MTU2MDU=-flat-PooledConnectionProvider.java-21.html,19,jedis-MDEwOlJlcG9zaXRvcnk3MTU2MDU=-flat-JedisPooled.java,jedis-MDEwOlJlcG9zaXRvcnk3MTU2MDU=-flat-PooledConnectionProvider.java,44,46,2,29,31,2
22,https://htmlpreview.github.io/?https://github.com/Christina96/boilerplate-sample-matches/blob/main/Java/jedis-MDEwOlJlcG9zaXRvcnk3MTU2MDU=-flat-ScriptingCommandsTest.java-motan-MDEwOlJlcG9zaXRvcnk1NjY3OTUyMQ==-flat-RefererInvocationHandlerTest.java-22.html,17,jedis-MDEwOlJlcG9zaXRvcnk3MTU2MDU=-flat-ScriptingCommandsTest.java,motan-MDEwOlJlcG9zaXRvcnk1NjY3OTUyMQ==-flat-RefererInvocationHandlerTest.java,86,87,1,66,67,1
23,https://htmlpreview.github.io/?https://github.com/Christina96/boilerplate-sample-matches/blob/main/Java/Essentials-MDEwOlJlcG9zaXRvcnkxNzczNzU0-flat-WorldsHolder.java-motan-MDEwOlJlcG9zaXRvcnk1NjY3OTUyMQ==-flat-NettyExampleTest.java-23.html,16,Essentials-MDEwOlJlcG9zaXRvcnkxNzczNzU0-flat-WorldsHolder.java,motan-MDEwOlJlcG9zaXRvcnk1NjY3OTUyMQ==-flat-NettyExampleTest.java,100,103,3,93,96,3
24,https://htmlpreview.github.io/?https://github.com/Christina96/boilerplate-sample-matches/blob/main/Java/BungeeCord-MDEwOlJlcG9zaXRvcnk2MDg0MjEw-flat-BungeeTitle.java-BungeeCord-MDEwOlJlcG9zaXRvcnk2MDg0MjEw-flat-BungeeTitle.java-24.html,31,BungeeCord-MDEwOlJlcG9zaXRvcnk2MDg0MjEw-flat-BungeeTitle.java,BungeeCord-MDEwOlJlcG9zaXRvcnk2MDg0MjEw-flat-BungeeTitle.java,110,117,7,99,106,7
25,https://htmlpreview.github.io/?https://github.com/Christina96/boilerplate-sample-matches/blob/main/Java/Essentials-MDEwOlJlcG9zaXRvcnkxNzczNzU0-flat-YamlStorageWriter.java-VitamioBundle-MDEwOlJlcG9zaXRvcnk2MjkyMDI5-flat-MediaPlayer.java-25.html,14,Essentials-MDEwOlJlcG9zaXRvcnkxNzczNzU0-flat-YamlStorageWriter.java,VitamioBundle-MDEwOlJlcG9zaXRvcnk2MjkyMDI5-flat-MediaPlayer.java,225,230,5,253,256,3
26,https://htmlpreview.github.io/?https://github.com/Christina96/boilerplate-sample-matches/blob/main/Java/jedis-MDEwOlJlcG9zaXRvcnk3MTU2MDU=-flat-CommandObjects.java-jedis-MDEwOlJlcG9zaXRvcnk3MTU2MDU=-flat-CommandObjects.java-26.html,18,jedis-MDEwOlJlcG9zaXRvcnk3MTU2MDU=-flat-CommandObjects.java,jedis-MDEwOlJlcG9zaXRvcnk3MTU2MDU=-flat-CommandObjects.java,2507,2508,1,2522,2523,1
27,https://htmlpreview.github.io/?https://github.com/Christina96/boilerplate-sample-matches/blob/main/Java/jedis-MDEwOlJlcG9zaXRvcnk3MTU2MDU=-flat-StreamsCommandsTest.java-jedis-MDEwOlJlcG9zaXRvcnk3MTU2MDU=-flat-StreamsCommandsTest.java-27.html,64,jedis-MDEwOlJlcG9zaXRvcnk3MTU2MDU=-flat-StreamsCommandsTest.java,jedis-MDEwOlJlcG9zaXRvcnk3MTU2MDU=-flat-StreamsCommandsTest.java,478,484,6,500,506,6
28,https://htmlpreview.github.io/?https://github.com/Christina96/boilerplate-sample-matches/blob/main/Java/ribbon-MDEwOlJlcG9zaXRvcnk3NjE2MTU4-flat-ObserverWithLatch.java-segmentfault-lessons-MDEwOlJlcG9zaXRvcnk5MzE1NzM4MQ==-flat-FutureCircuitBreakerDemo.java-28.html,22,ribbon-MDEwOlJlcG9zaXRvcnk3NjE2MTU4-flat-ObserverWithLatch.java,segmentfault-lessons-MDEwOlJlcG9zaXRvcnk5MzE1NzM4MQ==-flat-FutureCircuitBreakerDemo.java,30,33,3,10,13,3
29,https://htmlpreview.github.io/?https://github.com/Christina96/boilerplate-sample-matches/blob/main/Java/jedis-MDEwOlJlcG9zaXRvcnk3MTU2MDU=-flat-JedisPubSubBase.java-jedis-MDEwOlJlcG9zaXRvcnk3MTU2MDU=-flat-JedisShardedPubSubBase.java-29.html,83,jedis-MDEwOlJlcG9zaXRvcnk3MTU2MDU=-flat-JedisPubSubBase.java,jedis-MDEwOlJlcG9zaXRvcnk3MTU2MDU=-flat-JedisShardedPubSubBase.java,29,42,13,20,33,13
30,https://htmlpreview.github.io/?https://github.com/Christina96/boilerplate-sample-matches/blob/main/Java/google-api-java-client-samples-MDEwOlJlcG9zaXRvcnkyOTc0OTA1Mg==-flat-AddOrEditNoteActivity.java-google-api-java-client-samples-MDEwOlJlcG9zaXRvcnkyOTc0OTA1Mg==-flat-AddOrEditCalendarActivity.java-30.html,30,google-api-java-client-samples-MDEwOlJlcG9zaXRvcnkyOTc0OTA1Mg==-flat-AddOrEditNoteActivity.java,google-api-java-client-samples-MDEwOlJlcG9zaXRvcnkyOTc0OTA1Mg==-flat-AddOrEditCalendarActivity.java,12,15,3,13,16,3
31,https://htmlpreview.github.io/?https://github.com/Christina96/boilerplate-sample-matches/blob/main/Java/ribbon-MDEwOlJlcG9zaXRvcnk3NjE2MTU4-flat-SimpleGet.java-BungeeCord-MDEwOlJlcG9zaXRvcnk2MDg0MjEw-flat-YamlConfig.java-31.html,14,ribbon-MDEwOlJlcG9zaXRvcnk3NjE2MTU4-flat-SimpleGet.java,BungeeCord-MDEwOlJlcG9zaXRvcnk2MDg0MjEw-flat-YamlConfig.java,14,15,1,193,194,1
32,https://htmlpreview.github.io/?https://github.com/Christina96/boilerplate-sample-matches/blob/main/Java/jedis-MDEwOlJlcG9zaXRvcnk3MTU2MDU=-flat-JedisPoolTest.java-jedis-MDEwOlJlcG9zaXRvcnk3MTU2MDU=-flat-JedisPoolTest.java-32.html,32,jedis-MDEwOlJlcG9zaXRvcnk3MTU2MDU=-flat-JedisPoolTest.java,jedis-MDEwOlJlcG9zaXRvcnk3MTU2MDU=-flat-JedisPoolTest.java,112,114,2,241,243,2
33,https://htmlpreview.github.io/?https://github.com/Christina96/boilerplate-sample-matches/blob/main/Java/jedis-MDEwOlJlcG9zaXRvcnk3MTU2MDU=-flat-GeoSearchParam.java-jedis-MDEwOlJlcG9zaXRvcnk3MTU2MDU=-flat-DefaultJedisClientConfig.java-33.html,17,jedis-MDEwOlJlcG9zaXRvcnk3MTU2MDU=-flat-GeoSearchParam.java,jedis-MDEwOlJlcG9zaXRvcnk3MTU2MDU=-flat-DefaultJedisClientConfig.java,70,73,3,123,126,3
34,https://htmlpreview.github.io/?https://github.com/Christina96/boilerplate-sample-matches/blob/main/Java/motan-MDEwOlJlcG9zaXRvcnk1NjY3OTUyMQ==-flat-DemoRpcClient.java-motan-MDEwOlJlcG9zaXRvcnk1NjY3OTUyMQ==-flat-Motan2RpcClientWithMesh.java-34.html,25,motan-MDEwOlJlcG9zaXRvcnk1NjY3OTUyMQ==-flat-DemoRpcClient.java,motan-MDEwOlJlcG9zaXRvcnk1NjY3OTUyMQ==-flat-Motan2RpcClientWithMesh.java,11,16,5,12,17,5
35,https://htmlpreview.github.io/?https://github.com/Christina96/boilerplate-sample-matches/blob/main/Java/Mybatis-PageHelper-MDEwOlJlcG9zaXRvcnkyMDY1MTY3Mg==-flat-UserExample.java-segmentfault-lessons-MDEwOlJlcG9zaXRvcnk5MzE1NzM4MQ==-flat-UserExample.java-35.html,14,Mybatis-PageHelper-MDEwOlJlcG9zaXRvcnkyMDY1MTY3Mg==-flat-UserExample.java,segmentfault-lessons-MDEwOlJlcG9zaXRvcnk5MzE1NzM4MQ==-flat-UserExample.java,26,28,2,41,43,2
36,https://htmlpreview.github.io/?https://github.com/Christina96/boilerplate-sample-matches/blob/main/Java/Essentials-MDEwOlJlcG9zaXRvcnkxNzczNzU0-flat-BukkitPermissions.java-Mybatis-PageHelper-MDEwOlJlcG9zaXRvcnkyMDY1MTY3Mg==-flat-ExecutorUtil.java-36.html,29,Essentials-MDEwOlJlcG9zaXRvcnkxNzczNzU0-flat-BukkitPermissions.java,Mybatis-PageHelper-MDEwOlJlcG9zaXRvcnkyMDY1MTY3Mg==-flat-ExecutorUtil.java,43,48,5,20,25,5
37,https://htmlpreview.github.io/?https://github.com/Christina96/boilerplate-sample-matches/blob/main/Java/Essentials-MDEwOlJlcG9zaXRvcnkxNzczNzU0-flat-TextInput.java-motan-MDEwOlJlcG9zaXRvcnk1NjY3OTUyMQ==-flat-ExceptionUtil.java-37.html,20,Essentials-MDEwOlJlcG9zaXRvcnkxNzczNzU0-flat-TextInput.java,motan-MDEwOlJlcG9zaXRvcnk1NjY3OTUyMQ==-flat-ExceptionUtil.java,93,96,3,34,37,3
38,https://htmlpreview.github.io/?https://github.com/Christina96/boilerplate-sample-matches/blob/main/Java/jedis-MDEwOlJlcG9zaXRvcnk3MTU2MDU=-flat-BuilderFactory.java-jedis-MDEwOlJlcG9zaXRvcnk3MTU2MDU=-flat-BuilderFactory.java-38.html,26,jedis-MDEwOlJlcG9zaXRvcnk3MTU2MDU=-flat-BuilderFactory.java,jedis-MDEwOlJlcG9zaXRvcnk3MTU2MDU=-flat-BuilderFactory.java,185,187,2,667,669,2
39,https://htmlpreview.github.io/?https://github.com/Christina96/boilerplate-sample-matches/blob/main/Java/motan-MDEwOlJlcG9zaXRvcnk1NjY3OTUyMQ==-flat-LocalSwitcherService.java-motan-MDEwOlJlcG9zaXRvcnk1NjY3OTUyMQ==-flat-FailbackRegistry.java-39.html,22,motan-MDEwOlJlcG9zaXRvcnk1NjY3OTUyMQ==-flat-LocalSwitcherService.java,motan-MDEwOlJlcG9zaXRvcnk1NjY3OTUyMQ==-flat-FailbackRegistry.java,65,70,5,75,80,5
40,https://htmlpreview.github.io/?https://github.com/Christina96/boilerplate-sample-matches/blob/main/Java/google-api-java-client-samples-MDEwOlJlcG9zaXRvcnkyOTc0OTA1Mg==-flat-VerificationSample.java-segmentfault-lessons-MDEwOlJlcG9zaXRvcnk5MzE1NzM4MQ==-flat-DeepCloneDemo.java-40.html,20,google-api-java-client-samples-MDEwOlJlcG9zaXRvcnkyOTc0OTA1Mg==-flat-VerificationSample.java,segmentfault-lessons-MDEwOlJlcG9zaXRvcnk5MzE1NzM4MQ==-flat-DeepCloneDemo.java,90,92,2,15,17,2
41,https://htmlpreview.github.io/?https://github.com/Christina96/boilerplate-sample-matches/blob/main/Java/BungeeCord-MDEwOlJlcG9zaXRvcnk2MDg0MjEw-flat-ConnectionThrottle.java-Mybatis-PageHelper-MDEwOlJlcG9zaXRvcnkyMDY1MTY3Mg==-flat-FunctionCountTest.java-41.html,14,BungeeCord-MDEwOlJlcG9zaXRvcnk2MDg0MjEw-flat-ConnectionThrottle.java,Mybatis-PageHelper-MDEwOlJlcG9zaXRvcnkyMDY1MTY3Mg==-flat-FunctionCountTest.java,44,45,1,32,33,1
42,https://htmlpreview.github.io/?https://github.com/Christina96/boilerplate-sample-matches/blob/main/Java/ribbon-MDEwOlJlcG9zaXRvcnk3NjE2MTU4-flat-TestExecutionListener.java-ribbon-MDEwOlJlcG9zaXRvcnk3NjE2MTU4-flat-TestExecutionListener.java-42.html,16,ribbon-MDEwOlJlcG9zaXRvcnk3NjE2MTU4-flat-TestExecutionListener.java,ribbon-MDEwOlJlcG9zaXRvcnk3NjE2MTU4-flat-TestExecutionListener.java,122,126,4,124,128,4
43,https://htmlpreview.github.io/?https://github.com/Christina96/boilerplate-sample-matches/blob/main/Java/jedis-MDEwOlJlcG9zaXRvcnk3MTU2MDU=-flat-ACLJedisTest.java-jedis-MDEwOlJlcG9zaXRvcnk3MTU2MDU=-flat-JedisTest.java-43.html,32,jedis-MDEwOlJlcG9zaXRvcnk3MTU2MDU=-flat-ACLJedisTest.java,jedis-MDEwOlJlcG9zaXRvcnk3MTU2MDU=-flat-JedisTest.java,26,29,3,45,48,3
44,https://htmlpreview.github.io/?https://github.com/Christina96/boilerplate-sample-matches/blob/main/Java/Essentials-MDEwOlJlcG9zaXRvcnkxNzczNzU0-flat-TextInput.java-Essentials-MDEwOlJlcG9zaXRvcnkxNzczNzU0-flat-EssentialsConf.java-44.html,29,Essentials-MDEwOlJlcG9zaXRvcnkxNzczNzU0-flat-TextInput.java,Essentials-MDEwOlJlcG9zaXRvcnkxNzczNzU0-flat-EssentialsConf.java,105,111,6,215,221,6
45,https://htmlpreview.github.io/?https://github.com/Christina96/boilerplate-sample-matches/blob/main/Java/jedis-MDEwOlJlcG9zaXRvcnk3MTU2MDU=-flat-ClusterCommandExecutorTest.java-jedis-MDEwOlJlcG9zaXRvcnk3MTU2MDU=-flat-ClusterCommandExecutorTest.java-45.html,55,jedis-MDEwOlJlcG9zaXRvcnk3MTU2MDU=-flat-ClusterCommandExecutorTest.java,jedis-MDEwOlJlcG9zaXRvcnk3MTU2MDU=-flat-ClusterCommandExecutorTest.java,100,111,11,128,139,11
46,https://htmlpreview.github.io/?https://github.com/Christina96/boilerplate-sample-matches/blob/main/Java/jedis-MDEwOlJlcG9zaXRvcnk3MTU2MDU=-flat-Jedis.java-jedis-MDEwOlJlcG9zaXRvcnk3MTU2MDU=-flat-Pipeline.java-46.html,16,jedis-MDEwOlJlcG9zaXRvcnk3MTU2MDU=-flat-Jedis.java,jedis-MDEwOlJlcG9zaXRvcnk3MTU2MDU=-flat-Pipeline.java,4060,4061,1,95,96,1
47,https://htmlpreview.github.io/?https://github.com/Christina96/boilerplate-sample-matches/blob/main/Java/jedis-MDEwOlJlcG9zaXRvcnk3MTU2MDU=-flat-XTrimParams.java-jedis-MDEwOlJlcG9zaXRvcnk3MTU2MDU=-flat-XAddParams.java-47.html,22,jedis-MDEwOlJlcG9zaXRvcnk3MTU2MDU=-flat-XTrimParams.java,jedis-MDEwOlJlcG9zaXRvcnk3MTU2MDU=-flat-XAddParams.java,9,14,5,14,19,5
48,https://htmlpreview.github.io/?https://github.com/Christina96/boilerplate-sample-matches/blob/main/Java/jedis-MDEwOlJlcG9zaXRvcnk3MTU2MDU=-flat-ListPipelineCommands.java-jedis-MDEwOlJlcG9zaXRvcnk3MTU2MDU=-flat-SortedSetPipelineCommands.java-48.html,18,jedis-MDEwOlJlcG9zaXRvcnk3MTU2MDU=-flat-ListPipelineCommands.java,jedis-MDEwOlJlcG9zaXRvcnk3MTU2MDU=-flat-SortedSetPipelineCommands.java,12,13,1,24,25,1
49,https://htmlpreview.github.io/?https://github.com/Christina96/boilerplate-sample-matches/blob/main/Java/motan-MDEwOlJlcG9zaXRvcnk1NjY3OTUyMQ==-flat-ClusterSpi.java-Essentials-MDEwOlJlcG9zaXRvcnkxNzczNzU0-flat-PermissionsBukkitHandler.java-49.html,19,motan-MDEwOlJlcG9zaXRvcnk1NjY3OTUyMQ==-flat-ClusterSpi.java,Essentials-MDEwOlJlcG9zaXRvcnkxNzczNzU0-flat-PermissionsBukkitHandler.java,32,37,5,23,28,5
50,https://htmlpreview.github.io/?https://github.com/Christina96/boilerplate-sample-matches/blob/main/Java/jedis-MDEwOlJlcG9zaXRvcnk3MTU2MDU=-flat-Jedis.java-jedis-MDEwOlJlcG9zaXRvcnk3MTU2MDU=-flat-Jedis.java-50.html,35,jedis-MDEwOlJlcG9zaXRvcnk3MTU2MDU=-flat-Jedis.java,jedis-MDEwOlJlcG9zaXRvcnk3MTU2MDU=-flat-Jedis.java,3668,3671,3,1585,1588,3
51,https://htmlpreview.github.io/?https://github.com/Christina96/boilerplate-sample-matches/blob/main/Java/jedis-MDEwOlJlcG9zaXRvcnk3MTU2MDU=-flat-FunctionStats.java-jedis-MDEwOlJlcG9zaXRvcnk3MTU2MDU=-flat-CommandInfo.java-51.html,31,jedis-MDEwOlJlcG9zaXRvcnk3MTU2MDU=-flat-FunctionStats.java,jedis-MDEwOlJlcG9zaXRvcnk3MTU2MDU=-flat-CommandInfo.java,19,24,5,48,53,5
52,https://htmlpreview.github.io/?https://github.com/Christina96/boilerplate-sample-matches/blob/main/Java/jedis-MDEwOlJlcG9zaXRvcnk3MTU2MDU=-flat-CommandObjects.java-jedis-MDEwOlJlcG9zaXRvcnk3MTU2MDU=-flat-CommandObjects.java-52.html,58,jedis-MDEwOlJlcG9zaXRvcnk3MTU2MDU=-flat-CommandObjects.java,jedis-MDEwOlJlcG9zaXRvcnk3MTU2MDU=-flat-CommandObjects.java,114,120,6,128,134,6
53,https://htmlpreview.github.io/?https://github.com/Christina96/boilerplate-sample-matches/blob/main/Java/ribbon-MDEwOlJlcG9zaXRvcnk3NjE2MTU4-flat-TestResource.java-ribbon-MDEwOlJlcG9zaXRvcnk3NjE2MTU4-flat-EmbeddedResources.java-53.html,15,ribbon-MDEwOlJlcG9zaXRvcnk3NjE2MTU4-flat-TestResource.java,ribbon-MDEwOlJlcG9zaXRvcnk3NjE2MTU4-flat-EmbeddedResources.java,27,28,1,86,87,1
54,https://htmlpreview.github.io/?https://github.com/Christina96/boilerplate-sample-matches/blob/main/Java/Essentials-MDEwOlJlcG9zaXRvcnkxNzczNzU0-flat-Variables.java-jedis-MDEwOlJlcG9zaXRvcnk3MTU2MDU=-flat-SentineledConnectionProvider.java-54.html,17,Essentials-MDEwOlJlcG9zaXRvcnkxNzczNzU0-flat-Variables.java,jedis-MDEwOlJlcG9zaXRvcnk3MTU2MDU=-flat-SentineledConnectionProvider.java,94,99,5,65,70,5
55,https://htmlpreview.github.io/?https://github.com/Christina96/boilerplate-sample-matches/blob/main/Java/jedis-MDEwOlJlcG9zaXRvcnk3MTU2MDU=-flat-RedisJsonV2Test.java-jedis-MDEwOlJlcG9zaXRvcnk3MTU2MDU=-flat-RedisJsonV1Test.java-55.html,29,jedis-MDEwOlJlcG9zaXRvcnk3MTU2MDU=-flat-RedisJsonV2Test.java,jedis-MDEwOlJlcG9zaXRvcnk3MTU2MDU=-flat-RedisJsonV1Test.java,276,277,1,280,281,1
56,https://htmlpreview.github.io/?https://github.com/Christina96/boilerplate-sample-matches/blob/main/Java/jedis-MDEwOlJlcG9zaXRvcnk3MTU2MDU=-flat-DefaultJedisClientConfig.java-jedis-MDEwOlJlcG9zaXRvcnk3MTU2MDU=-flat-DefaultJedisSocketFactory.java-56.html,16,jedis-MDEwOlJlcG9zaXRvcnk3MTU2MDU=-flat-DefaultJedisClientConfig.java,jedis-MDEwOlJlcG9zaXRvcnk3MTU2MDU=-flat-DefaultJedisSocketFactory.java,98,100,2,18,20,2
57,https://htmlpreview.github.io/?https://github.com/Christina96/boilerplate-sample-matches/blob/main/Java/motan-MDEwOlJlcG9zaXRvcnk1NjY3OTUyMQ==-flat-GrpcClient.java-BungeeCord-MDEwOlJlcG9zaXRvcnk2MDg0MjEw-flat-DownstreamBridge.java-57.html,14,motan-MDEwOlJlcG9zaXRvcnk1NjY3OTUyMQ==-flat-GrpcClient.java,BungeeCord-MDEwOlJlcG9zaXRvcnk2MDg0MjEw-flat-DownstreamBridge.java,52,54,2,273,276,3
58,https://htmlpreview.github.io/?https://github.com/Christina96/boilerplate-sample-matches/blob/main/Java/BungeeCord-MDEwOlJlcG9zaXRvcnk2MDg0MjEw-flat-EntityMap_1_14.java-BungeeCord-MDEwOlJlcG9zaXRvcnk2MDg0MjEw-flat-EntityMap_1_13.java-58.html,39,BungeeCord-MDEwOlJlcG9zaXRvcnk2MDg0MjEw-flat-EntityMap_1_14.java,BungeeCord-MDEwOlJlcG9zaXRvcnk2MDg0MjEw-flat-EntityMap_1_13.java,82,88,6,83,89,6
59,https://htmlpreview.github.io/?https://github.com/Christina96/boilerplate-sample-matches/blob/main/Java/ribbon-MDEwOlJlcG9zaXRvcnk3NjE2MTU4-flat-LBBuilderTest.java-ribbon-MDEwOlJlcG9zaXRvcnk3NjE2MTU4-flat-LBBuilderTest.java-59.html,22,ribbon-MDEwOlJlcG9zaXRvcnk3NjE2MTU4-flat-LBBuilderTest.java,ribbon-MDEwOlJlcG9zaXRvcnk3NjE2MTU4-flat-LBBuilderTest.java,123,125,2,122,124,2
60,https://htmlpreview.github.io/?https://github.com/Christina96/boilerplate-sample-matches/blob/main/Java/google-api-java-client-samples-MDEwOlJlcG9zaXRvcnkyOTc0OTA1Mg==-flat-AdSenseHostSample.java-google-api-java-client-samples-MDEwOlJlcG9zaXRvcnkyOTc0OTA1Mg==-flat-AdSenseHostSample.java-60.html,15,google-api-java-client-samples-MDEwOlJlcG9zaXRvcnkyOTc0OTA1Mg==-flat-AdSenseHostSample.java,google-api-java-client-samples-MDEwOlJlcG9zaXRvcnkyOTc0OTA1Mg==-flat-AdSenseHostSample.java,73,74,1,69,70,1
61,https://htmlpreview.github.io/?https://github.com/Christina96/boilerplate-sample-matches/blob/main/Java/jedis-MDEwOlJlcG9zaXRvcnk3MTU2MDU=-flat-ShardingTest.java-jedis-MDEwOlJlcG9zaXRvcnk3MTU2MDU=-flat-ShardingTest.java-61.html,91,jedis-MDEwOlJlcG9zaXRvcnk3MTU2MDU=-flat-ShardingTest.java,jedis-MDEwOlJlcG9zaXRvcnk3MTU2MDU=-flat-ShardingTest.java,32,45,13,57,70,13
62,https://htmlpreview.github.io/?https://github.com/Christina96/boilerplate-sample-matches/blob/main/Java/motan-MDEwOlJlcG9zaXRvcnk1NjY3OTUyMQ==-flat-StandardThreadExecutor_15.java-motan-MDEwOlJlcG9zaXRvcnk1NjY3OTUyMQ==-flat-StandardThreadExecutor.java-62.html,22,motan-MDEwOlJlcG9zaXRvcnk1NjY3OTUyMQ==-flat-StandardThreadExecutor_15.java,motan-MDEwOlJlcG9zaXRvcnk1NjY3OTUyMQ==-flat-StandardThreadExecutor.java,10,13,3,10,13,3
63,https://htmlpreview.github.io/?https://github.com/Christina96/boilerplate-sample-matches/blob/main/Java/Essentials-MDEwOlJlcG9zaXRvcnkxNzczNzU0-flat-EssentialsPlayerListener.java-Essentials-MDEwOlJlcG9zaXRvcnkxNzczNzU0-flat-UserMap.java-63.html,19,Essentials-MDEwOlJlcG9zaXRvcnkxNzczNzU0-flat-EssentialsPlayerListener.java,Essentials-MDEwOlJlcG9zaXRvcnkxNzczNzU0-flat-UserMap.java,121,125,4,61,65,4
64,https://htmlpreview.github.io/?https://github.com/Christina96/boilerplate-sample-matches/blob/main/Java/jedis-MDEwOlJlcG9zaXRvcnk3MTU2MDU=-flat-SortedSetBinaryCommands.java-jedis-MDEwOlJlcG9zaXRvcnk3MTU2MDU=-flat-SortedSetBinaryCommands.java-64.html,49,jedis-MDEwOlJlcG9zaXRvcnk3MTU2MDU=-flat-SortedSetBinaryCommands.java,jedis-MDEwOlJlcG9zaXRvcnk3MTU2MDU=-flat-SortedSetBinaryCommands.java,79,82,3,85,88,3
65,https://htmlpreview.github.io/?https://github.com/Christina96/boilerplate-sample-matches/blob/main/Java/motan-MDEwOlJlcG9zaXRvcnk1NjY3OTUyMQ==-flat-CommandServiceManagerTest.java-motan-MDEwOlJlcG9zaXRvcnk1NjY3OTUyMQ==-flat-CommandServiceManagerTest.java-65.html,55,motan-MDEwOlJlcG9zaXRvcnk1NjY3OTUyMQ==-flat-CommandServiceManagerTest.java,motan-MDEwOlJlcG9zaXRvcnk1NjY3OTUyMQ==-flat-CommandServiceManagerTest.java,199,205,6,259,265,6
66,https://htmlpreview.github.io/?https://github.com/Christina96/boilerplate-sample-matches/blob/main/Java/BungeeCord-MDEwOlJlcG9zaXRvcnk2MDg0MjEw-flat-HandlerBoss.java-BungeeCord-MDEwOlJlcG9zaXRvcnk2MDg0MjEw-flat-HandlerBoss.java-66.html,14,BungeeCord-MDEwOlJlcG9zaXRvcnk2MDg0MjEw-flat-HandlerBoss.java,BungeeCord-MDEwOlJlcG9zaXRvcnk2MDg0MjEw-flat-HandlerBoss.java,135,137,2,141,144,3
67,https://htmlpreview.github.io/?https://github.com/Christina96/boilerplate-sample-matches/blob/main/Java/motan-MDEwOlJlcG9zaXRvcnk1NjY3OTUyMQ==-flat-NettyHttpRequestHandler_3.java-segmentfault-lessons-MDEwOlJlcG9zaXRvcnk5MzE1NzM4MQ==-flat-JdbcController.java-67.html,22,motan-MDEwOlJlcG9zaXRvcnk1NjY3OTUyMQ==-flat-NettyHttpRequestHandler_3.java,segmentfault-lessons-MDEwOlJlcG9zaXRvcnk5MzE1NzM4MQ==-flat-JdbcController.java,86,90,4,83,87,4
68,https://htmlpreview.github.io/?https://github.com/Christina96/boilerplate-sample-matches/blob/main/Java/google-api-java-client-samples-MDEwOlJlcG9zaXRvcnkyOTc0OTA1Mg==-flat-CalendarSampleActivity.java-google-api-java-client-samples-MDEwOlJlcG9zaXRvcnkyOTc0OTA1Mg==-flat-TasksSample.java-68.html,35,google-api-java-client-samples-MDEwOlJlcG9zaXRvcnkyOTc0OTA1Mg==-flat-CalendarSampleActivity.java,google-api-java-client-samples-MDEwOlJlcG9zaXRvcnkyOTc0OTA1Mg==-flat-TasksSample.java,57,60,3,43,46,3
69,https://htmlpreview.github.io/?https://github.com/Christina96/boilerplate-sample-matches/blob/main/Java/jedis-MDEwOlJlcG9zaXRvcnk3MTU2MDU=-flat-SearchWithParamsTest.java-jedis-MDEwOlJlcG9zaXRvcnk3MTU2MDU=-flat-SearchTest.java-69.html,23,jedis-MDEwOlJlcG9zaXRvcnk3MTU2MDU=-flat-SearchWithParamsTest.java,jedis-MDEwOlJlcG9zaXRvcnk3MTU2MDU=-flat-SearchTest.java,424,427,3,458,461,3
70,https://htmlpreview.github.io/?https://github.com/Christina96/boilerplate-sample-matches/blob/main/Java/Essentials-MDEwOlJlcG9zaXRvcnkxNzczNzU0-flat-SignCreateEvent.java-Essentials-MDEwOlJlcG9zaXRvcnkxNzczNzU0-flat-SignInteractEvent.java-70.html,31,Essentials-MDEwOlJlcG9zaXRvcnkxNzczNzU0-flat-SignCreateEvent.java,Essentials-MDEwOlJlcG9zaXRvcnkxNzczNzU0-flat-SignInteractEvent.java,4,10,6,4,10,6
71,https://htmlpreview.github.io/?https://github.com/Christina96/boilerplate-sample-matches/blob/main/Java/motan-MDEwOlJlcG9zaXRvcnk1NjY3OTUyMQ==-flat-NettyServerChannelManage.java-motan-MDEwOlJlcG9zaXRvcnk1NjY3OTUyMQ==-flat-NettyServerChannelManage_18.java-71.html,77,motan-MDEwOlJlcG9zaXRvcnk1NjY3OTUyMQ==-flat-NettyServerChannelManage.java,motan-MDEwOlJlcG9zaXRvcnk1NjY3OTUyMQ==-flat-NettyServerChannelManage_18.java,56,67,11,58,69,11
72,https://htmlpreview.github.io/?https://github.com/Christina96/boilerplate-sample-matches/blob/main/Java/ribbon-MDEwOlJlcG9zaXRvcnk3NjE2MTU4-flat-BaseLoadBalancer.java-ribbon-MDEwOlJlcG9zaXRvcnk3NjE2MTU4-flat-BaseLoadBalancer.java-72.html,15,ribbon-MDEwOlJlcG9zaXRvcnk3NjE2MTU4-flat-BaseLoadBalancer.java,ribbon-MDEwOlJlcG9zaXRvcnk3NjE2MTU4-flat-BaseLoadBalancer.java,61,64,3,84,87,3
73,https://htmlpreview.github.io/?https://github.com/Christina96/boilerplate-sample-matches/blob/main/Java/SpringPetClinic-MDEwOlJlcG9zaXRvcnkzMDkzNDMzNTE=-flat-OwnerController.java-SpringPetClinic-MDEwOlJlcG9zaXRvcnkzMDkzNDMzNTE=-flat-ClinicServiceTests.java-73.html,16,SpringPetClinic-MDEwOlJlcG9zaXRvcnkzMDkzNDMzNTE=-flat-OwnerController.java,SpringPetClinic-MDEwOlJlcG9zaXRvcnkzMDkzNDMzNTE=-flat-ClinicServiceTests.java,73,75,2,68,70,2
74,https://htmlpreview.github.io/?https://github.com/Christina96/boilerplate-sample-matches/blob/main/Java/jedis-MDEwOlJlcG9zaXRvcnk3MTU2MDU=-flat-RedisJsonV1Test.java-jedis-MDEwOlJlcG9zaXRvcnk3MTU2MDU=-flat-RedisJsonV1Test.java-74.html,16,jedis-MDEwOlJlcG9zaXRvcnk3MTU2MDU=-flat-RedisJsonV1Test.java,jedis-MDEwOlJlcG9zaXRvcnk3MTU2MDU=-flat-RedisJsonV1Test.java,156,157,1,379,380,1
75,https://htmlpreview.github.io/?https://github.com/Christina96/boilerplate-sample-matches/blob/main/Java/motan-MDEwOlJlcG9zaXRvcnk1NjY3OTUyMQ==-flat-RouteSummary.java-motan-MDEwOlJlcG9zaXRvcnk1NjY3OTUyMQ==-flat-Point.java-75.html,100,motan-MDEwOlJlcG9zaXRvcnk1NjY3OTUyMQ==-flat-RouteSummary.java,motan-MDEwOlJlcG9zaXRvcnk1NjY3OTUyMQ==-flat-Point.java,160,174,14,122,136,14
76,https://htmlpreview.github.io/?https://github.com/Christina96/boilerplate-sample-matches/blob/main/Java/BungeeCord-MDEwOlJlcG9zaXRvcnk2MDg0MjEw-flat-DownstreamBridge.java-BungeeCord-MDEwOlJlcG9zaXRvcnk2MDg0MjEw-flat-DownstreamBridge.java-76.html,21,BungeeCord-MDEwOlJlcG9zaXRvcnk2MDg0MjEw-flat-DownstreamBridge.java,BungeeCord-MDEwOlJlcG9zaXRvcnk2MDg0MjEw-flat-DownstreamBridge.java,156,160,4,180,184,4
77,https://htmlpreview.github.io/?https://github.com/Christina96/boilerplate-sample-matches/blob/main/Java/motan-MDEwOlJlcG9zaXRvcnk1NjY3OTUyMQ==-flat-RefererConfigBeanTest.java-motan-MDEwOlJlcG9zaXRvcnk1NjY3OTUyMQ==-flat-Motan2RpcClient.java-77.html,17,motan-MDEwOlJlcG9zaXRvcnk1NjY3OTUyMQ==-flat-RefererConfigBeanTest.java,motan-MDEwOlJlcG9zaXRvcnk1NjY3OTUyMQ==-flat-Motan2RpcClient.java,31,33,2,22,24,2
78,https://htmlpreview.github.io/?https://github.com/Christina96/boilerplate-sample-matches/blob/main/Java/ribbon-MDEwOlJlcG9zaXRvcnk3NjE2MTU4-flat-ClientFactory.java-motan-MDEwOlJlcG9zaXRvcnk1NjY3OTUyMQ==-flat-AbstractEndpointFactory.java-78.html,16,ribbon-MDEwOlJlcG9zaXRvcnk3NjE2MTU4-flat-ClientFactory.java,motan-MDEwOlJlcG9zaXRvcnk1NjY3OTUyMQ==-flat-AbstractEndpointFactory.java,132,134,2,106,108,2
79,https://htmlpreview.github.io/?https://github.com/Christina96/boilerplate-sample-matches/blob/main/Java/jedis-MDEwOlJlcG9zaXRvcnk3MTU2MDU=-flat-ClusterCommandExecutorTest.java-jedis-MDEwOlJlcG9zaXRvcnk3MTU2MDU=-flat-ClusterCommandExecutorTest.java-79.html,32,jedis-MDEwOlJlcG9zaXRvcnk3MTU2MDU=-flat-ClusterCommandExecutorTest.java,jedis-MDEwOlJlcG9zaXRvcnk3MTU2MDU=-flat-ClusterCommandExecutorTest.java,259,267,8,76,84,8
80,https://htmlpreview.github.io/?https://github.com/Christina96/boilerplate-sample-matches/blob/main/Java/jedis-MDEwOlJlcG9zaXRvcnk3MTU2MDU=-flat-JedisPool.java-jedis-MDEwOlJlcG9zaXRvcnk3MTU2MDU=-flat-JedisPool.java-80.html,17,jedis-MDEwOlJlcG9zaXRvcnk3MTU2MDU=-flat-JedisPool.java,jedis-MDEwOlJlcG9zaXRvcnk3MTU2MDU=-flat-JedisPool.java,208,209,1,260,261,1
81,https://htmlpreview.github.io/?https://github.com/Christina96/boilerplate-sample-matches/blob/main/Java/Essentials-MDEwOlJlcG9zaXRvcnkxNzczNzU0-flat-PermissionsHandler.java-Essentials-MDEwOlJlcG9zaXRvcnkxNzczNzU0-flat-PermissionsHandler.java-81.html,68,Essentials-MDEwOlJlcG9zaXRvcnkxNzczNzU0-flat-PermissionsHandler.java,Essentials-MDEwOlJlcG9zaXRvcnkxNzczNzU0-flat-PermissionsHandler.java,106,120,14,156,170,14
82,https://htmlpreview.github.io/?https://github.com/Christina96/boilerplate-sample-matches/blob/main/Java/motan-MDEwOlJlcG9zaXRvcnk1NjY3OTUyMQ==-flat-RpcCommandUtilTest.java-ribbon-MDEwOlJlcG9zaXRvcnk3NjE2MTU4-flat-SimpleVipAddressResolver.java-82.html,15,motan-MDEwOlJlcG9zaXRvcnk1NjY3OTUyMQ==-flat-RpcCommandUtilTest.java,ribbon-MDEwOlJlcG9zaXRvcnk3NjE2MTU4-flat-SimpleVipAddressResolver.java,46,48,2,16,18,2
83,https://htmlpreview.github.io/?https://github.com/Christina96/boilerplate-sample-matches/blob/main/Java/ribbon-MDEwOlJlcG9zaXRvcnk3NjE2MTU4-flat-BaseLoadBalancer.java-ribbon-MDEwOlJlcG9zaXRvcnk3NjE2MTU4-flat-BaseLoadBalancer.java-83.html,32,ribbon-MDEwOlJlcG9zaXRvcnk3NjE2MTU4-flat-BaseLoadBalancer.java,ribbon-MDEwOlJlcG9zaXRvcnk3NjE2MTU4-flat-BaseLoadBalancer.java,451,457,6,585,591,6
84,https://htmlpreview.github.io/?https://github.com/Christina96/boilerplate-sample-matches/blob/main/Java/Essentials-MDEwOlJlcG9zaXRvcnkxNzczNzU0-flat-Jails.java-Essentials-MDEwOlJlcG9zaXRvcnkxNzczNzU0-flat-Jails.java-84.html,98,Essentials-MDEwOlJlcG9zaXRvcnkxNzczNzU0-flat-Jails.java,Essentials-MDEwOlJlcG9zaXRvcnkxNzczNzU0-flat-Jails.java,241,258,17,265,282,17
85,https://htmlpreview.github.io/?https://github.com/Christina96/boilerplate-sample-matches/blob/main/Java/ribbon-MDEwOlJlcG9zaXRvcnk3NjE2MTU4-flat-ClassTemplate.java-ribbon-MDEwOlJlcG9zaXRvcnk3NjE2MTU4-flat-HttpRequestBuilder.java-85.html,15,ribbon-MDEwOlJlcG9zaXRvcnk3NjE2MTU4-flat-ClassTemplate.java,ribbon-MDEwOlJlcG9zaXRvcnk3NjE2MTU4-flat-HttpRequestBuilder.java,8,10,2,30,32,2
86,https://htmlpreview.github.io/?https://github.com/Christina96/boilerplate-sample-matches/blob/main/Java/motan-MDEwOlJlcG9zaXRvcnk1NjY3OTUyMQ==-flat-ConsulEcwidClient.java-motan-MDEwOlJlcG9zaXRvcnk1NjY3OTUyMQ==-flat-ConsulEcwidClient.java-86.html,18,motan-MDEwOlJlcG9zaXRvcnk1NjY3OTUyMQ==-flat-ConsulEcwidClient.java,motan-MDEwOlJlcG9zaXRvcnk1NjY3OTUyMQ==-flat-ConsulEcwidClient.java,25,28,3,111,114,3
87,https://htmlpreview.github.io/?https://github.com/Christina96/boilerplate-sample-matches/blob/main/Java/jedis-MDEwOlJlcG9zaXRvcnk3MTU2MDU=-flat-UnifiedJedis.java-jedis-MDEwOlJlcG9zaXRvcnk3MTU2MDU=-flat-Jedis.java-87.html,20,jedis-MDEwOlJlcG9zaXRvcnk3MTU2MDU=-flat-UnifiedJedis.java,jedis-MDEwOlJlcG9zaXRvcnk3MTU2MDU=-flat-Jedis.java,2099,2100,1,4399,4400,1
88,https://htmlpreview.github.io/?https://github.com/Christina96/boilerplate-sample-matches/blob/main/Java/jedis-MDEwOlJlcG9zaXRvcnk3MTU2MDU=-flat-SortedSetPipelineBinaryCommands.java-jedis-MDEwOlJlcG9zaXRvcnk3MTU2MDU=-flat-SortedSetPipelineBinaryCommands.java-88.html,21,jedis-MDEwOlJlcG9zaXRvcnk3MTU2MDU=-flat-SortedSetPipelineBinaryCommands.java,jedis-MDEwOlJlcG9zaXRvcnk3MTU2MDU=-flat-SortedSetPipelineBinaryCommands.java,22,23,1,23,24,1
89,https://htmlpreview.github.io/?https://github.com/Christina96/boilerplate-sample-matches/blob/main/Java/Essentials-MDEwOlJlcG9zaXRvcnkxNzczNzU0-flat-ListType.java-Essentials-MDEwOlJlcG9zaXRvcnkxNzczNzU0-flat-MapKeyType.java-89.html,14,Essentials-MDEwOlJlcG9zaXRvcnkxNzczNzU0-flat-ListType.java,Essentials-MDEwOlJlcG9zaXRvcnkxNzczNzU0-flat-MapKeyType.java,8,11,3,8,11,3
90,https://htmlpreview.github.io/?https://github.com/Christina96/boilerplate-sample-matches/blob/main/Java/jedis-MDEwOlJlcG9zaXRvcnk3MTU2MDU=-flat-ControlCommandsTest.java-jedis-MDEwOlJlcG9zaXRvcnk3MTU2MDU=-flat-ControlCommandsTest.java-90.html,21,jedis-MDEwOlJlcG9zaXRvcnk3MTU2MDU=-flat-ControlCommandsTest.java,jedis-MDEwOlJlcG9zaXRvcnk3MTU2MDU=-flat-ControlCommandsTest.java,128,129,1,140,141,1
91,https://htmlpreview.github.io/?https://github.com/Christina96/boilerplate-sample-matches/blob/main/Java/jedis-MDEwOlJlcG9zaXRvcnk3MTU2MDU=-flat-AllKindOfValuesCommandsTest.java-jedis-MDEwOlJlcG9zaXRvcnk3MTU2MDU=-flat-AllKindOfValuesCommandsTest.java-91.html,18,jedis-MDEwOlJlcG9zaXRvcnk3MTU2MDU=-flat-AllKindOfValuesCommandsTest.java,jedis-MDEwOlJlcG9zaXRvcnk3MTU2MDU=-flat-AllKindOfValuesCommandsTest.java,394,396,2,366,368,2
92,https://htmlpreview.github.io/?https://github.com/Christina96/boilerplate-sample-matches/blob/main/Java/jedis-MDEwOlJlcG9zaXRvcnk3MTU2MDU=-flat-HashesCommandsTestBase.java-jedis-MDEwOlJlcG9zaXRvcnk3MTU2MDU=-flat-HashesCommandsTest.java-92.html,52,jedis-MDEwOlJlcG9zaXRvcnk3MTU2MDU=-flat-HashesCommandsTestBase.java,jedis-MDEwOlJlcG9zaXRvcnk3MTU2MDU=-flat-HashesCommandsTest.java,357,361,4,376,380,4
93,https://htmlpreview.github.io/?https://github.com/Christina96/boilerplate-sample-matches/blob/main/Java/jedis-MDEwOlJlcG9zaXRvcnk3MTU2MDU=-flat-Jedis.java-jedis-MDEwOlJlcG9zaXRvcnk3MTU2MDU=-flat-Jedis.java-93.html,19,jedis-MDEwOlJlcG9zaXRvcnk3MTU2MDU=-flat-Jedis.java,jedis-MDEwOlJlcG9zaXRvcnk3MTU2MDU=-flat-Jedis.java,244,249,5,248,253,5
94,https://htmlpreview.github.io/?https://github.com/Christina96/boilerplate-sample-matches/blob/main/Java/ribbon-MDEwOlJlcG9zaXRvcnk3NjE2MTU4-flat-SubsetFilterTest.java-ribbon-MDEwOlJlcG9zaXRvcnk3NjE2MTU4-flat-SubsetFilterTest.java-94.html,47,ribbon-MDEwOlJlcG9zaXRvcnk3NjE2MTU4-flat-SubsetFilterTest.java,ribbon-MDEwOlJlcG9zaXRvcnk3NjE2MTU4-flat-SubsetFilterTest.java,45,51,6,110,115,5
95,https://htmlpreview.github.io/?https://github.com/Christina96/boilerplate-sample-matches/blob/main/Java/jedis-MDEwOlJlcG9zaXRvcnk3MTU2MDU=-flat-StreamsCommandsTest.java-jedis-MDEwOlJlcG9zaXRvcnk3MTU2MDU=-flat-StreamsCommandsTest.java-95.html,62,jedis-MDEwOlJlcG9zaXRvcnk3MTU2MDU=-flat-StreamsCommandsTest.java,jedis-MDEwOlJlcG9zaXRvcnk3MTU2MDU=-flat-StreamsCommandsTest.java,521,526,5,565,570,5
96,https://htmlpreview.github.io/?https://github.com/Christina96/boilerplate-sample-matches/blob/main/Java/jedis-MDEwOlJlcG9zaXRvcnk3MTU2MDU=-flat-SearchWithParamsTest.java-jedis-MDEwOlJlcG9zaXRvcnk3MTU2MDU=-flat-SearchWithParamsTest.java-96.html,24,jedis-MDEwOlJlcG9zaXRvcnk3MTU2MDU=-flat-SearchWithParamsTest.java,jedis-MDEwOlJlcG9zaXRvcnk3MTU2MDU=-flat-SearchWithParamsTest.java,735,738,3,771,772,1
97,https://htmlpreview.github.io/?https://github.com/Christina96/boilerplate-sample-matches/blob/main/Java/jedis-MDEwOlJlcG9zaXRvcnk3MTU2MDU=-flat-CMSTest.java-jedis-MDEwOlJlcG9zaXRvcnk3MTU2MDU=-flat-VariadicCommandsTest.java-97.html,24,jedis-MDEwOlJlcG9zaXRvcnk3MTU2MDU=-flat-CMSTest.java,jedis-MDEwOlJlcG9zaXRvcnk3MTU2MDU=-flat-VariadicCommandsTest.java,104,107,3,93,96,3
98,https://htmlpreview.github.io/?https://github.com/Christina96/boilerplate-sample-matches/blob/main/Java/motan-MDEwOlJlcG9zaXRvcnk1NjY3OTUyMQ==-flat-ServletEndpointFactory.java-Essentials-MDEwOlJlcG9zaXRvcnkxNzczNzU0-flat-EssentialsConnect.java-98.html,14,motan-MDEwOlJlcG9zaXRvcnk1NjY3OTUyMQ==-flat-ServletEndpointFactory.java,Essentials-MDEwOlJlcG9zaXRvcnkxNzczNzU0-flat-EssentialsConnect.java,10,12,2,21,23,2
99,https://htmlpreview.github.io/?https://github.com/Christina96/boilerplate-sample-matches/blob/main/Java/jedis-MDEwOlJlcG9zaXRvcnk3MTU2MDU=-flat-ListPipelineBinaryCommands.java-jedis-MDEwOlJlcG9zaXRvcnk3MTU2MDU=-flat-SortedSetBinaryCommands.java-99.html,17,jedis-MDEwOlJlcG9zaXRvcnk3MTU2MDU=-flat-ListPipelineBinaryCommands.java,jedis-MDEwOlJlcG9zaXRvcnk3MTU2MDU=-flat-SortedSetBinaryCommands.java,14,15,1,31,32,1
100,https://htmlpreview.github.io/?https://github.com/Christina96/boilerplate-sample-matches/blob/main/Java/Essentials-MDEwOlJlcG9zaXRvcnkxNzczNzU0-flat-Commandessentials.java-Essentials-MDEwOlJlcG9zaXRvcnkxNzczNzU0-flat-EssentialsPlayerListener.java-100.html,17,Essentials-MDEwOlJlcG9zaXRvcnkxNzczNzU0-flat-Commandessentials.java,Essentials-MDEwOlJlcG9zaXRvcnkxNzczNzU0-flat-EssentialsPlayerListener.java,278,282,4,153,157,4
101,https://htmlpreview.github.io/?https://github.com/Christina96/boilerplate-sample-matches/blob/main/Java/motan-MDEwOlJlcG9zaXRvcnk1NjY3OTUyMQ==-flat-SimpleSerialization.java-motan-MDEwOlJlcG9zaXRvcnk1NjY3OTUyMQ==-flat-SimpleSerialization.java-101.html,19,motan-MDEwOlJlcG9zaXRvcnk1NjY3OTUyMQ==-flat-SimpleSerialization.java,motan-MDEwOlJlcG9zaXRvcnk1NjY3OTUyMQ==-flat-SimpleSerialization.java,370,373,3,357,360,3
102,https://htmlpreview.github.io/?https://github.com/Christina96/boilerplate-sample-matches/blob/main/Java/VitamioBundle-MDEwOlJlcG9zaXRvcnk2MjkyMDI5-flat-MediaController.java-VitamioBundle-MDEwOlJlcG9zaXRvcnk2MjkyMDI5-flat-VideoView.java-102.html,19,VitamioBundle-MDEwOlJlcG9zaXRvcnk2MjkyMDI5-flat-MediaController.java,VitamioBundle-MDEwOlJlcG9zaXRvcnk2MjkyMDI5-flat-VideoView.java,51,54,3,217,220,3
103,https://htmlpreview.github.io/?https://github.com/Christina96/boilerplate-sample-matches/blob/main/Java/BungeeCord-MDEwOlJlcG9zaXRvcnk2MDg0MjEw-flat-CompoundConfigurationTest.java-BungeeCord-MDEwOlJlcG9zaXRvcnk2MDg0MjEw-flat-AddressParseTest.java-103.html,25,BungeeCord-MDEwOlJlcG9zaXRvcnk2MDg0MjEw-flat-CompoundConfigurationTest.java,BungeeCord-MDEwOlJlcG9zaXRvcnk2MDg0MjEw-flat-AddressParseTest.java,19,24,5,19,24,5
104,https://htmlpreview.github.io/?https://github.com/Christina96/boilerplate-sample-matches/blob/main/Java/ribbon-MDEwOlJlcG9zaXRvcnk3NjE2MTU4-flat-MethodTemplateTest.java-ribbon-MDEwOlJlcG9zaXRvcnk3NjE2MTU4-flat-MethodTemplateTest.java-104.html,16,ribbon-MDEwOlJlcG9zaXRvcnk3NjE2MTU4-flat-MethodTemplateTest.java,ribbon-MDEwOlJlcG9zaXRvcnk3NjE2MTU4-flat-MethodTemplateTest.java,32,33,1,44,45,1
105,https://htmlpreview.github.io/?https://github.com/Christina96/boilerplate-sample-matches/blob/main/Java/jedis-MDEwOlJlcG9zaXRvcnk3MTU2MDU=-flat-ClusterValuesCommandsTest.java-jedis-MDEwOlJlcG9zaXRvcnk3MTU2MDU=-flat-PublishSubscribeCommandsTest.java-105.html,85,jedis-MDEwOlJlcG9zaXRvcnk3MTU2MDU=-flat-ClusterValuesCommandsTest.java,jedis-MDEwOlJlcG9zaXRvcnk3MTU2MDU=-flat-PublishSubscribeCommandsTest.java,83,99,16,41,57,16
106,https://htmlpreview.github.io/?https://github.com/Christina96/boilerplate-sample-matches/blob/main/Java/ribbon-MDEwOlJlcG9zaXRvcnk3NjE2MTU4-flat-ClientConfigTest.java-ribbon-MDEwOlJlcG9zaXRvcnk3NjE2MTU4-flat-ClientConfigTest.java-106.html,18,ribbon-MDEwOlJlcG9zaXRvcnk3NjE2MTU4-flat-ClientConfigTest.java,ribbon-MDEwOlJlcG9zaXRvcnk3NjE2MTU4-flat-ClientConfigTest.java,104,106,2,88,90,2
107,https://htmlpreview.github.io/?https://github.com/Christina96/boilerplate-sample-matches/blob/main/Java/motan-MDEwOlJlcG9zaXRvcnk1NjY3OTUyMQ==-flat-MeshRegistry.java-motan-MDEwOlJlcG9zaXRvcnk1NjY3OTUyMQ==-flat-MeshRegistry.java-107.html,14,motan-MDEwOlJlcG9zaXRvcnk1NjY3OTUyMQ==-flat-MeshRegistry.java,motan-MDEwOlJlcG9zaXRvcnk1NjY3OTUyMQ==-flat-MeshRegistry.java,66,67,1,67,68,1
108,https://htmlpreview.github.io/?https://github.com/Christina96/boilerplate-sample-matches/blob/main/Java/jedis-MDEwOlJlcG9zaXRvcnk3MTU2MDU=-flat-SortedSetCommandsTestBase.java-jedis-MDEwOlJlcG9zaXRvcnk3MTU2MDU=-flat-SortedSetCommandsTest.java-108.html,161,jedis-MDEwOlJlcG9zaXRvcnk3MTU2MDU=-flat-SortedSetCommandsTestBase.java,jedis-MDEwOlJlcG9zaXRvcnk3MTU2MDU=-flat-SortedSetCommandsTest.java,384,400,16,341,357,16
109,https://htmlpreview.github.io/?https://github.com/Christina96/boilerplate-sample-matches/blob/main/Java/VitamioBundle-MDEwOlJlcG9zaXRvcnk2MjkyMDI5-flat-MediaMetadataRetriever.java-Essentials-MDEwOlJlcG9zaXRvcnkxNzczNzU0-flat-AsyncStorageObjectHolder.java-109.html,14,VitamioBundle-MDEwOlJlcG9zaXRvcnk2MjkyMDI5-flat-MediaMetadataRetriever.java,Essentials-MDEwOlJlcG9zaXRvcnkxNzczNzU0-flat-AsyncStorageObjectHolder.java,60,63,3,96,100,4
110,https://htmlpreview.github.io/?https://github.com/Christina96/boilerplate-sample-matches/blob/main/Java/google-api-java-client-samples-MDEwOlJlcG9zaXRvcnkyOTc0OTA1Mg==-flat-UpdateDialogContent.java-ribbon-MDEwOlJlcG9zaXRvcnk3NjE2MTU4-flat-PropertyUtils.java-110.html,14,google-api-java-client-samples-MDEwOlJlcG9zaXRvcnkyOTc0OTA1Mg==-flat-UpdateDialogContent.java,ribbon-MDEwOlJlcG9zaXRvcnk3NjE2MTU4-flat-PropertyUtils.java,17,18,1,9,10,1
111,https://htmlpreview.github.io/?https://github.com/Christina96/boilerplate-sample-matches/blob/main/Java/Mybatis-PageHelper-MDEwOlJlcG9zaXRvcnkyMDY1MTY3Mg==-flat-MybatisHelper.java-Mybatis-PageHelper-MDEwOlJlcG9zaXRvcnkyMDY1MTY3Mg==-flat-MybatisRowBoundsHelper.java-111.html,94,Mybatis-PageHelper-MDEwOlJlcG9zaXRvcnkyMDY1MTY3Mg==-flat-MybatisHelper.java,Mybatis-PageHelper-MDEwOlJlcG9zaXRvcnkyMDY1MTY3Mg==-flat-MybatisRowBoundsHelper.java,30,45,15,23,38,15
112,https://htmlpreview.github.io/?https://github.com/Christina96/boilerplate-sample-matches/blob/main/Java/jedis-MDEwOlJlcG9zaXRvcnk3MTU2MDU=-flat-TDigestTest.java-jedis-MDEwOlJlcG9zaXRvcnk3MTU2MDU=-flat-TDigestTest.java-112.html,17,jedis-MDEwOlJlcG9zaXRvcnk3MTU2MDU=-flat-TDigestTest.java,jedis-MDEwOlJlcG9zaXRvcnk3MTU2MDU=-flat-TDigestTest.java,20,21,1,19,20,1
113,https://htmlpreview.github.io/?https://github.com/Christina96/boilerplate-sample-matches/blob/main/Java/jedis-MDEwOlJlcG9zaXRvcnk3MTU2MDU=-flat-GraphValuesTest.java-jedis-MDEwOlJlcG9zaXRvcnk3MTU2MDU=-flat-GraphValuesTest.java-113.html,17,jedis-MDEwOlJlcG9zaXRvcnk3MTU2MDU=-flat-GraphValuesTest.java,jedis-MDEwOlJlcG9zaXRvcnk3MTU2MDU=-flat-GraphValuesTest.java,25,27,2,39,41,2
114,https://htmlpreview.github.io/?https://github.com/Christina96/boilerplate-sample-matches/blob/main/Java/BungeeCord-MDEwOlJlcG9zaXRvcnk2MDg0MjEw-flat-YamlConfig.java-BungeeCord-MDEwOlJlcG9zaXRvcnk2MDg0MjEw-flat-YamlConfig.java-114.html,17,BungeeCord-MDEwOlJlcG9zaXRvcnk2MDg0MjEw-flat-YamlConfig.java,BungeeCord-MDEwOlJlcG9zaXRvcnk2MDg0MjEw-flat-YamlConfig.java,242,245,3,247,250,3
115,https://htmlpreview.github.io/?https://github.com/Christina96/boilerplate-sample-matches/blob/main/Java/jedis-MDEwOlJlcG9zaXRvcnk3MTU2MDU=-flat-AccessControlListCommandsTest.java-jedis-MDEwOlJlcG9zaXRvcnk3MTU2MDU=-flat-AccessControlListCommandsTest.java-115.html,26,jedis-MDEwOlJlcG9zaXRvcnk3MTU2MDU=-flat-AccessControlListCommandsTest.java,jedis-MDEwOlJlcG9zaXRvcnk3MTU2MDU=-flat-AccessControlListCommandsTest.java,289,291,2,305,307,2
116,https://htmlpreview.github.io/?https://github.com/Christina96/boilerplate-sample-matches/blob/main/Java/jedis-MDEwOlJlcG9zaXRvcnk3MTU2MDU=-flat-SearchTest.java-jedis-MDEwOlJlcG9zaXRvcnk3MTU2MDU=-flat-SearchTest.java-116.html,36,jedis-MDEwOlJlcG9zaXRvcnk3MTU2MDU=-flat-SearchTest.java,jedis-MDEwOlJlcG9zaXRvcnk3MTU2MDU=-flat-SearchTest.java,349,353,4,361,365,4
117,https://htmlpreview.github.io/?https://github.com/Christina96/boilerplate-sample-matches/blob/main/Java/Essentials-MDEwOlJlcG9zaXRvcnkxNzczNzU0-flat-ProtectConfig.java-BungeeCord-MDEwOlJlcG9zaXRvcnk2MDg0MjEw-flat-ListenerInfo.java-117.html,15,Essentials-MDEwOlJlcG9zaXRvcnkxNzczNzU0-flat-ProtectConfig.java,BungeeCord-MDEwOlJlcG9zaXRvcnk2MDg0MjEw-flat-ListenerInfo.java,46,49,3,19,22,3
118,https://htmlpreview.github.io/?https://github.com/Christina96/boilerplate-sample-matches/blob/main/Java/jedis-MDEwOlJlcG9zaXRvcnk3MTU2MDU=-flat-JsonSearchTest.java-jedis-MDEwOlJlcG9zaXRvcnk3MTU2MDU=-flat-JsonSearchTest.java-118.html,28,jedis-MDEwOlJlcG9zaXRvcnk3MTU2MDU=-flat-JsonSearchTest.java,jedis-MDEwOlJlcG9zaXRvcnk3MTU2MDU=-flat-JsonSearchTest.java,212,215,3,215,218,3
119,https://htmlpreview.github.io/?https://github.com/Christina96/boilerplate-sample-matches/blob/main/Java/motan-MDEwOlJlcG9zaXRvcnk1NjY3OTUyMQ==-flat-ConsistentHashLoadBalanceTest.java-motan-MDEwOlJlcG9zaXRvcnk1NjY3OTUyMQ==-flat-RoundRobinLoadBalanceTest.java-119.html,14,motan-MDEwOlJlcG9zaXRvcnk1NjY3OTUyMQ==-flat-ConsistentHashLoadBalanceTest.java,motan-MDEwOlJlcG9zaXRvcnk1NjY3OTUyMQ==-flat-RoundRobinLoadBalanceTest.java,10,13,3,12,15,3
120,https://htmlpreview.github.io/?https://github.com/Christina96/boilerplate-sample-matches/blob/main/Java/jedis-MDEwOlJlcG9zaXRvcnk3MTU2MDU=-flat-ListCommandsTest.java-jedis-MDEwOlJlcG9zaXRvcnk3MTU2MDU=-flat-HashesCommandsTest.java-120.html,15,jedis-MDEwOlJlcG9zaXRvcnk3MTU2MDU=-flat-ListCommandsTest.java,jedis-MDEwOlJlcG9zaXRvcnk3MTU2MDU=-flat-HashesCommandsTest.java,64,67,3,189,192,3
121,https://htmlpreview.github.io/?https://github.com/Christina96/boilerplate-sample-matches/blob/main/Java/google-api-java-client-samples-MDEwOlJlcG9zaXRvcnkyOTc0OTA1Mg==-flat-NoteEndpoint.java-google-api-java-client-samples-MDEwOlJlcG9zaXRvcnkyOTc0OTA1Mg==-flat-NoteEndpoint.java-121.html,60,google-api-java-client-samples-MDEwOlJlcG9zaXRvcnkyOTc0OTA1Mg==-flat-NoteEndpoint.java,google-api-java-client-samples-MDEwOlJlcG9zaXRvcnkyOTc0OTA1Mg==-flat-NoteEndpoint.java,52,62,10,66,76,10
122,https://htmlpreview.github.io/?https://github.com/Christina96/boilerplate-sample-matches/blob/main/Java/motan-MDEwOlJlcG9zaXRvcnk1NjY3OTUyMQ==-flat-DefaultRpcCodec.java-motan-MDEwOlJlcG9zaXRvcnk1NjY3OTUyMQ==-flat-ProtobufCodec.java-122.html,26,motan-MDEwOlJlcG9zaXRvcnk1NjY3OTUyMQ==-flat-DefaultRpcCodec.java,motan-MDEwOlJlcG9zaXRvcnk1NjY3OTUyMQ==-flat-ProtobufCodec.java,201,205,4,187,191,4
123,https://htmlpreview.github.io/?https://github.com/Christina96/boilerplate-sample-matches/blob/main/Java/Mybatis-PageHelper-MDEwOlJlcG9zaXRvcnkyMDY1MTY3Mg==-flat-AutoDialectTest.java-Mybatis-PageHelper-MDEwOlJlcG9zaXRvcnkyMDY1MTY3Mg==-flat-PageInfoTest.java-123.html,158,Mybatis-PageHelper-MDEwOlJlcG9zaXRvcnkyMDY1MTY3Mg==-flat-AutoDialectTest.java,Mybatis-PageHelper-MDEwOlJlcG9zaXRvcnkyMDY1MTY3Mg==-flat-PageInfoTest.java,20,34,14,20,34,14
124,https://htmlpreview.github.io/?https://github.com/Christina96/boilerplate-sample-matches/blob/main/Java/jedis-MDEwOlJlcG9zaXRvcnk3MTU2MDU=-flat-GraphAPITest.java-jedis-MDEwOlJlcG9zaXRvcnk3MTU2MDU=-flat-GraphAPITest.java-124.html,21,jedis-MDEwOlJlcG9zaXRvcnk3MTU2MDU=-flat-GraphAPITest.java,jedis-MDEwOlJlcG9zaXRvcnk3MTU2MDU=-flat-GraphAPITest.java,106,109,3,50,52,2
125,https://htmlpreview.github.io/?https://github.com/Christina96/boilerplate-sample-matches/blob/main/Java/jedis-MDEwOlJlcG9zaXRvcnk3MTU2MDU=-flat-MultiClusterClientConfig.java-jedis-MDEwOlJlcG9zaXRvcnk3MTU2MDU=-flat-MultiClusterClientConfig.java-125.html,54,jedis-MDEwOlJlcG9zaXRvcnk3MTU2MDU=-flat-MultiClusterClientConfig.java,jedis-MDEwOlJlcG9zaXRvcnk3MTU2MDU=-flat-MultiClusterClientConfig.java,185,192,7,199,206,7
126,https://htmlpreview.github.io/?https://github.com/Christina96/boilerplate-sample-matches/blob/main/Java/motan-MDEwOlJlcG9zaXRvcnk1NjY3OTUyMQ==-flat-NettyChannel_14.java-motan-MDEwOlJlcG9zaXRvcnk1NjY3OTUyMQ==-flat-NettyChannel.java-126.html,146,motan-MDEwOlJlcG9zaXRvcnk1NjY3OTUyMQ==-flat-NettyChannel_14.java,motan-MDEwOlJlcG9zaXRvcnk1NjY3OTUyMQ==-flat-NettyChannel.java,63,84,21,79,99,20
127,https://htmlpreview.github.io/?https://github.com/Christina96/boilerplate-sample-matches/blob/main/Java/ribbon-MDEwOlJlcG9zaXRvcnk3NjE2MTU4-flat-LoadBalancerBuilder.java-ribbon-MDEwOlJlcG9zaXRvcnk3NjE2MTU4-flat-LoadBalancerBuilder.java-127.html,46,ribbon-MDEwOlJlcG9zaXRvcnk3NjE2MTU4-flat-LoadBalancerBuilder.java,ribbon-MDEwOlJlcG9zaXRvcnk3NjE2MTU4-flat-LoadBalancerBuilder.java,61,71,10,74,84,10
128,https://htmlpreview.github.io/?https://github.com/Christina96/boilerplate-sample-matches/blob/main/Java/Essentials-MDEwOlJlcG9zaXRvcnkxNzczNzU0-flat-EssentialsCommand.java-BungeeCord-MDEwOlJlcG9zaXRvcnk2MDg0MjEw-flat-Configuration_0.java-128.html,17,Essentials-MDEwOlJlcG9zaXRvcnkxNzczNzU0-flat-EssentialsCommand.java,BungeeCord-MDEwOlJlcG9zaXRvcnk2MDg0MjEw-flat-Configuration_0.java,84,88,4,51,54,3
129,https://htmlpreview.github.io/?https://github.com/Christina96/boilerplate-sample-matches/blob/main/Java/google-api-java-client-samples-MDEwOlJlcG9zaXRvcnkyOTc0OTA1Mg==-flat-McfReportingApiReferenceSample.java-google-api-java-client-samples-MDEwOlJlcG9zaXRvcnkyOTc0OTA1Mg==-flat-CoreReportingApiReferenceSample.java-129.html,22,google-api-java-client-samples-MDEwOlJlcG9zaXRvcnkyOTc0OTA1Mg==-flat-McfReportingApiReferenceSample.java,google-api-java-client-samples-MDEwOlJlcG9zaXRvcnkyOTc0OTA1Mg==-flat-CoreReportingApiReferenceSample.java,189,194,5,151,156,5
130,https://htmlpreview.github.io/?https://github.com/Christina96/boilerplate-sample-matches/blob/main/Java/VitamioBundle-MDEwOlJlcG9zaXRvcnk2MjkyMDI5-flat-MediaPlayerSubtitle.java-motan-MDEwOlJlcG9zaXRvcnk1NjY3OTUyMQ==-flat-ConsulEcwidClient.java-130.html,20,VitamioBundle-MDEwOlJlcG9zaXRvcnk2MjkyMDI5-flat-MediaPlayerSubtitle.java,motan-MDEwOlJlcG9zaXRvcnk1NjY3OTUyMQ==-flat-ConsulEcwidClient.java,72,74,2,96,98,2
131,https://htmlpreview.github.io/?https://github.com/Christina96/boilerplate-sample-matches/blob/main/Java/segmentfault-lessons-MDEwOlJlcG9zaXRvcnk5MzE1NzM4MQ==-flat-SpringEventDemo_127.java-segmentfault-lessons-MDEwOlJlcG9zaXRvcnk5MzE1NzM4MQ==-flat-SpringEventDemo.java-131.html,74,segmentfault-lessons-MDEwOlJlcG9zaXRvcnk5MzE1NzM4MQ==-flat-SpringEventDemo_127.java,segmentfault-lessons-MDEwOlJlcG9zaXRvcnk5MzE1NzM4MQ==-flat-SpringEventDemo.java,11,27,16,11,27,16
132,https://htmlpreview.github.io/?https://github.com/Christina96/boilerplate-sample-matches/blob/main/Java/segmentfault-lessons-MDEwOlJlcG9zaXRvcnk5MzE1NzM4MQ==-flat-module-info.java-segmentfault-lessons-MDEwOlJlcG9zaXRvcnk5MzE1NzM4MQ==-flat-module-info_7.java-132.html,16,segmentfault-lessons-MDEwOlJlcG9zaXRvcnk5MzE1NzM4MQ==-flat-module-info.java,segmentfault-lessons-MDEwOlJlcG9zaXRvcnk5MzE1NzM4MQ==-flat-module-info_7.java,4,6,2,4,6,2
133,https://htmlpreview.github.io/?https://github.com/Christina96/boilerplate-sample-matches/blob/main/Java/ribbon-MDEwOlJlcG9zaXRvcnk3NjE2MTU4-flat-ResponseTimeWeightedRule.java-ribbon-MDEwOlJlcG9zaXRvcnk3NjE2MTU4-flat-WeightedResponseTimeRule.java-133.html,20,ribbon-MDEwOlJlcG9zaXRvcnk3NjE2MTU4-flat-ResponseTimeWeightedRule.java,ribbon-MDEwOlJlcG9zaXRvcnk3NjE2MTU4-flat-WeightedResponseTimeRule.java,147,152,5,169,174,5
134,https://htmlpreview.github.io/?https://github.com/Christina96/boilerplate-sample-matches/blob/main/Java/segmentfault-lessons-MDEwOlJlcG9zaXRvcnk5MzE1NzM4MQ==-flat-SynchronousQueueDemo.java-segmentfault-lessons-MDEwOlJlcG9zaXRvcnk5MzE1NzM4MQ==-flat-SynchronousQueueDemo.java-134.html,20,segmentfault-lessons-MDEwOlJlcG9zaXRvcnk5MzE1NzM4MQ==-flat-SynchronousQueueDemo.java,segmentfault-lessons-MDEwOlJlcG9zaXRvcnk5MzE1NzM4MQ==-flat-SynchronousQueueDemo.java,29,31,2,32,34,2
135,https://htmlpreview.github.io/?https://github.com/Christina96/boilerplate-sample-matches/blob/main/Java/jedis-MDEwOlJlcG9zaXRvcnk3MTU2MDU=-flat-RedisJsonV2PipelineCommands.java-jedis-MDEwOlJlcG9zaXRvcnk3MTU2MDU=-flat-RedisJsonV1PipelineCommands.java-135.html,33,jedis-MDEwOlJlcG9zaXRvcnk3MTU2MDU=-flat-RedisJsonV2PipelineCommands.java,jedis-MDEwOlJlcG9zaXRvcnk3MTU2MDU=-flat-RedisJsonV1PipelineCommands.java,16,20,4,9,13,4
136,https://htmlpreview.github.io/?https://github.com/Christina96/boilerplate-sample-matches/blob/main/Java/jedis-MDEwOlJlcG9zaXRvcnk3MTU2MDU=-flat-RedisJsonV2Commands.java-jedis-MDEwOlJlcG9zaXRvcnk3MTU2MDU=-flat-KeyCommands.java-136.html,16,jedis-MDEwOlJlcG9zaXRvcnk3MTU2MDU=-flat-RedisJsonV2Commands.java,jedis-MDEwOlJlcG9zaXRvcnk3MTU2MDU=-flat-KeyCommands.java,36,37,1,55,56,1
137,https://htmlpreview.github.io/?https://github.com/Christina96/boilerplate-sample-matches/blob/main/Java/jedis-MDEwOlJlcG9zaXRvcnk3MTU2MDU=-flat-CommandObjects.java-jedis-MDEwOlJlcG9zaXRvcnk3MTU2MDU=-flat-CommandObjects.java-137.html,14,jedis-MDEwOlJlcG9zaXRvcnk3MTU2MDU=-flat-CommandObjects.java,jedis-MDEwOlJlcG9zaXRvcnk3MTU2MDU=-flat-CommandObjects.java,2600,2602,2,2556,2558,2
138,https://htmlpreview.github.io/?https://github.com/Christina96/boilerplate-sample-matches/blob/main/Java/motan-MDEwOlJlcG9zaXRvcnk1NjY3OTUyMQ==-flat-FeatureDatabase.java-motan-MDEwOlJlcG9zaXRvcnk1NjY3OTUyMQ==-flat-Rectangle.java-138.html,115,motan-MDEwOlJlcG9zaXRvcnk1NjY3OTUyMQ==-flat-FeatureDatabase.java,motan-MDEwOlJlcG9zaXRvcnk1NjY3OTUyMQ==-flat-Rectangle.java,14,37,23,13,36,23
139,https://htmlpreview.github.io/?https://github.com/Christina96/boilerplate-sample-matches/blob/main/Java/jedis-MDEwOlJlcG9zaXRvcnk3MTU2MDU=-flat-GeoCommandsTestBase.java-jedis-MDEwOlJlcG9zaXRvcnk3MTU2MDU=-flat-GeoCommandsTest.java-139.html,28,jedis-MDEwOlJlcG9zaXRvcnk3MTU2MDU=-flat-GeoCommandsTestBase.java,jedis-MDEwOlJlcG9zaXRvcnk3MTU2MDU=-flat-GeoCommandsTest.java,70,72,2,70,72,2
140,https://htmlpreview.github.io/?https://github.com/Christina96/boilerplate-sample-matches/blob/main/Java/motan-MDEwOlJlcG9zaXRvcnk1NjY3OTUyMQ==-flat-LogService.java-motan-MDEwOlJlcG9zaXRvcnk1NjY3OTUyMQ==-flat-LogService.java-140.html,18,motan-MDEwOlJlcG9zaXRvcnk1NjY3OTUyMQ==-flat-LogService.java,motan-MDEwOlJlcG9zaXRvcnk1NjY3OTUyMQ==-flat-LogService.java,5,7,2,19,21,2
141,https://htmlpreview.github.io/?https://github.com/Christina96/boilerplate-sample-matches/blob/main/Java/google-api-java-client-samples-MDEwOlJlcG9zaXRvcnkyOTc0OTA1Mg==-flat-CalendarSample.java-google-api-java-client-samples-MDEwOlJlcG9zaXRvcnkyOTc0OTA1Mg==-flat-VerificationSample.java-141.html,26,google-api-java-client-samples-MDEwOlJlcG9zaXRvcnkyOTc0OTA1Mg==-flat-CalendarSample.java,google-api-java-client-samples-MDEwOlJlcG9zaXRvcnkyOTc0OTA1Mg==-flat-VerificationSample.java,43,46,3,42,45,3
142,https://htmlpreview.github.io/?https://github.com/Christina96/boilerplate-sample-matches/blob/main/Java/motan-MDEwOlJlcG9zaXRvcnk1NjY3OTUyMQ==-flat-ServiceConfigBean.java-motan-MDEwOlJlcG9zaXRvcnk1NjY3OTUyMQ==-flat-RefererConfigBean.java-142.html,122,motan-MDEwOlJlcG9zaXRvcnk1NjY3OTUyMQ==-flat-ServiceConfigBean.java,motan-MDEwOlJlcG9zaXRvcnk1NjY3OTUyMQ==-flat-RefererConfigBean.java,50,70,20,49,69,20
143,https://htmlpreview.github.io/?https://github.com/Christina96/boilerplate-sample-matches/blob/main/Java/ribbon-MDEwOlJlcG9zaXRvcnk3NjE2MTU4-flat-HystrixObservableCommandChain.java-ribbon-MDEwOlJlcG9zaXRvcnk3NjE2MTU4-flat-HystrixObservableCommandChain.java-143.html,20,ribbon-MDEwOlJlcG9zaXRvcnk3NjE2MTU4-flat-HystrixObservableCommandChain.java,ribbon-MDEwOlJlcG9zaXRvcnk3NjE2MTU4-flat-HystrixObservableCommandChain.java,26,30,4,34,38,4
144,https://htmlpreview.github.io/?https://github.com/Christina96/boilerplate-sample-matches/blob/main/Java/motan-MDEwOlJlcG9zaXRvcnk1NjY3OTUyMQ==-flat-StatsUtil.java-motan-MDEwOlJlcG9zaXRvcnk1NjY3OTUyMQ==-flat-StatsUtil.java-144.html,15,motan-MDEwOlJlcG9zaXRvcnk1NjY3OTUyMQ==-flat-StatsUtil.java,motan-MDEwOlJlcG9zaXRvcnk1NjY3OTUyMQ==-flat-StatsUtil.java,310,312,2,331,333,2
145,https://htmlpreview.github.io/?https://github.com/Christina96/boilerplate-sample-matches/blob/main/Java/jedis-MDEwOlJlcG9zaXRvcnk3MTU2MDU=-flat-ObjectCommandsTest.java-jedis-MDEwOlJlcG9zaXRvcnk3MTU2MDU=-flat-ObjectCommandsTest.java-145.html,38,jedis-MDEwOlJlcG9zaXRvcnk3MTU2MDU=-flat-ObjectCommandsTest.java,jedis-MDEwOlJlcG9zaXRvcnk3MTU2MDU=-flat-ObjectCommandsTest.java,46,50,4,52,56,4
146,https://htmlpreview.github.io/?https://github.com/Christina96/boilerplate-sample-matches/blob/main/Java/jedis-MDEwOlJlcG9zaXRvcnk3MTU2MDU=-flat-SearchQuickstartExample.java-jedis-MDEwOlJlcG9zaXRvcnk3MTU2MDU=-flat-SearchQuickstartExample.java-146.html,16,jedis-MDEwOlJlcG9zaXRvcnk3MTU2MDU=-flat-SearchQuickstartExample.java,jedis-MDEwOlJlcG9zaXRvcnk3MTU2MDU=-flat-SearchQuickstartExample.java,12,16,4,13,17,4
147,https://htmlpreview.github.io/?https://github.com/Christina96/boilerplate-sample-matches/blob/main/Java/jedis-MDEwOlJlcG9zaXRvcnk3MTU2MDU=-flat-SortedSetCommandsTest.java-jedis-MDEwOlJlcG9zaXRvcnk3MTU2MDU=-flat-SortedSetCommandsTestBase.java-147.html,31,jedis-MDEwOlJlcG9zaXRvcnk3MTU2MDU=-flat-SortedSetCommandsTest.java,jedis-MDEwOlJlcG9zaXRvcnk3MTU2MDU=-flat-SortedSetCommandsTestBase.java,1038,1040,2,1032,1034,2
148,https://htmlpreview.github.io/?https://github.com/Christina96/boilerplate-sample-matches/blob/main/Java/jedis-MDEwOlJlcG9zaXRvcnk3MTU2MDU=-flat-GeoPipelineCommands.java-jedis-MDEwOlJlcG9zaXRvcnk3MTU2MDU=-flat-GeoPipelineCommands.java-148.html,20,jedis-MDEwOlJlcG9zaXRvcnk3MTU2MDU=-flat-GeoPipelineCommands.java,jedis-MDEwOlJlcG9zaXRvcnk3MTU2MDU=-flat-GeoPipelineCommands.java,20,21,1,24,25,1
149,https://htmlpreview.github.io/?https://github.com/Christina96/boilerplate-sample-matches/blob/main/Java/segmentfault-lessons-MDEwOlJlcG9zaXRvcnk5MzE1NzM4MQ==-flat-ElasticsearchConfiguration.java-ribbon-MDEwOlJlcG9zaXRvcnk3NjE2MTU4-flat-RestClientTest.java-149.html,18,segmentfault-lessons-MDEwOlJlcG9zaXRvcnk5MzE1NzM4MQ==-flat-ElasticsearchConfiguration.java,ribbon-MDEwOlJlcG9zaXRvcnk3NjE2MTU4-flat-RestClientTest.java,15,16,1,63,64,1
150,https://htmlpreview.github.io/?https://github.com/Christina96/boilerplate-sample-matches/blob/main/Java/VitamioBundle-MDEwOlJlcG9zaXRvcnk2MjkyMDI5-flat-MediaPlayerDemo_Video.java-VitamioBundle-MDEwOlJlcG9zaXRvcnk2MjkyMDI5-flat-VideoView.java-150.html,14,VitamioBundle-MDEwOlJlcG9zaXRvcnk2MjkyMDI5-flat-MediaPlayerDemo_Video.java,VitamioBundle-MDEwOlJlcG9zaXRvcnk2MjkyMDI5-flat-VideoView.java,92,96,4,118,122,4
151,https://htmlpreview.github.io/?https://github.com/Christina96/boilerplate-sample-matches/blob/main/Java/jedis-MDEwOlJlcG9zaXRvcnk3MTU2MDU=-flat-Protocol.java-jedis-MDEwOlJlcG9zaXRvcnk3MTU2MDU=-flat-Protocol.java-151.html,39,jedis-MDEwOlJlcG9zaXRvcnk3MTU2MDU=-flat-Protocol.java,jedis-MDEwOlJlcG9zaXRvcnk3MTU2MDU=-flat-Protocol.java,72,74,2,75,77,2
152,https://htmlpreview.github.io/?https://github.com/Christina96/boilerplate-sample-matches/blob/main/Java/google-api-java-client-samples-MDEwOlJlcG9zaXRvcnkyOTc0OTA1Mg==-flat-Noteendpoint.java-google-api-java-client-samples-MDEwOlJlcG9zaXRvcnkyOTc0OTA1Mg==-flat-Deviceinfoendpoint.java-152.html,105,google-api-java-client-samples-MDEwOlJlcG9zaXRvcnkyOTc0OTA1Mg==-flat-Noteendpoint.java,google-api-java-client-samples-MDEwOlJlcG9zaXRvcnkyOTc0OTA1Mg==-flat-Deviceinfoendpoint.java,42,72,30,42,72,30
153,https://htmlpreview.github.io/?https://github.com/Christina96/boilerplate-sample-matches/blob/main/Java/jedis-MDEwOlJlcG9zaXRvcnk3MTU2MDU=-flat-ScriptingKeyPipelineCommands.java-jedis-MDEwOlJlcG9zaXRvcnk3MTU2MDU=-flat-ScriptingKeyPipelineCommands.java-153.html,61,jedis-MDEwOlJlcG9zaXRvcnk3MTU2MDU=-flat-ScriptingKeyPipelineCommands.java,jedis-MDEwOlJlcG9zaXRvcnk3MTU2MDU=-flat-ScriptingKeyPipelineCommands.java,6,9,3,10,13,3
154,https://htmlpreview.github.io/?https://github.com/Christina96/boilerplate-sample-matches/blob/main/Java/motan-MDEwOlJlcG9zaXRvcnk1NjY3OTUyMQ==-flat-StatsUtil.java-motan-MDEwOlJlcG9zaXRvcnk1NjY3OTUyMQ==-flat-StatsUtil.java-154.html,103,motan-MDEwOlJlcG9zaXRvcnk1NjY3OTUyMQ==-flat-StatsUtil.java,motan-MDEwOlJlcG9zaXRvcnk1NjY3OTUyMQ==-flat-StatsUtil.java,109,122,13,141,154,13
155,https://htmlpreview.github.io/?https://github.com/Christina96/boilerplate-sample-matches/blob/main/Java/BungeeCord-MDEwOlJlcG9zaXRvcnk2MDg0MjEw-flat-CompoundConfigurationTest.java-BungeeCord-MDEwOlJlcG9zaXRvcnk2MDg0MjEw-flat-LoggingOutputStream.java-155.html,20,BungeeCord-MDEwOlJlcG9zaXRvcnk2MDg0MjEw-flat-CompoundConfigurationTest.java,BungeeCord-MDEwOlJlcG9zaXRvcnk2MDg0MjEw-flat-LoggingOutputStream.java,127,132,5,12,17,5
156,https://htmlpreview.github.io/?https://github.com/Christina96/boilerplate-sample-matches/blob/main/Java/BungeeCord-MDEwOlJlcG9zaXRvcnk2MDg0MjEw-flat-ModuleManager.java-BungeeCord-MDEwOlJlcG9zaXRvcnk2MDg0MjEw-flat-NativeCode.java-156.html,18,BungeeCord-MDEwOlJlcG9zaXRvcnk2MDg0MjEw-flat-ModuleManager.java,BungeeCord-MDEwOlJlcG9zaXRvcnk2MDg0MjEw-flat-NativeCode.java,48,51,3,43,46,3
157,https://htmlpreview.github.io/?https://github.com/Christina96/boilerplate-sample-matches/blob/main/Java/google-api-java-client-samples-MDEwOlJlcG9zaXRvcnkyOTc0OTA1Mg==-flat-NoteendpointRequest.java-google-api-java-client-samples-MDEwOlJlcG9zaXRvcnkyOTc0OTA1Mg==-flat-DeviceinfoendpointRequest.java-157.html,336,google-api-java-client-samples-MDEwOlJlcG9zaXRvcnkyOTc0OTA1Mg==-flat-NoteendpointRequest.java,google-api-java-client-samples-MDEwOlJlcG9zaXRvcnkyOTc0OTA1Mg==-flat-DeviceinfoendpointRequest.java,7,73,66,7,73,66
158,https://htmlpreview.github.io/?https://github.com/Christina96/boilerplate-sample-matches/blob/main/Java/motan-MDEwOlJlcG9zaXRvcnk1NjY3OTUyMQ==-flat-MotanAsyncProcessor.java-motan-MDEwOlJlcG9zaXRvcnk1NjY3OTUyMQ==-flat-ProtectedExecutionHandler.java-158.html,17,motan-MDEwOlJlcG9zaXRvcnk1NjY3OTUyMQ==-flat-MotanAsyncProcessor.java,motan-MDEwOlJlcG9zaXRvcnk1NjY3OTUyMQ==-flat-ProtectedExecutionHandler.java,104,105,1,26,27,1
159,https://htmlpreview.github.io/?https://github.com/Christina96/boilerplate-sample-matches/blob/main/Java/jedis-MDEwOlJlcG9zaXRvcnk3MTU2MDU=-flat-ResultSetBuilder.java-jedis-MDEwOlJlcG9zaXRvcnk3MTU2MDU=-flat-ResultSetBuilder.java-159.html,15,jedis-MDEwOlJlcG9zaXRvcnk3MTU2MDU=-flat-ResultSetBuilder.java,jedis-MDEwOlJlcG9zaXRvcnk3MTU2MDU=-flat-ResultSetBuilder.java,117,120,3,111,114,3
160,https://htmlpreview.github.io/?https://github.com/Christina96/boilerplate-sample-matches/blob/main/Java/Essentials-MDEwOlJlcG9zaXRvcnkxNzczNzU0-flat-Settings.java-jedis-MDEwOlJlcG9zaXRvcnk3MTU2MDU=-flat-Query.java-160.html,18,Essentials-MDEwOlJlcG9zaXRvcnkxNzczNzU0-flat-Settings.java,jedis-MDEwOlJlcG9zaXRvcnk3MTU2MDU=-flat-Query.java,747,750,3,106,109,3
161,https://htmlpreview.github.io/?https://github.com/Christina96/boilerplate-sample-matches/blob/main/Java/Essentials-MDEwOlJlcG9zaXRvcnkxNzczNzU0-flat-EconomyTest.java-Essentials-MDEwOlJlcG9zaXRvcnkxNzczNzU0-flat-EconomyTest.java-161.html,42,Essentials-MDEwOlJlcG9zaXRvcnkxNzczNzU0-flat-EconomyTest.java,Essentials-MDEwOlJlcG9zaXRvcnkxNzczNzU0-flat-EconomyTest.java,55,59,4,84,88,4
162,https://htmlpreview.github.io/?https://github.com/Christina96/boilerplate-sample-matches/blob/main/Java/Essentials-MDEwOlJlcG9zaXRvcnkxNzczNzU0-flat-User_0.java-Essentials-MDEwOlJlcG9zaXRvcnkxNzczNzU0-flat-User_0.java-162.html,22,Essentials-MDEwOlJlcG9zaXRvcnkxNzczNzU0-flat-User_0.java,Essentials-MDEwOlJlcG9zaXRvcnkxNzczNzU0-flat-User_0.java,404,406,2,434,436,2
163,https://htmlpreview.github.io/?https://github.com/Christina96/boilerplate-sample-matches/blob/main/Java/motan-MDEwOlJlcG9zaXRvcnk1NjY3OTUyMQ==-flat-ProtobufCodec.java-motan-MDEwOlJlcG9zaXRvcnk1NjY3OTUyMQ==-flat-DefaultRpcCodec.java-163.html,34,motan-MDEwOlJlcG9zaXRvcnk1NjY3OTUyMQ==-flat-ProtobufCodec.java,motan-MDEwOlJlcG9zaXRvcnk1NjY3OTUyMQ==-flat-DefaultRpcCodec.java,195,201,6,209,215,6
164,https://htmlpreview.github.io/?https://github.com/Christina96/boilerplate-sample-matches/blob/main/Java/jedis-MDEwOlJlcG9zaXRvcnk3MTU2MDU=-flat-SSLJedisClusterTest.java-jedis-MDEwOlJlcG9zaXRvcnk3MTU2MDU=-flat-SSLACLJedisClusterTest.java-164.html,55,jedis-MDEwOlJlcG9zaXRvcnk3MTU2MDU=-flat-SSLJedisClusterTest.java,jedis-MDEwOlJlcG9zaXRvcnk3MTU2MDU=-flat-SSLACLJedisClusterTest.java,125,132,7,128,135,7
165,https://htmlpreview.github.io/?https://github.com/Christina96/boilerplate-sample-matches/blob/main/Java/ribbon-MDEwOlJlcG9zaXRvcnk3NjE2MTU4-flat-NamedConnectionPool.java-google-api-java-client-samples-MDEwOlJlcG9zaXRvcnkyOTc0OTA1Mg==-flat-Deviceinfoendpoint.java-165.html,17,ribbon-MDEwOlJlcG9zaXRvcnk3NjE2MTU4-flat-NamedConnectionPool.java,google-api-java-client-samples-MDEwOlJlcG9zaXRvcnkyOTc0OTA1Mg==-flat-Deviceinfoendpoint.java,47,49,2,26,28,2
166,https://htmlpreview.github.io/?https://github.com/Christina96/boilerplate-sample-matches/blob/main/Java/jedis-MDEwOlJlcG9zaXRvcnk3MTU2MDU=-flat-HyperLogLogBinaryCommands.java-jedis-MDEwOlJlcG9zaXRvcnk3MTU2MDU=-flat-AccessControlLogBinaryCommands.java-166.html,15,jedis-MDEwOlJlcG9zaXRvcnk3MTU2MDU=-flat-HyperLogLogBinaryCommands.java,jedis-MDEwOlJlcG9zaXRvcnk3MTU2MDU=-flat-AccessControlLogBinaryCommands.java,4,5,1,13,14,1
167,https://htmlpreview.github.io/?https://github.com/Christina96/boilerplate-sample-matches/blob/main/Java/jedis-MDEwOlJlcG9zaXRvcnk3MTU2MDU=-flat-HyperLogLogCommandsTest.java-jedis-MDEwOlJlcG9zaXRvcnk3MTU2MDU=-flat-HyperLogLogCommandsTestBase.java-167.html,15,jedis-MDEwOlJlcG9zaXRvcnk3MTU2MDU=-flat-HyperLogLogCommandsTest.java,jedis-MDEwOlJlcG9zaXRvcnk3MTU2MDU=-flat-HyperLogLogCommandsTestBase.java,61,62,1,61,62,1
168,https://htmlpreview.github.io/?https://github.com/Christina96/boilerplate-sample-matches/blob/main/Java/jedis-MDEwOlJlcG9zaXRvcnk3MTU2MDU=-flat-SearchTest.java-jedis-MDEwOlJlcG9zaXRvcnk3MTU2MDU=-flat-SearchWithParamsTest.java-168.html,20,jedis-MDEwOlJlcG9zaXRvcnk3MTU2MDU=-flat-SearchTest.java,jedis-MDEwOlJlcG9zaXRvcnk3MTU2MDU=-flat-SearchWithParamsTest.java,924,925,1,773,774,1
169,https://htmlpreview.github.io/?https://github.com/Christina96/boilerplate-sample-matches/blob/main/Java/motan-MDEwOlJlcG9zaXRvcnk1NjY3OTUyMQ==-flat-Motan2RpcClient.java-motan-MDEwOlJlcG9zaXRvcnk1NjY3OTUyMQ==-flat-Motan2RpcClient.java-169.html,27,motan-MDEwOlJlcG9zaXRvcnk1NjY3OTUyMQ==-flat-Motan2RpcClient.java,motan-MDEwOlJlcG9zaXRvcnk1NjY3OTUyMQ==-flat-Motan2RpcClient.java,44,45,1,47,48,1
170,https://htmlpreview.github.io/?https://github.com/Christina96/boilerplate-sample-matches/blob/main/Java/VitamioBundle-MDEwOlJlcG9zaXRvcnk2MjkyMDI5-flat-InitActivity.java-segmentfault-lessons-MDEwOlJlcG9zaXRvcnk5MzE1NzM4MQ==-flat-CommandLineDemo.java-170.html,17,VitamioBundle-MDEwOlJlcG9zaXRvcnk2MjkyMDI5-flat-InitActivity.java,segmentfault-lessons-MDEwOlJlcG9zaXRvcnk5MzE1NzM4MQ==-flat-CommandLineDemo.java,50,52,2,7,9,2
171,https://htmlpreview.github.io/?https://github.com/Christina96/boilerplate-sample-matches/blob/main/Java/motan-MDEwOlJlcG9zaXRvcnk1NjY3OTUyMQ==-flat-AbstractInterfaceConfig.java-motan-MDEwOlJlcG9zaXRvcnk1NjY3OTUyMQ==-flat-ServiceConfig.java-171.html,24,motan-MDEwOlJlcG9zaXRvcnk1NjY3OTUyMQ==-flat-AbstractInterfaceConfig.java,motan-MDEwOlJlcG9zaXRvcnk1NjY3OTUyMQ==-flat-ServiceConfig.java,275,277,2,100,102,2
172,https://htmlpreview.github.io/?https://github.com/Christina96/boilerplate-sample-matches/blob/main/Java/jedis-MDEwOlJlcG9zaXRvcnk3MTU2MDU=-flat-SearchWithParamsTest.java-jedis-MDEwOlJlcG9zaXRvcnk3MTU2MDU=-flat-SearchWithParamsTest.java-172.html,17,jedis-MDEwOlJlcG9zaXRvcnk3MTU2MDU=-flat-SearchWithParamsTest.java,jedis-MDEwOlJlcG9zaXRvcnk3MTU2MDU=-flat-SearchWithParamsTest.java,850,851,1,386,387,1
173,https://htmlpreview.github.io/?https://github.com/Christina96/boilerplate-sample-matches/blob/main/Java/jedis-MDEwOlJlcG9zaXRvcnk3MTU2MDU=-flat-Jedis.java-jedis-MDEwOlJlcG9zaXRvcnk3MTU2MDU=-flat-Jedis.java-173.html,26,jedis-MDEwOlJlcG9zaXRvcnk3MTU2MDU=-flat-Jedis.java,jedis-MDEwOlJlcG9zaXRvcnk3MTU2MDU=-flat-Jedis.java,4602,4606,4,2947,2951,4
174,https://htmlpreview.github.io/?https://github.com/Christina96/boilerplate-sample-matches/blob/main/Java/Essentials-MDEwOlJlcG9zaXRvcnkxNzczNzU0-flat-WorldDataHolder.java-Essentials-MDEwOlJlcG9zaXRvcnkxNzczNzU0-flat-WorldDataHolder.java-174.html,22,Essentials-MDEwOlJlcG9zaXRvcnkxNzczNzU0-flat-WorldDataHolder.java,Essentials-MDEwOlJlcG9zaXRvcnkxNzczNzU0-flat-WorldDataHolder.java,209,212,3,228,231,3
175,https://htmlpreview.github.io/?https://github.com/Christina96/boilerplate-sample-matches/blob/main/Java/jedis-MDEwOlJlcG9zaXRvcnk3MTU2MDU=-flat-SortedSetCommandsTest.java-jedis-MDEwOlJlcG9zaXRvcnk3MTU2MDU=-flat-SortedSetCommandsTestBase.java-175.html,1765,jedis-MDEwOlJlcG9zaXRvcnk3MTU2MDU=-flat-SortedSetCommandsTest.java,jedis-MDEwOlJlcG9zaXRvcnk3MTU2MDU=-flat-SortedSetCommandsTestBase.java,51,201,150,51,201,150
176,https://htmlpreview.github.io/?https://github.com/Christina96/boilerplate-sample-matches/blob/main/Java/Essentials-MDEwOlJlcG9zaXRvcnkxNzczNzU0-flat-EssentialsUpgrade.java-Essentials-MDEwOlJlcG9zaXRvcnkxNzczNzU0-flat-EssentialsUpgrade.java-176.html,22,Essentials-MDEwOlJlcG9zaXRvcnkxNzczNzU0-flat-EssentialsUpgrade.java,Essentials-MDEwOlJlcG9zaXRvcnkxNzczNzU0-flat-EssentialsUpgrade.java,488,492,4,540,544,4
177,https://htmlpreview.github.io/?https://github.com/Christina96/boilerplate-sample-matches/blob/main/Java/jedis-MDEwOlJlcG9zaXRvcnk3MTU2MDU=-flat-HostAndPorts.java-jedis-MDEwOlJlcG9zaXRvcnk3MTU2MDU=-flat-HostAndPorts.java-177.html,18,jedis-MDEwOlJlcG9zaXRvcnk3MTU2MDU=-flat-HostAndPorts.java,jedis-MDEwOlJlcG9zaXRvcnk3MTU2MDU=-flat-HostAndPorts.java,44,49,5,47,52,5
178,https://htmlpreview.github.io/?https://github.com/Christina96/boilerplate-sample-matches/blob/main/Java/jedis-MDEwOlJlcG9zaXRvcnk3MTU2MDU=-flat-Slowlog.java-segmentfault-lessons-MDEwOlJlcG9zaXRvcnk5MzE1NzM4MQ==-flat-DeepCloneDemo.java-178.html,16,jedis-MDEwOlJlcG9zaXRvcnk3MTU2MDU=-flat-Slowlog.java,segmentfault-lessons-MDEwOlJlcG9zaXRvcnk5MzE1NzM4MQ==-flat-DeepCloneDemo.java,30,34,4,31,35,4
179,https://htmlpreview.github.io/?https://github.com/Christina96/boilerplate-sample-matches/blob/main/Java/jedis-MDEwOlJlcG9zaXRvcnk3MTU2MDU=-flat-SetBinaryCommands.java-jedis-MDEwOlJlcG9zaXRvcnk3MTU2MDU=-flat-StringBinaryCommands.java-179.html,15,jedis-MDEwOlJlcG9zaXRvcnk3MTU2MDU=-flat-SetBinaryCommands.java,jedis-MDEwOlJlcG9zaXRvcnk3MTU2MDU=-flat-StringBinaryCommands.java,21,22,1,21,22,1
180,https://htmlpreview.github.io/?https://github.com/Christina96/boilerplate-sample-matches/blob/main/Java/BungeeCord-MDEwOlJlcG9zaXRvcnk2MDg0MjEw-flat-TextComponent.java-Essentials-MDEwOlJlcG9zaXRvcnkxNzczNzU0-flat-GroupManagerEventHandler.java-180.html,15,BungeeCord-MDEwOlJlcG9zaXRvcnk2MDg0MjEw-flat-TextComponent.java,Essentials-MDEwOlJlcG9zaXRvcnkxNzczNzU0-flat-GroupManagerEventHandler.java,158,161,3,19,21,2
181,https://htmlpreview.github.io/?https://github.com/Christina96/boilerplate-sample-matches/blob/main/Java/Essentials-MDEwOlJlcG9zaXRvcnkxNzczNzU0-flat-AnjoPermissionsHandler.java-Essentials-MDEwOlJlcG9zaXRvcnkxNzczNzU0-flat-AnjoPermissionsHandler.java-181.html,32,Essentials-MDEwOlJlcG9zaXRvcnkxNzczNzU0-flat-AnjoPermissionsHandler.java,Essentials-MDEwOlJlcG9zaXRvcnkxNzczNzU0-flat-AnjoPermissionsHandler.java,699,703,4,683,687,4
182,https://htmlpreview.github.io/?https://github.com/Christina96/boilerplate-sample-matches/blob/main/Java/Essentials-MDEwOlJlcG9zaXRvcnkxNzczNzU0-flat-Commandtree.java-Essentials-MDEwOlJlcG9zaXRvcnkxNzczNzU0-flat-Commandtree.java-182.html,28,Essentials-MDEwOlJlcG9zaXRvcnkxNzczNzU0-flat-Commandtree.java,Essentials-MDEwOlJlcG9zaXRvcnkxNzczNzU0-flat-Commandtree.java,55,61,6,51,57,6
183,https://htmlpreview.github.io/?https://github.com/Christina96/boilerplate-sample-matches/blob/main/Java/jedis-MDEwOlJlcG9zaXRvcnk3MTU2MDU=-flat-SearchTest.java-jedis-MDEwOlJlcG9zaXRvcnk3MTU2MDU=-flat-AggregationTest.java-183.html,23,jedis-MDEwOlJlcG9zaXRvcnk3MTU2MDU=-flat-SearchTest.java,jedis-MDEwOlJlcG9zaXRvcnk3MTU2MDU=-flat-AggregationTest.java,280,282,2,103,106,3
184,https://htmlpreview.github.io/?https://github.com/Christina96/boilerplate-sample-matches/blob/main/Java/jedis-MDEwOlJlcG9zaXRvcnk3MTU2MDU=-flat-AbortedTransactionException.java-jedis-MDEwOlJlcG9zaXRvcnk3MTU2MDU=-flat-JedisNoScriptException.java-184.html,14,jedis-MDEwOlJlcG9zaXRvcnk3MTU2MDU=-flat-AbortedTransactionException.java,jedis-MDEwOlJlcG9zaXRvcnk3MTU2MDU=-flat-JedisNoScriptException.java,4,7,3,5,8,3
185,https://htmlpreview.github.io/?https://github.com/Christina96/boilerplate-sample-matches/blob/main/Java/motan-MDEwOlJlcG9zaXRvcnk1NjY3OTUyMQ==-flat-MockDefaultRpcCodec.java-motan-MDEwOlJlcG9zaXRvcnk1NjY3OTUyMQ==-flat-DefaultRpcCodec.java-185.html,25,motan-MDEwOlJlcG9zaXRvcnk1NjY3OTUyMQ==-flat-MockDefaultRpcCodec.java,motan-MDEwOlJlcG9zaXRvcnk1NjY3OTUyMQ==-flat-DefaultRpcCodec.java,15,18,3,24,27,3
186,https://htmlpreview.github.io/?https://github.com/Christina96/boilerplate-sample-matches/blob/main/Java/jedis-MDEwOlJlcG9zaXRvcnk3MTU2MDU=-flat-CommandObjects.java-jedis-MDEwOlJlcG9zaXRvcnk3MTU2MDU=-flat-CommandObjects.java-186.html,17,jedis-MDEwOlJlcG9zaXRvcnk3MTU2MDU=-flat-CommandObjects.java,jedis-MDEwOlJlcG9zaXRvcnk3MTU2MDU=-flat-CommandObjects.java,1024,1026,2,1384,1386,2
187,https://htmlpreview.github.io/?https://github.com/Christina96/boilerplate-sample-matches/blob/main/Java/google-api-java-client-samples-MDEwOlJlcG9zaXRvcnkyOTc0OTA1Mg==-flat-PlusSampleServlet_2.java-google-api-java-client-samples-MDEwOlJlcG9zaXRvcnkyOTc0OTA1Mg==-flat-PlusSampleServlet.java-187.html,50,google-api-java-client-samples-MDEwOlJlcG9zaXRvcnkyOTc0OTA1Mg==-flat-PlusSampleServlet_2.java,google-api-java-client-samples-MDEwOlJlcG9zaXRvcnkyOTc0OTA1Mg==-flat-PlusSampleServlet.java,29,33,4,24,28,4
188,https://htmlpreview.github.io/?https://github.com/Christina96/boilerplate-sample-matches/blob/main/Java/ribbon-MDEwOlJlcG9zaXRvcnk3NjE2MTU4-flat-ListenerTest.java-ribbon-MDEwOlJlcG9zaXRvcnk3NjE2MTU4-flat-ListenerTest.java-188.html,51,ribbon-MDEwOlJlcG9zaXRvcnk3NjE2MTU4-flat-ListenerTest.java,ribbon-MDEwOlJlcG9zaXRvcnk3NjE2MTU4-flat-ListenerTest.java,211,222,11,253,264,11
189,https://htmlpreview.github.io/?https://github.com/Christina96/boilerplate-sample-matches/blob/main/Java/jedis-MDEwOlJlcG9zaXRvcnk3MTU2MDU=-flat-SearchTest.java-jedis-MDEwOlJlcG9zaXRvcnk3MTU2MDU=-flat-SearchTest.java-189.html,22,jedis-MDEwOlJlcG9zaXRvcnk3MTU2MDU=-flat-SearchTest.java,jedis-MDEwOlJlcG9zaXRvcnk3MTU2MDU=-flat-SearchTest.java,657,658,1,760,761,1
190,https://htmlpreview.github.io/?https://github.com/Christina96/boilerplate-sample-matches/blob/main/Java/jedis-MDEwOlJlcG9zaXRvcnk3MTU2MDU=-flat-FTProfileParams.java-jedis-MDEwOlJlcG9zaXRvcnk3MTU2MDU=-flat-GetExParams.java-190.html,24,jedis-MDEwOlJlcG9zaXRvcnk3MTU2MDU=-flat-FTProfileParams.java,jedis-MDEwOlJlcG9zaXRvcnk3MTU2MDU=-flat-GetExParams.java,6,12,6,7,13,6
191,https://htmlpreview.github.io/?https://github.com/Christina96/boilerplate-sample-matches/blob/main/Java/jedis-MDEwOlJlcG9zaXRvcnk3MTU2MDU=-flat-SearchQuickstartExample.java-jedis-MDEwOlJlcG9zaXRvcnk3MTU2MDU=-flat-SearchQuickstartExample.java-191.html,18,jedis-MDEwOlJlcG9zaXRvcnk3MTU2MDU=-flat-SearchQuickstartExample.java,jedis-MDEwOlJlcG9zaXRvcnk3MTU2MDU=-flat-SearchQuickstartExample.java,112,119,7,94,101,7
192,https://htmlpreview.github.io/?https://github.com/Christina96/boilerplate-sample-matches/blob/main/Java/ribbon-MDEwOlJlcG9zaXRvcnk3NjE2MTU4-flat-AvailabilityPredicate.java-ribbon-MDEwOlJlcG9zaXRvcnk3NjE2MTU4-flat-ZoneAvoidancePredicate.java-192.html,27,ribbon-MDEwOlJlcG9zaXRvcnk3NjE2MTU4-flat-AvailabilityPredicate.java,ribbon-MDEwOlJlcG9zaXRvcnk3NjE2MTU4-flat-ZoneAvoidancePredicate.java,26,31,5,30,35,5
193,https://htmlpreview.github.io/?https://github.com/Christina96/boilerplate-sample-matches/blob/main/Java/motan-MDEwOlJlcG9zaXRvcnk1NjY3OTUyMQ==-flat-NettyDecoder.java-motan-MDEwOlJlcG9zaXRvcnk1NjY3OTUyMQ==-flat-NettyDecoder_12.java-193.html,22,motan-MDEwOlJlcG9zaXRvcnk1NjY3OTUyMQ==-flat-NettyDecoder.java,motan-MDEwOlJlcG9zaXRvcnk1NjY3OTUyMQ==-flat-NettyDecoder_12.java,35,37,2,39,41,2
194,https://htmlpreview.github.io/?https://github.com/Christina96/boilerplate-sample-matches/blob/main/Java/motan-MDEwOlJlcG9zaXRvcnk1NjY3OTUyMQ==-flat-StandardThreadExecutorTest.java-motan-MDEwOlJlcG9zaXRvcnk1NjY3OTUyMQ==-flat-StandardThreadExecutorTest.java-194.html,17,motan-MDEwOlJlcG9zaXRvcnk1NjY3OTUyMQ==-flat-StandardThreadExecutorTest.java,motan-MDEwOlJlcG9zaXRvcnk1NjY3OTUyMQ==-flat-StandardThreadExecutorTest.java,44,48,4,51,55,4
195,https://htmlpreview.github.io/?https://github.com/Christina96/boilerplate-sample-matches/blob/main/Java/Mybatis-PageHelper-MDEwOlJlcG9zaXRvcnkyMDY1MTY3Mg==-flat-FunctionCountTest.java-Mybatis-PageHelper-MDEwOlJlcG9zaXRvcnkyMDY1MTY3Mg==-flat-FunctionCountTest.java-195.html,36,Mybatis-PageHelper-MDEwOlJlcG9zaXRvcnkyMDY1MTY3Mg==-flat-FunctionCountTest.java,Mybatis-PageHelper-MDEwOlJlcG9zaXRvcnkyMDY1MTY3Mg==-flat-FunctionCountTest.java,29,32,3,46,49,3
196,https://htmlpreview.github.io/?https://github.com/Christina96/boilerplate-sample-matches/blob/main/Java/jedis-MDEwOlJlcG9zaXRvcnk3MTU2MDU=-flat-StreamsCommandsTest.java-jedis-MDEwOlJlcG9zaXRvcnk3MTU2MDU=-flat-StreamsCommandsTest.java-196.html,18,jedis-MDEwOlJlcG9zaXRvcnk3MTU2MDU=-flat-StreamsCommandsTest.java,jedis-MDEwOlJlcG9zaXRvcnk3MTU2MDU=-flat-StreamsCommandsTest.java,599,602,3,602,605,3
197,https://htmlpreview.github.io/?https://github.com/Christina96/boilerplate-sample-matches/blob/main/Java/jedis-MDEwOlJlcG9zaXRvcnk3MTU2MDU=-flat-TimeSeriesTest.java-jedis-MDEwOlJlcG9zaXRvcnk3MTU2MDU=-flat-TimeSeriesTest.java-197.html,16,jedis-MDEwOlJlcG9zaXRvcnk3MTU2MDU=-flat-TimeSeriesTest.java,jedis-MDEwOlJlcG9zaXRvcnk3MTU2MDU=-flat-TimeSeriesTest.java,592,594,2,349,351,2
198,https://htmlpreview.github.io/?https://github.com/Christina96/boilerplate-sample-matches/blob/main/Java/google-api-java-client-samples-MDEwOlJlcG9zaXRvcnkyOTc0OTA1Mg==-flat-GetAllAdClients.java-google-api-java-client-samples-MDEwOlJlcG9zaXRvcnkyOTc0OTA1Mg==-flat-GetAllAdClientsForHost.java-198.html,23,google-api-java-client-samples-MDEwOlJlcG9zaXRvcnkyOTc0OTA1Mg==-flat-GetAllAdClients.java,google-api-java-client-samples-MDEwOlJlcG9zaXRvcnkyOTc0OTA1Mg==-flat-GetAllAdClientsForHost.java,12,16,4,12,16,4
199,https://htmlpreview.github.io/?https://github.com/Christina96/boilerplate-sample-matches/blob/main/Java/jedis-MDEwOlJlcG9zaXRvcnk3MTU2MDU=-flat-TDigestSketchPipelineCommands.java-jedis-MDEwOlJlcG9zaXRvcnk3MTU2MDU=-flat-TDigestSketchPipelineCommands.java-199.html,16,jedis-MDEwOlJlcG9zaXRvcnk3MTU2MDU=-flat-TDigestSketchPipelineCommands.java,jedis-MDEwOlJlcG9zaXRvcnk3MTU2MDU=-flat-TDigestSketchPipelineCommands.java,20,21,1,15,16,1
200,https://htmlpreview.github.io/?https://github.com/Christina96/boilerplate-sample-matches/blob/main/Java/motan-MDEwOlJlcG9zaXRvcnk1NjY3OTUyMQ==-flat-Feature.java-motan-MDEwOlJlcG9zaXRvcnk1NjY3OTUyMQ==-flat-RouteNote.java-200.html,139,motan-MDEwOlJlcG9zaXRvcnk1NjY3OTUyMQ==-flat-Feature.java,motan-MDEwOlJlcG9zaXRvcnk1NjY3OTUyMQ==-flat-RouteNote.java,9,37,28,9,37,28
201,https://htmlpreview.github.io/?https://github.com/Christina96/boilerplate-sample-matches/blob/main/Java/ribbon-MDEwOlJlcG9zaXRvcnk3NjE2MTU4-flat-GetPostTest.java-ribbon-MDEwOlJlcG9zaXRvcnk3NjE2MTU4-flat-ClientFactoryTest.java-201.html,15,ribbon-MDEwOlJlcG9zaXRvcnk3NjE2MTU4-flat-GetPostTest.java,ribbon-MDEwOlJlcG9zaXRvcnk3NjE2MTU4-flat-ClientFactoryTest.java,36,39,3,19,22,3
202,https://htmlpreview.github.io/?https://github.com/Christina96/boilerplate-sample-matches/blob/main/Java/jedis-MDEwOlJlcG9zaXRvcnk3MTU2MDU=-flat-PipeliningTest.java-jedis-MDEwOlJlcG9zaXRvcnk3MTU2MDU=-flat-ClusterScriptingCommandsTest.java-202.html,15,jedis-MDEwOlJlcG9zaXRvcnk3MTU2MDU=-flat-PipeliningTest.java,jedis-MDEwOlJlcG9zaXRvcnk3MTU2MDU=-flat-ClusterScriptingCommandsTest.java,373,375,2,86,88,2
203,https://htmlpreview.github.io/?https://github.com/Christina96/boilerplate-sample-matches/blob/main/Java/jedis-MDEwOlJlcG9zaXRvcnk3MTU2MDU=-flat-JedisSentinelPool.java-jedis-MDEwOlJlcG9zaXRvcnk3MTU2MDU=-flat-JedisSentinelPool.java-203.html,21,jedis-MDEwOlJlcG9zaXRvcnk3MTU2MDU=-flat-JedisSentinelPool.java,jedis-MDEwOlJlcG9zaXRvcnk3MTU2MDU=-flat-JedisSentinelPool.java,22,24,2,142,144,2
204,https://htmlpreview.github.io/?https://github.com/Christina96/boilerplate-sample-matches/blob/main/Java/jedis-MDEwOlJlcG9zaXRvcnk3MTU2MDU=-flat-TSInfo.java-jedis-MDEwOlJlcG9zaXRvcnk3MTU2MDU=-flat-TSInfo.java-204.html,54,jedis-MDEwOlJlcG9zaXRvcnk3MTU2MDU=-flat-TSInfo.java,jedis-MDEwOlJlcG9zaXRvcnk3MTU2MDU=-flat-TSInfo.java,104,113,9,163,172,9
205,https://htmlpreview.github.io/?https://github.com/Christina96/boilerplate-sample-matches/blob/main/Java/ribbon-MDEwOlJlcG9zaXRvcnk3NjE2MTU4-flat-DefaultClientConfigImplTest.java-ribbon-MDEwOlJlcG9zaXRvcnk3NjE2MTU4-flat-DefaultClientConfigImplTest.java-205.html,31,ribbon-MDEwOlJlcG9zaXRvcnk3NjE2MTU4-flat-DefaultClientConfigImplTest.java,ribbon-MDEwOlJlcG9zaXRvcnk3NjE2MTU4-flat-DefaultClientConfigImplTest.java,31,34,3,36,39,3
206,https://htmlpreview.github.io/?https://github.com/Christina96/boilerplate-sample-matches/blob/main/Java/Essentials-MDEwOlJlcG9zaXRvcnkxNzczNzU0-flat-WorldsHolder.java-Essentials-MDEwOlJlcG9zaXRvcnkxNzczNzU0-flat-WorldsHolder.java-206.html,17,Essentials-MDEwOlJlcG9zaXRvcnkxNzczNzU0-flat-WorldsHolder.java,Essentials-MDEwOlJlcG9zaXRvcnkxNzczNzU0-flat-WorldsHolder.java,241,244,3,335,338,3
207,https://htmlpreview.github.io/?https://github.com/Christina96/boilerplate-sample-matches/blob/main/Java/motan-MDEwOlJlcG9zaXRvcnk1NjY3OTUyMQ==-flat-DefaultRpcCodec.java-motan-MDEwOlJlcG9zaXRvcnk1NjY3OTUyMQ==-flat-ProtobufCodec.java-207.html,42,motan-MDEwOlJlcG9zaXRvcnk1NjY3OTUyMQ==-flat-DefaultRpcCodec.java,motan-MDEwOlJlcG9zaXRvcnk1NjY3OTUyMQ==-flat-ProtobufCodec.java,199,205,6,185,191,6
208,https://htmlpreview.github.io/?https://github.com/Christina96/boilerplate-sample-matches/blob/main/Java/jedis-MDEwOlJlcG9zaXRvcnk3MTU2MDU=-flat-FailoverParams.java-jedis-MDEwOlJlcG9zaXRvcnk3MTU2MDU=-flat-GeoSearchParam.java-208.html,28,jedis-MDEwOlJlcG9zaXRvcnk3MTU2MDU=-flat-FailoverParams.java,jedis-MDEwOlJlcG9zaXRvcnk3MTU2MDU=-flat-GeoSearchParam.java,30,32,2,97,99,2
209,https://htmlpreview.github.io/?https://github.com/Christina96/boilerplate-sample-matches/blob/main/Java/jedis-MDEwOlJlcG9zaXRvcnk3MTU2MDU=-flat-BitCommandsTestBase.java-jedis-MDEwOlJlcG9zaXRvcnk3MTU2MDU=-flat-BitCommandsTest.java-209.html,2022,jedis-MDEwOlJlcG9zaXRvcnk3MTU2MDU=-flat-BitCommandsTestBase.java,jedis-MDEwOlJlcG9zaXRvcnk3MTU2MDU=-flat-BitCommandsTest.java,21,205,184,21,205,184
210,https://htmlpreview.github.io/?https://github.com/Christina96/boilerplate-sample-matches/blob/main/Java/motan-MDEwOlJlcG9zaXRvcnk1NjY3OTUyMQ==-flat-DefaultResponseFuture.java-VitamioBundle-MDEwOlJlcG9zaXRvcnk2MjkyMDI5-flat-MediaPlayerSubtitle.java-210.html,14,motan-MDEwOlJlcG9zaXRvcnk1NjY3OTUyMQ==-flat-DefaultResponseFuture.java,VitamioBundle-MDEwOlJlcG9zaXRvcnk2MjkyMDI5-flat-MediaPlayerSubtitle.java,180,182,2,45,47,2
211,https://htmlpreview.github.io/?https://github.com/Christina96/boilerplate-sample-matches/blob/main/Java/BungeeCord-MDEwOlJlcG9zaXRvcnk2MDg0MjEw-flat-ChatColor.java-BungeeCord-MDEwOlJlcG9zaXRvcnk2MDg0MjEw-flat-YamlConfig.java-211.html,17,BungeeCord-MDEwOlJlcG9zaXRvcnk2MDg0MjEw-flat-ChatColor.java,BungeeCord-MDEwOlJlcG9zaXRvcnk2MDg0MjEw-flat-YamlConfig.java,144,145,1,227,228,1
212,https://htmlpreview.github.io/?https://github.com/Christina96/boilerplate-sample-matches/blob/main/Java/jedis-MDEwOlJlcG9zaXRvcnk3MTU2MDU=-flat-SortedSetCommandsTest.java-jedis-MDEwOlJlcG9zaXRvcnk3MTU2MDU=-flat-BinaryValuesCommandsTest.java-212.html,15,jedis-MDEwOlJlcG9zaXRvcnk3MTU2MDU=-flat-SortedSetCommandsTest.java,jedis-MDEwOlJlcG9zaXRvcnk3MTU2MDU=-flat-BinaryValuesCommandsTest.java,706,707,1,139,140,1
213,https://htmlpreview.github.io/?https://github.com/Christina96/boilerplate-sample-matches/blob/main/Java/jedis-MDEwOlJlcG9zaXRvcnk3MTU2MDU=-flat-SentineledConnectionProvider.java-jedis-MDEwOlJlcG9zaXRvcnk3MTU2MDU=-flat-JedisSentinelPool.java-213.html,34,jedis-MDEwOlJlcG9zaXRvcnk3MTU2MDU=-flat-SentineledConnectionProvider.java,jedis-MDEwOlJlcG9zaXRvcnk3MTU2MDU=-flat-JedisSentinelPool.java,175,182,7,311,318,7
214,https://htmlpreview.github.io/?https://github.com/Christina96/boilerplate-sample-matches/blob/main/Java/BungeeCord-MDEwOlJlcG9zaXRvcnk2MDg0MjEw-flat-ServerConnector.java-Essentials-MDEwOlJlcG9zaXRvcnkxNzczNzU0-flat-Commandremove.java-214.html,15,BungeeCord-MDEwOlJlcG9zaXRvcnk2MDg0MjEw-flat-ServerConnector.java,Essentials-MDEwOlJlcG9zaXRvcnkxNzczNzU0-flat-Commandremove.java,236,238,2,265,267,2
215,https://htmlpreview.github.io/?https://github.com/Christina96/boilerplate-sample-matches/blob/main/Java/jedis-MDEwOlJlcG9zaXRvcnk3MTU2MDU=-flat-CommandObjects.java-jedis-MDEwOlJlcG9zaXRvcnk3MTU2MDU=-flat-CommandObjects.java-215.html,20,jedis-MDEwOlJlcG9zaXRvcnk3MTU2MDU=-flat-CommandObjects.java,jedis-MDEwOlJlcG9zaXRvcnk3MTU2MDU=-flat-CommandObjects.java,264,265,1,2772,2773,1
216,https://htmlpreview.github.io/?https://github.com/Christina96/boilerplate-sample-matches/blob/main/Java/BungeeCord-MDEwOlJlcG9zaXRvcnk2MDg0MjEw-flat-UserConnection.java-BungeeCord-MDEwOlJlcG9zaXRvcnk2MDg0MjEw-flat-UserConnection.java-216.html,17,BungeeCord-MDEwOlJlcG9zaXRvcnk2MDg0MjEw-flat-UserConnection.java,BungeeCord-MDEwOlJlcG9zaXRvcnk2MDg0MjEw-flat-UserConnection.java,468,472,4,376,380,4
217,https://htmlpreview.github.io/?https://github.com/Christina96/boilerplate-sample-matches/blob/main/Java/jedis-MDEwOlJlcG9zaXRvcnk3MTU2MDU=-flat-MigrateTest.java-jedis-MDEwOlJlcG9zaXRvcnk3MTU2MDU=-flat-BinaryValuesCommandsTestBase.java-217.html,31,jedis-MDEwOlJlcG9zaXRvcnk3MTU2MDU=-flat-MigrateTest.java,jedis-MDEwOlJlcG9zaXRvcnk3MTU2MDU=-flat-BinaryValuesCommandsTestBase.java,102,107,5,48,53,5
218,https://htmlpreview.github.io/?https://github.com/Christina96/boilerplate-sample-matches/blob/main/Java/Essentials-MDEwOlJlcG9zaXRvcnkxNzczNzU0-flat-TNTExplodeListener.java-Essentials-MDEwOlJlcG9zaXRvcnkxNzczNzU0-flat-UserMap.java-218.html,18,Essentials-MDEwOlJlcG9zaXRvcnkxNzczNzU0-flat-TNTExplodeListener.java,Essentials-MDEwOlJlcG9zaXRvcnkxNzczNzU0-flat-UserMap.java,13,17,4,29,33,4
219,https://htmlpreview.github.io/?https://github.com/Christina96/boilerplate-sample-matches/blob/main/Java/VitamioBundle-MDEwOlJlcG9zaXRvcnk2MjkyMDI5-flat-MediaScanner.java-motan-MDEwOlJlcG9zaXRvcnk1NjY3OTUyMQ==-flat-Hessian2Serialization.java-219.html,15,VitamioBundle-MDEwOlJlcG9zaXRvcnk2MjkyMDI5-flat-MediaScanner.java,motan-MDEwOlJlcG9zaXRvcnk1NjY3OTUyMQ==-flat-Hessian2Serialization.java,112,113,1,40,41,1
220,https://htmlpreview.github.io/?https://github.com/Christina96/boilerplate-sample-matches/blob/main/Java/google-api-java-client-samples-MDEwOlJlcG9zaXRvcnkyOTc0OTA1Mg==-flat-Utils_7.java-google-api-java-client-samples-MDEwOlJlcG9zaXRvcnkyOTc0OTA1Mg==-flat-Utils_6.java-220.html,48,google-api-java-client-samples-MDEwOlJlcG9zaXRvcnkyOTc0OTA1Mg==-flat-Utils_7.java,google-api-java-client-samples-MDEwOlJlcG9zaXRvcnkyOTc0OTA1Mg==-flat-Utils_6.java,16,23,7,16,23,7
221,https://htmlpreview.github.io/?https://github.com/Christina96/boilerplate-sample-matches/blob/main/Java/ribbon-MDEwOlJlcG9zaXRvcnk3NjE2MTU4-flat-BaseLoadBalancer.java-jedis-MDEwOlJlcG9zaXRvcnk3MTU2MDU=-flat-JedisClusterInfoCache.java-221.html,16,ribbon-MDEwOlJlcG9zaXRvcnk3NjE2MTU4-flat-BaseLoadBalancer.java,jedis-MDEwOlJlcG9zaXRvcnk3MTU2MDU=-flat-JedisClusterInfoCache.java,260,264,4,68,72,4
222,https://htmlpreview.github.io/?https://github.com/Christina96/boilerplate-sample-matches/blob/main/Java/Essentials-MDEwOlJlcG9zaXRvcnkxNzczNzU0-flat-Commandremove.java-Essentials-MDEwOlJlcG9zaXRvcnkxNzczNzU0-flat-Commandremove.java-222.html,15,Essentials-MDEwOlJlcG9zaXRvcnkxNzczNzU0-flat-Commandremove.java,Essentials-MDEwOlJlcG9zaXRvcnkxNzczNzU0-flat-Commandremove.java,205,210,5,191,196,5
223,https://htmlpreview.github.io/?https://github.com/Christina96/boilerplate-sample-matches/blob/main/Java/jedis-MDEwOlJlcG9zaXRvcnk3MTU2MDU=-flat-AllKindOfValuesCommandsTestBase.java-jedis-MDEwOlJlcG9zaXRvcnk3MTU2MDU=-flat-AllKindOfValuesCommandsTest.java-223.html,429,jedis-MDEwOlJlcG9zaXRvcnk3MTU2MDU=-flat-AllKindOfValuesCommandsTestBase.java,jedis-MDEwOlJlcG9zaXRvcnk3MTU2MDU=-flat-AllKindOfValuesCommandsTest.java,500,538,38,642,680,38
224,https://htmlpreview.github.io/?https://github.com/Christina96/boilerplate-sample-matches/blob/main/Java/Essentials-MDEwOlJlcG9zaXRvcnkxNzczNzU0-flat-BookInput.java-Essentials-MDEwOlJlcG9zaXRvcnkxNzczNzU0-flat-TextInput.java-224.html,93,Essentials-MDEwOlJlcG9zaXRvcnkxNzczNzU0-flat-BookInput.java,Essentials-MDEwOlJlcG9zaXRvcnkxNzczNzU0-flat-TextInput.java,73,92,19,54,73,19
225,https://htmlpreview.github.io/?https://github.com/Christina96/boilerplate-sample-matches/blob/main/Java/Essentials-MDEwOlJlcG9zaXRvcnkxNzczNzU0-flat-SignTrade.java-Essentials-MDEwOlJlcG9zaXRvcnkxNzczNzU0-flat-SignTrade.java-225.html,21,Essentials-MDEwOlJlcG9zaXRvcnkxNzczNzU0-flat-SignTrade.java,Essentials-MDEwOlJlcG9zaXRvcnkxNzczNzU0-flat-SignTrade.java,352,355,3,160,163,3
226,https://htmlpreview.github.io/?https://github.com/Christina96/boilerplate-sample-matches/blob/main/Java/motan-MDEwOlJlcG9zaXRvcnk1NjY3OTUyMQ==-flat-Point.java-motan-MDEwOlJlcG9zaXRvcnk1NjY3OTUyMQ==-flat-Feature.java-226.html,772,motan-MDEwOlJlcG9zaXRvcnk1NjY3OTUyMQ==-flat-Point.java,motan-MDEwOlJlcG9zaXRvcnk1NjY3OTUyMQ==-flat-Feature.java,137,239,102,177,279,102
227,https://htmlpreview.github.io/?https://github.com/Christina96/boilerplate-sample-matches/blob/main/Java/motan-MDEwOlJlcG9zaXRvcnk1NjY3OTUyMQ==-flat-DemoRpcClient.java-motan-MDEwOlJlcG9zaXRvcnk1NjY3OTUyMQ==-flat-DemoRpcAsyncClient.java-227.html,46,motan-MDEwOlJlcG9zaXRvcnk1NjY3OTUyMQ==-flat-DemoRpcClient.java,motan-MDEwOlJlcG9zaXRvcnk1NjY3OTUyMQ==-flat-DemoRpcAsyncClient.java,8,11,3,11,14,3
228,https://htmlpreview.github.io/?https://github.com/Christina96/boilerplate-sample-matches/blob/main/Java/segmentfault-lessons-MDEwOlJlcG9zaXRvcnk5MzE1NzM4MQ==-flat-UserServiceClientBusConfiguration.java-segmentfault-lessons-MDEwOlJlcG9zaXRvcnk5MzE1NzM4MQ==-flat-BusConfiguration.java-228.html,53,segmentfault-lessons-MDEwOlJlcG9zaXRvcnk5MzE1NzM4MQ==-flat-UserServiceClientBusConfiguration.java,segmentfault-lessons-MDEwOlJlcG9zaXRvcnk5MzE1NzM4MQ==-flat-BusConfiguration.java,36,46,10,35,45,10
229,https://htmlpreview.github.io/?https://github.com/Christina96/boilerplate-sample-matches/blob/main/Java/google-api-java-client-samples-MDEwOlJlcG9zaXRvcnkyOTc0OTA1Mg==-flat-DeleteDialogContent.java-google-api-java-client-samples-MDEwOlJlcG9zaXRvcnkyOTc0OTA1Mg==-flat-UpdateDialogContent.java-229.html,75,google-api-java-client-samples-MDEwOlJlcG9zaXRvcnkyOTc0OTA1Mg==-flat-DeleteDialogContent.java,google-api-java-client-samples-MDEwOlJlcG9zaXRvcnkyOTc0OTA1Mg==-flat-UpdateDialogContent.java,18,32,14,21,35,14
230,https://htmlpreview.github.io/?https://github.com/Christina96/boilerplate-sample-matches/blob/main/Java/ribbon-MDEwOlJlcG9zaXRvcnk3NjE2MTU4-flat-LoadBalancingRxClientWithPoolOptions.java-ribbon-MDEwOlJlcG9zaXRvcnk3NjE2MTU4-flat-LoadBalancingRxClientWithPoolOptions.java-230.html,28,ribbon-MDEwOlJlcG9zaXRvcnk3NjE2MTU4-flat-LoadBalancingRxClientWithPoolOptions.java,ribbon-MDEwOlJlcG9zaXRvcnk3NjE2MTU4-flat-LoadBalancingRxClientWithPoolOptions.java,43,45,2,45,46,1
231,https://htmlpreview.github.io/?https://github.com/Christina96/boilerplate-sample-matches/blob/main/Java/jedis-MDEwOlJlcG9zaXRvcnk3MTU2MDU=-flat-PipelineBase.java-jedis-MDEwOlJlcG9zaXRvcnk3MTU2MDU=-flat-TransactionBase.java-231.html,34,jedis-MDEwOlJlcG9zaXRvcnk3MTU2MDU=-flat-PipelineBase.java,jedis-MDEwOlJlcG9zaXRvcnk3MTU2MDU=-flat-TransactionBase.java,438,442,4,567,571,4
232,https://htmlpreview.github.io/?https://github.com/Christina96/boilerplate-sample-matches/blob/main/Java/motan-MDEwOlJlcG9zaXRvcnk1NjY3OTUyMQ==-flat-NettyHttpRequestHandlerTest.java-motan-MDEwOlJlcG9zaXRvcnk1NjY3OTUyMQ==-flat-NettyHttpRequestHandlerTest.java-232.html,41,motan-MDEwOlJlcG9zaXRvcnk1NjY3OTUyMQ==-flat-NettyHttpRequestHandlerTest.java,motan-MDEwOlJlcG9zaXRvcnk1NjY3OTUyMQ==-flat-NettyHttpRequestHandlerTest.java,46,53,7,74,81,7
233,https://htmlpreview.github.io/?https://github.com/Christina96/boilerplate-sample-matches/blob/main/Java/google-api-java-client-samples-MDEwOlJlcG9zaXRvcnkyOTc0OTA1Mg==-flat-Noteendpoint.java-google-api-java-client-samples-MDEwOlJlcG9zaXRvcnkyOTc0OTA1Mg==-flat-Deviceinfoendpoint.java-233.html,107,google-api-java-client-samples-MDEwOlJlcG9zaXRvcnkyOTc0OTA1Mg==-flat-Noteendpoint.java,google-api-java-client-samples-MDEwOlJlcG9zaXRvcnkyOTc0OTA1Mg==-flat-Deviceinfoendpoint.java,41,72,31,41,72,31
234,https://htmlpreview.github.io/?https://github.com/Christina96/boilerplate-sample-matches/blob/main/Java/Essentials-MDEwOlJlcG9zaXRvcnkxNzczNzU0-flat-OfflinePlayer.java-Essentials-MDEwOlJlcG9zaXRvcnkxNzczNzU0-flat-OfflinePlayer.java-234.html,28,Essentials-MDEwOlJlcG9zaXRvcnkxNzczNzU0-flat-OfflinePlayer.java,Essentials-MDEwOlJlcG9zaXRvcnkxNzczNzU0-flat-OfflinePlayer.java,1008,1016,8,1148,1156,8
235,https://htmlpreview.github.io/?https://github.com/Christina96/boilerplate-sample-matches/blob/main/Java/ribbon-MDEwOlJlcG9zaXRvcnk3NjE2MTU4-flat-ListenerTest.java-ribbon-MDEwOlJlcG9zaXRvcnk3NjE2MTU4-flat-ListenerTest.java-235.html,115,ribbon-MDEwOlJlcG9zaXRvcnk3NjE2MTU4-flat-ListenerTest.java,ribbon-MDEwOlJlcG9zaXRvcnk3NjE2MTU4-flat-ListenerTest.java,203,222,19,245,264,19
236,https://htmlpreview.github.io/?https://github.com/Christina96/boilerplate-sample-matches/blob/main/Java/jedis-MDEwOlJlcG9zaXRvcnk3MTU2MDU=-flat-ScriptingKeyPipelineBinaryCommands.java-jedis-MDEwOlJlcG9zaXRvcnk3MTU2MDU=-flat-ScriptingKeyPipelineBinaryCommands.java-236.html,77,jedis-MDEwOlJlcG9zaXRvcnk3MTU2MDU=-flat-ScriptingKeyPipelineBinaryCommands.java,jedis-MDEwOlJlcG9zaXRvcnk3MTU2MDU=-flat-ScriptingKeyPipelineBinaryCommands.java,6,9,3,10,13,3
237,https://htmlpreview.github.io/?https://github.com/Christina96/boilerplate-sample-matches/blob/main/Java/google-api-java-client-samples-MDEwOlJlcG9zaXRvcnkyOTc0OTA1Mg==-flat-VerificationSample.java-google-api-java-client-samples-MDEwOlJlcG9zaXRvcnkyOTc0OTA1Mg==-flat-VerificationSample.java-237.html,47,google-api-java-client-samples-MDEwOlJlcG9zaXRvcnkyOTc0OTA1Mg==-flat-VerificationSample.java,google-api-java-client-samples-MDEwOlJlcG9zaXRvcnkyOTc0OTA1Mg==-flat-VerificationSample.java,160,167,7,168,175,7
238,https://htmlpreview.github.io/?https://github.com/Christina96/boilerplate-sample-matches/blob/main/Java/google-api-java-client-samples-MDEwOlJlcG9zaXRvcnkyOTc0OTA1Mg==-flat-Noteendpoint.java-google-api-java-client-samples-MDEwOlJlcG9zaXRvcnkyOTc0OTA1Mg==-flat-Noteendpoint.java-238.html,206,google-api-java-client-samples-MDEwOlJlcG9zaXRvcnkyOTc0OTA1Mg==-flat-Noteendpoint.java,google-api-java-client-samples-MDEwOlJlcG9zaXRvcnkyOTc0OTA1Mg==-flat-Noteendpoint.java,81,102,21,140,161,21
239,https://htmlpreview.github.io/?https://github.com/Christina96/boilerplate-sample-matches/blob/main/Java/Essentials-MDEwOlJlcG9zaXRvcnkxNzczNzU0-flat-BukkitPermissions.java-Essentials-MDEwOlJlcG9zaXRvcnkxNzczNzU0-flat-BukkitPermissions.java-239.html,21,Essentials-MDEwOlJlcG9zaXRvcnkxNzczNzU0-flat-BukkitPermissions.java,Essentials-MDEwOlJlcG9zaXRvcnkxNzczNzU0-flat-BukkitPermissions.java,127,128,1,133,134,1
240,https://htmlpreview.github.io/?https://github.com/Christina96/boilerplate-sample-matches/blob/main/Java/jedis-MDEwOlJlcG9zaXRvcnk3MTU2MDU=-flat-JedisSentinelPoolTest.java-jedis-MDEwOlJlcG9zaXRvcnk3MTU2MDU=-flat-ConnectionTest.java-240.html,16,jedis-MDEwOlJlcG9zaXRvcnk3MTU2MDU=-flat-JedisSentinelPoolTest.java,jedis-MDEwOlJlcG9zaXRvcnk3MTU2MDU=-flat-ConnectionTest.java,39,42,3,16,19,3
241,https://htmlpreview.github.io/?https://github.com/Christina96/boilerplate-sample-matches/blob/main/Java/ribbon-MDEwOlJlcG9zaXRvcnk3NjE2MTU4-flat-RxMovieTemplateExample.java-ribbon-MDEwOlJlcG9zaXRvcnk3NjE2MTU4-flat-RxMovieProxyExample.java-241.html,22,ribbon-MDEwOlJlcG9zaXRvcnk3NjE2MTU4-flat-RxMovieTemplateExample.java,ribbon-MDEwOlJlcG9zaXRvcnk3NjE2MTU4-flat-RxMovieProxyExample.java,96,99,3,49,52,3
242,https://htmlpreview.github.io/?https://github.com/Christina96/boilerplate-sample-matches/blob/main/Java/motan-MDEwOlJlcG9zaXRvcnk1NjY3OTUyMQ==-flat-StatsUtil.java-motan-MDEwOlJlcG9zaXRvcnk1NjY3OTUyMQ==-flat-StatsUtil.java-242.html,23,motan-MDEwOlJlcG9zaXRvcnk1NjY3OTUyMQ==-flat-StatsUtil.java,motan-MDEwOlJlcG9zaXRvcnk1NjY3OTUyMQ==-flat-StatsUtil.java,154,156,2,178,181,3
243,https://htmlpreview.github.io/?https://github.com/Christina96/boilerplate-sample-matches/blob/main/Java/VitamioBundle-MDEwOlJlcG9zaXRvcnk2MjkyMDI5-flat-MediaPlayer.java-VitamioBundle-MDEwOlJlcG9zaXRvcnk2MjkyMDI5-flat-MediaPlayer.java-243.html,16,VitamioBundle-MDEwOlJlcG9zaXRvcnk2MjkyMDI5-flat-MediaPlayer.java,VitamioBundle-MDEwOlJlcG9zaXRvcnk2MjkyMDI5-flat-MediaPlayer.java,356,360,4,355,359,4
244,https://htmlpreview.github.io/?https://github.com/Christina96/boilerplate-sample-matches/blob/main/Java/jedis-MDEwOlJlcG9zaXRvcnk3MTU2MDU=-flat-RedisJsonV2Test.java-jedis-MDEwOlJlcG9zaXRvcnk3MTU2MDU=-flat-RedisModulesPipelineTest.java-244.html,17,jedis-MDEwOlJlcG9zaXRvcnk3MTU2MDU=-flat-RedisJsonV2Test.java,jedis-MDEwOlJlcG9zaXRvcnk3MTU2MDU=-flat-RedisModulesPipelineTest.java,22,24,2,24,26,2
245,https://htmlpreview.github.io/?https://github.com/Christina96/boilerplate-sample-matches/blob/main/Java/jedis-MDEwOlJlcG9zaXRvcnk3MTU2MDU=-flat-Jedis.java-jedis-MDEwOlJlcG9zaXRvcnk3MTU2MDU=-flat-Jedis.java-245.html,17,jedis-MDEwOlJlcG9zaXRvcnk3MTU2MDU=-flat-Jedis.java,jedis-MDEwOlJlcG9zaXRvcnk3MTU2MDU=-flat-Jedis.java,706,708,2,913,915,2
246,https://htmlpreview.github.io/?https://github.com/Christina96/boilerplate-sample-matches/blob/main/Java/jedis-MDEwOlJlcG9zaXRvcnk3MTU2MDU=-flat-BuilderFactory.java-ribbon-MDEwOlJlcG9zaXRvcnk3NjE2MTU4-flat-MockedDiscoveryServerListTest.java-246.html,14,jedis-MDEwOlJlcG9zaXRvcnk3MTU2MDU=-flat-BuilderFactory.java,ribbon-MDEwOlJlcG9zaXRvcnk3NjE2MTU4-flat-MockedDiscoveryServerListTest.java,881,886,5,38,43,5
247,https://htmlpreview.github.io/?https://github.com/Christina96/boilerplate-sample-matches/blob/main/Java/jedis-MDEwOlJlcG9zaXRvcnk3MTU2MDU=-flat-StreamsCommandsTest.java-jedis-MDEwOlJlcG9zaXRvcnk3MTU2MDU=-flat-ListCommandsTestBase.java-247.html,14,jedis-MDEwOlJlcG9zaXRvcnk3MTU2MDU=-flat-StreamsCommandsTest.java,jedis-MDEwOlJlcG9zaXRvcnk3MTU2MDU=-flat-ListCommandsTestBase.java,498,500,2,621,623,2
248,https://htmlpreview.github.io/?https://github.com/Christina96/boilerplate-sample-matches/blob/main/Java/jedis-MDEwOlJlcG9zaXRvcnk3MTU2MDU=-flat-ClusterCommandsTest.java-jedis-MDEwOlJlcG9zaXRvcnk3MTU2MDU=-flat-ClusterPipeliningTest.java-248.html,42,jedis-MDEwOlJlcG9zaXRvcnk3MTU2MDU=-flat-ClusterCommandsTest.java,jedis-MDEwOlJlcG9zaXRvcnk3MTU2MDU=-flat-ClusterPipeliningTest.java,22,26,4,27,31,4
249,https://htmlpreview.github.io/?https://github.com/Christina96/boilerplate-sample-matches/blob/main/Java/jedis-MDEwOlJlcG9zaXRvcnk3MTU2MDU=-flat-SortedSetCommandsTest.java-jedis-MDEwOlJlcG9zaXRvcnk3MTU2MDU=-flat-SortedSetCommandsTestBase.java-249.html,4626,jedis-MDEwOlJlcG9zaXRvcnk3MTU2MDU=-flat-SortedSetCommandsTest.java,jedis-MDEwOlJlcG9zaXRvcnk3MTU2MDU=-flat-SortedSetCommandsTestBase.java,233,674,441,276,717,441
250,https://htmlpreview.github.io/?https://github.com/Christina96/boilerplate-sample-matches/blob/main/Java/Essentials-MDEwOlJlcG9zaXRvcnkxNzczNzU0-flat-Commandrepair.java-Essentials-MDEwOlJlcG9zaXRvcnkxNzczNzU0-flat-Commandenchant.java-250.html,20,Essentials-MDEwOlJlcG9zaXRvcnkxNzczNzU0-flat-Commandrepair.java,Essentials-MDEwOlJlcG9zaXRvcnkxNzczNzU0-flat-Commandenchant.java,56,58,2,67,69,2
251,https://htmlpreview.github.io/?https://github.com/Christina96/boilerplate-sample-matches/blob/main/Java/Essentials-MDEwOlJlcG9zaXRvcnkxNzczNzU0-flat-EssentialsUpgrade.java-VitamioBundle-MDEwOlJlcG9zaXRvcnk2MjkyMDI5-flat-EGL.java-251.html,15,Essentials-MDEwOlJlcG9zaXRvcnkxNzczNzU0-flat-EssentialsUpgrade.java,VitamioBundle-MDEwOlJlcG9zaXRvcnk2MjkyMDI5-flat-EGL.java,695,700,5,28,32,4
252,https://htmlpreview.github.io/?https://github.com/Christina96/boilerplate-sample-matches/blob/main/Java/motan-MDEwOlJlcG9zaXRvcnk1NjY3OTUyMQ==-flat-ConsistentHashLoadBalanceTest.java-motan-MDEwOlJlcG9zaXRvcnk1NjY3OTUyMQ==-flat-ConsistentHashLoadBalanceTest.java-252.html,62,motan-MDEwOlJlcG9zaXRvcnk1NjY3OTUyMQ==-flat-ConsistentHashLoadBalanceTest.java,motan-MDEwOlJlcG9zaXRvcnk1NjY3OTUyMQ==-flat-ConsistentHashLoadBalanceTest.java,24,33,9,46,55,9
253,https://htmlpreview.github.io/?https://github.com/Christina96/boilerplate-sample-matches/blob/main/Java/motan-MDEwOlJlcG9zaXRvcnk1NjY3OTUyMQ==-flat-DefaultResponseFuture.java-motan-MDEwOlJlcG9zaXRvcnk1NjY3OTUyMQ==-flat-DefaultResponse.java-253.html,25,motan-MDEwOlJlcG9zaXRvcnk1NjY3OTUyMQ==-flat-DefaultResponseFuture.java,motan-MDEwOlJlcG9zaXRvcnk1NjY3OTUyMQ==-flat-DefaultResponse.java,205,208,3,60,63,3
254,https://htmlpreview.github.io/?https://github.com/Christina96/boilerplate-sample-matches/blob/main/Java/BungeeCord-MDEwOlJlcG9zaXRvcnk2MDg0MjEw-flat-BungeeTitle.java-BungeeCord-MDEwOlJlcG9zaXRvcnk2MDg0MjEw-flat-BungeeTitle.java-254.html,31,BungeeCord-MDEwOlJlcG9zaXRvcnk2MDg0MjEw-flat-BungeeTitle.java,BungeeCord-MDEwOlJlcG9zaXRvcnk2MDg0MjEw-flat-BungeeTitle.java,99,106,7,88,95,7
255,https://htmlpreview.github.io/?https://github.com/Christina96/boilerplate-sample-matches/blob/main/Java/jedis-MDEwOlJlcG9zaXRvcnk3MTU2MDU=-flat-ConnectionTest.java-jedis-MDEwOlJlcG9zaXRvcnk3MTU2MDU=-flat-JedisSentinelPoolTest.java-255.html,16,jedis-MDEwOlJlcG9zaXRvcnk3MTU2MDU=-flat-ConnectionTest.java,jedis-MDEwOlJlcG9zaXRvcnk3MTU2MDU=-flat-JedisSentinelPoolTest.java,16,19,3,39,42,3
256,https://htmlpreview.github.io/?https://github.com/Christina96/boilerplate-sample-matches/blob/main/Java/BungeeCord-MDEwOlJlcG9zaXRvcnk2MDg0MjEw-flat-EventBusTest.java-SpringPetClinic-MDEwOlJlcG9zaXRvcnkzMDkzNDMzNTE=-flat-PetController.java-256.html,18,BungeeCord-MDEwOlJlcG9zaXRvcnk2MDg0MjEw-flat-EventBusTest.java,SpringPetClinic-MDEwOlJlcG9zaXRvcnkzMDkzNDMzNTE=-flat-PetController.java,17,20,3,33,35,2
257,https://htmlpreview.github.io/?https://github.com/Christina96/boilerplate-sample-matches/blob/main/Java/jedis-MDEwOlJlcG9zaXRvcnk3MTU2MDU=-flat-PublishSubscribeCommandsTest.java-jedis-MDEwOlJlcG9zaXRvcnk3MTU2MDU=-flat-PublishSubscribeCommandsTest.java-257.html,39,jedis-MDEwOlJlcG9zaXRvcnk3MTU2MDU=-flat-PublishSubscribeCommandsTest.java,jedis-MDEwOlJlcG9zaXRvcnk3MTU2MDU=-flat-PublishSubscribeCommandsTest.java,322,327,5,351,356,5
258,https://htmlpreview.github.io/?https://github.com/Christina96/boilerplate-sample-matches/blob/main/Java/jedis-MDEwOlJlcG9zaXRvcnk3MTU2MDU=-flat-SearchWithParamsTest.java-jedis-MDEwOlJlcG9zaXRvcnk3MTU2MDU=-flat-SearchWithParamsTest.java-258.html,14,jedis-MDEwOlJlcG9zaXRvcnk3MTU2MDU=-flat-SearchWithParamsTest.java,jedis-MDEwOlJlcG9zaXRvcnk3MTU2MDU=-flat-SearchWithParamsTest.java,335,336,1,596,597,1
259,https://htmlpreview.github.io/?https://github.com/Christina96/boilerplate-sample-matches/blob/main/Java/jedis-MDEwOlJlcG9zaXRvcnk3MTU2MDU=-flat-ReliableTransactionTest.java-jedis-MDEwOlJlcG9zaXRvcnk3MTU2MDU=-flat-TransactionV2Test.java-259.html,1455,jedis-MDEwOlJlcG9zaXRvcnk3MTU2MDU=-flat-ReliableTransactionTest.java,jedis-MDEwOlJlcG9zaXRvcnk3MTU2MDU=-flat-TransactionV2Test.java,67,222,155,69,224,155
260,https://htmlpreview.github.io/?https://github.com/Christina96/boilerplate-sample-matches/blob/main/Java/ribbon-MDEwOlJlcG9zaXRvcnk3NjE2MTU4-flat-DiscoveryEnabledNIWSServerList.java-ribbon-MDEwOlJlcG9zaXRvcnk3NjE2MTU4-flat-DiscoveryEnabledNIWSServerList.java-260.html,21,ribbon-MDEwOlJlcG9zaXRvcnk3NjE2MTU4-flat-DiscoveryEnabledNIWSServerList.java,ribbon-MDEwOlJlcG9zaXRvcnk3NjE2MTU4-flat-DiscoveryEnabledNIWSServerList.java,67,72,5,75,81,6
261,https://htmlpreview.github.io/?https://github.com/Christina96/boilerplate-sample-matches/blob/main/Java/Essentials-MDEwOlJlcG9zaXRvcnkxNzczNzU0-flat-Commandpotion.java-Essentials-MDEwOlJlcG9zaXRvcnkxNzczNzU0-flat-Commandfireball.java-261.html,22,Essentials-MDEwOlJlcG9zaXRvcnkxNzczNzU0-flat-Commandpotion.java,Essentials-MDEwOlJlcG9zaXRvcnkxNzczNzU0-flat-Commandfireball.java,43,47,4,18,22,4
262,https://htmlpreview.github.io/?https://github.com/Christina96/boilerplate-sample-matches/blob/main/Java/ribbon-MDEwOlJlcG9zaXRvcnk3NjE2MTU4-flat-BaseLoadBalancer.java-ribbon-MDEwOlJlcG9zaXRvcnk3NjE2MTU4-flat-BaseLoadBalancer.java-262.html,19,ribbon-MDEwOlJlcG9zaXRvcnk3NjE2MTU4-flat-BaseLoadBalancer.java,ribbon-MDEwOlJlcG9zaXRvcnk3NjE2MTU4-flat-BaseLoadBalancer.java,313,316,3,338,341,3
263,https://htmlpreview.github.io/?https://github.com/Christina96/boilerplate-sample-matches/blob/main/Java/motan-MDEwOlJlcG9zaXRvcnk1NjY3OTUyMQ==-flat-DefaultRpcCodecTest.java-Mybatis-PageHelper-MDEwOlJlcG9zaXRvcnkyMDY1MTY3Mg==-flat-SqlServerRowBoundsDialect.java-263.html,15,motan-MDEwOlJlcG9zaXRvcnk1NjY3OTUyMQ==-flat-DefaultRpcCodecTest.java,Mybatis-PageHelper-MDEwOlJlcG9zaXRvcnkyMDY1MTY3Mg==-flat-SqlServerRowBoundsDialect.java,17,19,2,14,16,2
264,https://htmlpreview.github.io/?https://github.com/Christina96/boilerplate-sample-matches/blob/main/Java/segmentfault-lessons-MDEwOlJlcG9zaXRvcnk5MzE1NzM4MQ==-flat-AtomicDemo.java-segmentfault-lessons-MDEwOlJlcG9zaXRvcnk5MzE1NzM4MQ==-flat-AtomicDemo.java-264.html,16,segmentfault-lessons-MDEwOlJlcG9zaXRvcnk5MzE1NzM4MQ==-flat-AtomicDemo.java,segmentfault-lessons-MDEwOlJlcG9zaXRvcnk5MzE1NzM4MQ==-flat-AtomicDemo.java,16,19,3,21,24,3
265,https://htmlpreview.github.io/?https://github.com/Christina96/boilerplate-sample-matches/blob/main/Java/jedis-MDEwOlJlcG9zaXRvcnk3MTU2MDU=-flat-Transaction.java-jedis-MDEwOlJlcG9zaXRvcnk3MTU2MDU=-flat-Transaction.java-265.html,30,jedis-MDEwOlJlcG9zaXRvcnk3MTU2MDU=-flat-Transaction.java,jedis-MDEwOlJlcG9zaXRvcnk3MTU2MDU=-flat-Transaction.java,35,43,8,47,55,8
266,https://htmlpreview.github.io/?https://github.com/Christina96/boilerplate-sample-matches/blob/main/Java/BungeeCord-MDEwOlJlcG9zaXRvcnk2MDg0MjEw-flat-JDK14LoggerAdapter.java-BungeeCord-MDEwOlJlcG9zaXRvcnk2MDg0MjEw-flat-DownstreamBridge.java-266.html,16,BungeeCord-MDEwOlJlcG9zaXRvcnk2MDg0MjEw-flat-JDK14LoggerAdapter.java,BungeeCord-MDEwOlJlcG9zaXRvcnk2MDg0MjEw-flat-DownstreamBridge.java,259,261,2,107,109,2
267,https://htmlpreview.github.io/?https://github.com/Christina96/boilerplate-sample-matches/blob/main/Java/Mybatis-PageHelper-MDEwOlJlcG9zaXRvcnkyMDY1MTY3Mg==-flat-MybatisInterceptorHelper.java-Mybatis-PageHelper-MDEwOlJlcG9zaXRvcnkyMDY1MTY3Mg==-flat-MybatisAutoDialectHelper.java-267.html,94,Mybatis-PageHelper-MDEwOlJlcG9zaXRvcnkyMDY1MTY3Mg==-flat-MybatisInterceptorHelper.java,Mybatis-PageHelper-MDEwOlJlcG9zaXRvcnkyMDY1MTY3Mg==-flat-MybatisAutoDialectHelper.java,23,38,15,23,38,15
268,https://htmlpreview.github.io/?https://github.com/Christina96/boilerplate-sample-matches/blob/main/Java/VitamioBundle-MDEwOlJlcG9zaXRvcnk2MjkyMDI5-flat-MediaPlayer.java-jedis-MDEwOlJlcG9zaXRvcnk3MTU2MDU=-flat-Jedis.java-268.html,15,VitamioBundle-MDEwOlJlcG9zaXRvcnk2MjkyMDI5-flat-MediaPlayer.java,jedis-MDEwOlJlcG9zaXRvcnk3MTU2MDU=-flat-Jedis.java,396,397,1,4830,4831,1
269,https://htmlpreview.github.io/?https://github.com/Christina96/boilerplate-sample-matches/blob/main/Java/jedis-MDEwOlJlcG9zaXRvcnk3MTU2MDU=-flat-PooledPipeliningTest.java-jedis-MDEwOlJlcG9zaXRvcnk3MTU2MDU=-flat-ClusterPipeliningTest.java-269.html,19,jedis-MDEwOlJlcG9zaXRvcnk3MTU2MDU=-flat-PooledPipeliningTest.java,jedis-MDEwOlJlcG9zaXRvcnk3MTU2MDU=-flat-ClusterPipeliningTest.java,58,60,2,899,901,2
270,https://htmlpreview.github.io/?https://github.com/Christina96/boilerplate-sample-matches/blob/main/Java/motan-MDEwOlJlcG9zaXRvcnk1NjY3OTUyMQ==-flat-GrpcUtil.java-motan-MDEwOlJlcG9zaXRvcnk1NjY3OTUyMQ==-flat-GrpcUtil.java-270.html,19,motan-MDEwOlJlcG9zaXRvcnk1NjY3OTUyMQ==-flat-GrpcUtil.java,motan-MDEwOlJlcG9zaXRvcnk1NjY3OTUyMQ==-flat-GrpcUtil.java,123,125,2,126,129,3
271,https://htmlpreview.github.io/?https://github.com/Christina96/boilerplate-sample-matches/blob/main/Java/segmentfault-lessons-MDEwOlJlcG9zaXRvcnk5MzE1NzM4MQ==-flat-UserIdRequest.java-segmentfault-lessons-MDEwOlJlcG9zaXRvcnk5MzE1NzM4MQ==-flat-UserResponse.java-271.html,14,segmentfault-lessons-MDEwOlJlcG9zaXRvcnk5MzE1NzM4MQ==-flat-UserIdRequest.java,segmentfault-lessons-MDEwOlJlcG9zaXRvcnk5MzE1NzM4MQ==-flat-UserResponse.java,9,13,4,10,14,4
272,https://htmlpreview.github.io/?https://github.com/Christina96/boilerplate-sample-matches/blob/main/Java/VitamioBundle-MDEwOlJlcG9zaXRvcnk2MjkyMDI5-flat-Base64.java-BungeeCord-MDEwOlJlcG9zaXRvcnk2MDg0MjEw-flat-DefinedPacket.java-272.html,14,VitamioBundle-MDEwOlJlcG9zaXRvcnk2MjkyMDI5-flat-Base64.java,BungeeCord-MDEwOlJlcG9zaXRvcnk2MDg0MjEw-flat-DefinedPacket.java,16,17,1,78,80,2
273,https://htmlpreview.github.io/?https://github.com/Christina96/boilerplate-sample-matches/blob/main/Java/jedis-MDEwOlJlcG9zaXRvcnk3MTU2MDU=-flat-JedisPooledTest.java-jedis-MDEwOlJlcG9zaXRvcnk3MTU2MDU=-flat-JedisClusterTest.java-273.html,14,jedis-MDEwOlJlcG9zaXRvcnk3MTU2MDU=-flat-JedisPooledTest.java,jedis-MDEwOlJlcG9zaXRvcnk3MTU2MDU=-flat-JedisClusterTest.java,34,38,4,425,429,4
274,https://htmlpreview.github.io/?https://github.com/Christina96/boilerplate-sample-matches/blob/main/Java/ribbon-MDEwOlJlcG9zaXRvcnk3NjE2MTU4-flat-ZoneAwareLoadBalancerTest.java-ribbon-MDEwOlJlcG9zaXRvcnk3NjE2MTU4-flat-ZoneAwareLoadBalancerTest.java-274.html,18,ribbon-MDEwOlJlcG9zaXRvcnk3NjE2MTU4-flat-ZoneAwareLoadBalancerTest.java,ribbon-MDEwOlJlcG9zaXRvcnk3NjE2MTU4-flat-ZoneAwareLoadBalancerTest.java,107,109,2,125,127,2
275,https://htmlpreview.github.io/?https://github.com/Christina96/boilerplate-sample-matches/blob/main/Java/ribbon-MDEwOlJlcG9zaXRvcnk3NjE2MTU4-flat-ResponseTimeWeightedRule.java-ribbon-MDEwOlJlcG9zaXRvcnk3NjE2MTU4-flat-WeightedResponseTimeRule.java-275.html,16,ribbon-MDEwOlJlcG9zaXRvcnk3NjE2MTU4-flat-ResponseTimeWeightedRule.java,ribbon-MDEwOlJlcG9zaXRvcnk3NjE2MTU4-flat-WeightedResponseTimeRule.java,69,72,3,88,91,3
276,https://htmlpreview.github.io/?https://github.com/Christina96/boilerplate-sample-matches/blob/main/Java/google-api-java-client-samples-MDEwOlJlcG9zaXRvcnkyOTc0OTA1Mg==-flat-AsyncInsertCalendar.java-google-api-java-client-samples-MDEwOlJlcG9zaXRvcnkyOTc0OTA1Mg==-flat-AsyncDeleteCalendar.java-276.html,14,google-api-java-client-samples-MDEwOlJlcG9zaXRvcnkyOTc0OTA1Mg==-flat-AsyncInsertCalendar.java,google-api-java-client-samples-MDEwOlJlcG9zaXRvcnkyOTc0OTA1Mg==-flat-AsyncDeleteCalendar.java,6,8,2,6,8,2
277,https://htmlpreview.github.io/?https://github.com/Christina96/boilerplate-sample-matches/blob/main/Java/motan-MDEwOlJlcG9zaXRvcnk1NjY3OTUyMQ==-flat-Feature.java-motan-MDEwOlJlcG9zaXRvcnk1NjY3OTUyMQ==-flat-Rectangle.java-277.html,63,motan-MDEwOlJlcG9zaXRvcnk1NjY3OTUyMQ==-flat-Feature.java,motan-MDEwOlJlcG9zaXRvcnk1NjY3OTUyMQ==-flat-Rectangle.java,336,344,8,341,349,8
278,https://htmlpreview.github.io/?https://github.com/Christina96/boilerplate-sample-matches/blob/main/Java/jedis-MDEwOlJlcG9zaXRvcnk3MTU2MDU=-flat-ControlCommandsTest.java-jedis-MDEwOlJlcG9zaXRvcnk3MTU2MDU=-flat-CMSTest.java-278.html,15,jedis-MDEwOlJlcG9zaXRvcnk3MTU2MDU=-flat-ControlCommandsTest.java,jedis-MDEwOlJlcG9zaXRvcnk3MTU2MDU=-flat-CMSTest.java,186,187,1,29,30,1
279,https://htmlpreview.github.io/?https://github.com/Christina96/boilerplate-sample-matches/blob/main/Java/jedis-MDEwOlJlcG9zaXRvcnk3MTU2MDU=-flat-JsonObjects.java-jedis-MDEwOlJlcG9zaXRvcnk3MTU2MDU=-flat-JsonObjects.java-279.html,30,jedis-MDEwOlJlcG9zaXRvcnk3MTU2MDU=-flat-JsonObjects.java,jedis-MDEwOlJlcG9zaXRvcnk3MTU2MDU=-flat-JsonObjects.java,111,116,5,53,58,5
280,https://htmlpreview.github.io/?https://github.com/Christina96/boilerplate-sample-matches/blob/main/Java/motan-MDEwOlJlcG9zaXRvcnk1NjY3OTUyMQ==-flat-CommandServiceManagerTest.java-motan-MDEwOlJlcG9zaXRvcnk1NjY3OTUyMQ==-flat-CommandServiceManagerTest.java-280.html,22,motan-MDEwOlJlcG9zaXRvcnk1NjY3OTUyMQ==-flat-CommandServiceManagerTest.java,motan-MDEwOlJlcG9zaXRvcnk1NjY3OTUyMQ==-flat-CommandServiceManagerTest.java,211,212,1,216,217,1
281,https://htmlpreview.github.io/?https://github.com/Christina96/boilerplate-sample-matches/blob/main/Java/motan-MDEwOlJlcG9zaXRvcnk1NjY3OTUyMQ==-flat-FailbackRegistry.java-motan-MDEwOlJlcG9zaXRvcnk1NjY3OTUyMQ==-flat-FailbackRegistry.java-281.html,108,motan-MDEwOlJlcG9zaXRvcnk1NjY3OTUyMQ==-flat-FailbackRegistry.java,motan-MDEwOlJlcG9zaXRvcnk1NjY3OTUyMQ==-flat-FailbackRegistry.java,179,194,15,203,218,15
282,https://htmlpreview.github.io/?https://github.com/Christina96/boilerplate-sample-matches/blob/main/Java/motan-MDEwOlJlcG9zaXRvcnk1NjY3OTUyMQ==-flat-MotanReferer.java-motan-MDEwOlJlcG9zaXRvcnk1NjY3OTUyMQ==-flat-MotanReferer.java-282.html,14,motan-MDEwOlJlcG9zaXRvcnk1NjY3OTUyMQ==-flat-MotanReferer.java,motan-MDEwOlJlcG9zaXRvcnk1NjY3OTUyMQ==-flat-MotanReferer.java,14,16,2,39,41,2
283,https://htmlpreview.github.io/?https://github.com/Christina96/boilerplate-sample-matches/blob/main/Java/motan-MDEwOlJlcG9zaXRvcnk1NjY3OTUyMQ==-flat-ProtobufCodec.java-motan-MDEwOlJlcG9zaXRvcnk1NjY3OTUyMQ==-flat-CompressRpcCodec.java-283.html,43,motan-MDEwOlJlcG9zaXRvcnk1NjY3OTUyMQ==-flat-ProtobufCodec.java,motan-MDEwOlJlcG9zaXRvcnk1NjY3OTUyMQ==-flat-CompressRpcCodec.java,98,106,8,104,110,6
284,https://htmlpreview.github.io/?https://github.com/Christina96/boilerplate-sample-matches/blob/main/Java/jedis-MDEwOlJlcG9zaXRvcnk3MTU2MDU=-flat-TimeSeriesBuilderFactory.java-jedis-MDEwOlJlcG9zaXRvcnk3MTU2MDU=-flat-TimeSeriesBuilderFactory.java-284.html,14,jedis-MDEwOlJlcG9zaXRvcnk3MTU2MDU=-flat-TimeSeriesBuilderFactory.java,jedis-MDEwOlJlcG9zaXRvcnk3MTU2MDU=-flat-TimeSeriesBuilderFactory.java,86,87,1,56,57,1
285,https://htmlpreview.github.io/?https://github.com/Christina96/boilerplate-sample-matches/blob/main/Java/motan-MDEwOlJlcG9zaXRvcnk1NjY3OTUyMQ==-flat-NettyServer_13.java-VitamioBundle-MDEwOlJlcG9zaXRvcnk2MjkyMDI5-flat-Vitamio.java-285.html,16,motan-MDEwOlJlcG9zaXRvcnk1NjY3OTUyMQ==-flat-NettyServer_13.java,VitamioBundle-MDEwOlJlcG9zaXRvcnk2MjkyMDI5-flat-Vitamio.java,85,87,2,180,182,2
286,https://htmlpreview.github.io/?https://github.com/Christina96/boilerplate-sample-matches/blob/main/Java/jedis-MDEwOlJlcG9zaXRvcnk3MTU2MDU=-flat-UnifiedJedis.java-jedis-MDEwOlJlcG9zaXRvcnk3MTU2MDU=-flat-UnifiedJedis.java-286.html,25,jedis-MDEwOlJlcG9zaXRvcnk3MTU2MDU=-flat-UnifiedJedis.java,jedis-MDEwOlJlcG9zaXRvcnk3MTU2MDU=-flat-UnifiedJedis.java,2818,2821,3,384,387,3
287,https://htmlpreview.github.io/?https://github.com/Christina96/boilerplate-sample-matches/blob/main/Java/BungeeCord-MDEwOlJlcG9zaXRvcnk2MDg0MjEw-flat-PluginManager.java-motan-MDEwOlJlcG9zaXRvcnk1NjY3OTUyMQ==-flat-BaseSerializeTest.java-287.html,14,BungeeCord-MDEwOlJlcG9zaXRvcnk2MDg0MjEw-flat-PluginManager.java,motan-MDEwOlJlcG9zaXRvcnk1NjY3OTUyMQ==-flat-BaseSerializeTest.java,284,285,1,54,55,1
288,https://htmlpreview.github.io/?https://github.com/Christina96/boilerplate-sample-matches/blob/main/Java/segmentfault-lessons-MDEwOlJlcG9zaXRvcnk5MzE1NzM4MQ==-flat-ClassLoadingDemo.java-motan-MDEwOlJlcG9zaXRvcnk1NjY3OTUyMQ==-flat-YarMessageRouter.java-288.html,15,segmentfault-lessons-MDEwOlJlcG9zaXRvcnk5MzE1NzM4MQ==-flat-ClassLoadingDemo.java,motan-MDEwOlJlcG9zaXRvcnk1NjY3OTUyMQ==-flat-YarMessageRouter.java,14,15,1,38,39,1
289,https://htmlpreview.github.io/?https://github.com/Christina96/boilerplate-sample-matches/blob/main/Java/Essentials-MDEwOlJlcG9zaXRvcnkxNzczNzU0-flat-Settings.java-Essentials-MDEwOlJlcG9zaXRvcnkxNzczNzU0-flat-EssentialsUpgrade.java-289.html,19,Essentials-MDEwOlJlcG9zaXRvcnkxNzczNzU0-flat-Settings.java,Essentials-MDEwOlJlcG9zaXRvcnkxNzczNzU0-flat-EssentialsUpgrade.java,225,226,1,603,604,1
290,https://htmlpreview.github.io/?https://github.com/Christina96/boilerplate-sample-matches/blob/main/Java/Essentials-MDEwOlJlcG9zaXRvcnkxNzczNzU0-flat-AnjoPermissionsHandler.java-Essentials-MDEwOlJlcG9zaXRvcnkxNzczNzU0-flat-AnjoPermissionsHandler.java-290.html,29,Essentials-MDEwOlJlcG9zaXRvcnkxNzczNzU0-flat-AnjoPermissionsHandler.java,Essentials-MDEwOlJlcG9zaXRvcnkxNzczNzU0-flat-AnjoPermissionsHandler.java,358,363,5,205,210,5
291,https://htmlpreview.github.io/?https://github.com/Christina96/boilerplate-sample-matches/blob/main/Java/google-api-java-client-samples-MDEwOlJlcG9zaXRvcnkyOTc0OTA1Mg==-flat-AsyncLoadCalendars.java-google-api-java-client-samples-MDEwOlJlcG9zaXRvcnkyOTc0OTA1Mg==-flat-AsyncLoadTasks.java-291.html,22,google-api-java-client-samples-MDEwOlJlcG9zaXRvcnkyOTc0OTA1Mg==-flat-AsyncLoadCalendars.java,google-api-java-client-samples-MDEwOlJlcG9zaXRvcnkyOTc0OTA1Mg==-flat-AsyncLoadTasks.java,5,10,5,7,12,5
292,https://htmlpreview.github.io/?https://github.com/Christina96/boilerplate-sample-matches/blob/main/Java/ribbon-MDEwOlJlcG9zaXRvcnk3NjE2MTU4-flat-TemplateBuilderTest.java-BungeeCord-MDEwOlJlcG9zaXRvcnk2MDg0MjEw-flat-ScoreComponentSerializer.java-292.html,14,ribbon-MDEwOlJlcG9zaXRvcnk3NjE2MTU4-flat-TemplateBuilderTest.java,BungeeCord-MDEwOlJlcG9zaXRvcnk2MDg0MjEw-flat-ScoreComponentSerializer.java,49,50,1,21,22,1
293,https://htmlpreview.github.io/?https://github.com/Christina96/boilerplate-sample-matches/blob/main/Java/motan-MDEwOlJlcG9zaXRvcnk1NjY3OTUyMQ==-flat-ProtobufSerialization.java-motan-MDEwOlJlcG9zaXRvcnk1NjY3OTUyMQ==-flat-GrpcPbSerialization.java-293.html,21,motan-MDEwOlJlcG9zaXRvcnk1NjY3OTUyMQ==-flat-ProtobufSerialization.java,motan-MDEwOlJlcG9zaXRvcnk1NjY3OTUyMQ==-flat-GrpcPbSerialization.java,122,127,5,32,37,5
294,https://htmlpreview.github.io/?https://github.com/Christina96/boilerplate-sample-matches/blob/main/Java/segmentfault-lessons-MDEwOlJlcG9zaXRvcnk5MzE1NzM4MQ==-flat-CyclicBarrierDemo.java-segmentfault-lessons-MDEwOlJlcG9zaXRvcnk5MzE1NzM4MQ==-flat-WeakReferenceMapDemo.java-294.html,22,segmentfault-lessons-MDEwOlJlcG9zaXRvcnk5MzE1NzM4MQ==-flat-CyclicBarrierDemo.java,segmentfault-lessons-MDEwOlJlcG9zaXRvcnk5MzE1NzM4MQ==-flat-WeakReferenceMapDemo.java,20,22,2,13,15,2
295,https://htmlpreview.github.io/?https://github.com/Christina96/boilerplate-sample-matches/blob/main/Java/jedis-MDEwOlJlcG9zaXRvcnk3MTU2MDU=-flat-ClusterPipeliningTest.java-jedis-MDEwOlJlcG9zaXRvcnk3MTU2MDU=-flat-ClusterPipeliningTest.java-295.html,55,jedis-MDEwOlJlcG9zaXRvcnk3MTU2MDU=-flat-ClusterPipeliningTest.java,jedis-MDEwOlJlcG9zaXRvcnk3MTU2MDU=-flat-ClusterPipeliningTest.java,162,166,4,182,186,4
296,https://htmlpreview.github.io/?https://github.com/Christina96/boilerplate-sample-matches/blob/main/Java/motan-MDEwOlJlcG9zaXRvcnk1NjY3OTUyMQ==-flat-DefaultMeshClient.java-motan-MDEwOlJlcG9zaXRvcnk1NjY3OTUyMQ==-flat-LocalSwitcherService.java-296.html,14,motan-MDEwOlJlcG9zaXRvcnk1NjY3OTUyMQ==-flat-DefaultMeshClient.java,motan-MDEwOlJlcG9zaXRvcnk1NjY3OTUyMQ==-flat-LocalSwitcherService.java,99,102,3,37,40,3
297,https://htmlpreview.github.io/?https://github.com/Christina96/boilerplate-sample-matches/blob/main/Java/ribbon-MDEwOlJlcG9zaXRvcnk3NjE2MTU4-flat-RibbonDynamicProxy.java-motan-MDEwOlJlcG9zaXRvcnk1NjY3OTUyMQ==-flat-NettyDecoder_12.java-297.html,17,ribbon-MDEwOlJlcG9zaXRvcnk3NjE2MTU4-flat-RibbonDynamicProxy.java,motan-MDEwOlJlcG9zaXRvcnk1NjY3OTUyMQ==-flat-NettyDecoder_12.java,111,113,2,102,104,2
298,https://htmlpreview.github.io/?https://github.com/Christina96/boilerplate-sample-matches/blob/main/Java/Essentials-MDEwOlJlcG9zaXRvcnkxNzczNzU0-flat-BookInput.java-Essentials-MDEwOlJlcG9zaXRvcnkxNzczNzU0-flat-TextInput.java-298.html,191,Essentials-MDEwOlJlcG9zaXRvcnkxNzczNzU0-flat-BookInput.java,Essentials-MDEwOlJlcG9zaXRvcnkxNzczNzU0-flat-TextInput.java,62,92,30,43,73,30
299,https://htmlpreview.github.io/?https://github.com/Christina96/boilerplate-sample-matches/blob/main/Java/jedis-MDEwOlJlcG9zaXRvcnk3MTU2MDU=-flat-SSLJedisTest.java-jedis-MDEwOlJlcG9zaXRvcnk3MTU2MDU=-flat-SSLACLJedisTest.java-299.html,22,jedis-MDEwOlJlcG9zaXRvcnk3MTU2MDU=-flat-SSLJedisTest.java,jedis-MDEwOlJlcG9zaXRvcnk3MTU2MDU=-flat-SSLACLJedisTest.java,103,106,3,63,66,3
300,https://htmlpreview.github.io/?https://github.com/Christina96/boilerplate-sample-matches/blob/main/Java/jedis-MDEwOlJlcG9zaXRvcnk3MTU2MDU=-flat-JedisClusterInfoCache.java-motan-MDEwOlJlcG9zaXRvcnk1NjY3OTUyMQ==-flat-ClusterSupport.java-300.html,16,jedis-MDEwOlJlcG9zaXRvcnk3MTU2MDU=-flat-JedisClusterInfoCache.java,motan-MDEwOlJlcG9zaXRvcnk1NjY3OTUyMQ==-flat-ClusterSupport.java,185,187,2,88,90,2
301,https://htmlpreview.github.io/?https://github.com/Christina96/boilerplate-sample-matches/blob/main/Java/segmentfault-lessons-MDEwOlJlcG9zaXRvcnk5MzE1NzM4MQ==-flat-MyRule_61.java-segmentfault-lessons-MDEwOlJlcG9zaXRvcnk5MzE1NzM4MQ==-flat-MyRule_85.java-301.html,20,segmentfault-lessons-MDEwOlJlcG9zaXRvcnk5MzE1NzM4MQ==-flat-MyRule_61.java,segmentfault-lessons-MDEwOlJlcG9zaXRvcnk5MzE1NzM4MQ==-flat-MyRule_85.java,19,22,3,19,22,3
302,https://htmlpreview.github.io/?https://github.com/Christina96/boilerplate-sample-matches/blob/main/Java/motan-MDEwOlJlcG9zaXRvcnk1NjY3OTUyMQ==-flat-RouteSummary.java-motan-MDEwOlJlcG9zaXRvcnk1NjY3OTUyMQ==-flat-Point.java-302.html,27,motan-MDEwOlJlcG9zaXRvcnk1NjY3OTUyMQ==-flat-RouteSummary.java,motan-MDEwOlJlcG9zaXRvcnk1NjY3OTUyMQ==-flat-Point.java,35,44,9,33,42,9
303,https://htmlpreview.github.io/?https://github.com/Christina96/boilerplate-sample-matches/blob/main/Java/google-api-java-client-samples-MDEwOlJlcG9zaXRvcnkyOTc0OTA1Mg==-flat-BooksSample.java-google-api-java-client-samples-MDEwOlJlcG9zaXRvcnkyOTc0OTA1Mg==-flat-BooksSample.java-303.html,31,google-api-java-client-samples-MDEwOlJlcG9zaXRvcnkyOTc0OTA1Mg==-flat-BooksSample.java,google-api-java-client-samples-MDEwOlJlcG9zaXRvcnkyOTc0OTA1Mg==-flat-BooksSample.java,74,79,5,97,101,4
304,https://htmlpreview.github.io/?https://github.com/Christina96/boilerplate-sample-matches/blob/main/Java/Essentials-MDEwOlJlcG9zaXRvcnkxNzczNzU0-flat-Commandptime.java-Essentials-MDEwOlJlcG9zaXRvcnkxNzczNzU0-flat-Commandpweather.java-304.html,112,Essentials-MDEwOlJlcG9zaXRvcnkxNzczNzU0-flat-Commandptime.java,Essentials-MDEwOlJlcG9zaXRvcnkxNzczNzU0-flat-Commandpweather.java,172,196,24,127,150,23
305,https://htmlpreview.github.io/?https://github.com/Christina96/boilerplate-sample-matches/blob/main/Java/jedis-MDEwOlJlcG9zaXRvcnk3MTU2MDU=-flat-AllKindOfValuesCommandsTestBase.java-jedis-MDEwOlJlcG9zaXRvcnk3MTU2MDU=-flat-AllKindOfValuesCommandsTestBase.java-305.html,31,jedis-MDEwOlJlcG9zaXRvcnk3MTU2MDU=-flat-AllKindOfValuesCommandsTestBase.java,jedis-MDEwOlJlcG9zaXRvcnk3MTU2MDU=-flat-AllKindOfValuesCommandsTestBase.java,371,374,3,249,252,3
306,https://htmlpreview.github.io/?https://github.com/Christina96/boilerplate-sample-matches/blob/main/Java/motan-MDEwOlJlcG9zaXRvcnk1NjY3OTUyMQ==-flat-LocalFirstLoadBalance.java-motan-MDEwOlJlcG9zaXRvcnk1NjY3OTUyMQ==-flat-LocalFirstLoadBalance.java-306.html,33,motan-MDEwOlJlcG9zaXRvcnk1NjY3OTUyMQ==-flat-LocalFirstLoadBalance.java,motan-MDEwOlJlcG9zaXRvcnk1NjY3OTUyMQ==-flat-LocalFirstLoadBalance.java,32,34,2,56,58,2
307,https://htmlpreview.github.io/?https://github.com/Christina96/boilerplate-sample-matches/blob/main/Java/google-api-java-client-samples-MDEwOlJlcG9zaXRvcnkyOTc0OTA1Mg==-flat-Noteendpoint.java-google-api-java-client-samples-MDEwOlJlcG9zaXRvcnkyOTc0OTA1Mg==-flat-Deviceinfoendpoint.java-307.html,24,google-api-java-client-samples-MDEwOlJlcG9zaXRvcnkyOTc0OTA1Mg==-flat-Noteendpoint.java,google-api-java-client-samples-MDEwOlJlcG9zaXRvcnkyOTc0OTA1Mg==-flat-Deviceinfoendpoint.java,35,44,9,35,44,9
308,https://htmlpreview.github.io/?https://github.com/Christina96/boilerplate-sample-matches/blob/main/Java/Mybatis-PageHelper-MDEwOlJlcG9zaXRvcnkyMDY1MTY3Mg==-flat-PageHelperTest.java-Mybatis-PageHelper-MDEwOlJlcG9zaXRvcnkyMDY1MTY3Mg==-flat-PageHelperTest.java-308.html,30,Mybatis-PageHelper-MDEwOlJlcG9zaXRvcnkyMDY1MTY3Mg==-flat-PageHelperTest.java,Mybatis-PageHelper-MDEwOlJlcG9zaXRvcnkyMDY1MTY3Mg==-flat-PageHelperTest.java,63,65,2,39,41,2
309,https://htmlpreview.github.io/?https://github.com/Christina96/boilerplate-sample-matches/blob/main/Java/motan-MDEwOlJlcG9zaXRvcnk1NjY3OTUyMQ==-flat-URL.java-motan-MDEwOlJlcG9zaXRvcnk1NjY3OTUyMQ==-flat-URL.java-309.html,29,motan-MDEwOlJlcG9zaXRvcnk1NjY3OTUyMQ==-flat-URL.java,motan-MDEwOlJlcG9zaXRvcnk1NjY3OTUyMQ==-flat-URL.java,260,266,6,274,280,6
310,https://htmlpreview.github.io/?https://github.com/Christina96/boilerplate-sample-matches/blob/main/Java/motan-MDEwOlJlcG9zaXRvcnk1NjY3OTUyMQ==-flat-MeshRegistryTest.java-jedis-MDEwOlJlcG9zaXRvcnk3MTU2MDU=-flat-AllKindOfValuesCommandsTestBase.java-310.html,16,motan-MDEwOlJlcG9zaXRvcnk1NjY3OTUyMQ==-flat-MeshRegistryTest.java,jedis-MDEwOlJlcG9zaXRvcnk3MTU2MDU=-flat-AllKindOfValuesCommandsTestBase.java,124,126,2,268,270,2
311,https://htmlpreview.github.io/?https://github.com/Christina96/boilerplate-sample-matches/blob/main/Java/Essentials-MDEwOlJlcG9zaXRvcnkxNzczNzU0-flat-Economy_5.java-Essentials-MDEwOlJlcG9zaXRvcnkxNzczNzU0-flat-Economy_5.java-311.html,81,Essentials-MDEwOlJlcG9zaXRvcnkxNzczNzU0-flat-Economy_5.java,Essentials-MDEwOlJlcG9zaXRvcnkxNzczNzU0-flat-Economy_5.java,126,137,11,180,191,11
312,https://htmlpreview.github.io/?https://github.com/Christina96/boilerplate-sample-matches/blob/main/Java/segmentfault-lessons-MDEwOlJlcG9zaXRvcnk5MzE1NzM4MQ==-flat-AbstractQueuedSynchronizerDemo.java-segmentfault-lessons-MDEwOlJlcG9zaXRvcnk5MzE1NzM4MQ==-flat-AbstractQueuedSynchronizerDemo.java-312.html,20,segmentfault-lessons-MDEwOlJlcG9zaXRvcnk5MzE1NzM4MQ==-flat-AbstractQueuedSynchronizerDemo.java,segmentfault-lessons-MDEwOlJlcG9zaXRvcnk5MzE1NzM4MQ==-flat-AbstractQueuedSynchronizerDemo.java,21,23,2,22,24,2
313,https://htmlpreview.github.io/?https://github.com/Christina96/boilerplate-sample-matches/blob/main/Java/jedis-MDEwOlJlcG9zaXRvcnk3MTU2MDU=-flat-ClusterConnectionProvider.java-jedis-MDEwOlJlcG9zaXRvcnk3MTU2MDU=-flat-ShardedConnectionProvider.java-313.html,28,jedis-MDEwOlJlcG9zaXRvcnk3MTU2MDU=-flat-ClusterConnectionProvider.java,jedis-MDEwOlJlcG9zaXRvcnk3MTU2MDU=-flat-ShardedConnectionProvider.java,100,106,6,123,129,6
314,https://htmlpreview.github.io/?https://github.com/Christina96/boilerplate-sample-matches/blob/main/Java/ribbon-MDEwOlJlcG9zaXRvcnk3NjE2MTU4-flat-HttpClientRequest.java-ribbon-MDEwOlJlcG9zaXRvcnk3NjE2MTU4-flat-HttpRequest_7.java-314.html,27,ribbon-MDEwOlJlcG9zaXRvcnk3NjE2MTU4-flat-HttpClientRequest.java,ribbon-MDEwOlJlcG9zaXRvcnk3NjE2MTU4-flat-HttpRequest_7.java,56,62,6,85,91,6
315,https://htmlpreview.github.io/?https://github.com/Christina96/boilerplate-sample-matches/blob/main/Java/motan-MDEwOlJlcG9zaXRvcnk1NjY3OTUyMQ==-flat-ConsulRegistry.java-motan-MDEwOlJlcG9zaXRvcnk1NjY3OTUyMQ==-flat-MotanGlobalConfigUtil.java-315.html,21,motan-MDEwOlJlcG9zaXRvcnk1NjY3OTUyMQ==-flat-ConsulRegistry.java,motan-MDEwOlJlcG9zaXRvcnk1NjY3OTUyMQ==-flat-MotanGlobalConfigUtil.java,234,236,2,46,48,2
316,https://htmlpreview.github.io/?https://github.com/Christina96/boilerplate-sample-matches/blob/main/Java/Essentials-MDEwOlJlcG9zaXRvcnkxNzczNzU0-flat-SignEntityListener.java-Essentials-MDEwOlJlcG9zaXRvcnkxNzczNzU0-flat-SignEntityListener.java-316.html,73,Essentials-MDEwOlJlcG9zaXRvcnkxNzczNzU0-flat-SignEntityListener.java,Essentials-MDEwOlJlcG9zaXRvcnkxNzczNzU0-flat-SignEntityListener.java,27,37,10,54,65,11
317,https://htmlpreview.github.io/?https://github.com/Christina96/boilerplate-sample-matches/blob/main/Java/BungeeCord-MDEwOlJlcG9zaXRvcnk2MDg0MjEw-flat-PendingConnection.java-Essentials-MDEwOlJlcG9zaXRvcnkxNzczNzU0-flat-IUser_3.java-317.html,17,BungeeCord-MDEwOlJlcG9zaXRvcnk2MDg0MjEw-flat-PendingConnection.java,Essentials-MDEwOlJlcG9zaXRvcnkxNzczNzU0-flat-IUser_3.java,15,18,3,41,44,3
318,https://htmlpreview.github.io/?https://github.com/Christina96/boilerplate-sample-matches/blob/main/Java/jedis-MDEwOlJlcG9zaXRvcnk3MTU2MDU=-flat-GraphAPITest.java-jedis-MDEwOlJlcG9zaXRvcnk3MTU2MDU=-flat-GeoCommandsTestBase.java-318.html,17,jedis-MDEwOlJlcG9zaXRvcnk3MTU2MDU=-flat-GraphAPITest.java,jedis-MDEwOlJlcG9zaXRvcnk3MTU2MDU=-flat-GeoCommandsTestBase.java,556,557,1,94,95,1
319,https://htmlpreview.github.io/?https://github.com/Christina96/boilerplate-sample-matches/blob/main/Java/jedis-MDEwOlJlcG9zaXRvcnk3MTU2MDU=-flat-TSMRangeParams.java-jedis-MDEwOlJlcG9zaXRvcnk3MTU2MDU=-flat-TSMRangeParams.java-319.html,14,jedis-MDEwOlJlcG9zaXRvcnk3MTU2MDU=-flat-TSMRangeParams.java,jedis-MDEwOlJlcG9zaXRvcnk3MTU2MDU=-flat-TSMRangeParams.java,16,19,3,23,26,3
320,https://htmlpreview.github.io/?https://github.com/Christina96/boilerplate-sample-matches/blob/main/Java/Essentials-MDEwOlJlcG9zaXRvcnkxNzczNzU0-flat-iCo6.java-Essentials-MDEwOlJlcG9zaXRvcnkxNzczNzU0-flat-MCUR.java-320.html,25,Essentials-MDEwOlJlcG9zaXRvcnkxNzczNzU0-flat-iCo6.java,Essentials-MDEwOlJlcG9zaXRvcnkxNzczNzU0-flat-MCUR.java,57,64,7,55,62,7
321,https://htmlpreview.github.io/?https://github.com/Christina96/boilerplate-sample-matches/blob/main/Java/BungeeCord-MDEwOlJlcG9zaXRvcnk2MDg0MjEw-flat-TranslationRegistry.java-google-api-java-client-samples-MDEwOlJlcG9zaXRvcnkyOTc0OTA1Mg==-flat-CloudNotesActivity.java-321.html,15,BungeeCord-MDEwOlJlcG9zaXRvcnk2MDg0MjEw-flat-TranslationRegistry.java,google-api-java-client-samples-MDEwOlJlcG9zaXRvcnkyOTc0OTA1Mg==-flat-CloudNotesActivity.java,44,47,3,149,151,2
322,https://htmlpreview.github.io/?https://github.com/Christina96/boilerplate-sample-matches/blob/main/Java/motan-MDEwOlJlcG9zaXRvcnk1NjY3OTUyMQ==-flat-ProtobufCodec.java-motan-MDEwOlJlcG9zaXRvcnk1NjY3OTUyMQ==-flat-DefaultRpcCodec.java-322.html,42,motan-MDEwOlJlcG9zaXRvcnk1NjY3OTUyMQ==-flat-ProtobufCodec.java,motan-MDEwOlJlcG9zaXRvcnk1NjY3OTUyMQ==-flat-DefaultRpcCodec.java,185,191,6,199,205,6
323,https://htmlpreview.github.io/?https://github.com/Christina96/boilerplate-sample-matches/blob/main/Java/ribbon-MDEwOlJlcG9zaXRvcnk3NjE2MTU4-flat-RestClient.java-ribbon-MDEwOlJlcG9zaXRvcnk3NjE2MTU4-flat-RestClient.java-323.html,16,ribbon-MDEwOlJlcG9zaXRvcnk3NjE2MTU4-flat-RestClient.java,ribbon-MDEwOlJlcG9zaXRvcnk3NjE2MTU4-flat-RestClient.java,69,73,4,70,74,4
324,https://htmlpreview.github.io/?https://github.com/Christina96/boilerplate-sample-matches/blob/main/Java/jedis-MDEwOlJlcG9zaXRvcnk3MTU2MDU=-flat-Query.java-jedis-MDEwOlJlcG9zaXRvcnk3MTU2MDU=-flat-Query.java-324.html,18,jedis-MDEwOlJlcG9zaXRvcnk3MTU2MDU=-flat-Query.java,jedis-MDEwOlJlcG9zaXRvcnk3MTU2MDU=-flat-Query.java,310,313,3,325,328,3
325,https://htmlpreview.github.io/?https://github.com/Christina96/boilerplate-sample-matches/blob/main/Java/motan-MDEwOlJlcG9zaXRvcnk1NjY3OTUyMQ==-flat-NettyClient.java-motan-MDEwOlJlcG9zaXRvcnk1NjY3OTUyMQ==-flat-NettyClient_19.java-325.html,138,motan-MDEwOlJlcG9zaXRvcnk1NjY3OTUyMQ==-flat-NettyClient.java,motan-MDEwOlJlcG9zaXRvcnk1NjY3OTUyMQ==-flat-NettyClient_19.java,218,241,23,219,242,23
326,https://htmlpreview.github.io/?https://github.com/Christina96/boilerplate-sample-matches/blob/main/Java/Essentials-MDEwOlJlcG9zaXRvcnkxNzczNzU0-flat-WorldDataHolder.java-Essentials-MDEwOlJlcG9zaXRvcnkxNzczNzU0-flat-WorldDataHolder.java-326.html,28,Essentials-MDEwOlJlcG9zaXRvcnkxNzczNzU0-flat-WorldDataHolder.java,Essentials-MDEwOlJlcG9zaXRvcnkxNzczNzU0-flat-WorldDataHolder.java,208,212,4,227,231,4
327,https://htmlpreview.github.io/?https://github.com/Christina96/boilerplate-sample-matches/blob/main/Java/Essentials-MDEwOlJlcG9zaXRvcnkxNzczNzU0-flat-FakeWorld.java-Essentials-MDEwOlJlcG9zaXRvcnkxNzczNzU0-flat-FakeWorld.java-327.html,21,Essentials-MDEwOlJlcG9zaXRvcnkxNzczNzU0-flat-FakeWorld.java,Essentials-MDEwOlJlcG9zaXRvcnkxNzczNzU0-flat-FakeWorld.java,377,382,5,382,387,5
328,https://htmlpreview.github.io/?https://github.com/Christina96/boilerplate-sample-matches/blob/main/Java/Mybatis-PageHelper-MDEwOlJlcG9zaXRvcnkyMDY1MTY3Mg==-flat-AbstractHelperDialect.java-Mybatis-PageHelper-MDEwOlJlcG9zaXRvcnkyMDY1MTY3Mg==-flat-PageParams.java-328.html,18,Mybatis-PageHelper-MDEwOlJlcG9zaXRvcnkyMDY1MTY3Mg==-flat-AbstractHelperDialect.java,Mybatis-PageHelper-MDEwOlJlcG9zaXRvcnkyMDY1MTY3Mg==-flat-PageParams.java,129,133,4,40,44,4
329,https://htmlpreview.github.io/?https://github.com/Christina96/boilerplate-sample-matches/blob/main/Java/jedis-MDEwOlJlcG9zaXRvcnk3MTU2MDU=-flat-CuckooTest.java-jedis-MDEwOlJlcG9zaXRvcnk3MTU2MDU=-flat-CuckooTest.java-329.html,24,jedis-MDEwOlJlcG9zaXRvcnk3MTU2MDU=-flat-CuckooTest.java,jedis-MDEwOlJlcG9zaXRvcnk3MTU2MDU=-flat-CuckooTest.java,100,104,4,125,129,4
330,https://htmlpreview.github.io/?https://github.com/Christina96/boilerplate-sample-matches/blob/main/Java/Essentials-MDEwOlJlcG9zaXRvcnkxNzczNzU0-flat-SetExpFix.java-Essentials-MDEwOlJlcG9zaXRvcnkxNzczNzU0-flat-SetExpFix.java-330.html,41,Essentials-MDEwOlJlcG9zaXRvcnkxNzczNzU0-flat-SetExpFix.java,Essentials-MDEwOlJlcG9zaXRvcnkxNzczNzU0-flat-SetExpFix.java,62,66,4,77,81,4
331,https://htmlpreview.github.io/?https://github.com/Christina96/boilerplate-sample-matches/blob/main/Java/google-api-java-client-samples-MDEwOlJlcG9zaXRvcnkyOTc0OTA1Mg==-flat-ManagementApiReferenceSample.java-google-api-java-client-samples-MDEwOlJlcG9zaXRvcnkyOTc0OTA1Mg==-flat-ManagementApiReferenceSample.java-331.html,24,google-api-java-client-samples-MDEwOlJlcG9zaXRvcnkyOTc0OTA1Mg==-flat-ManagementApiReferenceSample.java,google-api-java-client-samples-MDEwOlJlcG9zaXRvcnkyOTc0OTA1Mg==-flat-ManagementApiReferenceSample.java,197,200,3,204,207,3
332,https://htmlpreview.github.io/?https://github.com/Christina96/boilerplate-sample-matches/blob/main/Java/jedis-MDEwOlJlcG9zaXRvcnk3MTU2MDU=-flat-JedisPoolTest.java-jedis-MDEwOlJlcG9zaXRvcnk3MTU2MDU=-flat-ACLJedisPoolTest.java-332.html,72,jedis-MDEwOlJlcG9zaXRvcnk3MTU2MDU=-flat-JedisPoolTest.java,jedis-MDEwOlJlcG9zaXRvcnk3MTU2MDU=-flat-ACLJedisPoolTest.java,175,184,9,187,196,9
333,https://htmlpreview.github.io/?https://github.com/Christina96/boilerplate-sample-matches/blob/main/Java/motan-MDEwOlJlcG9zaXRvcnk1NjY3OTUyMQ==-flat-FeatureDatabase.java-Essentials-MDEwOlJlcG9zaXRvcnkxNzczNzU0-flat-SignBlockListener.java-333.html,16,motan-MDEwOlJlcG9zaXRvcnk1NjY3OTUyMQ==-flat-FeatureDatabase.java,Essentials-MDEwOlJlcG9zaXRvcnkxNzczNzU0-flat-SignBlockListener.java,99,102,3,96,99,3
334,https://htmlpreview.github.io/?https://github.com/Christina96/boilerplate-sample-matches/blob/main/Java/segmentfault-lessons-MDEwOlJlcG9zaXRvcnk5MzE1NzM4MQ==-flat-LambdaDemo.java-segmentfault-lessons-MDEwOlJlcG9zaXRvcnk5MzE1NzM4MQ==-flat-LambdaDemo_14.java-334.html,223,segmentfault-lessons-MDEwOlJlcG9zaXRvcnk5MzE1NzM4MQ==-flat-LambdaDemo.java,segmentfault-lessons-MDEwOlJlcG9zaXRvcnk5MzE1NzM4MQ==-flat-LambdaDemo_14.java,20,60,40,20,60,40
335,https://htmlpreview.github.io/?https://github.com/Christina96/boilerplate-sample-matches/blob/main/Java/BungeeCord-MDEwOlJlcG9zaXRvcnk2MDg0MjEw-flat-ClientSettings.java-BungeeCord-MDEwOlJlcG9zaXRvcnk2MDg0MjEw-flat-ServerData.java-335.html,26,BungeeCord-MDEwOlJlcG9zaXRvcnk2MDg0MjEw-flat-ClientSettings.java,BungeeCord-MDEwOlJlcG9zaXRvcnk2MDg0MjEw-flat-ServerData.java,23,28,5,18,23,5
336,https://htmlpreview.github.io/?https://github.com/Christina96/boilerplate-sample-matches/blob/main/Java/motan-MDEwOlJlcG9zaXRvcnk1NjY3OTUyMQ==-flat-ConsulRegistryTest.java-motan-MDEwOlJlcG9zaXRvcnk1NjY3OTUyMQ==-flat-ConsulHeartbeatManagerTest.java-336.html,23,motan-MDEwOlJlcG9zaXRvcnk1NjY3OTUyMQ==-flat-ConsulRegistryTest.java,motan-MDEwOlJlcG9zaXRvcnk1NjY3OTUyMQ==-flat-ConsulHeartbeatManagerTest.java,34,39,5,21,26,5
337,https://htmlpreview.github.io/?https://github.com/Christina96/boilerplate-sample-matches/blob/main/Java/jedis-MDEwOlJlcG9zaXRvcnk3MTU2MDU=-flat-ReliableTransactionTest.java-jedis-MDEwOlJlcG9zaXRvcnk3MTU2MDU=-flat-TransactionCommandsTest.java-337.html,197,jedis-MDEwOlJlcG9zaXRvcnk3MTU2MDU=-flat-ReliableTransactionTest.java,jedis-MDEwOlJlcG9zaXRvcnk3MTU2MDU=-flat-TransactionCommandsTest.java,188,205,17,267,284,17
338,https://htmlpreview.github.io/?https://github.com/Christina96/boilerplate-sample-matches/blob/main/Java/motan-MDEwOlJlcG9zaXRvcnk1NjY3OTUyMQ==-flat-UserProto.java-motan-MDEwOlJlcG9zaXRvcnk1NjY3OTUyMQ==-flat-FeatureDatabase.java-338.html,20,motan-MDEwOlJlcG9zaXRvcnk1NjY3OTUyMQ==-flat-UserProto.java,motan-MDEwOlJlcG9zaXRvcnk1NjY3OTUyMQ==-flat-FeatureDatabase.java,581,583,2,372,374,2
339,https://htmlpreview.github.io/?https://github.com/Christina96/boilerplate-sample-matches/blob/main/Java/VitamioBundle-MDEwOlJlcG9zaXRvcnk2MjkyMDI5-flat-Base64.java-VitamioBundle-MDEwOlJlcG9zaXRvcnk2MjkyMDI5-flat-Base64.java-339.html,46,VitamioBundle-MDEwOlJlcG9zaXRvcnk2MjkyMDI5-flat-Base64.java,VitamioBundle-MDEwOlJlcG9zaXRvcnk2MjkyMDI5-flat-Base64.java,101,105,4,144,148,4
340,https://htmlpreview.github.io/?https://github.com/Christina96/boilerplate-sample-matches/blob/main/Java/motan-MDEwOlJlcG9zaXRvcnk1NjY3OTUyMQ==-flat-UserProto.java-motan-MDEwOlJlcG9zaXRvcnk1NjY3OTUyMQ==-flat-FeatureDatabase.java-340.html,23,motan-MDEwOlJlcG9zaXRvcnk1NjY3OTUyMQ==-flat-UserProto.java,motan-MDEwOlJlcG9zaXRvcnk1NjY3OTUyMQ==-flat-FeatureDatabase.java,745,749,4,536,540,4
341,https://htmlpreview.github.io/?https://github.com/Christina96/boilerplate-sample-matches/blob/main/Java/motan-MDEwOlJlcG9zaXRvcnk1NjY3OTUyMQ==-flat-MotanGlobalConfigUtilTest.java-ribbon-MDEwOlJlcG9zaXRvcnk3NjE2MTU4-flat-DefaultNIWSServerListFilterTest.java-341.html,16,motan-MDEwOlJlcG9zaXRvcnk1NjY3OTUyMQ==-flat-MotanGlobalConfigUtilTest.java,ribbon-MDEwOlJlcG9zaXRvcnk3NjE2MTU4-flat-DefaultNIWSServerListFilterTest.java,77,79,2,150,152,2
342,https://htmlpreview.github.io/?https://github.com/Christina96/boilerplate-sample-matches/blob/main/Java/jedis-MDEwOlJlcG9zaXRvcnk3MTU2MDU=-flat-PipeliningTest.java-jedis-MDEwOlJlcG9zaXRvcnk3MTU2MDU=-flat-ClusterPipeliningTest.java-342.html,193,jedis-MDEwOlJlcG9zaXRvcnk3MTU2MDU=-flat-PipeliningTest.java,jedis-MDEwOlJlcG9zaXRvcnk3MTU2MDU=-flat-ClusterPipeliningTest.java,155,169,14,272,286,14
343,https://htmlpreview.github.io/?https://github.com/Christina96/boilerplate-sample-matches/blob/main/Java/ribbon-MDEwOlJlcG9zaXRvcnk3NjE2MTU4-flat-RxMovieProxyExampleTest_1.java-ribbon-MDEwOlJlcG9zaXRvcnk3NjE2MTU4-flat-RxMovieProxyExampleTest_1.java-343.html,62,ribbon-MDEwOlJlcG9zaXRvcnk3NjE2MTU4-flat-RxMovieProxyExampleTest_1.java,ribbon-MDEwOlJlcG9zaXRvcnk3NjE2MTU4-flat-RxMovieProxyExampleTest_1.java,56,62,6,78,84,6
344,https://htmlpreview.github.io/?https://github.com/Christina96/boilerplate-sample-matches/blob/main/Java/motan-MDEwOlJlcG9zaXRvcnk1NjY3OTUyMQ==-flat-MotanBeanDefinitionParser.java-motan-MDEwOlJlcG9zaXRvcnk1NjY3OTUyMQ==-flat-MotanBeanDefinitionParser.java-344.html,23,motan-MDEwOlJlcG9zaXRvcnk1NjY3OTUyMQ==-flat-MotanBeanDefinitionParser.java,motan-MDEwOlJlcG9zaXRvcnk1NjY3OTUyMQ==-flat-MotanBeanDefinitionParser.java,66,68,2,68,70,2
345,https://htmlpreview.github.io/?https://github.com/Christina96/boilerplate-sample-matches/blob/main/Java/google-api-java-client-samples-MDEwOlJlcG9zaXRvcnkyOTc0OTA1Mg==-flat-TaskQueueSample.java-google-api-java-client-samples-MDEwOlJlcG9zaXRvcnkyOTc0OTA1Mg==-flat-VerificationSample.java-345.html,15,google-api-java-client-samples-MDEwOlJlcG9zaXRvcnkyOTc0OTA1Mg==-flat-TaskQueueSample.java,google-api-java-client-samples-MDEwOlJlcG9zaXRvcnkyOTc0OTA1Mg==-flat-VerificationSample.java,58,61,3,72,75,3
346,https://htmlpreview.github.io/?https://github.com/Christina96/boilerplate-sample-matches/blob/main/Java/VitamioBundle-MDEwOlJlcG9zaXRvcnk2MjkyMDI5-flat-MediaScanner.java-VitamioBundle-MDEwOlJlcG9zaXRvcnk2MjkyMDI5-flat-MediaPlayer.java-346.html,19,VitamioBundle-MDEwOlJlcG9zaXRvcnk2MjkyMDI5-flat-MediaScanner.java,VitamioBundle-MDEwOlJlcG9zaXRvcnk2MjkyMDI5-flat-MediaPlayer.java,277,280,3,435,438,3
347,https://htmlpreview.github.io/?https://github.com/Christina96/boilerplate-sample-matches/blob/main/Java/jedis-MDEwOlJlcG9zaXRvcnk3MTU2MDU=-flat-CuckooTest.java-jedis-MDEwOlJlcG9zaXRvcnk3MTU2MDU=-flat-BloomTest.java-347.html,88,jedis-MDEwOlJlcG9zaXRvcnk3MTU2MDU=-flat-CuckooTest.java,jedis-MDEwOlJlcG9zaXRvcnk3MTU2MDU=-flat-BloomTest.java,204,212,8,152,160,8
348,https://htmlpreview.github.io/?https://github.com/Christina96/boilerplate-sample-matches/blob/main/Java/jedis-MDEwOlJlcG9zaXRvcnk3MTU2MDU=-flat-SortedSetCommandsTest.java-jedis-MDEwOlJlcG9zaXRvcnk3MTU2MDU=-flat-SortedSetCommandsTest.java-348.html,22,jedis-MDEwOlJlcG9zaXRvcnk3MTU2MDU=-flat-SortedSetCommandsTest.java,jedis-MDEwOlJlcG9zaXRvcnk3MTU2MDU=-flat-SortedSetCommandsTest.java,738,740,2,339,341,2
349,https://htmlpreview.github.io/?https://github.com/Christina96/boilerplate-sample-matches/blob/main/Java/Essentials-MDEwOlJlcG9zaXRvcnkxNzczNzU0-flat-LocationUtil.java-Essentials-MDEwOlJlcG9zaXRvcnkxNzczNzU0-flat-Commandlist.java-349.html,14,Essentials-MDEwOlJlcG9zaXRvcnkxNzczNzU0-flat-LocationUtil.java,Essentials-MDEwOlJlcG9zaXRvcnkxNzczNzU0-flat-Commandlist.java,184,186,2,95,97,2
350,https://htmlpreview.github.io/?https://github.com/Christina96/boilerplate-sample-matches/blob/main/Java/google-api-java-client-samples-MDEwOlJlcG9zaXRvcnkyOTc0OTA1Mg==-flat-View.java-google-api-java-client-samples-MDEwOlJlcG9zaXRvcnkyOTc0OTA1Mg==-flat-View.java-350.html,19,google-api-java-client-samples-MDEwOlJlcG9zaXRvcnkyOTc0OTA1Mg==-flat-View.java,google-api-java-client-samples-MDEwOlJlcG9zaXRvcnkyOTc0OTA1Mg==-flat-View.java,13,15,2,22,24,2
351,https://htmlpreview.github.io/?https://github.com/Christina96/boilerplate-sample-matches/blob/main/Java/jedis-MDEwOlJlcG9zaXRvcnk3MTU2MDU=-flat-RedisJsonV1Test.java-jedis-MDEwOlJlcG9zaXRvcnk3MTU2MDU=-flat-RedisJsonV1Test.java-351.html,16,jedis-MDEwOlJlcG9zaXRvcnk3MTU2MDU=-flat-RedisJsonV1Test.java,jedis-MDEwOlJlcG9zaXRvcnk3MTU2MDU=-flat-RedisJsonV1Test.java,287,288,1,335,336,1
352,https://htmlpreview.github.io/?https://github.com/Christina96/boilerplate-sample-matches/blob/main/Java/jedis-MDEwOlJlcG9zaXRvcnk3MTU2MDU=-flat-StringValuesCommandsTestBase.java-jedis-MDEwOlJlcG9zaXRvcnk3MTU2MDU=-flat-StringValuesCommandsTest.java-352.html,951,jedis-MDEwOlJlcG9zaXRvcnk3MTU2MDU=-flat-StringValuesCommandsTestBase.java,jedis-MDEwOlJlcG9zaXRvcnk3MTU2MDU=-flat-StringValuesCommandsTest.java,91,207,116,91,207,116
353,https://htmlpreview.github.io/?https://github.com/Christina96/boilerplate-sample-matches/blob/main/Java/jedis-MDEwOlJlcG9zaXRvcnk3MTU2MDU=-flat-CuckooTest.java-jedis-MDEwOlJlcG9zaXRvcnk3MTU2MDU=-flat-BloomTest.java-353.html,93,jedis-MDEwOlJlcG9zaXRvcnk3MTU2MDU=-flat-CuckooTest.java,jedis-MDEwOlJlcG9zaXRvcnk3MTU2MDU=-flat-BloomTest.java,203,212,9,151,160,9
354,https://htmlpreview.github.io/?https://github.com/Christina96/boilerplate-sample-matches/blob/main/Java/jedis-MDEwOlJlcG9zaXRvcnk3MTU2MDU=-flat-JedisClusterCRC16.java-jedis-MDEwOlJlcG9zaXRvcnk3MTU2MDU=-flat-JedisClusterCRC16.java-354.html,22,jedis-MDEwOlJlcG9zaXRvcnk3MTU2MDU=-flat-JedisClusterCRC16.java,jedis-MDEwOlJlcG9zaXRvcnk3MTU2MDU=-flat-JedisClusterCRC16.java,12,13,1,7,8,1
355,https://htmlpreview.github.io/?https://github.com/Christina96/boilerplate-sample-matches/blob/main/Java/ribbon-MDEwOlJlcG9zaXRvcnk3NjE2MTU4-flat-RibbonTest.java-ribbon-MDEwOlJlcG9zaXRvcnk3NjE2MTU4-flat-NettyClientTest.java-355.html,22,ribbon-MDEwOlJlcG9zaXRvcnk3NjE2MTU4-flat-RibbonTest.java,ribbon-MDEwOlJlcG9zaXRvcnk3NjE2MTU4-flat-NettyClientTest.java,190,196,6,634,639,5
356,https://htmlpreview.github.io/?https://github.com/Christina96/boilerplate-sample-matches/blob/main/Java/Mybatis-PageHelper-MDEwOlJlcG9zaXRvcnkyMDY1MTY3Mg==-flat-SqlTest.java-jedis-MDEwOlJlcG9zaXRvcnk3MTU2MDU=-flat-ClusterCommandsTest.java-356.html,17,Mybatis-PageHelper-MDEwOlJlcG9zaXRvcnkyMDY1MTY3Mg==-flat-SqlTest.java,jedis-MDEwOlJlcG9zaXRvcnk3MTU2MDU=-flat-ClusterCommandsTest.java,133,137,4,165,169,4
357,https://htmlpreview.github.io/?https://github.com/Christina96/boilerplate-sample-matches/blob/main/Java/motan-MDEwOlJlcG9zaXRvcnk1NjY3OTUyMQ==-flat-OpenTracingFilter.java-google-api-java-client-samples-MDEwOlJlcG9zaXRvcnkyOTc0OTA1Mg==-flat-StreetViewPublishSample.java-357.html,15,motan-MDEwOlJlcG9zaXRvcnk1NjY3OTUyMQ==-flat-OpenTracingFilter.java,google-api-java-client-samples-MDEwOlJlcG9zaXRvcnkyOTc0OTA1Mg==-flat-StreetViewPublishSample.java,108,109,1,96,97,1
358,https://htmlpreview.github.io/?https://github.com/Christina96/boilerplate-sample-matches/blob/main/Java/jedis-MDEwOlJlcG9zaXRvcnk3MTU2MDU=-flat-RedisJsonV2Commands.java-jedis-MDEwOlJlcG9zaXRvcnk3MTU2MDU=-flat-RedisJsonV1PipelineCommands.java-358.html,15,jedis-MDEwOlJlcG9zaXRvcnk3MTU2MDU=-flat-RedisJsonV2Commands.java,jedis-MDEwOlJlcG9zaXRvcnk3MTU2MDU=-flat-RedisJsonV1PipelineCommands.java,35,36,1,30,31,1
359,https://htmlpreview.github.io/?https://github.com/Christina96/boilerplate-sample-matches/blob/main/Java/jedis-MDEwOlJlcG9zaXRvcnk3MTU2MDU=-flat-MigrateTest.java-jedis-MDEwOlJlcG9zaXRvcnk3MTU2MDU=-flat-MigrateTest.java-359.html,19,jedis-MDEwOlJlcG9zaXRvcnk3MTU2MDU=-flat-MigrateTest.java,jedis-MDEwOlJlcG9zaXRvcnk3MTU2MDU=-flat-MigrateTest.java,139,141,2,126,128,2
360,https://htmlpreview.github.io/?https://github.com/Christina96/boilerplate-sample-matches/blob/main/Java/ribbon-MDEwOlJlcG9zaXRvcnk3NjE2MTU4-flat-MovieServiceInterfaces.java-ribbon-MDEwOlJlcG9zaXRvcnk3NjE2MTU4-flat-MovieServiceInterfaces_9.java-360.html,478,ribbon-MDEwOlJlcG9zaXRvcnk3NjE2MTU4-flat-MovieServiceInterfaces.java,ribbon-MDEwOlJlcG9zaXRvcnk3NjE2MTU4-flat-MovieServiceInterfaces_9.java,82,143,61,74,135,61
361,https://htmlpreview.github.io/?https://github.com/Christina96/boilerplate-sample-matches/blob/main/Java/Essentials-MDEwOlJlcG9zaXRvcnkxNzczNzU0-flat-EssentialsSign.java-Essentials-MDEwOlJlcG9zaXRvcnkxNzczNzU0-flat-EssentialsSign.java-361.html,15,Essentials-MDEwOlJlcG9zaXRvcnkxNzczNzU0-flat-EssentialsSign.java,Essentials-MDEwOlJlcG9zaXRvcnkxNzczNzU0-flat-EssentialsSign.java,42,48,6,85,91,6
362,https://htmlpreview.github.io/?https://github.com/Christina96/boilerplate-sample-matches/blob/main/Java/Mybatis-PageHelper-MDEwOlJlcG9zaXRvcnkyMDY1MTY3Mg==-flat-RowBoundsTest_1.java-Mybatis-PageHelper-MDEwOlJlcG9zaXRvcnkyMDY1MTY3Mg==-flat-RowBoundsTest_1.java-362.html,36,Mybatis-PageHelper-MDEwOlJlcG9zaXRvcnkyMDY1MTY3Mg==-flat-RowBoundsTest_1.java,Mybatis-PageHelper-MDEwOlJlcG9zaXRvcnkyMDY1MTY3Mg==-flat-RowBoundsTest_1.java,57,60,3,37,40,3
363,https://htmlpreview.github.io/?https://github.com/Christina96/boilerplate-sample-matches/blob/main/Java/Essentials-MDEwOlJlcG9zaXRvcnkxNzczNzU0-flat-Commandlist.java-Essentials-MDEwOlJlcG9zaXRvcnkxNzczNzU0-flat-Commandlist.java-363.html,24,Essentials-MDEwOlJlcG9zaXRvcnkxNzczNzU0-flat-Commandlist.java,Essentials-MDEwOlJlcG9zaXRvcnkxNzczNzU0-flat-Commandlist.java,109,111,2,70,72,2
364,https://htmlpreview.github.io/?https://github.com/Christina96/boilerplate-sample-matches/blob/main/Java/jedis-MDEwOlJlcG9zaXRvcnk3MTU2MDU=-flat-UnifiedJedis.java-jedis-MDEwOlJlcG9zaXRvcnk3MTU2MDU=-flat-UnifiedJedis.java-364.html,32,jedis-MDEwOlJlcG9zaXRvcnk3MTU2MDU=-flat-UnifiedJedis.java,jedis-MDEwOlJlcG9zaXRvcnk3MTU2MDU=-flat-UnifiedJedis.java,1125,1129,4,3181,3185,4
365,https://htmlpreview.github.io/?https://github.com/Christina96/boilerplate-sample-matches/blob/main/Java/Essentials-MDEwOlJlcG9zaXRvcnkxNzczNzU0-flat-BookInput.java-Essentials-MDEwOlJlcG9zaXRvcnkxNzczNzU0-flat-TextInput.java-365.html,54,Essentials-MDEwOlJlcG9zaXRvcnkxNzczNzU0-flat-BookInput.java,Essentials-MDEwOlJlcG9zaXRvcnkxNzczNzU0-flat-TextInput.java,29,41,12,104,116,12
366,https://htmlpreview.github.io/?https://github.com/Christina96/boilerplate-sample-matches/blob/main/Java/jedis-MDEwOlJlcG9zaXRvcnk3MTU2MDU=-flat-ShardingTest.java-jedis-MDEwOlJlcG9zaXRvcnk3MTU2MDU=-flat-ShardingTest.java-366.html,74,jedis-MDEwOlJlcG9zaXRvcnk3MTU2MDU=-flat-ShardingTest.java,jedis-MDEwOlJlcG9zaXRvcnk3MTU2MDU=-flat-ShardingTest.java,34,45,11,84,95,11
367,https://htmlpreview.github.io/?https://github.com/Christina96/boilerplate-sample-matches/blob/main/Java/BungeeCord-MDEwOlJlcG9zaXRvcnk2MDg0MjEw-flat-InitialHandler.java-BungeeCord-MDEwOlJlcG9zaXRvcnk2MDg0MjEw-flat-ServerPing.java-367.html,15,BungeeCord-MDEwOlJlcG9zaXRvcnk2MDg0MjEw-flat-InitialHandler.java,BungeeCord-MDEwOlJlcG9zaXRvcnk2MDg0MjEw-flat-ServerPing.java,618,620,2,59,61,2
368,https://htmlpreview.github.io/?https://github.com/Christina96/boilerplate-sample-matches/blob/main/Java/VitamioBundle-MDEwOlJlcG9zaXRvcnk2MjkyMDI5-flat-FileUtils.java-motan-MDEwOlJlcG9zaXRvcnk1NjY3OTUyMQ==-flat-ReflectUtil.java-368.html,17,VitamioBundle-MDEwOlJlcG9zaXRvcnk2MjkyMDI5-flat-FileUtils.java,motan-MDEwOlJlcG9zaXRvcnk1NjY3OTUyMQ==-flat-ReflectUtil.java,48,50,2,32,34,2
369,https://htmlpreview.github.io/?https://github.com/Christina96/boilerplate-sample-matches/blob/main/Java/ribbon-MDEwOlJlcG9zaXRvcnk3NjE2MTU4-flat-LoadBalancerStats.java-ribbon-MDEwOlJlcG9zaXRvcnk3NjE2MTU4-flat-LoadBalancerStats.java-369.html,15,ribbon-MDEwOlJlcG9zaXRvcnk3NjE2MTU4-flat-LoadBalancerStats.java,ribbon-MDEwOlJlcG9zaXRvcnk3NjE2MTU4-flat-LoadBalancerStats.java,165,168,3,140,143,3
370,https://htmlpreview.github.io/?https://github.com/Christina96/boilerplate-sample-matches/blob/main/Java/BungeeCord-MDEwOlJlcG9zaXRvcnk2MDg0MjEw-flat-BossBar.java-BungeeCord-MDEwOlJlcG9zaXRvcnk2MDg0MjEw-flat-EntityMap.java-370.html,21,BungeeCord-MDEwOlJlcG9zaXRvcnk2MDg0MjEw-flat-BossBar.java,BungeeCord-MDEwOlJlcG9zaXRvcnk2MDg0MjEw-flat-EntityMap.java,68,73,5,273,278,5
371,https://htmlpreview.github.io/?https://github.com/Christina96/boilerplate-sample-matches/blob/main/Java/Essentials-MDEwOlJlcG9zaXRvcnkxNzczNzU0-flat-EssentialsLoopCommand.java-Essentials-MDEwOlJlcG9zaXRvcnkxNzczNzU0-flat-EssentialsSign.java-371.html,15,Essentials-MDEwOlJlcG9zaXRvcnkxNzczNzU0-flat-EssentialsLoopCommand.java,Essentials-MDEwOlJlcG9zaXRvcnkxNzczNzU0-flat-EssentialsSign.java,131,134,3,453,456,3
372,https://htmlpreview.github.io/?https://github.com/Christina96/boilerplate-sample-matches/blob/main/Java/motan-MDEwOlJlcG9zaXRvcnk1NjY3OTUyMQ==-flat-ReflectUtil.java-motan-MDEwOlJlcG9zaXRvcnk1NjY3OTUyMQ==-flat-AbstractEndpointFactory_5.java-372.html,20,motan-MDEwOlJlcG9zaXRvcnk1NjY3OTUyMQ==-flat-ReflectUtil.java,motan-MDEwOlJlcG9zaXRvcnk1NjY3OTUyMQ==-flat-AbstractEndpointFactory_5.java,61,65,4,48,52,4
373,https://htmlpreview.github.io/?https://github.com/Christina96/boilerplate-sample-matches/blob/main/Java/VitamioBundle-MDEwOlJlcG9zaXRvcnk2MjkyMDI5-flat-Vitamio.java-VitamioBundle-MDEwOlJlcG9zaXRvcnk2MjkyMDI5-flat-Vitamio.java-373.html,31,VitamioBundle-MDEwOlJlcG9zaXRvcnk2MjkyMDI5-flat-Vitamio.java,VitamioBundle-MDEwOlJlcG9zaXRvcnk2MjkyMDI5-flat-Vitamio.java,37,40,3,39,42,3
374,https://htmlpreview.github.io/?https://github.com/Christina96/boilerplate-sample-matches/blob/main/Java/Essentials-MDEwOlJlcG9zaXRvcnkxNzczNzU0-flat-ToggleTest.java-Essentials-MDEwOlJlcG9zaXRvcnkxNzczNzU0-flat-ToggleTest.java-374.html,21,Essentials-MDEwOlJlcG9zaXRvcnkxNzczNzU0-flat-ToggleTest.java,Essentials-MDEwOlJlcG9zaXRvcnkxNzczNzU0-flat-ToggleTest.java,167,170,3,172,175,3
375,https://htmlpreview.github.io/?https://github.com/Christina96/boilerplate-sample-matches/blob/main/Java/jedis-MDEwOlJlcG9zaXRvcnk3MTU2MDU=-flat-BinaryValuesCommandsTest.java-jedis-MDEwOlJlcG9zaXRvcnk3MTU2MDU=-flat-BinaryValuesCommandsTestBase.java-375.html,27,jedis-MDEwOlJlcG9zaXRvcnk3MTU2MDU=-flat-BinaryValuesCommandsTest.java,jedis-MDEwOlJlcG9zaXRvcnk3MTU2MDU=-flat-BinaryValuesCommandsTestBase.java,61,62,1,61,62,1
376,https://htmlpreview.github.io/?https://github.com/Christina96/boilerplate-sample-matches/blob/main/Java/jedis-MDEwOlJlcG9zaXRvcnk3MTU2MDU=-flat-RetryableCommandExecutor.java-jedis-MDEwOlJlcG9zaXRvcnk3MTU2MDU=-flat-ClusterCommandExecutor.java-376.html,51,jedis-MDEwOlJlcG9zaXRvcnk3MTU2MDU=-flat-RetryableCommandExecutor.java,jedis-MDEwOlJlcG9zaXRvcnk3MTU2MDU=-flat-ClusterCommandExecutor.java,56,63,7,111,118,7
377,https://htmlpreview.github.io/?https://github.com/Christina96/boilerplate-sample-matches/blob/main/Java/jedis-MDEwOlJlcG9zaXRvcnk3MTU2MDU=-flat-SortedSetCommandsTest.java-jedis-MDEwOlJlcG9zaXRvcnk3MTU2MDU=-flat-SortedSetCommandsTest.java-377.html,16,jedis-MDEwOlJlcG9zaXRvcnk3MTU2MDU=-flat-SortedSetCommandsTest.java,jedis-MDEwOlJlcG9zaXRvcnk3MTU2MDU=-flat-SortedSetCommandsTest.java,322,326,4,571,575,4
378,https://htmlpreview.github.io/?https://github.com/Christina96/boilerplate-sample-matches/blob/main/Java/jedis-MDEwOlJlcG9zaXRvcnk3MTU2MDU=-flat-SortedSetCommandsTest.java-jedis-MDEwOlJlcG9zaXRvcnk3MTU2MDU=-flat-SortedSetCommandsTestBase.java-378.html,4395,jedis-MDEwOlJlcG9zaXRvcnk3MTU2MDU=-flat-SortedSetCommandsTest.java,jedis-MDEwOlJlcG9zaXRvcnk3MTU2MDU=-flat-SortedSetCommandsTestBase.java,251,674,423,294,717,423
379,https://htmlpreview.github.io/?https://github.com/Christina96/boilerplate-sample-matches/blob/main/Java/motan-MDEwOlJlcG9zaXRvcnk1NjY3OTUyMQ==-flat-DefaultRpcCodec.java-motan-MDEwOlJlcG9zaXRvcnk1NjY3OTUyMQ==-flat-CompressRpcCodec.java-379.html,48,motan-MDEwOlJlcG9zaXRvcnk1NjY3OTUyMQ==-flat-DefaultRpcCodec.java,motan-MDEwOlJlcG9zaXRvcnk1NjY3OTUyMQ==-flat-CompressRpcCodec.java,205,209,4,387,391,4
380,https://htmlpreview.github.io/?https://github.com/Christina96/boilerplate-sample-matches/blob/main/Java/motan-MDEwOlJlcG9zaXRvcnk1NjY3OTUyMQ==-flat-ConsulCommandService.java-motan-MDEwOlJlcG9zaXRvcnk1NjY3OTUyMQ==-flat-ZookeeperRegistryService.java-380.html,20,motan-MDEwOlJlcG9zaXRvcnk1NjY3OTUyMQ==-flat-ConsulCommandService.java,motan-MDEwOlJlcG9zaXRvcnk1NjY3OTUyMQ==-flat-ZookeeperRegistryService.java,27,31,4,26,30,4
381,https://htmlpreview.github.io/?https://github.com/Christina96/boilerplate-sample-matches/blob/main/Java/jedis-MDEwOlJlcG9zaXRvcnk3MTU2MDU=-flat-MurmurHash.java-motan-MDEwOlJlcG9zaXRvcnk1NjY3OTUyMQ==-flat-ByteUtil.java-381.html,14,jedis-MDEwOlJlcG9zaXRvcnk3MTU2MDU=-flat-MurmurHash.java,motan-MDEwOlJlcG9zaXRvcnk1NjY3OTUyMQ==-flat-ByteUtil.java,6,7,1,52,53,1
382,https://htmlpreview.github.io/?https://github.com/Christina96/boilerplate-sample-matches/blob/main/Java/motan-MDEwOlJlcG9zaXRvcnk1NjY3OTUyMQ==-flat-DefaultProtectedStrategy.java-ribbon-MDEwOlJlcG9zaXRvcnk3NjE2MTU4-flat-PredicateBasedRule.java-382.html,15,motan-MDEwOlJlcG9zaXRvcnk1NjY3OTUyMQ==-flat-DefaultProtectedStrategy.java,ribbon-MDEwOlJlcG9zaXRvcnk3NjE2MTU4-flat-PredicateBasedRule.java,104,109,5,10,15,5
