ID,Link,Similarity,Tokens,File 1,File 2,Start 1,End 1,Detected Lines 1,Start 2,End 2,Detected Lines 2
127,https://htmlpreview.github.io/?https://github.com/Christina96/boilerplate-sample-matches/blob/main/Java/BungeeCord-MDEwOlJlcG9zaXRvcnk2MDg0MjEw-flat-ColouredWriter.java-Essentials-MDEwOlJlcG9zaXRvcnkxNzczNzU0-flat-Commandbalancetop.java.html,0.046948356807511735,10,BungeeCord-MDEwOlJlcG9zaXRvcnk2MDg0MjEw-flat-ColouredWriter.java,Essentials-MDEwOlJlcG9zaXRvcnkxNzczNzU0-flat-Commandbalancetop.java,1,10,9,1,10,9
1363,https://htmlpreview.github.io/?https://github.com/Christina96/boilerplate-sample-matches/blob/main/Java/motan-MDEwOlJlcG9zaXRvcnk1NjY3OTUyMQ==-flat-MockServer.java-motan-MDEwOlJlcG9zaXRvcnk1NjY3OTUyMQ==-flat-DefaultHttpMeshTransport.java.html,0.0966183574879227,10,motan-MDEwOlJlcG9zaXRvcnk1NjY3OTUyMQ==-flat-MockServer.java,motan-MDEwOlJlcG9zaXRvcnk1NjY3OTUyMQ==-flat-DefaultHttpMeshTransport.java,2,11,9,15,24,9
4166,https://htmlpreview.github.io/?https://github.com/Christina96/boilerplate-sample-matches/blob/main/Java/segmentfault-lessons-MDEwOlJlcG9zaXRvcnk5MzE1NzM4MQ==-flat-JavaClassMemberDemo.java-ribbon-MDEwOlJlcG9zaXRvcnk3NjE2MTU4-flat-MethodTemplateExecutorTest.java.html,0.10897435897435898,17,segmentfault-lessons-MDEwOlJlcG9zaXRvcnk5MzE1NzM4MQ==-flat-JavaClassMemberDemo.java,ribbon-MDEwOlJlcG9zaXRvcnk3NjE2MTU4-flat-MethodTemplateExecutorTest.java,15,18,3,101,106,5
7501,https://htmlpreview.github.io/?https://github.com/Christina96/boilerplate-sample-matches/blob/main/Java/Essentials-MDEwOlJlcG9zaXRvcnkxNzczNzU0-flat-Commandworld.java-Essentials-MDEwOlJlcG9zaXRvcnkxNzczNzU0-flat-Commandexp.java.html,0.1016949152542373,18,Essentials-MDEwOlJlcG9zaXRvcnkxNzczNzU0-flat-Commandworld.java,Essentials-MDEwOlJlcG9zaXRvcnkxNzczNzU0-flat-Commandexp.java,2,17,15,3,18,15
8317,https://htmlpreview.github.io/?https://github.com/Christina96/boilerplate-sample-matches/blob/main/Java/ribbon-MDEwOlJlcG9zaXRvcnk3NjE2MTU4-flat-MethodTemplateExecutor.java-ribbon-MDEwOlJlcG9zaXRvcnk3NjE2MTU4-flat-HttpRequestTemplate.java.html,0.1111111111111111,10,ribbon-MDEwOlJlcG9zaXRvcnk3NjE2MTU4-flat-MethodTemplateExecutor.java,ribbon-MDEwOlJlcG9zaXRvcnk3NjE2MTU4-flat-HttpRequestTemplate.java,32,38,6,35,41,6
8862,https://htmlpreview.github.io/?https://github.com/Christina96/boilerplate-sample-matches/blob/main/Java/motan-MDEwOlJlcG9zaXRvcnk1NjY3OTUyMQ==-flat-LocalRegistryService.java-BungeeCord-MDEwOlJlcG9zaXRvcnk2MDg0MjEw-flat-DefinedPacket.java.html,0.09009009009009009,10,motan-MDEwOlJlcG9zaXRvcnk1NjY3OTUyMQ==-flat-LocalRegistryService.java,BungeeCord-MDEwOlJlcG9zaXRvcnk2MDg0MjEw-flat-DefinedPacket.java,121,127,6,191,199,8
9774,https://htmlpreview.github.io/?https://github.com/Christina96/boilerplate-sample-matches/blob/main/Java/motan-MDEwOlJlcG9zaXRvcnk1NjY3OTUyMQ==-flat-AbstractRefererHandler.java-motan-MDEwOlJlcG9zaXRvcnk1NjY3OTUyMQ==-flat-MotanBeanDefinitionParser.java.html,0.08442503639010189,19,motan-MDEwOlJlcG9zaXRvcnk1NjY3OTUyMQ==-flat-AbstractRefererHandler.java,motan-MDEwOlJlcG9zaXRvcnk1NjY3OTUyMQ==-flat-MotanBeanDefinitionParser.java,1,19,18,1,19,18
9814,https://htmlpreview.github.io/?https://github.com/Christina96/boilerplate-sample-matches/blob/main/Java/motan-MDEwOlJlcG9zaXRvcnk1NjY3OTUyMQ==-flat-YarMessageRouter.java-motan-MDEwOlJlcG9zaXRvcnk1NjY3OTUyMQ==-flat-ConsulRegistry.java.html,0.08098591549295775,10,motan-MDEwOlJlcG9zaXRvcnk1NjY3OTUyMQ==-flat-YarMessageRouter.java,motan-MDEwOlJlcG9zaXRvcnk1NjY3OTUyMQ==-flat-ConsulRegistry.java,40,45,5,71,77,6
10353,https://htmlpreview.github.io/?https://github.com/Christina96/boilerplate-sample-matches/blob/main/Java/jedis-MDEwOlJlcG9zaXRvcnk3MTU2MDU=-flat-XPendingParams.java-ribbon-MDEwOlJlcG9zaXRvcnk3NjE2MTU4-flat-ResponseTimeWeightedRule.java.html,0.057803468208092484,10,jedis-MDEwOlJlcG9zaXRvcnk3MTU2MDU=-flat-XPendingParams.java,ribbon-MDEwOlJlcG9zaXRvcnk3NjE2MTU4-flat-ResponseTimeWeightedRule.java,2,11,9,7,16,9
11193,https://htmlpreview.github.io/?https://github.com/Christina96/boilerplate-sample-matches/blob/main/Java/Mybatis-PageHelper-MDEwOlJlcG9zaXRvcnkyMDY1MTY3Mg==-flat-FunctionCountTest.java-ribbon-MDEwOlJlcG9zaXRvcnk3NjE2MTU4-flat-MovieService.java.html,0.11764705882352941,12,Mybatis-PageHelper-MDEwOlJlcG9zaXRvcnkyMDY1MTY3Mg==-flat-FunctionCountTest.java,ribbon-MDEwOlJlcG9zaXRvcnk3NjE2MTU4-flat-MovieService.java,1,12,11,1,12,11
12733,https://htmlpreview.github.io/?https://github.com/Christina96/boilerplate-sample-matches/blob/main/Java/ribbon-MDEwOlJlcG9zaXRvcnk3NjE2MTU4-flat-RibbonModule.java-BungeeCord-MDEwOlJlcG9zaXRvcnk2MDg0MjEw-flat-Respawn.java.html,0.12987012987012986,10,ribbon-MDEwOlJlcG9zaXRvcnk3NjE2MTU4-flat-RibbonModule.java,BungeeCord-MDEwOlJlcG9zaXRvcnk2MDg0MjEw-flat-Respawn.java,1,10,9,1,10,9
15992,https://htmlpreview.github.io/?https://github.com/Christina96/boilerplate-sample-matches/blob/main/Java/Mybatis-PageHelper-MDEwOlJlcG9zaXRvcnkyMDY1MTY3Mg==-flat-MySqlDialect.java-motan-MDEwOlJlcG9zaXRvcnk1NjY3OTUyMQ==-flat-YarProtocolUtil.java.html,0.12921348314606743,13,Mybatis-PageHelper-MDEwOlJlcG9zaXRvcnkyMDY1MTY3Mg==-flat-MySqlDialect.java,motan-MDEwOlJlcG9zaXRvcnk1NjY3OTUyMQ==-flat-YarProtocolUtil.java,2,14,12,4,16,12
16011,https://htmlpreview.github.io/?https://github.com/Christina96/boilerplate-sample-matches/blob/main/Java/jedis-MDEwOlJlcG9zaXRvcnk3MTU2MDU=-flat-UtilsTest.java-jedis-MDEwOlJlcG9zaXRvcnk3MTU2MDU=-flat-SetCommandsTestBase.java.html,0.07048458149779736,12,jedis-MDEwOlJlcG9zaXRvcnk3MTU2MDU=-flat-UtilsTest.java,jedis-MDEwOlJlcG9zaXRvcnk3MTU2MDU=-flat-SetCommandsTestBase.java,26,33,7,345,355,10
17834,https://htmlpreview.github.io/?https://github.com/Christina96/boilerplate-sample-matches/blob/main/Java/Mybatis-PageHelper-MDEwOlJlcG9zaXRvcnkyMDY1MTY3Mg==-flat-IPageTest.java-motan-MDEwOlJlcG9zaXRvcnk1NjY3OTUyMQ==-flat-ConsulCommandService.java.html,0.1134020618556701,11,Mybatis-PageHelper-MDEwOlJlcG9zaXRvcnkyMDY1MTY3Mg==-flat-IPageTest.java,motan-MDEwOlJlcG9zaXRvcnk1NjY3OTUyMQ==-flat-ConsulCommandService.java,1,11,10,1,11,10
21189,https://htmlpreview.github.io/?https://github.com/Christina96/boilerplate-sample-matches/blob/main/Java/ribbon-MDEwOlJlcG9zaXRvcnk3NjE2MTU4-flat-MethodTemplateTest.java-BungeeCord-MDEwOlJlcG9zaXRvcnk2MDg0MjEw-flat-Protocol.java.html,0.06321839080459771,11,ribbon-MDEwOlJlcG9zaXRvcnk3NjE2MTU4-flat-MethodTemplateTest.java,BungeeCord-MDEwOlJlcG9zaXRvcnk2MDg0MjEw-flat-Protocol.java,1,11,10,1,11,10
21912,https://htmlpreview.github.io/?https://github.com/Christina96/boilerplate-sample-matches/blob/main/Java/segmentfault-lessons-MDEwOlJlcG9zaXRvcnk5MzE1NzM4MQ==-flat-AbstractQueuedSynchronizerDemo.java-google-api-java-client-samples-MDEwOlJlcG9zaXRvcnkyOTc0OTA1Mg==-flat-GenerateReport.java.html,0.2,13,segmentfault-lessons-MDEwOlJlcG9zaXRvcnk5MzE1NzM4MQ==-flat-AbstractQueuedSynchronizerDemo.java,google-api-java-client-samples-MDEwOlJlcG9zaXRvcnkyOTc0OTA1Mg==-flat-GenerateReport.java,1,12,11,1,12,11
22999,https://htmlpreview.github.io/?https://github.com/Christina96/boilerplate-sample-matches/blob/main/Java/BungeeCord-MDEwOlJlcG9zaXRvcnk2MDg0MjEw-flat-ScoreboardScore.java-BungeeCord-MDEwOlJlcG9zaXRvcnk2MDg0MjEw-flat-LoginSuccess.java.html,0.6956521739130435,11,BungeeCord-MDEwOlJlcG9zaXRvcnk2MDg0MjEw-flat-ScoreboardScore.java,BungeeCord-MDEwOlJlcG9zaXRvcnk2MDg0MjEw-flat-LoginSuccess.java,36,47,11,47,58,11
25403,https://htmlpreview.github.io/?https://github.com/Christina96/boilerplate-sample-matches/blob/main/Java/jedis-MDEwOlJlcG9zaXRvcnk3MTU2MDU=-flat-TimeSeriesBuilderFactory.java-google-api-java-client-samples-MDEwOlJlcG9zaXRvcnkyOTc0OTA1Mg==-flat-McfReportingApiReferenceSample.java.html,0.08030592734225621,10,jedis-MDEwOlJlcG9zaXRvcnk3MTU2MDU=-flat-TimeSeriesBuilderFactory.java,google-api-java-client-samples-MDEwOlJlcG9zaXRvcnkyOTc0OTA1Mg==-flat-McfReportingApiReferenceSample.java,56,59,3,105,110,5
30089,https://htmlpreview.github.io/?https://github.com/Christina96/boilerplate-sample-matches/blob/main/Java/SpringPetClinic-MDEwOlJlcG9zaXRvcnkzMDkzNDMzNTE=-flat-VetControllerTests.java-motan-MDEwOlJlcG9zaXRvcnk1NjY3OTUyMQ==-flat-AccessStatisticFilterTest.java.html,0.4,11,SpringPetClinic-MDEwOlJlcG9zaXRvcnkzMDkzNDMzNTE=-flat-VetControllerTests.java,motan-MDEwOlJlcG9zaXRvcnk1NjY3OTUyMQ==-flat-AccessStatisticFilterTest.java,45,48,3,41,46,5
32326,https://htmlpreview.github.io/?https://github.com/Christina96/boilerplate-sample-matches/blob/main/Java/ribbon-MDEwOlJlcG9zaXRvcnk3NjE2MTU4-flat-ServerStatusChangeListenerTest.java-jedis-MDEwOlJlcG9zaXRvcnk3MTU2MDU=-flat-SlowlogCommandsTest.java.html,0.4827586206896552,15,ribbon-MDEwOlJlcG9zaXRvcnk3NjE2MTU4-flat-ServerStatusChangeListenerTest.java,jedis-MDEwOlJlcG9zaXRvcnk3MTU2MDU=-flat-SlowlogCommandsTest.java,41,46,5,68,73,5
33990,https://htmlpreview.github.io/?https://github.com/Christina96/boilerplate-sample-matches/blob/main/Java/BungeeCord-MDEwOlJlcG9zaXRvcnk2MDg0MjEw-flat-Util.java-jedis-MDEwOlJlcG9zaXRvcnk3MTU2MDU=-flat-Values.java.html,0.10212765957446808,12,BungeeCord-MDEwOlJlcG9zaXRvcnk2MDg0MjEw-flat-Util.java,jedis-MDEwOlJlcG9zaXRvcnk3MTU2MDU=-flat-Values.java,45,53,8,51,57,6
36186,https://htmlpreview.github.io/?https://github.com/Christina96/boilerplate-sample-matches/blob/main/Java/SpringPetClinic-MDEwOlJlcG9zaXRvcnkzMDkzNDMzNTE=-flat-VisitController.java-VitamioBundle-MDEwOlJlcG9zaXRvcnk2MjkyMDI5-flat-ScreenResolution.java.html,0.16806722689075632,10,SpringPetClinic-MDEwOlJlcG9zaXRvcnkzMDkzNDMzNTE=-flat-VisitController.java,VitamioBundle-MDEwOlJlcG9zaXRvcnk2MjkyMDI5-flat-ScreenResolution.java,1,10,9,1,10,9
41091,https://htmlpreview.github.io/?https://github.com/Christina96/boilerplate-sample-matches/blob/main/Java/segmentfault-lessons-MDEwOlJlcG9zaXRvcnk5MzE1NzM4MQ==-flat-MyFilter2.java-segmentfault-lessons-MDEwOlJlcG9zaXRvcnk5MzE1NzM4MQ==-flat-UserRibbonController_25.java.html,0.2682926829268293,11,segmentfault-lessons-MDEwOlJlcG9zaXRvcnk5MzE1NzM4MQ==-flat-MyFilter2.java,segmentfault-lessons-MDEwOlJlcG9zaXRvcnk5MzE1NzM4MQ==-flat-UserRibbonController_25.java,1,11,10,1,11,10
45149,https://htmlpreview.github.io/?https://github.com/Christina96/boilerplate-sample-matches/blob/main/Java/Mybatis-PageHelper-MDEwOlJlcG9zaXRvcnkyMDY1MTY3Mg==-flat-EnumTest.java-google-api-java-client-samples-MDEwOlJlcG9zaXRvcnkyOTc0OTA1Mg==-flat-Deviceinfoendpoint_26.java.html,0.05305039787798409,10,Mybatis-PageHelper-MDEwOlJlcG9zaXRvcnkyMDY1MTY3Mg==-flat-EnumTest.java,google-api-java-client-samples-MDEwOlJlcG9zaXRvcnkyOTc0OTA1Mg==-flat-Deviceinfoendpoint_26.java,1,10,9,1,10,9
45850,https://htmlpreview.github.io/?https://github.com/Christina96/boilerplate-sample-matches/blob/main/Java/motan-MDEwOlJlcG9zaXRvcnk1NjY3OTUyMQ==-flat-Netty4HttpServer.java-motan-MDEwOlJlcG9zaXRvcnk1NjY3OTUyMQ==-flat-RegistryConfig.java.html,0.0867579908675799,19,motan-MDEwOlJlcG9zaXRvcnk1NjY3OTUyMQ==-flat-Netty4HttpServer.java,motan-MDEwOlJlcG9zaXRvcnk1NjY3OTUyMQ==-flat-RegistryConfig.java,18,36,18,2,20,18
47994,https://htmlpreview.github.io/?https://github.com/Christina96/boilerplate-sample-matches/blob/main/Java/Mybatis-PageHelper-MDEwOlJlcG9zaXRvcnkyMDY1MTY3Mg==-flat-TestGroupBy.java-Essentials-MDEwOlJlcG9zaXRvcnkxNzczNzU0-flat-UserData.java.html,0.02047082906857728,10,Mybatis-PageHelper-MDEwOlJlcG9zaXRvcnkyMDY1MTY3Mg==-flat-TestGroupBy.java,Essentials-MDEwOlJlcG9zaXRvcnkxNzczNzU0-flat-UserData.java,1,10,9,1,10,9
48858,https://htmlpreview.github.io/?https://github.com/Christina96/boilerplate-sample-matches/blob/main/Java/ribbon-MDEwOlJlcG9zaXRvcnk3NjE2MTU4-flat-PingUrl.java-ribbon-MDEwOlJlcG9zaXRvcnk3NjE2MTU4-flat-EurekaDynamicServerListLoadBalancerTest.java.html,0.06666666666666667,10,ribbon-MDEwOlJlcG9zaXRvcnk3NjE2MTU4-flat-PingUrl.java,ribbon-MDEwOlJlcG9zaXRvcnk3NjE2MTU4-flat-EurekaDynamicServerListLoadBalancerTest.java,1,10,9,1,10,9
52757,https://htmlpreview.github.io/?https://github.com/Christina96/boilerplate-sample-matches/blob/main/Java/Mybatis-PageHelper-MDEwOlJlcG9zaXRvcnkyMDY1MTY3Mg==-flat-TestExample.java-google-api-java-client-samples-MDEwOlJlcG9zaXRvcnkyOTc0OTA1Mg==-flat-GenerateReportWithPaging_8.java.html,0.19704433497536947,10,Mybatis-PageHelper-MDEwOlJlcG9zaXRvcnkyMDY1MTY3Mg==-flat-TestExample.java,google-api-java-client-samples-MDEwOlJlcG9zaXRvcnkyOTc0OTA1Mg==-flat-GenerateReportWithPaging_8.java,1,10,9,1,10,9
53478,https://htmlpreview.github.io/?https://github.com/Christina96/boilerplate-sample-matches/blob/main/Java/google-api-java-client-samples-MDEwOlJlcG9zaXRvcnkyOTc0OTA1Mg==-flat-BigqueryUtils.java-Essentials-MDEwOlJlcG9zaXRvcnkxNzczNzU0-flat-UtilTest.java.html,0.0411663807890223,12,google-api-java-client-samples-MDEwOlJlcG9zaXRvcnkyOTc0OTA1Mg==-flat-BigqueryUtils.java,Essentials-MDEwOlJlcG9zaXRvcnkxNzczNzU0-flat-UtilTest.java,13,24,11,2,14,12
55746,https://htmlpreview.github.io/?https://github.com/Christina96/boilerplate-sample-matches/blob/main/Java/motan-MDEwOlJlcG9zaXRvcnk1NjY3OTUyMQ==-flat-YarMessageHandlerWarpperTest.java-jedis-MDEwOlJlcG9zaXRvcnk3MTU2MDU=-flat-AggregationTest.java.html,0.13730569948186527,10,motan-MDEwOlJlcG9zaXRvcnk1NjY3OTUyMQ==-flat-YarMessageHandlerWarpperTest.java,jedis-MDEwOlJlcG9zaXRvcnk3MTU2MDU=-flat-AggregationTest.java,49,56,7,118,125,7
56360,https://htmlpreview.github.io/?https://github.com/Christina96/boilerplate-sample-matches/blob/main/Java/segmentfault-lessons-MDEwOlJlcG9zaXRvcnk5MzE1NzM4MQ==-flat-Compiler.java-ribbon-MDEwOlJlcG9zaXRvcnk3NjE2MTU4-flat-HttpRequestTemplate.java.html,0.07602339181286549,13,segmentfault-lessons-MDEwOlJlcG9zaXRvcnk5MzE1NzM4MQ==-flat-Compiler.java,ribbon-MDEwOlJlcG9zaXRvcnk3NjE2MTU4-flat-HttpRequestTemplate.java,1,13,12,1,13,12
57558,https://htmlpreview.github.io/?https://github.com/Christina96/boilerplate-sample-matches/blob/main/Java/Essentials-MDEwOlJlcG9zaXRvcnkxNzczNzU0-flat-Economy_16.java-ribbon-MDEwOlJlcG9zaXRvcnk3NjE2MTU4-flat-ServerStats.java.html,0.06060606060606061,11,Essentials-MDEwOlJlcG9zaXRvcnkxNzczNzU0-flat-Economy_16.java,ribbon-MDEwOlJlcG9zaXRvcnk3NjE2MTU4-flat-ServerStats.java,50,56,6,318,323,5
58271,https://htmlpreview.github.io/?https://github.com/Christina96/boilerplate-sample-matches/blob/main/Java/Essentials-MDEwOlJlcG9zaXRvcnkxNzczNzU0-flat-Commandspawn.java-jedis-MDEwOlJlcG9zaXRvcnk3MTU2MDU=-flat-MultiClusterPooledConnectionProvider.java.html,0.16120906801007556,12,Essentials-MDEwOlJlcG9zaXRvcnkxNzczNzU0-flat-Commandspawn.java,jedis-MDEwOlJlcG9zaXRvcnk3MTU2MDU=-flat-MultiClusterPooledConnectionProvider.java,1,12,11,1,12,11
58796,https://htmlpreview.github.io/?https://github.com/Christina96/boilerplate-sample-matches/blob/main/Java/jedis-MDEwOlJlcG9zaXRvcnk3MTU2MDU=-flat-ScanParams.java-motan-MDEwOlJlcG9zaXRvcnk1NjY3OTUyMQ==-flat-DefaultProtectedStrategyTest.java.html,0.08208955223880597,11,jedis-MDEwOlJlcG9zaXRvcnk3MTU2MDU=-flat-ScanParams.java,motan-MDEwOlJlcG9zaXRvcnk1NjY3OTUyMQ==-flat-DefaultProtectedStrategyTest.java,1,11,10,1,11,10
65175,https://htmlpreview.github.io/?https://github.com/Christina96/boilerplate-sample-matches/blob/main/Java/Mybatis-PageHelper-MDEwOlJlcG9zaXRvcnkyMDY1MTY3Mg==-flat-TestDynamicWhere.java-Mybatis-PageHelper-MDEwOlJlcG9zaXRvcnkyMDY1MTY3Mg==-flat-IPageTest.java.html,0.7058823529411765,12,Mybatis-PageHelper-MDEwOlJlcG9zaXRvcnkyMDY1MTY3Mg==-flat-TestDynamicWhere.java,Mybatis-PageHelper-MDEwOlJlcG9zaXRvcnkyMDY1MTY3Mg==-flat-IPageTest.java,26,32,6,34,40,6
65806,https://htmlpreview.github.io/?https://github.com/Christina96/boilerplate-sample-matches/blob/main/Java/BungeeCord-MDEwOlJlcG9zaXRvcnk2MDg0MjEw-flat-HttpInitializer.java-Mybatis-PageHelper-MDEwOlJlcG9zaXRvcnkyMDY1MTY3Mg==-flat-UserMapper.java.html,0.09302325581395349,10,BungeeCord-MDEwOlJlcG9zaXRvcnk2MDg0MjEw-flat-HttpInitializer.java,Mybatis-PageHelper-MDEwOlJlcG9zaXRvcnkyMDY1MTY3Mg==-flat-UserMapper.java,1,10,9,1,10,9
65923,https://htmlpreview.github.io/?https://github.com/Christina96/boilerplate-sample-matches/blob/main/Java/motan-MDEwOlJlcG9zaXRvcnk1NjY3OTUyMQ==-flat-SpringBeanUtil.java-google-api-java-client-samples-MDEwOlJlcG9zaXRvcnkyOTc0OTA1Mg==-flat-BigqueryUtils.java.html,0.06472491909385113,10,motan-MDEwOlJlcG9zaXRvcnk1NjY3OTUyMQ==-flat-SpringBeanUtil.java,google-api-java-client-samples-MDEwOlJlcG9zaXRvcnkyOTc0OTA1Mg==-flat-BigqueryUtils.java,2,11,9,15,24,9
65953,https://htmlpreview.github.io/?https://github.com/Christina96/boilerplate-sample-matches/blob/main/Java/SpringPetClinic-MDEwOlJlcG9zaXRvcnkzMDkzNDMzNTE=-flat-PetValidator.java-google-api-java-client-samples-MDEwOlJlcG9zaXRvcnkyOTc0OTA1Mg==-flat-OAuth2Callback.java.html,0.25316455696202533,10,SpringPetClinic-MDEwOlJlcG9zaXRvcnkzMDkzNDMzNTE=-flat-PetValidator.java,google-api-java-client-samples-MDEwOlJlcG9zaXRvcnkyOTc0OTA1Mg==-flat-OAuth2Callback.java,2,9,7,8,14,6
66137,https://htmlpreview.github.io/?https://github.com/Christina96/boilerplate-sample-matches/blob/main/Java/VitamioBundle-MDEwOlJlcG9zaXRvcnk2MjkyMDI5-flat-MediaPlayerDemo_Video.java-jedis-MDEwOlJlcG9zaXRvcnk3MTU2MDU=-flat-JedisPool.java.html,0.09446693657219973,14,VitamioBundle-MDEwOlJlcG9zaXRvcnk2MjkyMDI5-flat-MediaPlayerDemo_Video.java,jedis-MDEwOlJlcG9zaXRvcnk3MTU2MDU=-flat-JedisPool.java,17,30,13,211,215,4
67024,https://htmlpreview.github.io/?https://github.com/Christina96/boilerplate-sample-matches/blob/main/Java/motan-MDEwOlJlcG9zaXRvcnk1NjY3OTUyMQ==-flat-HelloResource.java-motan-MDEwOlJlcG9zaXRvcnk1NjY3OTUyMQ==-flat-ConfigurableWeightLoadBalanceTest.java.html,0.12716763005780346,11,motan-MDEwOlJlcG9zaXRvcnk1NjY3OTUyMQ==-flat-HelloResource.java,motan-MDEwOlJlcG9zaXRvcnk1NjY3OTUyMQ==-flat-ConfigurableWeightLoadBalanceTest.java,1,11,10,1,11,10
68806,https://htmlpreview.github.io/?https://github.com/Christina96/boilerplate-sample-matches/blob/main/Java/Essentials-MDEwOlJlcG9zaXRvcnkxNzczNzU0-flat-Commandmsg.java-ribbon-MDEwOlJlcG9zaXRvcnk3NjE2MTU4-flat-MovieServiceInterfaces.java.html,0.0477326968973747,10,Essentials-MDEwOlJlcG9zaXRvcnkxNzczNzU0-flat-Commandmsg.java,ribbon-MDEwOlJlcG9zaXRvcnk3NjE2MTU4-flat-MovieServiceInterfaces.java,1,10,9,1,10,9
69481,https://htmlpreview.github.io/?https://github.com/Christina96/boilerplate-sample-matches/blob/main/Java/motan-MDEwOlJlcG9zaXRvcnk1NjY3OTUyMQ==-flat-MeshClientConfigBean.java-jedis-MDEwOlJlcG9zaXRvcnk3MTU2MDU=-flat-SearchConfigTest.java.html,0.2894736842105263,11,motan-MDEwOlJlcG9zaXRvcnk1NjY3OTUyMQ==-flat-MeshClientConfigBean.java,jedis-MDEwOlJlcG9zaXRvcnk3MTU2MDU=-flat-SearchConfigTest.java,2,11,9,5,14,9
72060,https://htmlpreview.github.io/?https://github.com/Christina96/boilerplate-sample-matches/blob/main/Java/Essentials-MDEwOlJlcG9zaXRvcnkxNzczNzU0-flat-EssentialsChatPlayer.java-motan-MDEwOlJlcG9zaXRvcnk1NjY3OTUyMQ==-flat-DefaultHttpMeshTransport.java.html,0.09205020920502092,11,Essentials-MDEwOlJlcG9zaXRvcnkxNzczNzU0-flat-EssentialsChatPlayer.java,motan-MDEwOlJlcG9zaXRvcnk1NjY3OTUyMQ==-flat-DefaultHttpMeshTransport.java,2,13,11,14,24,10
74105,https://htmlpreview.github.io/?https://github.com/Christina96/boilerplate-sample-matches/blob/main/Java/Essentials-MDEwOlJlcG9zaXRvcnkxNzczNzU0-flat-EmergencyListener.java-motan-MDEwOlJlcG9zaXRvcnk1NjY3OTUyMQ==-flat-AuthenticationTokenProcessingFilter.java.html,0.1732283464566929,11,Essentials-MDEwOlJlcG9zaXRvcnkxNzczNzU0-flat-EmergencyListener.java,motan-MDEwOlJlcG9zaXRvcnk1NjY3OTUyMQ==-flat-AuthenticationTokenProcessingFilter.java,1,11,10,1,11,10
75070,https://htmlpreview.github.io/?https://github.com/Christina96/boilerplate-sample-matches/blob/main/Java/segmentfault-lessons-MDEwOlJlcG9zaXRvcnk5MzE1NzM4MQ==-flat-User_19.java-motan-MDEwOlJlcG9zaXRvcnk1NjY3OTUyMQ==-flat-ProtocolConfig.java.html,0.11522633744855967,14,segmentfault-lessons-MDEwOlJlcG9zaXRvcnk5MzE1NzM4MQ==-flat-User_19.java,motan-MDEwOlJlcG9zaXRvcnk1NjY3OTUyMQ==-flat-ProtocolConfig.java,5,16,11,39,50,11
78443,https://htmlpreview.github.io/?https://github.com/Christina96/boilerplate-sample-matches/blob/main/Java/SpringPetClinic-MDEwOlJlcG9zaXRvcnkzMDkzNDMzNTE=-flat-PetTypeFormatterTests.java-Essentials-MDEwOlJlcG9zaXRvcnkxNzczNzU0-flat-Backup.java.html,0.08620689655172414,10,SpringPetClinic-MDEwOlJlcG9zaXRvcnkzMDkzNDMzNTE=-flat-PetTypeFormatterTests.java,Essentials-MDEwOlJlcG9zaXRvcnkxNzczNzU0-flat-Backup.java,1,10,9,1,10,9
79080,https://htmlpreview.github.io/?https://github.com/Christina96/boilerplate-sample-matches/blob/main/Java/motan-MDEwOlJlcG9zaXRvcnk1NjY3OTUyMQ==-flat-CompatibleCodec.java-Essentials-MDEwOlJlcG9zaXRvcnkxNzczNzU0-flat-Commandsudo.java.html,0.1360544217687075,10,motan-MDEwOlJlcG9zaXRvcnk1NjY3OTUyMQ==-flat-CompatibleCodec.java,Essentials-MDEwOlJlcG9zaXRvcnkxNzczNzU0-flat-Commandsudo.java,31,36,5,16,23,7
80705,https://htmlpreview.github.io/?https://github.com/Christina96/boilerplate-sample-matches/blob/main/Java/ribbon-MDEwOlJlcG9zaXRvcnk3NjE2MTU4-flat-HelloUdpServer.java-ribbon-MDEwOlJlcG9zaXRvcnk3NjE2MTU4-flat-GetPostTest.java.html,0.15306122448979592,15,ribbon-MDEwOlJlcG9zaXRvcnk3NjE2MTU4-flat-HelloUdpServer.java,ribbon-MDEwOlJlcG9zaXRvcnk3NjE2MTU4-flat-GetPostTest.java,2,16,14,9,23,14
81285,https://htmlpreview.github.io/?https://github.com/Christina96/boilerplate-sample-matches/blob/main/Java/Essentials-MDEwOlJlcG9zaXRvcnkxNzczNzU0-flat-IEssentials_4.java-ribbon-MDEwOlJlcG9zaXRvcnk3NjE2MTU4-flat-MethodTemplateExecutor.java.html,0.09836065573770492,15,Essentials-MDEwOlJlcG9zaXRvcnkxNzczNzU0-flat-IEssentials_4.java,ribbon-MDEwOlJlcG9zaXRvcnk3NjE2MTU4-flat-MethodTemplateExecutor.java,1,15,14,1,15,14
84911,https://htmlpreview.github.io/?https://github.com/Christina96/boilerplate-sample-matches/blob/main/Java/VitamioBundle-MDEwOlJlcG9zaXRvcnk2MjkyMDI5-flat-VitamioListActivity.java-ribbon-MDEwOlJlcG9zaXRvcnk3NjE2MTU4-flat-TestExecutionListener.java.html,0.10212765957446808,12,VitamioBundle-MDEwOlJlcG9zaXRvcnk2MjkyMDI5-flat-VitamioListActivity.java,ribbon-MDEwOlJlcG9zaXRvcnk3NjE2MTU4-flat-TestExecutionListener.java,1,12,11,1,12,11
85915,https://htmlpreview.github.io/?https://github.com/Christina96/boilerplate-sample-matches/blob/main/Java/jedis-MDEwOlJlcG9zaXRvcnk3MTU2MDU=-flat-ClusterJedisCommandsTestBase.java-motan-MDEwOlJlcG9zaXRvcnk1NjY3OTUyMQ==-flat-CompressRpcCodec.java.html,0.05674978503869303,12,jedis-MDEwOlJlcG9zaXRvcnk3MTU2MDU=-flat-ClusterJedisCommandsTestBase.java,motan-MDEwOlJlcG9zaXRvcnk1NjY3OTUyMQ==-flat-CompressRpcCodec.java,1,12,11,1,12,11
91204,https://htmlpreview.github.io/?https://github.com/Christina96/boilerplate-sample-matches/blob/main/Java/Mybatis-PageHelper-MDEwOlJlcG9zaXRvcnkyMDY1MTY3Mg==-flat-TestParameterList.java-ribbon-MDEwOlJlcG9zaXRvcnk3NjE2MTU4-flat-RxMovieTransportExample.java.html,0.10091743119266056,11,Mybatis-PageHelper-MDEwOlJlcG9zaXRvcnkyMDY1MTY3Mg==-flat-TestParameterList.java,ribbon-MDEwOlJlcG9zaXRvcnk3NjE2MTU4-flat-RxMovieTransportExample.java,1,11,10,1,11,10
93950,https://htmlpreview.github.io/?https://github.com/Christina96/boilerplate-sample-matches/blob/main/Java/motan-MDEwOlJlcG9zaXRvcnk1NjY3OTUyMQ==-flat-ClusterTest.java-jedis-MDEwOlJlcG9zaXRvcnk3MTU2MDU=-flat-BinaryValuesCommandsTestBase.java.html,0.25477707006369427,13,motan-MDEwOlJlcG9zaXRvcnk1NjY3OTUyMQ==-flat-ClusterTest.java,jedis-MDEwOlJlcG9zaXRvcnk3MTU2MDU=-flat-BinaryValuesCommandsTestBase.java,41,51,10,133,140,7
94829,https://htmlpreview.github.io/?https://github.com/Christina96/boilerplate-sample-matches/blob/main/Java/segmentfault-lessons-MDEwOlJlcG9zaXRvcnk5MzE1NzM4MQ==-flat-UserServiceProviderController_88.java-ribbon-MDEwOlJlcG9zaXRvcnk3NjE2MTU4-flat-LoadBalancerCommandTest.java.html,0.10126582278481013,12,segmentfault-lessons-MDEwOlJlcG9zaXRvcnk5MzE1NzM4MQ==-flat-UserServiceProviderController_88.java,ribbon-MDEwOlJlcG9zaXRvcnk3NjE2MTU4-flat-LoadBalancerCommandTest.java,1,12,11,1,12,11
100775,https://htmlpreview.github.io/?https://github.com/Christina96/boilerplate-sample-matches/blob/main/Java/google-api-java-client-samples-MDEwOlJlcG9zaXRvcnkyOTc0OTA1Mg==-flat-DataServlet.java-google-api-java-client-samples-MDEwOlJlcG9zaXRvcnkyOTc0OTA1Mg==-flat-DiscoverySample.java.html,0.0641399416909621,12,google-api-java-client-samples-MDEwOlJlcG9zaXRvcnkyOTc0OTA1Mg==-flat-DataServlet.java,google-api-java-client-samples-MDEwOlJlcG9zaXRvcnkyOTc0OTA1Mg==-flat-DiscoverySample.java,31,37,6,97,106,9
101517,https://htmlpreview.github.io/?https://github.com/Christina96/boilerplate-sample-matches/blob/main/Java/google-api-java-client-samples-MDEwOlJlcG9zaXRvcnkyOTc0OTA1Mg==-flat-TasksSample.java-jedis-MDEwOlJlcG9zaXRvcnk3MTU2MDU=-flat-AllKindOfValuesCommandsTestBase.java.html,0.041254125412541254,25,google-api-java-client-samples-MDEwOlJlcG9zaXRvcnkyOTc0OTA1Mg==-flat-TasksSample.java,jedis-MDEwOlJlcG9zaXRvcnk3MTU2MDU=-flat-AllKindOfValuesCommandsTestBase.java,2,26,24,15,39,24
103256,https://htmlpreview.github.io/?https://github.com/Christina96/boilerplate-sample-matches/blob/main/Java/jedis-MDEwOlJlcG9zaXRvcnk3MTU2MDU=-flat-BitPipelineCommands.java-jedis-MDEwOlJlcG9zaXRvcnk3MTU2MDU=-flat-FunctionPipelineBinaryCommands.java.html,0.24299065420560748,13,jedis-MDEwOlJlcG9zaXRvcnk3MTU2MDU=-flat-BitPipelineCommands.java,jedis-MDEwOlJlcG9zaXRvcnk3MTU2MDU=-flat-FunctionPipelineBinaryCommands.java,3,9,6,2,8,6
103561,https://htmlpreview.github.io/?https://github.com/Christina96/boilerplate-sample-matches/blob/main/Java/segmentfault-lessons-MDEwOlJlcG9zaXRvcnk5MzE1NzM4MQ==-flat-UserRibbonController_25.java-jedis-MDEwOlJlcG9zaXRvcnk3MTU2MDU=-flat-JedisClusterTest.java.html,0.025145067698259187,13,segmentfault-lessons-MDEwOlJlcG9zaXRvcnk5MzE1NzM4MQ==-flat-UserRibbonController_25.java,jedis-MDEwOlJlcG9zaXRvcnk3MTU2MDU=-flat-JedisClusterTest.java,1,13,12,1,13,12
104029,https://htmlpreview.github.io/?https://github.com/Christina96/boilerplate-sample-matches/blob/main/Java/BungeeCord-MDEwOlJlcG9zaXRvcnk2MDg0MjEw-flat-LoginEvent.java-jedis-MDEwOlJlcG9zaXRvcnk3MTU2MDU=-flat-Edge.java.html,0.1652892561983471,10,BungeeCord-MDEwOlJlcG9zaXRvcnk2MDg0MjEw-flat-LoginEvent.java,jedis-MDEwOlJlcG9zaXRvcnk3MTU2MDU=-flat-Edge.java,25,32,7,40,47,7
104792,https://htmlpreview.github.io/?https://github.com/Christina96/boilerplate-sample-matches/blob/main/Java/segmentfault-lessons-MDEwOlJlcG9zaXRvcnk5MzE1NzM4MQ==-flat-WebServicesConfiguration.java-ribbon-MDEwOlJlcG9zaXRvcnk3NjE2MTU4-flat-LoadBalancingExample.java.html,0.23404255319148937,11,segmentfault-lessons-MDEwOlJlcG9zaXRvcnk5MzE1NzM4MQ==-flat-WebServicesConfiguration.java,ribbon-MDEwOlJlcG9zaXRvcnk3NjE2MTU4-flat-LoadBalancingExample.java,1,11,10,1,11,10
105349,https://htmlpreview.github.io/?https://github.com/Christina96/boilerplate-sample-matches/blob/main/Java/segmentfault-lessons-MDEwOlJlcG9zaXRvcnk5MzE1NzM4MQ==-flat-BusEventController.java-Mybatis-PageHelper-MDEwOlJlcG9zaXRvcnkyMDY1MTY3Mg==-flat-TestAnnotations.java.html,0.1694915254237288,10,segmentfault-lessons-MDEwOlJlcG9zaXRvcnk5MzE1NzM4MQ==-flat-BusEventController.java,Mybatis-PageHelper-MDEwOlJlcG9zaXRvcnkyMDY1MTY3Mg==-flat-TestAnnotations.java,1,10,9,1,10,9
105889,https://htmlpreview.github.io/?https://github.com/Christina96/boilerplate-sample-matches/blob/main/Java/jedis-MDEwOlJlcG9zaXRvcnk3MTU2MDU=-flat-SearchBuilderFactory.java-jedis-MDEwOlJlcG9zaXRvcnk3MTU2MDU=-flat-JedisPoolTest.java.html,0.05203619909502263,10,jedis-MDEwOlJlcG9zaXRvcnk3MTU2MDU=-flat-SearchBuilderFactory.java,jedis-MDEwOlJlcG9zaXRvcnk3MTU2MDU=-flat-JedisPoolTest.java,134,136,2,168,173,5
106213,https://htmlpreview.github.io/?https://github.com/Christina96/boilerplate-sample-matches/blob/main/Java/Mybatis-PageHelper-MDEwOlJlcG9zaXRvcnkyMDY1MTY3Mg==-flat-TestParameterOne.java-BungeeCord-MDEwOlJlcG9zaXRvcnk2MDg0MjEw-flat-ServerConnectEvent.java.html,0.22448979591836735,11,Mybatis-PageHelper-MDEwOlJlcG9zaXRvcnkyMDY1MTY3Mg==-flat-TestParameterOne.java,BungeeCord-MDEwOlJlcG9zaXRvcnk2MDg0MjEw-flat-ServerConnectEvent.java,1,11,10,1,11,10
106312,https://htmlpreview.github.io/?https://github.com/Christina96/boilerplate-sample-matches/blob/main/Java/Essentials-MDEwOlJlcG9zaXRvcnkxNzczNzU0-flat-Commandban.java-BungeeCord-MDEwOlJlcG9zaXRvcnk2MDg0MjEw-flat-TabList.java.html,0.091324200913242,10,Essentials-MDEwOlJlcG9zaXRvcnkxNzczNzU0-flat-Commandban.java,BungeeCord-MDEwOlJlcG9zaXRvcnk2MDg0MjEw-flat-TabList.java,1,10,9,1,10,9
110075,https://htmlpreview.github.io/?https://github.com/Christina96/boilerplate-sample-matches/blob/main/Java/motan-MDEwOlJlcG9zaXRvcnk1NjY3OTUyMQ==-flat-GrpcUtil.java-motan-MDEwOlJlcG9zaXRvcnk1NjY3OTUyMQ==-flat-DefaultResponseFuture.java.html,0.04262877442273535,12,motan-MDEwOlJlcG9zaXRvcnk1NjY3OTUyMQ==-flat-GrpcUtil.java,motan-MDEwOlJlcG9zaXRvcnk1NjY3OTUyMQ==-flat-DefaultResponseFuture.java,7,18,11,2,13,11
115578,https://htmlpreview.github.io/?https://github.com/Christina96/boilerplate-sample-matches/blob/main/Java/jedis-MDEwOlJlcG9zaXRvcnk3MTU2MDU=-flat-TDigestTest.java-jedis-MDEwOlJlcG9zaXRvcnk3MTU2MDU=-flat-ListCommandsTestBase.java.html,0.24591439688715952,32,jedis-MDEwOlJlcG9zaXRvcnk3MTU2MDU=-flat-TDigestTest.java,jedis-MDEwOlJlcG9zaXRvcnk3MTU2MDU=-flat-ListCommandsTestBase.java,80,99,19,464,486,22
115994,https://htmlpreview.github.io/?https://github.com/Christina96/boilerplate-sample-matches/blob/main/Java/google-api-java-client-samples-MDEwOlJlcG9zaXRvcnkyOTc0OTA1Mg==-flat-ObjectsGetMetadataExample.java-Mybatis-PageHelper-MDEwOlJlcG9zaXRvcnkyMDY1MTY3Mg==-flat-SqlServerParser.java.html,0.039568345323741004,11,google-api-java-client-samples-MDEwOlJlcG9zaXRvcnkyOTc0OTA1Mg==-flat-ObjectsGetMetadataExample.java,Mybatis-PageHelper-MDEwOlJlcG9zaXRvcnkyMDY1MTY3Mg==-flat-SqlServerParser.java,2,12,10,4,14,10
117381,https://htmlpreview.github.io/?https://github.com/Christina96/boilerplate-sample-matches/blob/main/Java/motan-MDEwOlJlcG9zaXRvcnk1NjY3OTUyMQ==-flat-NoHeartbeatFactory.java-motan-MDEwOlJlcG9zaXRvcnk1NjY3OTUyMQ==-flat-JdkProxyFactory.java.html,0.31746031746031744,10,motan-MDEwOlJlcG9zaXRvcnk1NjY3OTUyMQ==-flat-NoHeartbeatFactory.java,motan-MDEwOlJlcG9zaXRvcnk1NjY3OTUyMQ==-flat-JdkProxyFactory.java,2,9,7,6,13,7
122983,https://htmlpreview.github.io/?https://github.com/Christina96/boilerplate-sample-matches/blob/main/Java/segmentfault-lessons-MDEwOlJlcG9zaXRvcnk5MzE1NzM4MQ==-flat-UserServiceClientController_75.java-motan-MDEwOlJlcG9zaXRvcnk1NjY3OTUyMQ==-flat-AbstractPoolClient.java.html,0.09322033898305085,11,segmentfault-lessons-MDEwOlJlcG9zaXRvcnk5MzE1NzM4MQ==-flat-UserServiceClientController_75.java,motan-MDEwOlJlcG9zaXRvcnk1NjY3OTUyMQ==-flat-AbstractPoolClient.java,1,11,10,1,11,10
125666,https://htmlpreview.github.io/?https://github.com/Christina96/boilerplate-sample-matches/blob/main/Java/ribbon-MDEwOlJlcG9zaXRvcnk3NjE2MTU4-flat-LoadBalancingTcpClient.java-Mybatis-PageHelper-MDEwOlJlcG9zaXRvcnkyMDY1MTY3Mg==-flat-SqlServerRowBoundsDialect.java.html,0.15950920245398773,13,ribbon-MDEwOlJlcG9zaXRvcnk3NjE2MTU4-flat-LoadBalancingTcpClient.java,Mybatis-PageHelper-MDEwOlJlcG9zaXRvcnkyMDY1MTY3Mg==-flat-SqlServerRowBoundsDialect.java,1,13,12,1,13,12
126114,https://htmlpreview.github.io/?https://github.com/Christina96/boilerplate-sample-matches/blob/main/Java/Mybatis-PageHelper-MDEwOlJlcG9zaXRvcnkyMDY1MTY3Mg==-flat-Db2Dialect.java-jedis-MDEwOlJlcG9zaXRvcnk3MTU2MDU=-flat-JedisFactory.java.html,0.0782122905027933,14,Mybatis-PageHelper-MDEwOlJlcG9zaXRvcnkyMDY1MTY3Mg==-flat-Db2Dialect.java,jedis-MDEwOlJlcG9zaXRvcnk3MTU2MDU=-flat-JedisFactory.java,10,15,5,66,68,2
128097,https://htmlpreview.github.io/?https://github.com/Christina96/boilerplate-sample-matches/blob/main/Java/google-api-java-client-samples-MDEwOlJlcG9zaXRvcnkyOTc0OTA1Mg==-flat-PlusServiceAccountSample.java-BungeeCord-MDEwOlJlcG9zaXRvcnk2MDg0MjEw-flat-TabCompleteResponse.java.html,0.15463917525773196,15,google-api-java-client-samples-MDEwOlJlcG9zaXRvcnkyOTc0OTA1Mg==-flat-PlusServiceAccountSample.java,BungeeCord-MDEwOlJlcG9zaXRvcnk2MDg0MjEw-flat-TabCompleteResponse.java,1,15,14,1,15,14
128739,https://htmlpreview.github.io/?https://github.com/Christina96/boilerplate-sample-matches/blob/main/Java/BungeeCord-MDEwOlJlcG9zaXRvcnk2MDg0MjEw-flat-ModuleManager.java-motan-MDEwOlJlcG9zaXRvcnk1NjY3OTUyMQ==-flat-ZookeeperRegistry.java.html,0.06128133704735376,22,BungeeCord-MDEwOlJlcG9zaXRvcnk2MDg0MjEw-flat-ModuleManager.java,motan-MDEwOlJlcG9zaXRvcnk1NjY3OTUyMQ==-flat-ZookeeperRegistry.java,3,24,21,2,22,20
129663,https://htmlpreview.github.io/?https://github.com/Christina96/boilerplate-sample-matches/blob/main/Java/Essentials-MDEwOlJlcG9zaXRvcnkxNzczNzU0-flat-EssentialsXMPP.java-Essentials-MDEwOlJlcG9zaXRvcnkxNzczNzU0-flat-Commandtime.java.html,0.055710306406685235,10,Essentials-MDEwOlJlcG9zaXRvcnkxNzczNzU0-flat-EssentialsXMPP.java,Essentials-MDEwOlJlcG9zaXRvcnkxNzczNzU0-flat-Commandtime.java,31,37,6,21,25,4
130128,https://htmlpreview.github.io/?https://github.com/Christina96/boilerplate-sample-matches/blob/main/Java/Mybatis-PageHelper-MDEwOlJlcG9zaXRvcnkyMDY1MTY3Mg==-flat-TestParameterList.java-ribbon-MDEwOlJlcG9zaXRvcnk3NjE2MTU4-flat-LBBuilderTest.java.html,0.18473895582329317,11,Mybatis-PageHelper-MDEwOlJlcG9zaXRvcnkyMDY1MTY3Mg==-flat-TestParameterList.java,ribbon-MDEwOlJlcG9zaXRvcnk3NjE2MTU4-flat-LBBuilderTest.java,1,11,10,1,11,10
131043,https://htmlpreview.github.io/?https://github.com/Christina96/boilerplate-sample-matches/blob/main/Java/jedis-MDEwOlJlcG9zaXRvcnk3MTU2MDU=-flat-DocumentTest.java-Essentials-MDEwOlJlcG9zaXRvcnkxNzczNzU0-flat-Commandgive.java.html,0.11764705882352941,14,jedis-MDEwOlJlcG9zaXRvcnk3MTU2MDU=-flat-DocumentTest.java,Essentials-MDEwOlJlcG9zaXRvcnkxNzczNzU0-flat-Commandgive.java,1,14,13,1,15,14
136573,https://htmlpreview.github.io/?https://github.com/Christina96/boilerplate-sample-matches/blob/main/Java/jedis-MDEwOlJlcG9zaXRvcnk3MTU2MDU=-flat-CMSTest.java-motan-MDEwOlJlcG9zaXRvcnk1NjY3OTUyMQ==-flat-DefaultProtectedStrategy.java.html,0.07430340557275542,12,jedis-MDEwOlJlcG9zaXRvcnk3MTU2MDU=-flat-CMSTest.java,motan-MDEwOlJlcG9zaXRvcnk1NjY3OTUyMQ==-flat-DefaultProtectedStrategy.java,1,12,11,1,12,11
136938,https://htmlpreview.github.io/?https://github.com/Christina96/boilerplate-sample-matches/blob/main/Java/ribbon-MDEwOlJlcG9zaXRvcnk3NjE2MTU4-flat-MethodTemplateTest.java-motan-MDEwOlJlcG9zaXRvcnk1NjY3OTUyMQ==-flat-ConsulEcwidClient.java.html,0.1554054054054054,12,ribbon-MDEwOlJlcG9zaXRvcnk3NjE2MTU4-flat-MethodTemplateTest.java,motan-MDEwOlJlcG9zaXRvcnk1NjY3OTUyMQ==-flat-ConsulEcwidClient.java,23,28,5,89,94,5
138129,https://htmlpreview.github.io/?https://github.com/Christina96/boilerplate-sample-matches/blob/main/Java/segmentfault-lessons-MDEwOlJlcG9zaXRvcnk5MzE1NzM4MQ==-flat-UserServiceProviderController_40.java-BungeeCord-MDEwOlJlcG9zaXRvcnk2MDg0MjEw-flat-HandlerBoss.java.html,0.09386281588447654,13,segmentfault-lessons-MDEwOlJlcG9zaXRvcnk5MzE1NzM4MQ==-flat-UserServiceProviderController_40.java,BungeeCord-MDEwOlJlcG9zaXRvcnk2MDg0MjEw-flat-HandlerBoss.java,1,13,12,1,13,12
142474,https://htmlpreview.github.io/?https://github.com/Christina96/boilerplate-sample-matches/blob/main/Java/motan-MDEwOlJlcG9zaXRvcnk1NjY3OTUyMQ==-flat-RestfulClientInvoker.java-motan-MDEwOlJlcG9zaXRvcnk1NjY3OTUyMQ==-flat-DefaultRpcHeartbeatFactory.java.html,0.1702127659574468,12,motan-MDEwOlJlcG9zaXRvcnk1NjY3OTUyMQ==-flat-RestfulClientInvoker.java,motan-MDEwOlJlcG9zaXRvcnk1NjY3OTUyMQ==-flat-DefaultRpcHeartbeatFactory.java,1,12,11,1,12,11
147530,https://htmlpreview.github.io/?https://github.com/Christina96/boilerplate-sample-matches/blob/main/Java/Essentials-MDEwOlJlcG9zaXRvcnkxNzczNzU0-flat-NumberUtil.java-Essentials-MDEwOlJlcG9zaXRvcnkxNzczNzU0-flat-GroupManagerHandler.java.html,0.1111111111111111,10,Essentials-MDEwOlJlcG9zaXRvcnkxNzczNzU0-flat-NumberUtil.java,Essentials-MDEwOlJlcG9zaXRvcnkxNzczNzU0-flat-GroupManagerHandler.java,1,11,10,1,11,10
147871,https://htmlpreview.github.io/?https://github.com/Christina96/boilerplate-sample-matches/blob/main/Java/segmentfault-lessons-MDEwOlJlcG9zaXRvcnk5MzE1NzM4MQ==-flat-BusEventController_100.java-Essentials-MDEwOlJlcG9zaXRvcnkxNzczNzU0-flat-UserData.java.html,0.024691358024691357,12,segmentfault-lessons-MDEwOlJlcG9zaXRvcnk5MzE1NzM4MQ==-flat-BusEventController_100.java,Essentials-MDEwOlJlcG9zaXRvcnkxNzczNzU0-flat-UserData.java,1,12,11,1,12,11
148810,https://htmlpreview.github.io/?https://github.com/Christina96/boilerplate-sample-matches/blob/main/Java/Mybatis-PageHelper-MDEwOlJlcG9zaXRvcnkyMDY1MTY3Mg==-flat-AutoDialectTest.java-SpringPetClinic-MDEwOlJlcG9zaXRvcnkzMDkzNDMzNTE=-flat-ClinicServiceTests.java.html,0.3323943661971831,19,Mybatis-PageHelper-MDEwOlJlcG9zaXRvcnkyMDY1MTY3Mg==-flat-AutoDialectTest.java,SpringPetClinic-MDEwOlJlcG9zaXRvcnkzMDkzNDMzNTE=-flat-ClinicServiceTests.java,22,31,9,40,44,4
148888,https://htmlpreview.github.io/?https://github.com/Christina96/boilerplate-sample-matches/blob/main/Java/Essentials-MDEwOlJlcG9zaXRvcnkxNzczNzU0-flat-ChatStore.java-motan-MDEwOlJlcG9zaXRvcnk1NjY3OTUyMQ==-flat-RouteNote.java.html,0.02976190476190476,10,Essentials-MDEwOlJlcG9zaXRvcnkxNzczNzU0-flat-ChatStore.java,motan-MDEwOlJlcG9zaXRvcnk1NjY3OTUyMQ==-flat-RouteNote.java,25,35,10,76,83,7
148952,https://htmlpreview.github.io/?https://github.com/Christina96/boilerplate-sample-matches/blob/main/Java/VitamioBundle-MDEwOlJlcG9zaXRvcnk2MjkyMDI5-flat-MediaStore.java-jedis-MDEwOlJlcG9zaXRvcnk3MTU2MDU=-flat-GraphAPITest.java.html,0.02030456852791878,14,VitamioBundle-MDEwOlJlcG9zaXRvcnk2MjkyMDI5-flat-MediaStore.java,jedis-MDEwOlJlcG9zaXRvcnk3MTU2MDU=-flat-GraphAPITest.java,1,14,13,1,14,13
150435,https://htmlpreview.github.io/?https://github.com/Christina96/boilerplate-sample-matches/blob/main/Java/segmentfault-lessons-MDEwOlJlcG9zaXRvcnk5MzE1NzM4MQ==-flat-JavaGenericDemo_3.java-motan-MDEwOlJlcG9zaXRvcnk1NjY3OTUyMQ==-flat-AbstractCommandService.java.html,0.08823529411764706,12,segmentfault-lessons-MDEwOlJlcG9zaXRvcnk5MzE1NzM4MQ==-flat-JavaGenericDemo_3.java,motan-MDEwOlJlcG9zaXRvcnk1NjY3OTUyMQ==-flat-AbstractCommandService.java,1,12,11,1,12,11
152944,https://htmlpreview.github.io/?https://github.com/Christina96/boilerplate-sample-matches/blob/main/Java/BungeeCord-MDEwOlJlcG9zaXRvcnk2MDg0MjEw-flat-JavaCipher.java-motan-MDEwOlJlcG9zaXRvcnk1NjY3OTUyMQ==-flat-GrpcServer.java.html,0.09009009009009009,10,BungeeCord-MDEwOlJlcG9zaXRvcnk2MDg0MjEw-flat-JavaCipher.java,motan-MDEwOlJlcG9zaXRvcnk1NjY3OTUyMQ==-flat-GrpcServer.java,2,12,10,9,18,9
155117,https://htmlpreview.github.io/?https://github.com/Christina96/boilerplate-sample-matches/blob/main/Java/jedis-MDEwOlJlcG9zaXRvcnk3MTU2MDU=-flat-JedisCluster.java-jedis-MDEwOlJlcG9zaXRvcnk3MTU2MDU=-flat-RedisJsonV2Test.java.html,0.059900166389351084,12,jedis-MDEwOlJlcG9zaXRvcnk3MTU2MDU=-flat-JedisCluster.java,jedis-MDEwOlJlcG9zaXRvcnk3MTU2MDU=-flat-RedisJsonV2Test.java,131,136,5,81,85,4
155904,https://htmlpreview.github.io/?https://github.com/Christina96/boilerplate-sample-matches/blob/main/Java/google-api-java-client-samples-MDEwOlJlcG9zaXRvcnkyOTc0OTA1Mg==-flat-CloudNotesActivity.java-VitamioBundle-MDEwOlJlcG9zaXRvcnk2MjkyMDI5-flat-VideoView.java.html,0.07792207792207792,35,google-api-java-client-samples-MDEwOlJlcG9zaXRvcnkyOTc0OTA1Mg==-flat-CloudNotesActivity.java,VitamioBundle-MDEwOlJlcG9zaXRvcnk2MjkyMDI5-flat-VideoView.java,2,36,34,17,51,34
156608,https://htmlpreview.github.io/?https://github.com/Christina96/boilerplate-sample-matches/blob/main/Java/Mybatis-PageHelper-MDEwOlJlcG9zaXRvcnkyMDY1MTY3Mg==-flat-TestDynamicWhere.java-motan-MDEwOlJlcG9zaXRvcnk1NjY3OTUyMQ==-flat-ServiceMockFilterTest.java.html,0.08450704225352113,12,Mybatis-PageHelper-MDEwOlJlcG9zaXRvcnkyMDY1MTY3Mg==-flat-TestDynamicWhere.java,motan-MDEwOlJlcG9zaXRvcnk1NjY3OTUyMQ==-flat-ServiceMockFilterTest.java,1,12,11,1,12,11
157007,https://htmlpreview.github.io/?https://github.com/Christina96/boilerplate-sample-matches/blob/main/Java/segmentfault-lessons-MDEwOlJlcG9zaXRvcnk5MzE1NzM4MQ==-flat-PersonIntegrationTest.java-motan-MDEwOlJlcG9zaXRvcnk1NjY3OTUyMQ==-flat-UserController.java.html,0.2191780821917808,16,segmentfault-lessons-MDEwOlJlcG9zaXRvcnk5MzE1NzM4MQ==-flat-PersonIntegrationTest.java,motan-MDEwOlJlcG9zaXRvcnk1NjY3OTUyMQ==-flat-UserController.java,2,16,14,9,23,14
164360,https://htmlpreview.github.io/?https://github.com/Christina96/boilerplate-sample-matches/blob/main/Java/ribbon-MDEwOlJlcG9zaXRvcnk3NjE2MTU4-flat-LoadBalancingUdpClient.java-Essentials-MDEwOlJlcG9zaXRvcnkxNzczNzU0-flat-Commandessentials.java.html,0.05327868852459016,13,ribbon-MDEwOlJlcG9zaXRvcnk3NjE2MTU4-flat-LoadBalancingUdpClient.java,Essentials-MDEwOlJlcG9zaXRvcnkxNzczNzU0-flat-Commandessentials.java,1,13,12,1,13,12
167295,https://htmlpreview.github.io/?https://github.com/Christina96/boilerplate-sample-matches/blob/main/Java/Mybatis-PageHelper-MDEwOlJlcG9zaXRvcnkyMDY1MTY3Mg==-flat-HerdDBDialect.java-Essentials-MDEwOlJlcG9zaXRvcnkxNzczNzU0-flat-Commandgetpos.java.html,0.14473684210526316,11,Mybatis-PageHelper-MDEwOlJlcG9zaXRvcnkyMDY1MTY3Mg==-flat-HerdDBDialect.java,Essentials-MDEwOlJlcG9zaXRvcnkxNzczNzU0-flat-Commandgetpos.java,15,19,4,34,38,4
167301,https://htmlpreview.github.io/?https://github.com/Christina96/boilerplate-sample-matches/blob/main/Java/ribbon-MDEwOlJlcG9zaXRvcnk3NjE2MTU4-flat-MethodTemplateTest.java-jedis-MDEwOlJlcG9zaXRvcnk3MTU2MDU=-flat-MultiClusterPooledConnectionProviderTest.java.html,0.1413427561837456,10,ribbon-MDEwOlJlcG9zaXRvcnk3NjE2MTU4-flat-MethodTemplateTest.java,jedis-MDEwOlJlcG9zaXRvcnk3MTU2MDU=-flat-MultiClusterPooledConnectionProviderTest.java,17,23,6,28,35,7
167342,https://htmlpreview.github.io/?https://github.com/Christina96/boilerplate-sample-matches/blob/main/Java/motan-MDEwOlJlcG9zaXRvcnk1NjY3OTUyMQ==-flat-HelloServiceImpl.java-jedis-MDEwOlJlcG9zaXRvcnk3MTU2MDU=-flat-ShardedCommandObjects.java.html,0.0944206008583691,11,motan-MDEwOlJlcG9zaXRvcnk1NjY3OTUyMQ==-flat-HelloServiceImpl.java,jedis-MDEwOlJlcG9zaXRvcnk3MTU2MDU=-flat-ShardedCommandObjects.java,15,19,4,88,91,3
170684,https://htmlpreview.github.io/?https://github.com/Christina96/boilerplate-sample-matches/blob/main/Java/motan-MDEwOlJlcG9zaXRvcnk1NjY3OTUyMQ==-flat-ProtobufSerialization.java-Essentials-MDEwOlJlcG9zaXRvcnkxNzczNzU0-flat-Commandessentials.java.html,0.07207207207207207,11,motan-MDEwOlJlcG9zaXRvcnk1NjY3OTUyMQ==-flat-ProtobufSerialization.java,Essentials-MDEwOlJlcG9zaXRvcnkxNzczNzU0-flat-Commandessentials.java,81,87,6,32,44,12
172253,https://htmlpreview.github.io/?https://github.com/Christina96/boilerplate-sample-matches/blob/main/Java/jedis-MDEwOlJlcG9zaXRvcnk3MTU2MDU=-flat-PathTest.java-BungeeCord-MDEwOlJlcG9zaXRvcnk2MDg0MjEw-flat-Respawn.java.html,0.10344827586206896,12,jedis-MDEwOlJlcG9zaXRvcnk3MTU2MDU=-flat-PathTest.java,BungeeCord-MDEwOlJlcG9zaXRvcnk2MDg0MjEw-flat-Respawn.java,1,12,11,1,12,11
172326,https://htmlpreview.github.io/?https://github.com/Christina96/boilerplate-sample-matches/blob/main/Java/motan-MDEwOlJlcG9zaXRvcnk1NjY3OTUyMQ==-flat-AnnotationRpcServerDemo.java-ribbon-MDEwOlJlcG9zaXRvcnk3NjE2MTU4-flat-HelloUdpServer.java.html,0.14012738853503184,11,motan-MDEwOlJlcG9zaXRvcnk1NjY3OTUyMQ==-flat-AnnotationRpcServerDemo.java,ribbon-MDEwOlJlcG9zaXRvcnk3NjE2MTU4-flat-HelloUdpServer.java,1,11,10,1,11,10
172759,https://htmlpreview.github.io/?https://github.com/Christina96/boilerplate-sample-matches/blob/main/Java/BungeeCord-MDEwOlJlcG9zaXRvcnk2MDg0MjEw-flat-ClientChat.java-Mybatis-PageHelper-MDEwOlJlcG9zaXRvcnkyMDY1MTY3Mg==-flat-SqlServerDialect.java.html,0.0830188679245283,11,BungeeCord-MDEwOlJlcG9zaXRvcnk2MDg0MjEw-flat-ClientChat.java,Mybatis-PageHelper-MDEwOlJlcG9zaXRvcnkyMDY1MTY3Mg==-flat-SqlServerDialect.java,1,11,10,1,11,10
172937,https://htmlpreview.github.io/?https://github.com/Christina96/boilerplate-sample-matches/blob/main/Java/jedis-MDEwOlJlcG9zaXRvcnk3MTU2MDU=-flat-KeyBinaryCommands.java-jedis-MDEwOlJlcG9zaXRvcnk3MTU2MDU=-flat-RediSearchCommands.java.html,0.641860465116279,17,jedis-MDEwOlJlcG9zaXRvcnk3MTU2MDU=-flat-KeyBinaryCommands.java,jedis-MDEwOlJlcG9zaXRvcnk3MTU2MDU=-flat-RediSearchCommands.java,23,27,4,32,36,4
183834,https://htmlpreview.github.io/?https://github.com/Christina96/boilerplate-sample-matches/blob/main/Java/motan-MDEwOlJlcG9zaXRvcnk1NjY3OTUyMQ==-flat-AbstractConfig.java-BungeeCord-MDEwOlJlcG9zaXRvcnk2MDg0MjEw-flat-PluginManager.java.html,0.088,11,motan-MDEwOlJlcG9zaXRvcnk1NjY3OTUyMQ==-flat-AbstractConfig.java,BungeeCord-MDEwOlJlcG9zaXRvcnk2MDg0MjEw-flat-PluginManager.java,113,119,6,299,306,7
183913,https://htmlpreview.github.io/?https://github.com/Christina96/boilerplate-sample-matches/blob/main/Java/Mybatis-PageHelper-MDEwOlJlcG9zaXRvcnkyMDY1MTY3Mg==-flat-CollectionMapTest.java-BungeeCord-MDEwOlJlcG9zaXRvcnk2MDg0MjEw-flat-Respawn.java.html,0.12345679012345678,10,Mybatis-PageHelper-MDEwOlJlcG9zaXRvcnkyMDY1MTY3Mg==-flat-CollectionMapTest.java,BungeeCord-MDEwOlJlcG9zaXRvcnk2MDg0MjEw-flat-Respawn.java,1,10,9,1,10,9
187563,https://htmlpreview.github.io/?https://github.com/Christina96/boilerplate-sample-matches/blob/main/Java/ribbon-MDEwOlJlcG9zaXRvcnk3NjE2MTU4-flat-EurekaDynamicServerListLoadBalancerTest.java-jedis-MDEwOlJlcG9zaXRvcnk3MTU2MDU=-flat-ResultSetBuilder.java.html,0.05922551252847381,15,ribbon-MDEwOlJlcG9zaXRvcnk3NjE2MTU4-flat-EurekaDynamicServerListLoadBalancerTest.java,jedis-MDEwOlJlcG9zaXRvcnk3MTU2MDU=-flat-ResultSetBuilder.java,1,15,14,1,15,14
188352,https://htmlpreview.github.io/?https://github.com/Christina96/boilerplate-sample-matches/blob/main/Java/ribbon-MDEwOlJlcG9zaXRvcnk3NjE2MTU4-flat-ClientPropertiesProcessor.java-Essentials-MDEwOlJlcG9zaXRvcnkxNzczNzU0-flat-FakeServer.java.html,0.02404207362885049,16,ribbon-MDEwOlJlcG9zaXRvcnk3NjE2MTU4-flat-ClientPropertiesProcessor.java,Essentials-MDEwOlJlcG9zaXRvcnkxNzczNzU0-flat-FakeServer.java,1,16,15,1,16,15
189004,https://htmlpreview.github.io/?https://github.com/Christina96/boilerplate-sample-matches/blob/main/Java/segmentfault-lessons-MDEwOlJlcG9zaXRvcnk5MzE1NzM4MQ==-flat-JavaClassMemberDemo.java-jedis-MDEwOlJlcG9zaXRvcnk3MTU2MDU=-flat-SSLACLJedisClusterTest.java.html,0.10426540284360189,12,segmentfault-lessons-MDEwOlJlcG9zaXRvcnk5MzE1NzM4MQ==-flat-JavaClassMemberDemo.java,jedis-MDEwOlJlcG9zaXRvcnk3MTU2MDU=-flat-SSLACLJedisClusterTest.java,14,17,3,43,50,7
189329,https://htmlpreview.github.io/?https://github.com/Christina96/boilerplate-sample-matches/blob/main/Java/motan-MDEwOlJlcG9zaXRvcnk1NjY3OTUyMQ==-flat-MeshProxyUtilTest.java-jedis-MDEwOlJlcG9zaXRvcnk3MTU2MDU=-flat-SortedSetCommandsTestBase.java.html,0.09547004383828543,24,motan-MDEwOlJlcG9zaXRvcnk1NjY3OTUyMQ==-flat-MeshProxyUtilTest.java,jedis-MDEwOlJlcG9zaXRvcnk3MTU2MDU=-flat-SortedSetCommandsTestBase.java,68,77,9,50,58,8
191654,https://htmlpreview.github.io/?https://github.com/Christina96/boilerplate-sample-matches/blob/main/Java/Mybatis-PageHelper-MDEwOlJlcG9zaXRvcnkyMDY1MTY3Mg==-flat-ExecutorUtil.java-jedis-MDEwOlJlcG9zaXRvcnk3MTU2MDU=-flat-SearchBuilderFactory.java.html,0.06132075471698113,13,Mybatis-PageHelper-MDEwOlJlcG9zaXRvcnkyMDY1MTY3Mg==-flat-ExecutorUtil.java,jedis-MDEwOlJlcG9zaXRvcnk3MTU2MDU=-flat-SearchBuilderFactory.java,6,18,12,2,14,12
191982,https://htmlpreview.github.io/?https://github.com/Christina96/boilerplate-sample-matches/blob/main/Java/segmentfault-lessons-MDEwOlJlcG9zaXRvcnk5MzE1NzM4MQ==-flat-UserServiceClientApplication_119.java-motan-MDEwOlJlcG9zaXRvcnk1NjY3OTUyMQ==-flat-AnnotationRpcServerDemo.java.html,0.23008849557522124,13,segmentfault-lessons-MDEwOlJlcG9zaXRvcnk5MzE1NzM4MQ==-flat-UserServiceClientApplication_119.java,motan-MDEwOlJlcG9zaXRvcnk1NjY3OTUyMQ==-flat-AnnotationRpcServerDemo.java,6,17,11,2,13,11
192904,https://htmlpreview.github.io/?https://github.com/Christina96/boilerplate-sample-matches/blob/main/Java/segmentfault-lessons-MDEwOlJlcG9zaXRvcnk5MzE1NzM4MQ==-flat-UserServiceProviderController_22.java-ribbon-MDEwOlJlcG9zaXRvcnk3NjE2MTU4-flat-HystrixCommandChainTest.java.html,0.12790697674418605,11,segmentfault-lessons-MDEwOlJlcG9zaXRvcnk5MzE1NzM4MQ==-flat-UserServiceProviderController_22.java,ribbon-MDEwOlJlcG9zaXRvcnk3NjE2MTU4-flat-HystrixCommandChainTest.java,1,11,10,1,11,10
194135,https://htmlpreview.github.io/?https://github.com/Christina96/boilerplate-sample-matches/blob/main/Java/BungeeCord-MDEwOlJlcG9zaXRvcnk2MDg0MjEw-flat-ServerKickEvent.java-BungeeCord-MDEwOlJlcG9zaXRvcnk2MDg0MjEw-flat-TabList.java.html,0.125,12,BungeeCord-MDEwOlJlcG9zaXRvcnk2MDg0MjEw-flat-ServerKickEvent.java,BungeeCord-MDEwOlJlcG9zaXRvcnk2MDg0MjEw-flat-TabList.java,1,11,10,1,11,10
196439,https://htmlpreview.github.io/?https://github.com/Christina96/boilerplate-sample-matches/blob/main/Java/jedis-MDEwOlJlcG9zaXRvcnk3MTU2MDU=-flat-JedisSentinelTest.java-jedis-MDEwOlJlcG9zaXRvcnk3MTU2MDU=-flat-ClientCommandsTest.java.html,0.1315345699831366,10,jedis-MDEwOlJlcG9zaXRvcnk3MTU2MDU=-flat-JedisSentinelTest.java,jedis-MDEwOlJlcG9zaXRvcnk3MTU2MDU=-flat-ClientCommandsTest.java,108,113,5,74,77,3
198481,https://htmlpreview.github.io/?https://github.com/Christina96/boilerplate-sample-matches/blob/main/Java/motan-MDEwOlJlcG9zaXRvcnk1NjY3OTUyMQ==-flat-ConsulEcwidClient.java-motan-MDEwOlJlcG9zaXRvcnk1NjY3OTUyMQ==-flat-YarProtocolUtil.java.html,0.20861678004535147,14,motan-MDEwOlJlcG9zaXRvcnk1NjY3OTUyMQ==-flat-ConsulEcwidClient.java,motan-MDEwOlJlcG9zaXRvcnk1NjY3OTUyMQ==-flat-YarProtocolUtil.java,1,14,13,1,14,13
198574,https://htmlpreview.github.io/?https://github.com/Christina96/boilerplate-sample-matches/blob/main/Java/segmentfault-lessons-MDEwOlJlcG9zaXRvcnk5MzE1NzM4MQ==-flat-UserServiceClientApplication_71.java-segmentfault-lessons-MDEwOlJlcG9zaXRvcnk5MzE1NzM4MQ==-flat-UserServiceProviderController_40.java.html,0.27184466019417475,14,segmentfault-lessons-MDEwOlJlcG9zaXRvcnk5MzE1NzM4MQ==-flat-UserServiceClientApplication_71.java,segmentfault-lessons-MDEwOlJlcG9zaXRvcnk5MzE1NzM4MQ==-flat-UserServiceProviderController_40.java,4,16,12,2,14,12
199304,https://htmlpreview.github.io/?https://github.com/Christina96/boilerplate-sample-matches/blob/main/Java/jedis-MDEwOlJlcG9zaXRvcnk3MTU2MDU=-flat-DocumentTest.java-BungeeCord-MDEwOlJlcG9zaXRvcnk2MDg0MjEw-flat-UpstreamBridge.java.html,0.1095890410958904,12,jedis-MDEwOlJlcG9zaXRvcnk3MTU2MDU=-flat-DocumentTest.java,BungeeCord-MDEwOlJlcG9zaXRvcnk2MDg0MjEw-flat-UpstreamBridge.java,29,36,7,128,133,5
200563,https://htmlpreview.github.io/?https://github.com/Christina96/boilerplate-sample-matches/blob/main/Java/jedis-MDEwOlJlcG9zaXRvcnk3MTU2MDU=-flat-CommandArguments.java-ribbon-MDEwOlJlcG9zaXRvcnk3NjE2MTU4-flat-HttpClientResponse.java.html,0.11695906432748537,10,jedis-MDEwOlJlcG9zaXRvcnk3MTU2MDU=-flat-CommandArguments.java,ribbon-MDEwOlJlcG9zaXRvcnk3NjE2MTU4-flat-HttpClientResponse.java,2,11,9,14,23,9
201251,https://htmlpreview.github.io/?https://github.com/Christina96/boilerplate-sample-matches/blob/main/Java/BungeeCord-MDEwOlJlcG9zaXRvcnk2MDg0MjEw-flat-ClearTitles.java-Mybatis-PageHelper-MDEwOlJlcG9zaXRvcnkyMDY1MTY3Mg==-flat-SecondCacheTest.java.html,0.1694915254237288,10,BungeeCord-MDEwOlJlcG9zaXRvcnk2MDg0MjEw-flat-ClearTitles.java,Mybatis-PageHelper-MDEwOlJlcG9zaXRvcnkyMDY1MTY3Mg==-flat-SecondCacheTest.java,1,10,9,1,10,9
207007,https://htmlpreview.github.io/?https://github.com/Christina96/boilerplate-sample-matches/blob/main/Java/ribbon-MDEwOlJlcG9zaXRvcnk3NjE2MTU4-flat-HelloUdpServerExternalResource.java-motan-MDEwOlJlcG9zaXRvcnk1NjY3OTUyMQ==-flat-StandardThreadExecutor_1.java.html,0.07434944237918216,10,ribbon-MDEwOlJlcG9zaXRvcnk3NjE2MTU4-flat-HelloUdpServerExternalResource.java,motan-MDEwOlJlcG9zaXRvcnk1NjY3OTUyMQ==-flat-StandardThreadExecutor_1.java,10,19,9,2,11,9
207168,https://htmlpreview.github.io/?https://github.com/Christina96/boilerplate-sample-matches/blob/main/Java/jedis-MDEwOlJlcG9zaXRvcnk3MTU2MDU=-flat-TDigestTest.java-jedis-MDEwOlJlcG9zaXRvcnk3MTU2MDU=-flat-JedisSentinelTest.java.html,0.16299559471365638,11,jedis-MDEwOlJlcG9zaXRvcnk3MTU2MDU=-flat-TDigestTest.java,jedis-MDEwOlJlcG9zaXRvcnk3MTU2MDU=-flat-JedisSentinelTest.java,44,50,6,116,119,3
210809,https://htmlpreview.github.io/?https://github.com/Christina96/boilerplate-sample-matches/blob/main/Java/segmentfault-lessons-MDEwOlJlcG9zaXRvcnk5MzE1NzM4MQ==-flat-RepositoryAnnotationProcessor.java-ribbon-MDEwOlJlcG9zaXRvcnk3NjE2MTU4-flat-TestExecutionListener.java.html,0.09061488673139159,14,segmentfault-lessons-MDEwOlJlcG9zaXRvcnk5MzE1NzM4MQ==-flat-RepositoryAnnotationProcessor.java,ribbon-MDEwOlJlcG9zaXRvcnk3NjE2MTU4-flat-TestExecutionListener.java,1,14,13,1,14,13
211043,https://htmlpreview.github.io/?https://github.com/Christina96/boilerplate-sample-matches/blob/main/Java/segmentfault-lessons-MDEwOlJlcG9zaXRvcnk5MzE1NzM4MQ==-flat-DynamicHystrixCommandController.java-ribbon-MDEwOlJlcG9zaXRvcnk3NjE2MTU4-flat-CommonClientConfigKey.java.html,0.05010438413361169,12,segmentfault-lessons-MDEwOlJlcG9zaXRvcnk5MzE1NzM4MQ==-flat-DynamicHystrixCommandController.java,ribbon-MDEwOlJlcG9zaXRvcnk3NjE2MTU4-flat-CommonClientConfigKey.java,1,12,11,1,12,11
211259,https://htmlpreview.github.io/?https://github.com/Christina96/boilerplate-sample-matches/blob/main/Java/VitamioBundle-MDEwOlJlcG9zaXRvcnk2MjkyMDI5-flat-OutlineTextView.java-SpringPetClinic-MDEwOlJlcG9zaXRvcnkzMDkzNDMzNTE=-flat-OwnerControllerTests.java.html,0.09210526315789473,10,VitamioBundle-MDEwOlJlcG9zaXRvcnk2MjkyMDI5-flat-OutlineTextView.java,SpringPetClinic-MDEwOlJlcG9zaXRvcnkzMDkzNDMzNTE=-flat-OwnerControllerTests.java,1,10,9,1,10,9
211391,https://htmlpreview.github.io/?https://github.com/Christina96/boilerplate-sample-matches/blob/main/Java/ribbon-MDEwOlJlcG9zaXRvcnk3NjE2MTU4-flat-AcceptAllSocketFactory.java-ribbon-MDEwOlJlcG9zaXRvcnk3NjE2MTU4-flat-NFHttpClient.java.html,0.06486486486486487,12,ribbon-MDEwOlJlcG9zaXRvcnk3NjE2MTU4-flat-AcceptAllSocketFactory.java,ribbon-MDEwOlJlcG9zaXRvcnk3NjE2MTU4-flat-NFHttpClient.java,1,12,11,1,12,11
211631,https://htmlpreview.github.io/?https://github.com/Christina96/boilerplate-sample-matches/blob/main/Java/motan-MDEwOlJlcG9zaXRvcnk1NjY3OTUyMQ==-flat-ActiveLimitFilter.java-ribbon-MDEwOlJlcG9zaXRvcnk3NjE2MTU4-flat-EvCacheAnnotationTest.java.html,0.11578947368421053,11,motan-MDEwOlJlcG9zaXRvcnk1NjY3OTUyMQ==-flat-ActiveLimitFilter.java,ribbon-MDEwOlJlcG9zaXRvcnk3NjE2MTU4-flat-EvCacheAnnotationTest.java,2,11,9,17,26,9
218471,https://htmlpreview.github.io/?https://github.com/Christina96/boilerplate-sample-matches/blob/main/Java/Essentials-MDEwOlJlcG9zaXRvcnkxNzczNzU0-flat-Commandkit.java-motan-MDEwOlJlcG9zaXRvcnk1NjY3OTUyMQ==-flat-ZookeeperRegistry.java.html,0.031161473087818695,11,Essentials-MDEwOlJlcG9zaXRvcnkxNzczNzU0-flat-Commandkit.java,motan-MDEwOlJlcG9zaXRvcnk1NjY3OTUyMQ==-flat-ZookeeperRegistry.java,1,11,10,1,11,10
222484,https://htmlpreview.github.io/?https://github.com/Christina96/boilerplate-sample-matches/blob/main/Java/Mybatis-PageHelper-MDEwOlJlcG9zaXRvcnkyMDY1MTY3Mg==-flat-HsqldbDialect.java-ribbon-MDEwOlJlcG9zaXRvcnk3NjE2MTU4-flat-PrimeConnectionsTest.java.html,0.125,12,Mybatis-PageHelper-MDEwOlJlcG9zaXRvcnkyMDY1MTY3Mg==-flat-HsqldbDialect.java,ribbon-MDEwOlJlcG9zaXRvcnk3NjE2MTU4-flat-PrimeConnectionsTest.java,1,12,11,1,12,11
223462,https://htmlpreview.github.io/?https://github.com/Christina96/boilerplate-sample-matches/blob/main/Java/jedis-MDEwOlJlcG9zaXRvcnk3MTU2MDU=-flat-GraphPipelineTest.java-jedis-MDEwOlJlcG9zaXRvcnk3MTU2MDU=-flat-AllKindOfValuesCommandsTest.java.html,0.21108884435537742,20,jedis-MDEwOlJlcG9zaXRvcnk3MTU2MDU=-flat-GraphPipelineTest.java,jedis-MDEwOlJlcG9zaXRvcnk3MTU2MDU=-flat-AllKindOfValuesCommandsTest.java,1,20,19,1,20,19
224284,https://htmlpreview.github.io/?https://github.com/Christina96/boilerplate-sample-matches/blob/main/Java/Mybatis-PageHelper-MDEwOlJlcG9zaXRvcnkyMDY1MTY3Mg==-flat-PageInfoTest.java-jedis-MDEwOlJlcG9zaXRvcnk3MTU2MDU=-flat-HashesCommandsTestBase.java.html,0.33603707995365006,11,Mybatis-PageHelper-MDEwOlJlcG9zaXRvcnkyMDY1MTY3Mg==-flat-PageInfoTest.java,jedis-MDEwOlJlcG9zaXRvcnk3MTU2MDU=-flat-HashesCommandsTestBase.java,145,150,5,344,350,6
224560,https://htmlpreview.github.io/?https://github.com/Christina96/boilerplate-sample-matches/blob/main/Java/motan-MDEwOlJlcG9zaXRvcnk1NjY3OTUyMQ==-flat-SerializeTest.java-motan-MDEwOlJlcG9zaXRvcnk1NjY3OTUyMQ==-flat-NettyChannelHandler_10.java.html,0.05442176870748299,12,motan-MDEwOlJlcG9zaXRvcnk1NjY3OTUyMQ==-flat-SerializeTest.java,motan-MDEwOlJlcG9zaXRvcnk1NjY3OTUyMQ==-flat-NettyChannelHandler_10.java,28,36,8,42,46,4
226140,https://htmlpreview.github.io/?https://github.com/Christina96/boilerplate-sample-matches/blob/main/Java/Mybatis-PageHelper-MDEwOlJlcG9zaXRvcnkyMDY1MTY3Mg==-flat-CacheTest.java-ribbon-MDEwOlJlcG9zaXRvcnk3NjE2MTU4-flat-ArchaiusPropertyResolver.java.html,0.0944206008583691,11,Mybatis-PageHelper-MDEwOlJlcG9zaXRvcnkyMDY1MTY3Mg==-flat-CacheTest.java,ribbon-MDEwOlJlcG9zaXRvcnk3NjE2MTU4-flat-ArchaiusPropertyResolver.java,1,11,10,1,11,10
228053,https://htmlpreview.github.io/?https://github.com/Christina96/boilerplate-sample-matches/blob/main/Java/ribbon-MDEwOlJlcG9zaXRvcnk3NjE2MTU4-flat-HttpClientLoadBalancerErrorHandler.java-motan-MDEwOlJlcG9zaXRvcnk1NjY3OTUyMQ==-flat-DefaultResponse.java.html,0.11320754716981132,15,ribbon-MDEwOlJlcG9zaXRvcnk3NjE2MTU4-flat-HttpClientLoadBalancerErrorHandler.java,motan-MDEwOlJlcG9zaXRvcnk1NjY3OTUyMQ==-flat-DefaultResponse.java,3,17,14,2,16,14
229908,https://htmlpreview.github.io/?https://github.com/Christina96/boilerplate-sample-matches/blob/main/Java/segmentfault-lessons-MDEwOlJlcG9zaXRvcnk5MzE1NzM4MQ==-flat-PersonDemo_4.java-ribbon-MDEwOlJlcG9zaXRvcnk3NjE2MTU4-flat-DiscoveryEnabledLoadBalancerSupportsUseIpAddrTest.java.html,0.1875,11,segmentfault-lessons-MDEwOlJlcG9zaXRvcnk5MzE1NzM4MQ==-flat-PersonDemo_4.java,ribbon-MDEwOlJlcG9zaXRvcnk3NjE2MTU4-flat-DiscoveryEnabledLoadBalancerSupportsUseIpAddrTest.java,29,37,8,40,43,3
230411,https://htmlpreview.github.io/?https://github.com/Christina96/boilerplate-sample-matches/blob/main/Java/ribbon-MDEwOlJlcG9zaXRvcnk3NjE2MTU4-flat-UdpClientTest.java-google-api-java-client-samples-MDEwOlJlcG9zaXRvcnkyOTc0OTA1Mg==-flat-AdExchangeSellerSample.java.html,0.1510791366906475,21,ribbon-MDEwOlJlcG9zaXRvcnk3NjE2MTU4-flat-UdpClientTest.java,google-api-java-client-samples-MDEwOlJlcG9zaXRvcnkyOTc0OTA1Mg==-flat-AdExchangeSellerSample.java,1,21,20,1,21,20
231474,https://htmlpreview.github.io/?https://github.com/Christina96/boilerplate-sample-matches/blob/main/Java/jedis-MDEwOlJlcG9zaXRvcnk3MTU2MDU=-flat-RedisModuleCommandsTestBase.java-motan-MDEwOlJlcG9zaXRvcnk1NjY3OTUyMQ==-flat-ExtensionLoader.java.html,0.048417132216014895,13,jedis-MDEwOlJlcG9zaXRvcnk3MTU2MDU=-flat-RedisModuleCommandsTestBase.java,motan-MDEwOlJlcG9zaXRvcnk1NjY3OTUyMQ==-flat-ExtensionLoader.java,1,13,12,1,13,12
231499,https://htmlpreview.github.io/?https://github.com/Christina96/boilerplate-sample-matches/blob/main/Java/jedis-MDEwOlJlcG9zaXRvcnk3MTU2MDU=-flat-CFReserveParams.java-ribbon-MDEwOlJlcG9zaXRvcnk3NjE2MTU4-flat-NettyClientTest.java.html,0.01692047377326565,10,jedis-MDEwOlJlcG9zaXRvcnk3MTU2MDU=-flat-CFReserveParams.java,ribbon-MDEwOlJlcG9zaXRvcnk3NjE2MTU4-flat-NettyClientTest.java,2,11,9,57,66,9
235298,https://htmlpreview.github.io/?https://github.com/Christina96/boilerplate-sample-matches/blob/main/Java/BungeeCord-MDEwOlJlcG9zaXRvcnk2MDg0MjEw-flat-SchedulerTest.java-Essentials-MDEwOlJlcG9zaXRvcnkxNzczNzU0-flat-Commandwhois.java.html,0.09649122807017543,11,BungeeCord-MDEwOlJlcG9zaXRvcnk2MDg0MjEw-flat-SchedulerTest.java,Essentials-MDEwOlJlcG9zaXRvcnkxNzczNzU0-flat-Commandwhois.java,1,12,11,1,12,11
237898,https://htmlpreview.github.io/?https://github.com/Christina96/boilerplate-sample-matches/blob/main/Java/jedis-MDEwOlJlcG9zaXRvcnk3MTU2MDU=-flat-RedisJsonV2Test.java-jedis-MDEwOlJlcG9zaXRvcnk3MTU2MDU=-flat-GeoCommandsTest.java.html,0.3639494833524684,12,jedis-MDEwOlJlcG9zaXRvcnk3MTU2MDU=-flat-RedisJsonV2Test.java,jedis-MDEwOlJlcG9zaXRvcnk3MTU2MDU=-flat-GeoCommandsTest.java,117,124,7,60,65,5
237941,https://htmlpreview.github.io/?https://github.com/Christina96/boilerplate-sample-matches/blob/main/Java/segmentfault-lessons-MDEwOlJlcG9zaXRvcnk5MzE1NzM4MQ==-flat-UserRibbonController_98.java-ribbon-MDEwOlJlcG9zaXRvcnk3NjE2MTU4-flat-EurekaDynamicServerListLoadBalancerTest.java.html,0.10970464135021098,13,segmentfault-lessons-MDEwOlJlcG9zaXRvcnk5MzE1NzM4MQ==-flat-UserRibbonController_98.java,ribbon-MDEwOlJlcG9zaXRvcnk3NjE2MTU4-flat-EurekaDynamicServerListLoadBalancerTest.java,2,13,11,16,27,11
238898,https://htmlpreview.github.io/?https://github.com/Christina96/boilerplate-sample-matches/blob/main/Java/Mybatis-PageHelper-MDEwOlJlcG9zaXRvcnkyMDY1MTY3Mg==-flat-TestGroupBy.java-ribbon-MDEwOlJlcG9zaXRvcnk3NjE2MTU4-flat-URLConnectionLoadBalancer.java.html,0.15384615384615385,10,Mybatis-PageHelper-MDEwOlJlcG9zaXRvcnkyMDY1MTY3Mg==-flat-TestGroupBy.java,ribbon-MDEwOlJlcG9zaXRvcnk3NjE2MTU4-flat-URLConnectionLoadBalancer.java,1,10,9,1,10,9
240101,https://htmlpreview.github.io/?https://github.com/Christina96/boilerplate-sample-matches/blob/main/Java/Essentials-MDEwOlJlcG9zaXRvcnkxNzczNzU0-flat-SpawnMob.java-BungeeCord-MDEwOlJlcG9zaXRvcnk2MDg0MjEw-flat-Protocol.java.html,0.03761755485893417,18,Essentials-MDEwOlJlcG9zaXRvcnkxNzczNzU0-flat-SpawnMob.java,BungeeCord-MDEwOlJlcG9zaXRvcnk2MDg0MjEw-flat-Protocol.java,1,18,17,1,18,17
241554,https://htmlpreview.github.io/?https://github.com/Christina96/boilerplate-sample-matches/blob/main/Java/motan-MDEwOlJlcG9zaXRvcnk1NjY3OTUyMQ==-flat-Application.java-jedis-MDEwOlJlcG9zaXRvcnk3MTU2MDU=-flat-Edge.java.html,0.3137254901960784,16,motan-MDEwOlJlcG9zaXRvcnk1NjY3OTUyMQ==-flat-Application.java,jedis-MDEwOlJlcG9zaXRvcnk3MTU2MDU=-flat-Edge.java,7,20,13,17,30,13
242303,https://htmlpreview.github.io/?https://github.com/Christina96/boilerplate-sample-matches/blob/main/Java/ribbon-MDEwOlJlcG9zaXRvcnk3NjE2MTU4-flat-DiscoveryLoadBalancerTest.java-BungeeCord-MDEwOlJlcG9zaXRvcnk2MDg0MjEw-flat-LoginRequest.java.html,0.21621621621621623,12,ribbon-MDEwOlJlcG9zaXRvcnk3NjE2MTU4-flat-DiscoveryLoadBalancerTest.java,BungeeCord-MDEwOlJlcG9zaXRvcnk2MDg0MjEw-flat-LoginRequest.java,5,15,10,2,12,10
244192,https://htmlpreview.github.io/?https://github.com/Christina96/boilerplate-sample-matches/blob/main/Java/segmentfault-lessons-MDEwOlJlcG9zaXRvcnk5MzE1NzM4MQ==-flat-DirectoryOperationsDemo.java-motan-MDEwOlJlcG9zaXRvcnk1NjY3OTUyMQ==-flat-RegistryConfigTest.java.html,0.21153846153846154,11,segmentfault-lessons-MDEwOlJlcG9zaXRvcnk5MzE1NzM4MQ==-flat-DirectoryOperationsDemo.java,motan-MDEwOlJlcG9zaXRvcnk1NjY3OTUyMQ==-flat-RegistryConfigTest.java,11,12,1,12,17,5
245916,https://htmlpreview.github.io/?https://github.com/Christina96/boilerplate-sample-matches/blob/main/Java/jedis-MDEwOlJlcG9zaXRvcnk3MTU2MDU=-flat-BinaryValuesCommandsTestBase.java-jedis-MDEwOlJlcG9zaXRvcnk3MTU2MDU=-flat-GeoCommandsTest.java.html,0.3640226628895184,13,jedis-MDEwOlJlcG9zaXRvcnk3MTU2MDU=-flat-BinaryValuesCommandsTestBase.java,jedis-MDEwOlJlcG9zaXRvcnk3MTU2MDU=-flat-GeoCommandsTest.java,247,255,8,270,278,8
249563,https://htmlpreview.github.io/?https://github.com/Christina96/boilerplate-sample-matches/blob/main/Java/jedis-MDEwOlJlcG9zaXRvcnk3MTU2MDU=-flat-SetBinaryCommands.java-jedis-MDEwOlJlcG9zaXRvcnk3MTU2MDU=-flat-SetPipelineCommands.java.html,0.9830508474576272,87,jedis-MDEwOlJlcG9zaXRvcnk3MTU2MDU=-flat-SetBinaryCommands.java,jedis-MDEwOlJlcG9zaXRvcnk3MTU2MDU=-flat-SetPipelineCommands.java,2,30,28,3,31,28
249841,https://htmlpreview.github.io/?https://github.com/Christina96/boilerplate-sample-matches/blob/main/Java/motan-MDEwOlJlcG9zaXRvcnk1NjY3OTUyMQ==-flat-AbstractPoolClient.java-BungeeCord-MDEwOlJlcG9zaXRvcnk2MDg0MjEw-flat-InitialHandler.java.html,0.021032504780114723,11,motan-MDEwOlJlcG9zaXRvcnk1NjY3OTUyMQ==-flat-AbstractPoolClient.java,BungeeCord-MDEwOlJlcG9zaXRvcnk2MDg0MjEw-flat-InitialHandler.java,1,11,10,1,11,10
252222,https://htmlpreview.github.io/?https://github.com/Christina96/boilerplate-sample-matches/blob/main/Java/motan-MDEwOlJlcG9zaXRvcnk1NjY3OTUyMQ==-flat-NettyExampleTest.java-jedis-MDEwOlJlcG9zaXRvcnk3MTU2MDU=-flat-Protocol.java.html,0.018296973961998593,13,motan-MDEwOlJlcG9zaXRvcnk1NjY3OTUyMQ==-flat-NettyExampleTest.java,jedis-MDEwOlJlcG9zaXRvcnk3MTU2MDU=-flat-Protocol.java,1,13,12,1,13,12
255017,https://htmlpreview.github.io/?https://github.com/Christina96/boilerplate-sample-matches/blob/main/Java/jedis-MDEwOlJlcG9zaXRvcnk3MTU2MDU=-flat-UnavailableConnectionTest.java-google-api-java-client-samples-MDEwOlJlcG9zaXRvcnkyOTc0OTA1Mg==-flat-BooksSample.java.html,0.07434944237918216,10,jedis-MDEwOlJlcG9zaXRvcnk3MTU2MDU=-flat-UnavailableConnectionTest.java,google-api-java-client-samples-MDEwOlJlcG9zaXRvcnkyOTc0OTA1Mg==-flat-BooksSample.java,2,11,9,5,14,9
255332,https://htmlpreview.github.io/?https://github.com/Christina96/boilerplate-sample-matches/blob/main/Java/motan-MDEwOlJlcG9zaXRvcnk1NjY3OTUyMQ==-flat-ConsulHeartbeatManagerTest.java-motan-MDEwOlJlcG9zaXRvcnk1NjY3OTUyMQ==-flat-NettyServerTest.java.html,0.07942238267148015,11,motan-MDEwOlJlcG9zaXRvcnk1NjY3OTUyMQ==-flat-ConsulHeartbeatManagerTest.java,motan-MDEwOlJlcG9zaXRvcnk1NjY3OTUyMQ==-flat-NettyServerTest.java,2,12,10,10,20,10
255620,https://htmlpreview.github.io/?https://github.com/Christina96/boilerplate-sample-matches/blob/main/Java/Essentials-MDEwOlJlcG9zaXRvcnkxNzczNzU0-flat-ChargeException.java-jedis-MDEwOlJlcG9zaXRvcnk3MTU2MDU=-flat-JedisAccessControlException.java.html,0.7142857142857143,10,Essentials-MDEwOlJlcG9zaXRvcnkxNzczNzU0-flat-ChargeException.java,jedis-MDEwOlJlcG9zaXRvcnk3MTU2MDU=-flat-JedisAccessControlException.java,4,12,8,6,12,6
257898,https://htmlpreview.github.io/?https://github.com/Christina96/boilerplate-sample-matches/blob/main/Java/motan-MDEwOlJlcG9zaXRvcnk1NjY3OTUyMQ==-flat-ProtocolFilterDecoratorTest.java-google-api-java-client-samples-MDEwOlJlcG9zaXRvcnkyOTc0OTA1Mg==-flat-CoreReportingApiReferenceSample.java.html,0.0856269113149847,14,motan-MDEwOlJlcG9zaXRvcnk1NjY3OTUyMQ==-flat-ProtocolFilterDecoratorTest.java,google-api-java-client-samples-MDEwOlJlcG9zaXRvcnkyOTc0OTA1Mg==-flat-CoreReportingApiReferenceSample.java,2,15,13,14,27,13
259796,https://htmlpreview.github.io/?https://github.com/Christina96/boilerplate-sample-matches/blob/main/Java/ribbon-MDEwOlJlcG9zaXRvcnk3NjE2MTU4-flat-MovieService.java-jedis-MDEwOlJlcG9zaXRvcnk3MTU2MDU=-flat-SearchBuilderFactory.java.html,0.0633245382585752,12,ribbon-MDEwOlJlcG9zaXRvcnk3NjE2MTU4-flat-MovieService.java,jedis-MDEwOlJlcG9zaXRvcnk3MTU2MDU=-flat-SearchBuilderFactory.java,1,12,11,1,12,11
261638,https://htmlpreview.github.io/?https://github.com/Christina96/boilerplate-sample-matches/blob/main/Java/motan-MDEwOlJlcG9zaXRvcnk1NjY3OTUyMQ==-flat-SpringBeanUtil.java-ribbon-MDEwOlJlcG9zaXRvcnk3NjE2MTU4-flat-ServerStats.java.html,0.036036036036036036,10,motan-MDEwOlJlcG9zaXRvcnk1NjY3OTUyMQ==-flat-SpringBeanUtil.java,ribbon-MDEwOlJlcG9zaXRvcnk3NjE2MTU4-flat-ServerStats.java,2,11,9,9,18,9
262798,https://htmlpreview.github.io/?https://github.com/Christina96/boilerplate-sample-matches/blob/main/Java/segmentfault-lessons-MDEwOlJlcG9zaXRvcnk5MzE1NzM4MQ==-flat-DirectoryOperationsDemo.java-motan-MDEwOlJlcG9zaXRvcnk1NjY3OTUyMQ==-flat-MotanFrameworkUtil.java.html,0.06582278481012659,13,segmentfault-lessons-MDEwOlJlcG9zaXRvcnk5MzE1NzM4MQ==-flat-DirectoryOperationsDemo.java,motan-MDEwOlJlcG9zaXRvcnk1NjY3OTUyMQ==-flat-MotanFrameworkUtil.java,1,11,10,1,11,10
268261,https://htmlpreview.github.io/?https://github.com/Christina96/boilerplate-sample-matches/blob/main/Java/BungeeCord-MDEwOlJlcG9zaXRvcnk2MDg0MjEw-flat-UUIDTest.java-Mybatis-PageHelper-MDEwOlJlcG9zaXRvcnkyMDY1MTY3Mg==-flat-TestIntMax.java.html,0.3013698630136986,11,BungeeCord-MDEwOlJlcG9zaXRvcnk2MDg0MjEw-flat-UUIDTest.java,Mybatis-PageHelper-MDEwOlJlcG9zaXRvcnkyMDY1MTY3Mg==-flat-TestIntMax.java,2,12,10,7,15,8
273313,https://htmlpreview.github.io/?https://github.com/Christina96/boilerplate-sample-matches/blob/main/Java/jedis-MDEwOlJlcG9zaXRvcnk3MTU2MDU=-flat-StringPipelineCommands.java-jedis-MDEwOlJlcG9zaXRvcnk3MTU2MDU=-flat-SortedSetBinaryCommands.java.html,0.30425963488843816,10,jedis-MDEwOlJlcG9zaXRvcnk3MTU2MDU=-flat-StringPipelineCommands.java,jedis-MDEwOlJlcG9zaXRvcnk3MTU2MDU=-flat-SortedSetBinaryCommands.java,20,23,3,72,75,3
281573,https://htmlpreview.github.io/?https://github.com/Christina96/boilerplate-sample-matches/blob/main/Java/motan-MDEwOlJlcG9zaXRvcnk1NjY3OTUyMQ==-flat-YarMessageHandlerWarpperTest.java-motan-MDEwOlJlcG9zaXRvcnk1NjY3OTUyMQ==-flat-SimpleSerialization.java.html,0.024255788313120176,11,motan-MDEwOlJlcG9zaXRvcnk1NjY3OTUyMQ==-flat-YarMessageHandlerWarpperTest.java,motan-MDEwOlJlcG9zaXRvcnk1NjY3OTUyMQ==-flat-SimpleSerialization.java,73,78,5,264,272,8
281874,https://htmlpreview.github.io/?https://github.com/Christina96/boilerplate-sample-matches/blob/main/Java/ribbon-MDEwOlJlcG9zaXRvcnk3NjE2MTU4-flat-DiscoveryEnabledNIWSServerList.java-Essentials-MDEwOlJlcG9zaXRvcnkxNzczNzU0-flat-ItemDb.java.html,0.0427807486631016,12,ribbon-MDEwOlJlcG9zaXRvcnk3NjE2MTU4-flat-DiscoveryEnabledNIWSServerList.java,Essentials-MDEwOlJlcG9zaXRvcnkxNzczNzU0-flat-ItemDb.java,9,20,11,2,14,12
283225,https://htmlpreview.github.io/?https://github.com/Christina96/boilerplate-sample-matches/blob/main/Java/motan-MDEwOlJlcG9zaXRvcnk1NjY3OTUyMQ==-flat-RpcCommandUtil.java-ribbon-MDEwOlJlcG9zaXRvcnk3NjE2MTU4-flat-RibbonTest.java.html,0.06280193236714976,14,motan-MDEwOlJlcG9zaXRvcnk1NjY3OTUyMQ==-flat-RpcCommandUtil.java,ribbon-MDEwOlJlcG9zaXRvcnk3NjE2MTU4-flat-RibbonTest.java,38,41,3,148,153,5
284828,https://htmlpreview.github.io/?https://github.com/Christina96/boilerplate-sample-matches/blob/main/Java/BungeeCord-MDEwOlJlcG9zaXRvcnk2MDg0MjEw-flat-QueryHandler.java-Essentials-MDEwOlJlcG9zaXRvcnkxNzczNzU0-flat-User_2.java.html,0.0915032679738562,17,BungeeCord-MDEwOlJlcG9zaXRvcnk2MDg0MjEw-flat-QueryHandler.java,Essentials-MDEwOlJlcG9zaXRvcnkxNzczNzU0-flat-User_2.java,84,93,9,150,158,8
284960,https://htmlpreview.github.io/?https://github.com/Christina96/boilerplate-sample-matches/blob/main/Java/ribbon-MDEwOlJlcG9zaXRvcnk3NjE2MTU4-flat-CaseInsensitiveMultiMap.java-jedis-MDEwOlJlcG9zaXRvcnk3MTU2MDU=-flat-RedisModulesPipelineTest.java.html,0.038394415357766144,11,ribbon-MDEwOlJlcG9zaXRvcnk3NjE2MTU4-flat-CaseInsensitiveMultiMap.java,jedis-MDEwOlJlcG9zaXRvcnk3MTU2MDU=-flat-RedisModulesPipelineTest.java,2,12,10,15,25,10
286053,https://htmlpreview.github.io/?https://github.com/Christina96/boilerplate-sample-matches/blob/main/Java/Mybatis-PageHelper-MDEwOlJlcG9zaXRvcnkyMDY1MTY3Mg==-flat-PageTest.java-Essentials-MDEwOlJlcG9zaXRvcnkxNzczNzU0-flat-Kit.java.html,0.03508771929824561,10,Mybatis-PageHelper-MDEwOlJlcG9zaXRvcnkyMDY1MTY3Mg==-flat-PageTest.java,Essentials-MDEwOlJlcG9zaXRvcnkxNzczNzU0-flat-Kit.java,1,10,9,1,10,9
288254,https://htmlpreview.github.io/?https://github.com/Christina96/boilerplate-sample-matches/blob/main/Java/motan-MDEwOlJlcG9zaXRvcnk1NjY3OTUyMQ==-flat-RestfulProtocol.java-motan-MDEwOlJlcG9zaXRvcnk1NjY3OTUyMQ==-flat-RefererConfigTest.java.html,0.20118343195266272,10,motan-MDEwOlJlcG9zaXRvcnk1NjY3OTUyMQ==-flat-RestfulProtocol.java,motan-MDEwOlJlcG9zaXRvcnk1NjY3OTUyMQ==-flat-RefererConfigTest.java,38,42,4,21,26,5
290791,https://htmlpreview.github.io/?https://github.com/Christina96/boilerplate-sample-matches/blob/main/Java/Mybatis-PageHelper-MDEwOlJlcG9zaXRvcnkyMDY1MTY3Mg==-flat-TestParameterMap.java-SpringPetClinic-MDEwOlJlcG9zaXRvcnkzMDkzNDMzNTE=-flat-PetTypeFormatterTests.java.html,0.2,12,Mybatis-PageHelper-MDEwOlJlcG9zaXRvcnkyMDY1MTY3Mg==-flat-TestParameterMap.java,SpringPetClinic-MDEwOlJlcG9zaXRvcnkzMDkzNDMzNTE=-flat-PetTypeFormatterTests.java,1,12,11,1,12,11
292323,https://htmlpreview.github.io/?https://github.com/Christina96/boilerplate-sample-matches/blob/main/Java/motan-MDEwOlJlcG9zaXRvcnk1NjY3OTUyMQ==-flat-ProtocolFilterDecoratorTest.java-VitamioBundle-MDEwOlJlcG9zaXRvcnk2MjkyMDI5-flat-MediaPlayerSubtitle.java.html,0.1278538812785388,14,motan-MDEwOlJlcG9zaXRvcnk1NjY3OTUyMQ==-flat-ProtocolFilterDecoratorTest.java,VitamioBundle-MDEwOlJlcG9zaXRvcnk2MjkyMDI5-flat-MediaPlayerSubtitle.java,2,15,13,5,18,13
292764,https://htmlpreview.github.io/?https://github.com/Christina96/boilerplate-sample-matches/blob/main/Java/Essentials-MDEwOlJlcG9zaXRvcnkxNzczNzU0-flat-EssentialsChatPlayerListenerLowest.java-Essentials-MDEwOlJlcG9zaXRvcnkxNzczNzU0-flat-Metrics.java.html,0.07313195548489666,12,Essentials-MDEwOlJlcG9zaXRvcnkxNzczNzU0-flat-EssentialsChatPlayerListenerLowest.java,Essentials-MDEwOlJlcG9zaXRvcnkxNzczNzU0-flat-Metrics.java,34,38,4,185,192,7
294182,https://htmlpreview.github.io/?https://github.com/Christina96/boilerplate-sample-matches/blob/main/Java/BungeeCord-MDEwOlJlcG9zaXRvcnk2MDg0MjEw-flat-PreLoginEvent.java-google-api-java-client-samples-MDEwOlJlcG9zaXRvcnkyOTc0OTA1Mg==-flat-TasksSample.java.html,0.1004566210045662,11,BungeeCord-MDEwOlJlcG9zaXRvcnk2MDg0MjEw-flat-PreLoginEvent.java,google-api-java-client-samples-MDEwOlJlcG9zaXRvcnkyOTc0OTA1Mg==-flat-TasksSample.java,1,11,10,1,11,10
296200,https://htmlpreview.github.io/?https://github.com/Christina96/boilerplate-sample-matches/blob/main/Java/jedis-MDEwOlJlcG9zaXRvcnk3MTU2MDU=-flat-JedisCommandsTestBase.java-google-api-java-client-samples-MDEwOlJlcG9zaXRvcnkyOTc0OTA1Mg==-flat-Noteendpoint_24.java.html,0.050761421319796954,10,jedis-MDEwOlJlcG9zaXRvcnk3MTU2MDU=-flat-JedisCommandsTestBase.java,google-api-java-client-samples-MDEwOlJlcG9zaXRvcnkyOTc0OTA1Mg==-flat-Noteendpoint_24.java,17,22,5,263,271,8
296234,https://htmlpreview.github.io/?https://github.com/Christina96/boilerplate-sample-matches/blob/main/Java/Essentials-MDEwOlJlcG9zaXRvcnkxNzczNzU0-flat-Commandsell.java-ribbon-MDEwOlJlcG9zaXRvcnk3NjE2MTU4-flat-MethodTemplateExecutorTest.java.html,0.1497326203208556,17,Essentials-MDEwOlJlcG9zaXRvcnkxNzczNzU0-flat-Commandsell.java,ribbon-MDEwOlJlcG9zaXRvcnk3NjE2MTU4-flat-MethodTemplateExecutorTest.java,92,95,3,58,64,6
298948,https://htmlpreview.github.io/?https://github.com/Christina96/boilerplate-sample-matches/blob/main/Java/jedis-MDEwOlJlcG9zaXRvcnk3MTU2MDU=-flat-ClusterValuesCommandsTest.java-jedis-MDEwOlJlcG9zaXRvcnk3MTU2MDU=-flat-SetCommandsTestBase.java.html,0.133492252681764,20,jedis-MDEwOlJlcG9zaXRvcnk3MTU2MDU=-flat-ClusterValuesCommandsTest.java,jedis-MDEwOlJlcG9zaXRvcnk3MTU2MDU=-flat-SetCommandsTestBase.java,1,20,19,1,20,19
300327,https://htmlpreview.github.io/?https://github.com/Christina96/boilerplate-sample-matches/blob/main/Java/motan-MDEwOlJlcG9zaXRvcnk1NjY3OTUyMQ==-flat-ConsistentHashLoadBalance.java-jedis-MDEwOlJlcG9zaXRvcnk3MTU2MDU=-flat-Query.java.html,0.033112582781456956,10,motan-MDEwOlJlcG9zaXRvcnk1NjY3OTUyMQ==-flat-ConsistentHashLoadBalance.java,jedis-MDEwOlJlcG9zaXRvcnk3MTU2MDU=-flat-Query.java,1,10,9,1,10,9
302890,https://htmlpreview.github.io/?https://github.com/Christina96/boilerplate-sample-matches/blob/main/Java/segmentfault-lessons-MDEwOlJlcG9zaXRvcnk5MzE1NzM4MQ==-flat-PersonNamePrefix.java-Essentials-MDEwOlJlcG9zaXRvcnkxNzczNzU0-flat-UUIDMap.java.html,0.08097165991902834,10,segmentfault-lessons-MDEwOlJlcG9zaXRvcnk5MzE1NzM4MQ==-flat-PersonNamePrefix.java,Essentials-MDEwOlJlcG9zaXRvcnkxNzczNzU0-flat-UUIDMap.java,1,10,9,1,10,9
303998,https://htmlpreview.github.io/?https://github.com/Christina96/boilerplate-sample-matches/blob/main/Java/segmentfault-lessons-MDEwOlJlcG9zaXRvcnk5MzE1NzM4MQ==-flat-PersonSpringBootTest.java-jedis-MDEwOlJlcG9zaXRvcnk3MTU2MDU=-flat-ScriptingCommandsTest.java.html,0.03110419906687403,10,segmentfault-lessons-MDEwOlJlcG9zaXRvcnk5MzE1NzM4MQ==-flat-PersonSpringBootTest.java,jedis-MDEwOlJlcG9zaXRvcnk3MTU2MDU=-flat-ScriptingCommandsTest.java,17,21,4,384,387,3
304182,https://htmlpreview.github.io/?https://github.com/Christina96/boilerplate-sample-matches/blob/main/Java/motan-MDEwOlJlcG9zaXRvcnk1NjY3OTUyMQ==-flat-BaseTest.java-Essentials-MDEwOlJlcG9zaXRvcnkxNzczNzU0-flat-Commandptime.java.html,0.058997050147492625,10,motan-MDEwOlJlcG9zaXRvcnk1NjY3OTUyMQ==-flat-BaseTest.java,Essentials-MDEwOlJlcG9zaXRvcnkxNzczNzU0-flat-Commandptime.java,10,19,9,2,12,10
305615,https://htmlpreview.github.io/?https://github.com/Christina96/boilerplate-sample-matches/blob/main/Java/segmentfault-lessons-MDEwOlJlcG9zaXRvcnk5MzE1NzM4MQ==-flat-FileOperationsUsingByteChannelDemo.java-jedis-MDEwOlJlcG9zaXRvcnk3MTU2MDU=-flat-ClusterBinaryValuesCommandsTest_0.java.html,0.0975609756097561,12,segmentfault-lessons-MDEwOlJlcG9zaXRvcnk5MzE1NzM4MQ==-flat-FileOperationsUsingByteChannelDemo.java,jedis-MDEwOlJlcG9zaXRvcnk3MTU2MDU=-flat-ClusterBinaryValuesCommandsTest_0.java,2,13,11,9,20,11
306882,https://htmlpreview.github.io/?https://github.com/Christina96/boilerplate-sample-matches/blob/main/Java/VitamioBundle-MDEwOlJlcG9zaXRvcnk2MjkyMDI5-flat-ScreenResolution.java-jedis-MDEwOlJlcG9zaXRvcnk3MTU2MDU=-flat-TupleTest.java.html,0.12222222222222222,11,VitamioBundle-MDEwOlJlcG9zaXRvcnk2MjkyMDI5-flat-ScreenResolution.java,jedis-MDEwOlJlcG9zaXRvcnk3MTU2MDU=-flat-TupleTest.java,1,11,10,1,11,10
307734,https://htmlpreview.github.io/?https://github.com/Christina96/boilerplate-sample-matches/blob/main/Java/google-api-java-client-samples-MDEwOlJlcG9zaXRvcnkyOTc0OTA1Mg==-flat-PlusServiceAccountSample.java-VitamioBundle-MDEwOlJlcG9zaXRvcnk2MjkyMDI5-flat-MediaStore.java.html,0.10401891252955082,22,google-api-java-client-samples-MDEwOlJlcG9zaXRvcnkyOTc0OTA1Mg==-flat-PlusServiceAccountSample.java,VitamioBundle-MDEwOlJlcG9zaXRvcnk2MjkyMDI5-flat-MediaStore.java,1,23,22,1,33,32
309247,https://htmlpreview.github.io/?https://github.com/Christina96/boilerplate-sample-matches/blob/main/Java/Mybatis-PageHelper-MDEwOlJlcG9zaXRvcnkyMDY1MTY3Mg==-flat-IPageTest.java-jedis-MDEwOlJlcG9zaXRvcnk3MTU2MDU=-flat-JedisPoolTest.java.html,0.06358381502890173,11,Mybatis-PageHelper-MDEwOlJlcG9zaXRvcnkyMDY1MTY3Mg==-flat-IPageTest.java,jedis-MDEwOlJlcG9zaXRvcnk3MTU2MDU=-flat-JedisPoolTest.java,19,26,7,277,284,7
311645,https://htmlpreview.github.io/?https://github.com/Christina96/boilerplate-sample-matches/blob/main/Java/ribbon-MDEwOlJlcG9zaXRvcnk3NjE2MTU4-flat-RibbonTransport.java-BungeeCord-MDEwOlJlcG9zaXRvcnk2MDg0MjEw-flat-BungeeCord.java.html,0.04647160068846816,27,ribbon-MDEwOlJlcG9zaXRvcnk3NjE2MTU4-flat-RibbonTransport.java,BungeeCord-MDEwOlJlcG9zaXRvcnk2MDg0MjEw-flat-BungeeCord.java,2,28,26,76,103,27
312092,https://htmlpreview.github.io/?https://github.com/Christina96/boilerplate-sample-matches/blob/main/Java/BungeeCord-MDEwOlJlcG9zaXRvcnk2MDg0MjEw-flat-ForgeUtils.java-ribbon-MDEwOlJlcG9zaXRvcnk3NjE2MTU4-flat-ClientConfigTest.java.html,0.06470588235294118,11,BungeeCord-MDEwOlJlcG9zaXRvcnk2MDg0MjEw-flat-ForgeUtils.java,ribbon-MDEwOlJlcG9zaXRvcnk3NjE2MTU4-flat-ClientConfigTest.java,1,11,10,1,11,10
313886,https://htmlpreview.github.io/?https://github.com/Christina96/boilerplate-sample-matches/blob/main/Java/segmentfault-lessons-MDEwOlJlcG9zaXRvcnk5MzE1NzM4MQ==-flat-StreamCollectDemo.java-jedis-MDEwOlJlcG9zaXRvcnk3MTU2MDU=-flat-JsonSearchWithGsonTest.java.html,0.1935483870967742,12,segmentfault-lessons-MDEwOlJlcG9zaXRvcnk5MzE1NzM4MQ==-flat-StreamCollectDemo.java,jedis-MDEwOlJlcG9zaXRvcnk3MTU2MDU=-flat-JsonSearchWithGsonTest.java,8,15,7,54,60,6
315385,https://htmlpreview.github.io/?https://github.com/Christina96/boilerplate-sample-matches/blob/main/Java/Essentials-MDEwOlJlcG9zaXRvcnkxNzczNzU0-flat-Commandspawn.java-BungeeCord-MDEwOlJlcG9zaXRvcnk2MDg0MjEw-flat-ProxyServer.java.html,0.11650485436893204,12,Essentials-MDEwOlJlcG9zaXRvcnkxNzczNzU0-flat-Commandspawn.java,BungeeCord-MDEwOlJlcG9zaXRvcnk2MDg0MjEw-flat-ProxyServer.java,1,12,11,1,12,11
315946,https://htmlpreview.github.io/?https://github.com/Christina96/boilerplate-sample-matches/blob/main/Java/Essentials-MDEwOlJlcG9zaXRvcnkxNzczNzU0-flat-Method.java-jedis-MDEwOlJlcG9zaXRvcnk3MTU2MDU=-flat-ListPipelineCommands.java.html,0.15492957746478872,12,Essentials-MDEwOlJlcG9zaXRvcnkxNzczNzU0-flat-Method.java,jedis-MDEwOlJlcG9zaXRvcnk3MTU2MDU=-flat-ListPipelineCommands.java,13,16,3,9,12,3
317931,https://htmlpreview.github.io/?https://github.com/Christina96/boilerplate-sample-matches/blob/main/Java/jedis-MDEwOlJlcG9zaXRvcnk3MTU2MDU=-flat-JedisSentinelPoolTest.java-motan-MDEwOlJlcG9zaXRvcnk1NjY3OTUyMQ==-flat-NettyChannelHandler_10.java.html,0.0970464135021097,13,jedis-MDEwOlJlcG9zaXRvcnk3MTU2MDU=-flat-JedisSentinelPoolTest.java,motan-MDEwOlJlcG9zaXRvcnk1NjY3OTUyMQ==-flat-NettyChannelHandler_10.java,2,14,12,17,29,12
318104,https://htmlpreview.github.io/?https://github.com/Christina96/boilerplate-sample-matches/blob/main/Java/Mybatis-PageHelper-MDEwOlJlcG9zaXRvcnkyMDY1MTY3Mg==-flat-PageRowBounds.java-Essentials-MDEwOlJlcG9zaXRvcnkxNzczNzU0-flat-User_2.java.html,0.02857142857142857,15,Mybatis-PageHelper-MDEwOlJlcG9zaXRvcnkyMDY1MTY3Mg==-flat-PageRowBounds.java,Essentials-MDEwOlJlcG9zaXRvcnkxNzczNzU0-flat-User_2.java,8,20,12,638,654,16
320211,https://htmlpreview.github.io/?https://github.com/Christina96/boilerplate-sample-matches/blob/main/Java/ribbon-MDEwOlJlcG9zaXRvcnk3NjE2MTU4-flat-MethodTemplateExecutor.java-BungeeCord-MDEwOlJlcG9zaXRvcnk2MDg0MjEw-flat-DownstreamBridge.java.html,0.030395136778115502,15,ribbon-MDEwOlJlcG9zaXRvcnk3NjE2MTU4-flat-MethodTemplateExecutor.java,BungeeCord-MDEwOlJlcG9zaXRvcnk2MDg0MjEw-flat-DownstreamBridge.java,1,15,14,1,15,14
320663,https://htmlpreview.github.io/?https://github.com/Christina96/boilerplate-sample-matches/blob/main/Java/BungeeCord-MDEwOlJlcG9zaXRvcnk2MDg0MjEw-flat-Handshake.java-motan-MDEwOlJlcG9zaXRvcnk1NjY3OTUyMQ==-flat-ConsulRegistryService.java.html,0.09569377990430622,10,BungeeCord-MDEwOlJlcG9zaXRvcnk2MDg0MjEw-flat-Handshake.java,motan-MDEwOlJlcG9zaXRvcnk1NjY3OTUyMQ==-flat-ConsulRegistryService.java,2,10,8,7,15,8
321924,https://htmlpreview.github.io/?https://github.com/Christina96/boilerplate-sample-matches/blob/main/Java/google-api-java-client-samples-MDEwOlJlcG9zaXRvcnkyOTc0OTA1Mg==-flat-BucketsInsertExample.java-BungeeCord-MDEwOlJlcG9zaXRvcnk2MDg0MjEw-flat-Metrics.java.html,0.16568047337278108,14,google-api-java-client-samples-MDEwOlJlcG9zaXRvcnkyOTc0OTA1Mg==-flat-BucketsInsertExample.java,BungeeCord-MDEwOlJlcG9zaXRvcnk2MDg0MjEw-flat-Metrics.java,4,17,13,2,16,14
322570,https://htmlpreview.github.io/?https://github.com/Christina96/boilerplate-sample-matches/blob/main/Java/jedis-MDEwOlJlcG9zaXRvcnk3MTU2MDU=-flat-ListCommandsTest.java-jedis-MDEwOlJlcG9zaXRvcnk3MTU2MDU=-flat-SortedSetCommandsTestBase.java.html,0.4574143196470987,10,jedis-MDEwOlJlcG9zaXRvcnk3MTU2MDU=-flat-ListCommandsTest.java,jedis-MDEwOlJlcG9zaXRvcnk3MTU2MDU=-flat-SortedSetCommandsTestBase.java,330,335,5,455,462,7
323218,https://htmlpreview.github.io/?https://github.com/Christina96/boilerplate-sample-matches/blob/main/Java/Essentials-MDEwOlJlcG9zaXRvcnkxNzczNzU0-flat-GMUserEvent.java-motan-MDEwOlJlcG9zaXRvcnk1NjY3OTUyMQ==-flat-NettyServerTest.java.html,0.0975609756097561,14,Essentials-MDEwOlJlcG9zaXRvcnkxNzczNzU0-flat-GMUserEvent.java,motan-MDEwOlJlcG9zaXRvcnk1NjY3OTUyMQ==-flat-NettyServerTest.java,43,46,3,88,93,5
324630,https://htmlpreview.github.io/?https://github.com/Christina96/boilerplate-sample-matches/blob/main/Java/jedis-MDEwOlJlcG9zaXRvcnk3MTU2MDU=-flat-PathTest_1.java-Essentials-MDEwOlJlcG9zaXRvcnkxNzczNzU0-flat-Potions.java.html,0.24390243902439024,10,jedis-MDEwOlJlcG9zaXRvcnk3MTU2MDU=-flat-PathTest_1.java,Essentials-MDEwOlJlcG9zaXRvcnkxNzczNzU0-flat-Potions.java,26,27,1,25,34,9
326130,https://htmlpreview.github.io/?https://github.com/Christina96/boilerplate-sample-matches/blob/main/Java/segmentfault-lessons-MDEwOlJlcG9zaXRvcnk5MzE1NzM4MQ==-flat-SpringBootLesson1ApplicationTests.java-segmentfault-lessons-MDEwOlJlcG9zaXRvcnk5MzE1NzM4MQ==-flat-SpringBootLesson18ApplicationTests.java.html,1.0,12,segmentfault-lessons-MDEwOlJlcG9zaXRvcnk5MzE1NzM4MQ==-flat-SpringBootLesson1ApplicationTests.java,segmentfault-lessons-MDEwOlJlcG9zaXRvcnk5MzE1NzM4MQ==-flat-SpringBootLesson18ApplicationTests.java,1,12,11,1,12,11
326298,https://htmlpreview.github.io/?https://github.com/Christina96/boilerplate-sample-matches/blob/main/Java/Essentials-MDEwOlJlcG9zaXRvcnkxNzczNzU0-flat-UUIDMap.java-motan-MDEwOlJlcG9zaXRvcnk1NjY3OTUyMQ==-flat-NettyChannel_11.java.html,0.1390593047034765,10,Essentials-MDEwOlJlcG9zaXRvcnkxNzczNzU0-flat-UUIDMap.java,motan-MDEwOlJlcG9zaXRvcnk1NjY3OTUyMQ==-flat-NettyChannel_11.java,109,121,12,148,153,5
326758,https://htmlpreview.github.io/?https://github.com/Christina96/boilerplate-sample-matches/blob/main/Java/motan-MDEwOlJlcG9zaXRvcnk1NjY3OTUyMQ==-flat-ClientStatistics.java-Essentials-MDEwOlJlcG9zaXRvcnkxNzczNzU0-flat-Commandrecipe.java.html,0.08152173913043478,15,motan-MDEwOlJlcG9zaXRvcnk1NjY3OTUyMQ==-flat-ClientStatistics.java,Essentials-MDEwOlJlcG9zaXRvcnkxNzczNzU0-flat-Commandrecipe.java,58,65,7,128,130,2
327105,https://htmlpreview.github.io/?https://github.com/Christina96/boilerplate-sample-matches/blob/main/Java/motan-MDEwOlJlcG9zaXRvcnk1NjY3OTUyMQ==-flat-MotanFrameworkException.java-motan-MDEwOlJlcG9zaXRvcnk1NjY3OTUyMQ==-flat-DefaultThreadFactory.java.html,0.30434782608695654,14,motan-MDEwOlJlcG9zaXRvcnk1NjY3OTUyMQ==-flat-MotanFrameworkException.java,motan-MDEwOlJlcG9zaXRvcnk1NjY3OTUyMQ==-flat-DefaultThreadFactory.java,8,16,8,13,21,8
327521,https://htmlpreview.github.io/?https://github.com/Christina96/boilerplate-sample-matches/blob/main/Java/motan-MDEwOlJlcG9zaXRvcnk1NjY3OTUyMQ==-flat-NettyEndpointFactory.java-motan-MDEwOlJlcG9zaXRvcnk1NjY3OTUyMQ==-flat-MockRegistryFactory.java.html,0.3409090909090909,15,motan-MDEwOlJlcG9zaXRvcnk1NjY3OTUyMQ==-flat-NettyEndpointFactory.java,motan-MDEwOlJlcG9zaXRvcnk1NjY3OTUyMQ==-flat-MockRegistryFactory.java,1,13,12,1,13,12
327790,https://htmlpreview.github.io/?https://github.com/Christina96/boilerplate-sample-matches/blob/main/Java/jedis-MDEwOlJlcG9zaXRvcnk3MTU2MDU=-flat-CFReserveParams.java-Essentials-MDEwOlJlcG9zaXRvcnkxNzczNzU0-flat-UUIDMap.java.html,0.07575757575757576,10,jedis-MDEwOlJlcG9zaXRvcnk3MTU2MDU=-flat-CFReserveParams.java,Essentials-MDEwOlJlcG9zaXRvcnkxNzczNzU0-flat-UUIDMap.java,2,11,9,15,25,10
328132,https://htmlpreview.github.io/?https://github.com/Christina96/boilerplate-sample-matches/blob/main/Java/Mybatis-PageHelper-MDEwOlJlcG9zaXRvcnkyMDY1MTY3Mg==-flat-CloseableTest.java-jedis-MDEwOlJlcG9zaXRvcnk3MTU2MDU=-flat-ClusterScriptingCommandsTest.java.html,0.12345679012345678,10,Mybatis-PageHelper-MDEwOlJlcG9zaXRvcnkyMDY1MTY3Mg==-flat-CloseableTest.java,jedis-MDEwOlJlcG9zaXRvcnk3MTU2MDU=-flat-ClusterScriptingCommandsTest.java,2,10,8,7,15,8
328231,https://htmlpreview.github.io/?https://github.com/Christina96/boilerplate-sample-matches/blob/main/Java/segmentfault-lessons-MDEwOlJlcG9zaXRvcnk5MzE1NzM4MQ==-flat-UserServiceClientApplication_52.java-Mybatis-PageHelper-MDEwOlJlcG9zaXRvcnkyMDY1MTY3Mg==-flat-UsingDialectClassTest.java.html,0.15,15,segmentfault-lessons-MDEwOlJlcG9zaXRvcnk5MzE1NzM4MQ==-flat-UserServiceClientApplication_52.java,Mybatis-PageHelper-MDEwOlJlcG9zaXRvcnkyMDY1MTY3Mg==-flat-UsingDialectClassTest.java,1,15,14,1,15,14
328484,https://htmlpreview.github.io/?https://github.com/Christina96/boilerplate-sample-matches/blob/main/Java/motan-MDEwOlJlcG9zaXRvcnk1NjY3OTUyMQ==-flat-HelloResource.java-segmentfault-lessons-MDEwOlJlcG9zaXRvcnk5MzE1NzM4MQ==-flat-UserServiceProviderController_40.java.html,0.18181818181818182,11,motan-MDEwOlJlcG9zaXRvcnk1NjY3OTUyMQ==-flat-HelloResource.java,segmentfault-lessons-MDEwOlJlcG9zaXRvcnk5MzE1NzM4MQ==-flat-UserServiceProviderController_40.java,1,11,10,1,11,10
328745,https://htmlpreview.github.io/?https://github.com/Christina96/boilerplate-sample-matches/blob/main/Java/Mybatis-PageHelper-MDEwOlJlcG9zaXRvcnkyMDY1MTY3Mg==-flat-ExecutorUtil.java-Essentials-MDEwOlJlcG9zaXRvcnkxNzczNzU0-flat-TextPager.java.html,0.06741573033707865,12,Mybatis-PageHelper-MDEwOlJlcG9zaXRvcnkyMDY1MTY3Mg==-flat-ExecutorUtil.java,Essentials-MDEwOlJlcG9zaXRvcnkxNzczNzU0-flat-TextPager.java,55,61,6,21,26,5
330149,https://htmlpreview.github.io/?https://github.com/Christina96/boilerplate-sample-matches/blob/main/Java/google-api-java-client-samples-MDEwOlJlcG9zaXRvcnkyOTc0OTA1Mg==-flat-PlusBasicServlet.java-segmentfault-lessons-MDEwOlJlcG9zaXRvcnk5MzE1NzM4MQ==-flat-FileMonitor.java.html,0.20952380952380953,11,google-api-java-client-samples-MDEwOlJlcG9zaXRvcnkyOTc0OTA1Mg==-flat-PlusBasicServlet.java,segmentfault-lessons-MDEwOlJlcG9zaXRvcnk5MzE1NzM4MQ==-flat-FileMonitor.java,7,17,10,2,12,10
333129,https://htmlpreview.github.io/?https://github.com/Christina96/boilerplate-sample-matches/blob/main/Java/google-api-java-client-samples-MDEwOlJlcG9zaXRvcnkyOTc0OTA1Mg==-flat-DeviceInfo_27.java-google-api-java-client-samples-MDEwOlJlcG9zaXRvcnkyOTc0OTA1Mg==-flat-Deviceinfoendpoint_26.java.html,0.05333333333333334,10,google-api-java-client-samples-MDEwOlJlcG9zaXRvcnkyOTc0OTA1Mg==-flat-DeviceInfo_27.java,google-api-java-client-samples-MDEwOlJlcG9zaXRvcnkyOTc0OTA1Mg==-flat-Deviceinfoendpoint_26.java,5,13,8,190,198,8
338449,https://htmlpreview.github.io/?https://github.com/Christina96/boilerplate-sample-matches/blob/main/Java/BungeeCord-MDEwOlJlcG9zaXRvcnk2MDg0MjEw-flat-ChatChain.java-jedis-MDEwOlJlcG9zaXRvcnk3MTU2MDU=-flat-ClusterCommandsTest.java.html,0.05649717514124294,10,BungeeCord-MDEwOlJlcG9zaXRvcnk2MDg0MjEw-flat-ChatChain.java,jedis-MDEwOlJlcG9zaXRvcnk3MTU2MDU=-flat-ClusterCommandsTest.java,1,10,9,1,10,9
339136,https://htmlpreview.github.io/?https://github.com/Christina96/boilerplate-sample-matches/blob/main/Java/Essentials-MDEwOlJlcG9zaXRvcnkxNzczNzU0-flat-IEssentials_4.java-BungeeCord-MDEwOlJlcG9zaXRvcnk2MDg0MjEw-flat-AbstractPacketHandler.java.html,0.26366559485530544,12,Essentials-MDEwOlJlcG9zaXRvcnkxNzczNzU0-flat-IEssentials_4.java,BungeeCord-MDEwOlJlcG9zaXRvcnk2MDg0MjEw-flat-AbstractPacketHandler.java,28,32,4,62,72,10
339906,https://htmlpreview.github.io/?https://github.com/Christina96/boilerplate-sample-matches/blob/main/Java/ribbon-MDEwOlJlcG9zaXRvcnk3NjE2MTU4-flat-AnnotationProcessor.java-jedis-MDEwOlJlcG9zaXRvcnk3MTU2MDU=-flat-GeoBinaryCommands.java.html,0.10526315789473684,11,ribbon-MDEwOlJlcG9zaXRvcnk3NjE2MTU4-flat-AnnotationProcessor.java,jedis-MDEwOlJlcG9zaXRvcnk3MTU2MDU=-flat-GeoBinaryCommands.java,7,8,1,15,16,1
340118,https://htmlpreview.github.io/?https://github.com/Christina96/boilerplate-sample-matches/blob/main/Java/VitamioBundle-MDEwOlJlcG9zaXRvcnk2MjkyMDI5-flat-Vitamio.java-motan-MDEwOlJlcG9zaXRvcnk1NjY3OTUyMQ==-flat-StatsUtil.java.html,0.06498194945848375,10,VitamioBundle-MDEwOlJlcG9zaXRvcnk2MjkyMDI5-flat-Vitamio.java,motan-MDEwOlJlcG9zaXRvcnk1NjY3OTUyMQ==-flat-StatsUtil.java,25,35,10,236,245,9
340222,https://htmlpreview.github.io/?https://github.com/Christina96/boilerplate-sample-matches/blob/main/Java/ribbon-MDEwOlJlcG9zaXRvcnk3NjE2MTU4-flat-LoadBalancingUdpClient.java-Essentials-MDEwOlJlcG9zaXRvcnkxNzczNzU0-flat-Teleport.java.html,0.06496519721577726,14,ribbon-MDEwOlJlcG9zaXRvcnk3NjE2MTU4-flat-LoadBalancingUdpClient.java,Essentials-MDEwOlJlcG9zaXRvcnkxNzczNzU0-flat-Teleport.java,1,14,13,1,14,13
340592,https://htmlpreview.github.io/?https://github.com/Christina96/boilerplate-sample-matches/blob/main/Java/Mybatis-PageHelper-MDEwOlJlcG9zaXRvcnkyMDY1MTY3Mg==-flat-TestAnnotations.java-motan-MDEwOlJlcG9zaXRvcnk1NjY3OTUyMQ==-flat-TestServletCotainerRestful.java.html,0.26548672566371684,10,Mybatis-PageHelper-MDEwOlJlcG9zaXRvcnkyMDY1MTY3Mg==-flat-TestAnnotations.java,motan-MDEwOlJlcG9zaXRvcnk1NjY3OTUyMQ==-flat-TestServletCotainerRestful.java,1,10,9,1,10,9
341862,https://htmlpreview.github.io/?https://github.com/Christina96/boilerplate-sample-matches/blob/main/Java/motan-MDEwOlJlcG9zaXRvcnk1NjY3OTUyMQ==-flat-ConsulUtils.java-BungeeCord-MDEwOlJlcG9zaXRvcnk2MDg0MjEw-flat-ComponentsTest.java.html,0.10336538461538461,11,motan-MDEwOlJlcG9zaXRvcnk1NjY3OTUyMQ==-flat-ConsulUtils.java,BungeeCord-MDEwOlJlcG9zaXRvcnk2MDg0MjEw-flat-ComponentsTest.java,3,11,8,2,13,11
345539,https://htmlpreview.github.io/?https://github.com/Christina96/boilerplate-sample-matches/blob/main/Java/segmentfault-lessons-MDEwOlJlcG9zaXRvcnk5MzE1NzM4MQ==-flat-ActiveMQMessageChannelBinder_70.java-ribbon-MDEwOlJlcG9zaXRvcnk3NjE2MTU4-flat-EvCacheAnnotationTest.java.html,0.11764705882352941,12,segmentfault-lessons-MDEwOlJlcG9zaXRvcnk5MzE1NzM4MQ==-flat-ActiveMQMessageChannelBinder_70.java,ribbon-MDEwOlJlcG9zaXRvcnk3NjE2MTU4-flat-EvCacheAnnotationTest.java,1,12,11,1,12,11
345945,https://htmlpreview.github.io/?https://github.com/Christina96/boilerplate-sample-matches/blob/main/Java/ribbon-MDEwOlJlcG9zaXRvcnk3NjE2MTU4-flat-HttpPrimeConnection.java-BungeeCord-MDEwOlJlcG9zaXRvcnk2MDg0MjEw-flat-AddressParseTest.java.html,0.183206106870229,12,ribbon-MDEwOlJlcG9zaXRvcnk3NjE2MTU4-flat-HttpPrimeConnection.java,BungeeCord-MDEwOlJlcG9zaXRvcnk2MDg0MjEw-flat-AddressParseTest.java,1,12,11,1,12,11
346505,https://htmlpreview.github.io/?https://github.com/Christina96/boilerplate-sample-matches/blob/main/Java/motan-MDEwOlJlcG9zaXRvcnk1NjY3OTUyMQ==-flat-RestfulProtocol.java-ribbon-MDEwOlJlcG9zaXRvcnk3NjE2MTU4-flat-MethodTemplateExecutor.java.html,0.09202453987730061,15,motan-MDEwOlJlcG9zaXRvcnk1NjY3OTUyMQ==-flat-RestfulProtocol.java,ribbon-MDEwOlJlcG9zaXRvcnk3NjE2MTU4-flat-MethodTemplateExecutor.java,1,15,14,1,15,14
348919,https://htmlpreview.github.io/?https://github.com/Christina96/boilerplate-sample-matches/blob/main/Java/jedis-MDEwOlJlcG9zaXRvcnk3MTU2MDU=-flat-ShardedConnectionTest.java-jedis-MDEwOlJlcG9zaXRvcnk3MTU2MDU=-flat-JedisClusterTest.java.html,0.022577610536218252,12,jedis-MDEwOlJlcG9zaXRvcnk3MTU2MDU=-flat-ShardedConnectionTest.java,jedis-MDEwOlJlcG9zaXRvcnk3MTU2MDU=-flat-JedisClusterTest.java,2,13,11,23,34,11
351735,https://htmlpreview.github.io/?https://github.com/Christina96/boilerplate-sample-matches/blob/main/Java/google-api-java-client-samples-MDEwOlJlcG9zaXRvcnkyOTc0OTA1Mg==-flat-CalendarButtons.java-segmentfault-lessons-MDEwOlJlcG9zaXRvcnk5MzE1NzM4MQ==-flat-SelectorServerDemo.java.html,0.15748031496062992,10,google-api-java-client-samples-MDEwOlJlcG9zaXRvcnkyOTc0OTA1Mg==-flat-CalendarButtons.java,segmentfault-lessons-MDEwOlJlcG9zaXRvcnk5MzE1NzM4MQ==-flat-SelectorServerDemo.java,1,10,9,1,10,9
353046,https://htmlpreview.github.io/?https://github.com/Christina96/boilerplate-sample-matches/blob/main/Java/ribbon-MDEwOlJlcG9zaXRvcnk3NjE2MTU4-flat-LoadBalancingExample.java-motan-MDEwOlJlcG9zaXRvcnk1NjY3OTUyMQ==-flat-GrpcServer.java.html,0.13978494623655913,13,ribbon-MDEwOlJlcG9zaXRvcnk3NjE2MTU4-flat-LoadBalancingExample.java,motan-MDEwOlJlcG9zaXRvcnk1NjY3OTUyMQ==-flat-GrpcServer.java,1,13,12,1,13,12
356516,https://htmlpreview.github.io/?https://github.com/Christina96/boilerplate-sample-matches/blob/main/Java/BungeeCord-MDEwOlJlcG9zaXRvcnk2MDg0MjEw-flat-ItemTag.java-google-api-java-client-samples-MDEwOlJlcG9zaXRvcnkyOTc0OTA1Mg==-flat-GenerateReportForPublisher.java.html,0.14705882352941177,10,BungeeCord-MDEwOlJlcG9zaXRvcnk2MDg0MjEw-flat-ItemTag.java,google-api-java-client-samples-MDEwOlJlcG9zaXRvcnkyOTc0OTA1Mg==-flat-GenerateReportForPublisher.java,1,10,9,1,10,9
359412,https://htmlpreview.github.io/?https://github.com/Christina96/boilerplate-sample-matches/blob/main/Java/ribbon-MDEwOlJlcG9zaXRvcnk3NjE2MTU4-flat-MethodTemplateExecutorTest.java-VitamioBundle-MDEwOlJlcG9zaXRvcnk2MjkyMDI5-flat-Vitamio.java.html,0.06159420289855073,17,ribbon-MDEwOlJlcG9zaXRvcnk3NjE2MTU4-flat-MethodTemplateExecutorTest.java,VitamioBundle-MDEwOlJlcG9zaXRvcnk2MjkyMDI5-flat-Vitamio.java,1,17,16,1,17,16
364018,https://htmlpreview.github.io/?https://github.com/Christina96/boilerplate-sample-matches/blob/main/Java/motan-MDEwOlJlcG9zaXRvcnk1NjY3OTUyMQ==-flat-MeshRegistryTest.java-Essentials-MDEwOlJlcG9zaXRvcnkxNzczNzU0-flat-WorldsHolder.java.html,0.05897219882055602,21,motan-MDEwOlJlcG9zaXRvcnk1NjY3OTUyMQ==-flat-MeshRegistryTest.java,Essentials-MDEwOlJlcG9zaXRvcnkxNzczNzU0-flat-WorldsHolder.java,4,24,20,2,22,20
366122,https://htmlpreview.github.io/?https://github.com/Christina96/boilerplate-sample-matches/blob/main/Java/Essentials-MDEwOlJlcG9zaXRvcnkxNzczNzU0-flat-EssentialsUserConf.java-Mybatis-PageHelper-MDEwOlJlcG9zaXRvcnkyMDY1MTY3Mg==-flat-PageAutoDialect.java.html,0.05,10,Essentials-MDEwOlJlcG9zaXRvcnkxNzczNzU0-flat-EssentialsUserConf.java,Mybatis-PageHelper-MDEwOlJlcG9zaXRvcnkyMDY1MTY3Mg==-flat-PageAutoDialect.java,2,12,10,11,20,9
369040,https://htmlpreview.github.io/?https://github.com/Christina96/boilerplate-sample-matches/blob/main/Java/google-api-java-client-samples-MDEwOlJlcG9zaXRvcnkyOTc0OTA1Mg==-flat-OAuth2Sample.java-jedis-MDEwOlJlcG9zaXRvcnk3MTU2MDU=-flat-FailoverCommandsTest.java.html,0.08304498269896193,12,google-api-java-client-samples-MDEwOlJlcG9zaXRvcnkyOTc0OTA1Mg==-flat-OAuth2Sample.java,jedis-MDEwOlJlcG9zaXRvcnk3MTU2MDU=-flat-FailoverCommandsTest.java,11,22,11,2,13,11
370415,https://htmlpreview.github.io/?https://github.com/Christina96/boilerplate-sample-matches/blob/main/Java/jedis-MDEwOlJlcG9zaXRvcnk3MTU2MDU=-flat-AssertUtil.java-Essentials-MDEwOlJlcG9zaXRvcnkxNzczNzU0-flat-ISettings_3.java.html,0.056555269922879174,11,jedis-MDEwOlJlcG9zaXRvcnk3MTU2MDU=-flat-AssertUtil.java,Essentials-MDEwOlJlcG9zaXRvcnkxNzczNzU0-flat-ISettings_3.java,1,11,10,1,11,10
371513,https://htmlpreview.github.io/?https://github.com/Christina96/boilerplate-sample-matches/blob/main/Java/jedis-MDEwOlJlcG9zaXRvcnk3MTU2MDU=-flat-TDigestSketchCommands.java-jedis-MDEwOlJlcG9zaXRvcnk3MTU2MDU=-flat-SortedSetBinaryCommands.java.html,0.210989010989011,20,jedis-MDEwOlJlcG9zaXRvcnk3MTU2MDU=-flat-TDigestSketchCommands.java,jedis-MDEwOlJlcG9zaXRvcnk3MTU2MDU=-flat-SortedSetBinaryCommands.java,17,21,4,18,22,4
377084,https://htmlpreview.github.io/?https://github.com/Christina96/boilerplate-sample-matches/blob/main/Java/Essentials-MDEwOlJlcG9zaXRvcnkxNzczNzU0-flat-Commandban.java-jedis-MDEwOlJlcG9zaXRvcnk3MTU2MDU=-flat-TransactionCommandsTest.java.html,0.07857142857142857,11,Essentials-MDEwOlJlcG9zaXRvcnkxNzczNzU0-flat-Commandban.java,jedis-MDEwOlJlcG9zaXRvcnk3MTU2MDU=-flat-TransactionCommandsTest.java,1,11,10,1,11,10
378579,https://htmlpreview.github.io/?https://github.com/Christina96/boilerplate-sample-matches/blob/main/Java/Mybatis-PageHelper-MDEwOlJlcG9zaXRvcnkyMDY1MTY3Mg==-flat-IPageTest.java-Mybatis-PageHelper-MDEwOlJlcG9zaXRvcnkyMDY1MTY3Mg==-flat-MybatisHelper.java.html,0.16541353383458646,11,Mybatis-PageHelper-MDEwOlJlcG9zaXRvcnkyMDY1MTY3Mg==-flat-IPageTest.java,Mybatis-PageHelper-MDEwOlJlcG9zaXRvcnkyMDY1MTY3Mg==-flat-MybatisHelper.java,1,11,10,1,11,10
379424,https://htmlpreview.github.io/?https://github.com/Christina96/boilerplate-sample-matches/blob/main/Java/jedis-MDEwOlJlcG9zaXRvcnk3MTU2MDU=-flat-DoubleRangeValue.java-ribbon-MDEwOlJlcG9zaXRvcnk3NjE2MTU4-flat-EurekaNotificationServerListUpdater.java.html,0.07722007722007722,10,jedis-MDEwOlJlcG9zaXRvcnk3MTU2MDU=-flat-DoubleRangeValue.java,ribbon-MDEwOlJlcG9zaXRvcnk3NjE2MTU4-flat-EurekaNotificationServerListUpdater.java,16,22,6,86,92,6
384117,https://htmlpreview.github.io/?https://github.com/Christina96/boilerplate-sample-matches/blob/main/Java/motan-MDEwOlJlcG9zaXRvcnk1NjY3OTUyMQ==-flat-GrpcClient.java-motan-MDEwOlJlcG9zaXRvcnk1NjY3OTUyMQ==-flat-MeshClientConfig.java.html,0.08211143695014662,14,motan-MDEwOlJlcG9zaXRvcnk1NjY3OTUyMQ==-flat-GrpcClient.java,motan-MDEwOlJlcG9zaXRvcnk1NjY3OTUyMQ==-flat-MeshClientConfig.java,8,21,13,2,15,13
384298,https://htmlpreview.github.io/?https://github.com/Christina96/boilerplate-sample-matches/blob/main/Java/ribbon-MDEwOlJlcG9zaXRvcnk3NjE2MTU4-flat-PredicatesTest.java-Essentials-MDEwOlJlcG9zaXRvcnkxNzczNzU0-flat-Jails.java.html,0.0364656381486676,13,ribbon-MDEwOlJlcG9zaXRvcnk3NjE2MTU4-flat-PredicatesTest.java,Essentials-MDEwOlJlcG9zaXRvcnkxNzczNzU0-flat-Jails.java,1,13,12,1,13,12
388614,https://htmlpreview.github.io/?https://github.com/Christina96/boilerplate-sample-matches/blob/main/Java/Essentials-MDEwOlJlcG9zaXRvcnkxNzczNzU0-flat-GroupVariables.java-BungeeCord-MDEwOlJlcG9zaXRvcnk2MDg0MjEw-flat-ChatComponentTransformer.java.html,0.09777777777777778,11,Essentials-MDEwOlJlcG9zaXRvcnkxNzczNzU0-flat-GroupVariables.java,BungeeCord-MDEwOlJlcG9zaXRvcnk2MDg0MjEw-flat-ChatComponentTransformer.java,11,18,7,78,82,4
389149,https://htmlpreview.github.io/?https://github.com/Christina96/boilerplate-sample-matches/blob/main/Java/Essentials-MDEwOlJlcG9zaXRvcnkxNzczNzU0-flat-Commandtempban.java-Essentials-MDEwOlJlcG9zaXRvcnkxNzczNzU0-flat-EssentialsProtectEntityListener.java.html,0.15,11,Essentials-MDEwOlJlcG9zaXRvcnkxNzczNzU0-flat-Commandtempban.java,Essentials-MDEwOlJlcG9zaXRvcnkxNzczNzU0-flat-EssentialsProtectEntityListener.java,1,11,10,1,11,10
395117,https://htmlpreview.github.io/?https://github.com/Christina96/boilerplate-sample-matches/blob/main/Java/motan-MDEwOlJlcG9zaXRvcnk1NjY3OTUyMQ==-flat-ZookeeperRegistryTest.java-motan-MDEwOlJlcG9zaXRvcnk1NjY3OTUyMQ==-flat-ClusterSupportTest.java.html,0.07313642756680731,12,motan-MDEwOlJlcG9zaXRvcnk1NjY3OTUyMQ==-flat-ZookeeperRegistryTest.java,motan-MDEwOlJlcG9zaXRvcnk1NjY3OTUyMQ==-flat-ClusterSupportTest.java,52,60,8,142,146,4
397372,https://htmlpreview.github.io/?https://github.com/Christina96/boilerplate-sample-matches/blob/main/Java/Mybatis-PageHelper-MDEwOlJlcG9zaXRvcnkyMDY1MTY3Mg==-flat-AbstractDialect.java-ribbon-MDEwOlJlcG9zaXRvcnk3NjE2MTU4-flat-TestResource.java.html,0.12698412698412698,12,Mybatis-PageHelper-MDEwOlJlcG9zaXRvcnkyMDY1MTY3Mg==-flat-AbstractDialect.java,ribbon-MDEwOlJlcG9zaXRvcnk3NjE2MTU4-flat-TestResource.java,1,12,11,1,12,11
397551,https://htmlpreview.github.io/?https://github.com/Christina96/boilerplate-sample-matches/blob/main/Java/motan-MDEwOlJlcG9zaXRvcnk1NjY3OTUyMQ==-flat-MotanGlobalConfigUtilTest.java-ribbon-MDEwOlJlcG9zaXRvcnk3NjE2MTU4-flat-RxMovieServerTest.java.html,0.136986301369863,10,motan-MDEwOlJlcG9zaXRvcnk1NjY3OTUyMQ==-flat-MotanGlobalConfigUtilTest.java,ribbon-MDEwOlJlcG9zaXRvcnk3NjE2MTU4-flat-RxMovieServerTest.java,2,11,9,13,22,9
397785,https://htmlpreview.github.io/?https://github.com/Christina96/boilerplate-sample-matches/blob/main/Java/jedis-MDEwOlJlcG9zaXRvcnk3MTU2MDU=-flat-RedisJsonV2Test.java-jedis-MDEwOlJlcG9zaXRvcnk3MTU2MDU=-flat-ListCommandsTestBase.java.html,0.44585314315900687,13,jedis-MDEwOlJlcG9zaXRvcnk3MTU2MDU=-flat-RedisJsonV2Test.java,jedis-MDEwOlJlcG9zaXRvcnk3MTU2MDU=-flat-ListCommandsTestBase.java,50,56,6,319,327,8
400204,https://htmlpreview.github.io/?https://github.com/Christina96/boilerplate-sample-matches/blob/main/Java/BungeeCord-MDEwOlJlcG9zaXRvcnk2MDg0MjEw-flat-BaseComponentSerializer.java-BungeeCord-MDEwOlJlcG9zaXRvcnk2MDg0MjEw-flat-ServerConnector.java.html,0.18181818181818182,17,BungeeCord-MDEwOlJlcG9zaXRvcnk2MDg0MjEw-flat-BaseComponentSerializer.java,BungeeCord-MDEwOlJlcG9zaXRvcnk2MDg0MjEw-flat-ServerConnector.java,1,17,16,1,17,16
401343,https://htmlpreview.github.io/?https://github.com/Christina96/boilerplate-sample-matches/blob/main/Java/motan-MDEwOlJlcG9zaXRvcnk1NjY3OTUyMQ==-flat-LoggerUtil.java-motan-MDEwOlJlcG9zaXRvcnk1NjY3OTUyMQ==-flat-GrowableByteBuffer.java.html,0.272,10,motan-MDEwOlJlcG9zaXRvcnk1NjY3OTUyMQ==-flat-LoggerUtil.java,motan-MDEwOlJlcG9zaXRvcnk1NjY3OTUyMQ==-flat-GrowableByteBuffer.java,37,43,6,37,43,6
402481,https://htmlpreview.github.io/?https://github.com/Christina96/boilerplate-sample-matches/blob/main/Java/motan-MDEwOlJlcG9zaXRvcnk1NjY3OTUyMQ==-flat-TestProtoBuf.java-jedis-MDEwOlJlcG9zaXRvcnk3MTU2MDU=-flat-JedisFactory.java.html,0.1308411214953271,16,motan-MDEwOlJlcG9zaXRvcnk1NjY3OTUyMQ==-flat-TestProtoBuf.java,jedis-MDEwOlJlcG9zaXRvcnk3MTU2MDU=-flat-JedisFactory.java,64,69,5,68,74,6
403204,https://htmlpreview.github.io/?https://github.com/Christina96/boilerplate-sample-matches/blob/main/Java/Essentials-MDEwOlJlcG9zaXRvcnkxNzczNzU0-flat-Commandtempban.java-BungeeCord-MDEwOlJlcG9zaXRvcnk2MDg0MjEw-flat-EntityMap.java.html,0.05172413793103448,12,Essentials-MDEwOlJlcG9zaXRvcnkxNzczNzU0-flat-Commandtempban.java,BungeeCord-MDEwOlJlcG9zaXRvcnk2MDg0MjEw-flat-EntityMap.java,1,12,11,1,12,11
405836,https://htmlpreview.github.io/?https://github.com/Christina96/boilerplate-sample-matches/blob/main/Java/jedis-MDEwOlJlcG9zaXRvcnk3MTU2MDU=-flat-AllKindOfValuesCommandsTestBase.java-jedis-MDEwOlJlcG9zaXRvcnk3MTU2MDU=-flat-ListCommandsTest.java.html,0.5633802816901409,14,jedis-MDEwOlJlcG9zaXRvcnk3MTU2MDU=-flat-AllKindOfValuesCommandsTestBase.java,jedis-MDEwOlJlcG9zaXRvcnk3MTU2MDU=-flat-ListCommandsTest.java,160,168,8,339,347,8
407018,https://htmlpreview.github.io/?https://github.com/Christina96/boilerplate-sample-matches/blob/main/Java/ribbon-MDEwOlJlcG9zaXRvcnk3NjE2MTU4-flat-MockedDiscoveryServerListTest.java-jedis-MDEwOlJlcG9zaXRvcnk3MTU2MDU=-flat-JedisSentinelPoolTest.java.html,0.168,10,ribbon-MDEwOlJlcG9zaXRvcnk3NjE2MTU4-flat-MockedDiscoveryServerListTest.java,jedis-MDEwOlJlcG9zaXRvcnk3MTU2MDU=-flat-JedisSentinelPoolTest.java,52,57,5,52,59,7
408872,https://htmlpreview.github.io/?https://github.com/Christina96/boilerplate-sample-matches/blob/main/Java/Essentials-MDEwOlJlcG9zaXRvcnkxNzczNzU0-flat-StorageTest.java-motan-MDEwOlJlcG9zaXRvcnk1NjY3OTUyMQ==-flat-MeshRegistryListener.java.html,0.12429378531073447,11,Essentials-MDEwOlJlcG9zaXRvcnkxNzczNzU0-flat-StorageTest.java,motan-MDEwOlJlcG9zaXRvcnk1NjY3OTUyMQ==-flat-MeshRegistryListener.java,2,13,11,4,14,10
409435,https://htmlpreview.github.io/?https://github.com/Christina96/boilerplate-sample-matches/blob/main/Java/Mybatis-PageHelper-MDEwOlJlcG9zaXRvcnkyMDY1MTY3Mg==-flat-RemoveOrderTest.java-jedis-MDEwOlJlcG9zaXRvcnk3MTU2MDU=-flat-AllKindOfValuesCommandsTest.java.html,0.01558846453624318,10,Mybatis-PageHelper-MDEwOlJlcG9zaXRvcnkyMDY1MTY3Mg==-flat-RemoveOrderTest.java,jedis-MDEwOlJlcG9zaXRvcnk3MTU2MDU=-flat-AllKindOfValuesCommandsTest.java,1,10,9,1,10,9
409865,https://htmlpreview.github.io/?https://github.com/Christina96/boilerplate-sample-matches/blob/main/Java/jedis-MDEwOlJlcG9zaXRvcnk3MTU2MDU=-flat-KeyPipelineBinaryCommands.java-BungeeCord-MDEwOlJlcG9zaXRvcnk2MDg0MjEw-flat-ServerConnector.java.html,0.026845637583892617,10,jedis-MDEwOlJlcG9zaXRvcnk3MTU2MDU=-flat-KeyPipelineBinaryCommands.java,BungeeCord-MDEwOlJlcG9zaXRvcnk2MDg0MjEw-flat-ServerConnector.java,1,10,9,1,10,9
410980,https://htmlpreview.github.io/?https://github.com/Christina96/boilerplate-sample-matches/blob/main/Java/ribbon-MDEwOlJlcG9zaXRvcnk3NjE2MTU4-flat-MethodTemplateTest.java-Essentials-MDEwOlJlcG9zaXRvcnkxNzczNzU0-flat-MCUR.java.html,0.06535947712418301,10,ribbon-MDEwOlJlcG9zaXRvcnk3NjE2MTU4-flat-MethodTemplateTest.java,Essentials-MDEwOlJlcG9zaXRvcnkxNzczNzU0-flat-MCUR.java,17,23,6,84,89,5
412279,https://htmlpreview.github.io/?https://github.com/Christina96/boilerplate-sample-matches/blob/main/Java/segmentfault-lessons-MDEwOlJlcG9zaXRvcnk5MzE1NzM4MQ==-flat-SpringBootLesson1Application.java-ribbon-MDEwOlJlcG9zaXRvcnk3NjE2MTU4-flat-SimpleRoundRobinLBTest.java.html,0.1437125748502994,12,segmentfault-lessons-MDEwOlJlcG9zaXRvcnk5MzE1NzM4MQ==-flat-SpringBootLesson1Application.java,ribbon-MDEwOlJlcG9zaXRvcnk3NjE2MTU4-flat-SimpleRoundRobinLBTest.java,1,12,11,1,12,11
412605,https://htmlpreview.github.io/?https://github.com/Christina96/boilerplate-sample-matches/blob/main/Java/Essentials-MDEwOlJlcG9zaXRvcnkxNzczNzU0-flat-EssentialsXMPPPlayerListener.java-motan-MDEwOlJlcG9zaXRvcnk1NjY3OTUyMQ==-flat-MotanMultiConfigTest.java.html,0.08527131782945736,11,Essentials-MDEwOlJlcG9zaXRvcnkxNzczNzU0-flat-EssentialsXMPPPlayerListener.java,motan-MDEwOlJlcG9zaXRvcnk1NjY3OTUyMQ==-flat-MotanMultiConfigTest.java,3,14,11,2,12,10
412775,https://htmlpreview.github.io/?https://github.com/Christina96/boilerplate-sample-matches/blob/main/Java/Essentials-MDEwOlJlcG9zaXRvcnkxNzczNzU0-flat-SignMail.java-Mybatis-PageHelper-MDEwOlJlcG9zaXRvcnkyMDY1MTY3Mg==-flat-SimpleAutoDialect.java.html,0.29411764705882354,10,Essentials-MDEwOlJlcG9zaXRvcnkxNzczNzU0-flat-SignMail.java,Mybatis-PageHelper-MDEwOlJlcG9zaXRvcnkyMDY1MTY3Mg==-flat-SimpleAutoDialect.java,10,15,5,15,19,4
415172,https://htmlpreview.github.io/?https://github.com/Christina96/boilerplate-sample-matches/blob/main/Java/ribbon-MDEwOlJlcG9zaXRvcnk3NjE2MTU4-flat-ExecutionContext.java-ribbon-MDEwOlJlcG9zaXRvcnk3NjE2MTU4-flat-AbstractServerPredicate.java.html,0.05970149253731343,10,ribbon-MDEwOlJlcG9zaXRvcnk3NjE2MTU4-flat-ExecutionContext.java,ribbon-MDEwOlJlcG9zaXRvcnk3NjE2MTU4-flat-AbstractServerPredicate.java,54,61,7,65,72,7
417338,https://htmlpreview.github.io/?https://github.com/Christina96/boilerplate-sample-matches/blob/main/Java/jedis-MDEwOlJlcG9zaXRvcnk3MTU2MDU=-flat-LibraryInfo.java-ribbon-MDEwOlJlcG9zaXRvcnk3NjE2MTU4-flat-WeightedResponseTimeRuleTest.java.html,0.10989010989010989,10,jedis-MDEwOlJlcG9zaXRvcnk3MTU2MDU=-flat-LibraryInfo.java,ribbon-MDEwOlJlcG9zaXRvcnk3NjE2MTU4-flat-WeightedResponseTimeRuleTest.java,2,11,9,8,17,9
417372,https://htmlpreview.github.io/?https://github.com/Christina96/boilerplate-sample-matches/blob/main/Java/segmentfault-lessons-MDEwOlJlcG9zaXRvcnk5MzE1NzM4MQ==-flat-CloneableDemo.java-motan-MDEwOlJlcG9zaXRvcnk1NjY3OTUyMQ==-flat-Motan2RpcClient.java.html,0.11363636363636363,10,segmentfault-lessons-MDEwOlJlcG9zaXRvcnk5MzE1NzM4MQ==-flat-CloneableDemo.java,motan-MDEwOlJlcG9zaXRvcnk1NjY3OTUyMQ==-flat-Motan2RpcClient.java,6,11,5,22,25,3
418590,https://htmlpreview.github.io/?https://github.com/Christina96/boilerplate-sample-matches/blob/main/Java/Mybatis-PageHelper-MDEwOlJlcG9zaXRvcnkyMDY1MTY3Mg==-flat-TestDistinct.java-ribbon-MDEwOlJlcG9zaXRvcnk3NjE2MTU4-flat-MonitoredConnectionManager.java.html,0.25806451612903225,12,Mybatis-PageHelper-MDEwOlJlcG9zaXRvcnkyMDY1MTY3Mg==-flat-TestDistinct.java,ribbon-MDEwOlJlcG9zaXRvcnk3NjE2MTU4-flat-MonitoredConnectionManager.java,1,12,11,1,12,11
419002,https://htmlpreview.github.io/?https://github.com/Christina96/boilerplate-sample-matches/blob/main/Java/motan-MDEwOlJlcG9zaXRvcnk1NjY3OTUyMQ==-flat-BaseTest.java-jedis-MDEwOlJlcG9zaXRvcnk3MTU2MDU=-flat-SSLJedisClusterTest.java.html,0.16822429906542055,10,motan-MDEwOlJlcG9zaXRvcnk1NjY3OTUyMQ==-flat-BaseTest.java,jedis-MDEwOlJlcG9zaXRvcnk3MTU2MDU=-flat-SSLJedisClusterTest.java,38,42,4,52,57,5
419945,https://htmlpreview.github.io/?https://github.com/Christina96/boilerplate-sample-matches/blob/main/Java/ribbon-MDEwOlJlcG9zaXRvcnk3NjE2MTU4-flat-LoadBalancerTestUtils.java-Essentials-MDEwOlJlcG9zaXRvcnkxNzczNzU0-flat-Commandsell.java.html,0.13978494623655913,13,ribbon-MDEwOlJlcG9zaXRvcnk3NjE2MTU4-flat-LoadBalancerTestUtils.java,Essentials-MDEwOlJlcG9zaXRvcnkxNzczNzU0-flat-Commandsell.java,1,14,13,1,14,13
423395,https://htmlpreview.github.io/?https://github.com/Christina96/boilerplate-sample-matches/blob/main/Java/motan-MDEwOlJlcG9zaXRvcnk1NjY3OTUyMQ==-flat-ConfigurableWeightLoadBalance.java-BungeeCord-MDEwOlJlcG9zaXRvcnk2MDg0MjEw-flat-BungeeCord.java.html,0.055357142857142855,11,motan-MDEwOlJlcG9zaXRvcnk1NjY3OTUyMQ==-flat-ConfigurableWeightLoadBalance.java,BungeeCord-MDEwOlJlcG9zaXRvcnk2MDg0MjEw-flat-BungeeCord.java,1,11,10,1,11,10
423681,https://htmlpreview.github.io/?https://github.com/Christina96/boilerplate-sample-matches/blob/main/Java/google-api-java-client-samples-MDEwOlJlcG9zaXRvcnkyOTc0OTA1Mg==-flat-GetAllAdUnitsForCustomChannel.java-Essentials-MDEwOlJlcG9zaXRvcnkxNzczNzU0-flat-Commandtpa.java.html,0.17391304347826086,10,google-api-java-client-samples-MDEwOlJlcG9zaXRvcnkyOTc0OTA1Mg==-flat-GetAllAdUnitsForCustomChannel.java,Essentials-MDEwOlJlcG9zaXRvcnkxNzczNzU0-flat-Commandtpa.java,13,18,5,35,40,5
427017,https://htmlpreview.github.io/?https://github.com/Christina96/boilerplate-sample-matches/blob/main/Java/google-api-java-client-samples-MDEwOlJlcG9zaXRvcnkyOTc0OTA1Mg==-flat-GenerateReportForHost.java-google-api-java-client-samples-MDEwOlJlcG9zaXRvcnkyOTc0OTA1Mg==-flat-McfReportingApiReferenceSample.java.html,0.11794871794871795,11,google-api-java-client-samples-MDEwOlJlcG9zaXRvcnkyOTc0OTA1Mg==-flat-GenerateReportForHost.java,google-api-java-client-samples-MDEwOlJlcG9zaXRvcnkyOTc0OTA1Mg==-flat-McfReportingApiReferenceSample.java,2,12,10,16,26,10
427031,https://htmlpreview.github.io/?https://github.com/Christina96/boilerplate-sample-matches/blob/main/Java/segmentfault-lessons-MDEwOlJlcG9zaXRvcnk5MzE1NzM4MQ==-flat-MyFilter2.java-ribbon-MDEwOlJlcG9zaXRvcnk3NjE2MTU4-flat-EvCacheProvider.java.html,0.11398963730569948,11,segmentfault-lessons-MDEwOlJlcG9zaXRvcnk5MzE1NzM4MQ==-flat-MyFilter2.java,ribbon-MDEwOlJlcG9zaXRvcnk3NjE2MTU4-flat-EvCacheProvider.java,1,11,10,1,11,10
437013,https://htmlpreview.github.io/?https://github.com/Christina96/boilerplate-sample-matches/blob/main/Java/ribbon-MDEwOlJlcG9zaXRvcnk3NjE2MTU4-flat-DiscoveryEnabledLoadBalancerSupportsUseIpAddrTest.java-ribbon-MDEwOlJlcG9zaXRvcnk3NjE2MTU4-flat-ZoneAwareLoadBalancerTest.java.html,0.1863905325443787,11,ribbon-MDEwOlJlcG9zaXRvcnk3NjE2MTU4-flat-DiscoveryEnabledLoadBalancerSupportsUseIpAddrTest.java,ribbon-MDEwOlJlcG9zaXRvcnk3NjE2MTU4-flat-ZoneAwareLoadBalancerTest.java,81,87,6,133,141,8
437256,https://htmlpreview.github.io/?https://github.com/Christina96/boilerplate-sample-matches/blob/main/Java/Essentials-MDEwOlJlcG9zaXRvcnkxNzczNzU0-flat-Commandmsg.java-ribbon-MDEwOlJlcG9zaXRvcnk3NjE2MTU4-flat-ResponseTimeWeightedRule.java.html,0.06626506024096386,11,Essentials-MDEwOlJlcG9zaXRvcnkxNzczNzU0-flat-Commandmsg.java,ribbon-MDEwOlJlcG9zaXRvcnk3NjE2MTU4-flat-ResponseTimeWeightedRule.java,2,13,11,3,13,10
438493,https://htmlpreview.github.io/?https://github.com/Christina96/boilerplate-sample-matches/blob/main/Java/segmentfault-lessons-MDEwOlJlcG9zaXRvcnk5MzE1NzM4MQ==-flat-PersonControllerSpringBootTest.java-jedis-MDEwOlJlcG9zaXRvcnk3MTU2MDU=-flat-ShardedCommandObjects.java.html,0.12807881773399016,13,segmentfault-lessons-MDEwOlJlcG9zaXRvcnk5MzE1NzM4MQ==-flat-PersonControllerSpringBootTest.java,jedis-MDEwOlJlcG9zaXRvcnk3MTU2MDU=-flat-ShardedCommandObjects.java,4,15,11,2,13,11
440654,https://htmlpreview.github.io/?https://github.com/Christina96/boilerplate-sample-matches/blob/main/Java/google-api-java-client-samples-MDEwOlJlcG9zaXRvcnkyOTc0OTA1Mg==-flat-GenerateReportForHost.java-jedis-MDEwOlJlcG9zaXRvcnk3MTU2MDU=-flat-BitCommandsTestBase.java.html,0.10138248847926268,12,google-api-java-client-samples-MDEwOlJlcG9zaXRvcnkyOTc0OTA1Mg==-flat-GenerateReportForHost.java,jedis-MDEwOlJlcG9zaXRvcnk3MTU2MDU=-flat-BitCommandsTestBase.java,24,29,5,189,193,4
445426,https://htmlpreview.github.io/?https://github.com/Christina96/boilerplate-sample-matches/blob/main/Java/BungeeCord-MDEwOlJlcG9zaXRvcnk2MDg0MjEw-flat-ScoreboardObjective.java-jedis-MDEwOlJlcG9zaXRvcnk3MTU2MDU=-flat-JsonSearchWithGsonTest.java.html,0.11702127659574468,11,BungeeCord-MDEwOlJlcG9zaXRvcnk2MDg0MjEw-flat-ScoreboardObjective.java,jedis-MDEwOlJlcG9zaXRvcnk3MTU2MDU=-flat-JsonSearchWithGsonTest.java,1,11,10,1,11,10
447980,https://htmlpreview.github.io/?https://github.com/Christina96/boilerplate-sample-matches/blob/main/Java/Mybatis-PageHelper-MDEwOlJlcG9zaXRvcnkyMDY1MTY3Mg==-flat-MybatisReasonableHelper.java-ribbon-MDEwOlJlcG9zaXRvcnk3NjE2MTU4-flat-PingUrl.java.html,0.11834319526627218,10,Mybatis-PageHelper-MDEwOlJlcG9zaXRvcnkyMDY1MTY3Mg==-flat-MybatisReasonableHelper.java,ribbon-MDEwOlJlcG9zaXRvcnk3NjE2MTU4-flat-PingUrl.java,2,11,9,3,12,9
451473,https://htmlpreview.github.io/?https://github.com/Christina96/boilerplate-sample-matches/blob/main/Java/Essentials-MDEwOlJlcG9zaXRvcnkxNzczNzU0-flat-EssentialsChat.java-motan-MDEwOlJlcG9zaXRvcnk1NjY3OTUyMQ==-flat-NettyDecoderTest.java.html,0.15483870967741936,12,Essentials-MDEwOlJlcG9zaXRvcnkxNzczNzU0-flat-EssentialsChat.java,motan-MDEwOlJlcG9zaXRvcnk1NjY3OTUyMQ==-flat-NettyDecoderTest.java,2,14,12,14,25,11
456295,https://htmlpreview.github.io/?https://github.com/Christina96/boilerplate-sample-matches/blob/main/Java/ribbon-MDEwOlJlcG9zaXRvcnk3NjE2MTU4-flat-HttpMetaRequest.java-Essentials-MDEwOlJlcG9zaXRvcnkxNzczNzU0-flat-XMPPManager.java.html,0.06003159557661927,19,ribbon-MDEwOlJlcG9zaXRvcnk3NjE2MTU4-flat-HttpMetaRequest.java,Essentials-MDEwOlJlcG9zaXRvcnkxNzczNzU0-flat-XMPPManager.java,1,19,18,1,19,18
457719,https://htmlpreview.github.io/?https://github.com/Christina96/boilerplate-sample-matches/blob/main/Java/motan-MDEwOlJlcG9zaXRvcnk1NjY3OTUyMQ==-flat-BaseTest.java-motan-MDEwOlJlcG9zaXRvcnk1NjY3OTUyMQ==-flat-ConsulEcwidClient.java.html,0.2813688212927757,16,motan-MDEwOlJlcG9zaXRvcnk1NjY3OTUyMQ==-flat-BaseTest.java,motan-MDEwOlJlcG9zaXRvcnk1NjY3OTUyMQ==-flat-ConsulEcwidClient.java,4,19,15,2,17,15
458210,https://htmlpreview.github.io/?https://github.com/Christina96/boilerplate-sample-matches/blob/main/Java/ribbon-MDEwOlJlcG9zaXRvcnk3NjE2MTU4-flat-HelloUdpServerExternalResource.java-ribbon-MDEwOlJlcG9zaXRvcnk3NjE2MTU4-flat-PingUrl.java.html,0.12612612612612611,14,ribbon-MDEwOlJlcG9zaXRvcnk3NjE2MTU4-flat-HelloUdpServerExternalResource.java,ribbon-MDEwOlJlcG9zaXRvcnk3NjE2MTU4-flat-PingUrl.java,9,21,12,2,14,12
459010,https://htmlpreview.github.io/?https://github.com/Christina96/boilerplate-sample-matches/blob/main/Java/BungeeCord-MDEwOlJlcG9zaXRvcnk2MDg0MjEw-flat-ChatComponentTransformer.java-jedis-MDEwOlJlcG9zaXRvcnk3MTU2MDU=-flat-ClientCommandsTest.java.html,0.05588822355289421,14,BungeeCord-MDEwOlJlcG9zaXRvcnk2MDg0MjEw-flat-ChatComponentTransformer.java,jedis-MDEwOlJlcG9zaXRvcnk3MTU2MDU=-flat-ClientCommandsTest.java,1,14,13,1,14,13
459112,https://htmlpreview.github.io/?https://github.com/Christina96/boilerplate-sample-matches/blob/main/Java/Essentials-MDEwOlJlcG9zaXRvcnkxNzczNzU0-flat-SignDisposal.java-Essentials-MDEwOlJlcG9zaXRvcnkxNzczNzU0-flat-Commandsetspawn.java.html,0.5333333333333333,12,Essentials-MDEwOlJlcG9zaXRvcnkxNzczNzU0-flat-SignDisposal.java,Essentials-MDEwOlJlcG9zaXRvcnkxNzczNzU0-flat-Commandsetspawn.java,2,11,9,4,13,9
459273,https://htmlpreview.github.io/?https://github.com/Christina96/boilerplate-sample-matches/blob/main/Java/Essentials-MDEwOlJlcG9zaXRvcnkxNzczNzU0-flat-Commandjails.java-Essentials-MDEwOlJlcG9zaXRvcnkxNzczNzU0-flat-Commandtphere.java.html,0.38235294117647056,13,Essentials-MDEwOlJlcG9zaXRvcnkxNzczNzU0-flat-Commandjails.java,Essentials-MDEwOlJlcG9zaXRvcnkxNzczNzU0-flat-Commandtphere.java,2,12,10,4,14,10
459785,https://htmlpreview.github.io/?https://github.com/Christina96/boilerplate-sample-matches/blob/main/Java/ribbon-MDEwOlJlcG9zaXRvcnk3NjE2MTU4-flat-ClientFactoryTest.java-SpringPetClinic-MDEwOlJlcG9zaXRvcnkzMDkzNDMzNTE=-flat-Owner.java.html,0.14130434782608695,13,ribbon-MDEwOlJlcG9zaXRvcnk3NjE2MTU4-flat-ClientFactoryTest.java,SpringPetClinic-MDEwOlJlcG9zaXRvcnkzMDkzNDMzNTE=-flat-Owner.java,1,13,12,1,13,12
463310,https://htmlpreview.github.io/?https://github.com/Christina96/boilerplate-sample-matches/blob/main/Java/google-api-java-client-samples-MDEwOlJlcG9zaXRvcnkyOTc0OTA1Mg==-flat-PlusSampleServlet_0.java-jedis-MDEwOlJlcG9zaXRvcnk3MTU2MDU=-flat-DefaultJedisClientConfig.java.html,0.07096774193548387,11,google-api-java-client-samples-MDEwOlJlcG9zaXRvcnkyOTc0OTA1Mg==-flat-PlusSampleServlet_0.java,jedis-MDEwOlJlcG9zaXRvcnk3MTU2MDU=-flat-DefaultJedisClientConfig.java,27,33,6,203,207,4
465431,https://htmlpreview.github.io/?https://github.com/Christina96/boilerplate-sample-matches/blob/main/Java/ribbon-MDEwOlJlcG9zaXRvcnk3NjE2MTU4-flat-KeyStoreAwareSocketFactory.java-jedis-MDEwOlJlcG9zaXRvcnk3MTU2MDU=-flat-JedisURIHelperTest.java.html,0.12738853503184713,10,ribbon-MDEwOlJlcG9zaXRvcnk3NjE2MTU4-flat-KeyStoreAwareSocketFactory.java,jedis-MDEwOlJlcG9zaXRvcnk3MTU2MDU=-flat-JedisURIHelperTest.java,1,10,9,1,10,9
468247,https://htmlpreview.github.io/?https://github.com/Christina96/boilerplate-sample-matches/blob/main/Java/motan-MDEwOlJlcG9zaXRvcnk1NjY3OTUyMQ==-flat-OpenTracingFilter.java-Essentials-MDEwOlJlcG9zaXRvcnkxNzczNzU0-flat-EssentialsSpawnPlayerListener.java.html,0.11428571428571428,20,motan-MDEwOlJlcG9zaXRvcnk1NjY3OTUyMQ==-flat-OpenTracingFilter.java,Essentials-MDEwOlJlcG9zaXRvcnkxNzczNzU0-flat-EssentialsSpawnPlayerListener.java,1,20,19,1,20,19
469494,https://htmlpreview.github.io/?https://github.com/Christina96/boilerplate-sample-matches/blob/main/Java/motan-MDEwOlJlcG9zaXRvcnk1NjY3OTUyMQ==-flat-CommandController.java-BungeeCord-MDEwOlJlcG9zaXRvcnk2MDg0MjEw-flat-DefinedPacket.java.html,0.041666666666666664,12,motan-MDEwOlJlcG9zaXRvcnk1NjY3OTUyMQ==-flat-CommandController.java,BungeeCord-MDEwOlJlcG9zaXRvcnk2MDg0MjEw-flat-DefinedPacket.java,2,12,10,9,19,10
472392,https://htmlpreview.github.io/?https://github.com/Christina96/boilerplate-sample-matches/blob/main/Java/Mybatis-PageHelper-MDEwOlJlcG9zaXRvcnkyMDY1MTY3Mg==-flat-MybatisRowBoundsHelper.java-ribbon-MDEwOlJlcG9zaXRvcnk3NjE2MTU4-flat-NettyClientTest.java.html,0.01680672268907563,10,Mybatis-PageHelper-MDEwOlJlcG9zaXRvcnkyMDY1MTY3Mg==-flat-MybatisRowBoundsHelper.java,ribbon-MDEwOlJlcG9zaXRvcnk3NjE2MTU4-flat-NettyClientTest.java,2,11,9,55,64,9
472886,https://htmlpreview.github.io/?https://github.com/Christina96/boilerplate-sample-matches/blob/main/Java/Essentials-MDEwOlJlcG9zaXRvcnkxNzczNzU0-flat-Commandtree.java-motan-MDEwOlJlcG9zaXRvcnk1NjY3OTUyMQ==-flat-ReflectUtil.java.html,0.051643192488262914,11,Essentials-MDEwOlJlcG9zaXRvcnkxNzczNzU0-flat-Commandtree.java,motan-MDEwOlJlcG9zaXRvcnk1NjY3OTUyMQ==-flat-ReflectUtil.java,68,68,0,191,191,0
473282,https://htmlpreview.github.io/?https://github.com/Christina96/boilerplate-sample-matches/blob/main/Java/segmentfault-lessons-MDEwOlJlcG9zaXRvcnk5MzE1NzM4MQ==-flat-UserRibbonClientHystrixCommand_78.java-Essentials-MDEwOlJlcG9zaXRvcnkxNzczNzU0-flat-ZPermissionsHandler.java.html,0.10101010101010101,10,segmentfault-lessons-MDEwOlJlcG9zaXRvcnk5MzE1NzM4MQ==-flat-UserRibbonClientHystrixCommand_78.java,Essentials-MDEwOlJlcG9zaXRvcnkxNzczNzU0-flat-ZPermissionsHandler.java,2,10,8,7,16,9
474697,https://htmlpreview.github.io/?https://github.com/Christina96/boilerplate-sample-matches/blob/main/Java/ribbon-MDEwOlJlcG9zaXRvcnk3NjE2MTU4-flat-HttpAnnotationProcessor.java-jedis-MDEwOlJlcG9zaXRvcnk3MTU2MDU=-flat-Connection.java.html,0.04398826979472141,15,ribbon-MDEwOlJlcG9zaXRvcnk3NjE2MTU4-flat-HttpAnnotationProcessor.java,jedis-MDEwOlJlcG9zaXRvcnk3MTU2MDU=-flat-Connection.java,1,15,14,1,15,14
475765,https://htmlpreview.github.io/?https://github.com/Christina96/boilerplate-sample-matches/blob/main/Java/segmentfault-lessons-MDEwOlJlcG9zaXRvcnk5MzE1NzM4MQ==-flat-RepositoryAnnotationProcessor.java-motan-MDEwOlJlcG9zaXRvcnk1NjY3OTUyMQ==-flat-RefererConfig.java.html,0.11981566820276497,16,segmentfault-lessons-MDEwOlJlcG9zaXRvcnk5MzE1NzM4MQ==-flat-RepositoryAnnotationProcessor.java,motan-MDEwOlJlcG9zaXRvcnk1NjY3OTUyMQ==-flat-RefererConfig.java,1,16,15,1,16,15
475800,https://htmlpreview.github.io/?https://github.com/Christina96/boilerplate-sample-matches/blob/main/Java/google-api-java-client-samples-MDEwOlJlcG9zaXRvcnkyOTc0OTA1Mg==-flat-StartAssociationSession.java-segmentfault-lessons-MDEwOlJlcG9zaXRvcnk5MzE1NzM4MQ==-flat-CloneableDemo.java.html,0.28169014084507044,10,google-api-java-client-samples-MDEwOlJlcG9zaXRvcnkyOTc0OTA1Mg==-flat-StartAssociationSession.java,segmentfault-lessons-MDEwOlJlcG9zaXRvcnk5MzE1NzM4MQ==-flat-CloneableDemo.java,9,15,6,6,11,5
478269,https://htmlpreview.github.io/?https://github.com/Christina96/boilerplate-sample-matches/blob/main/Java/google-api-java-client-samples-MDEwOlJlcG9zaXRvcnkyOTc0OTA1Mg==-flat-GenerateReport.java-jedis-MDEwOlJlcG9zaXRvcnk3MTU2MDU=-flat-SpellCheckTest.java.html,0.22110552763819097,11,google-api-java-client-samples-MDEwOlJlcG9zaXRvcnkyOTc0OTA1Mg==-flat-GenerateReport.java,jedis-MDEwOlJlcG9zaXRvcnk3MTU2MDU=-flat-SpellCheckTest.java,2,12,10,8,18,10
478866,https://htmlpreview.github.io/?https://github.com/Christina96/boilerplate-sample-matches/blob/main/Java/Essentials-MDEwOlJlcG9zaXRvcnkxNzczNzU0-flat-Commandtpohere.java-Essentials-MDEwOlJlcG9zaXRvcnkxNzczNzU0-flat-SignWeather.java.html,0.43636363636363634,10,Essentials-MDEwOlJlcG9zaXRvcnkxNzczNzU0-flat-Commandtpohere.java,Essentials-MDEwOlJlcG9zaXRvcnkxNzczNzU0-flat-SignWeather.java,19,21,2,36,41,5
479779,https://htmlpreview.github.io/?https://github.com/Christina96/boilerplate-sample-matches/blob/main/Java/jedis-MDEwOlJlcG9zaXRvcnk3MTU2MDU=-flat-ControlBinaryCommands.java-segmentfault-lessons-MDEwOlJlcG9zaXRvcnk5MzE1NzM4MQ==-flat-UserMapper.java.html,0.29333333333333333,11,jedis-MDEwOlJlcG9zaXRvcnk3MTU2MDU=-flat-ControlBinaryCommands.java,segmentfault-lessons-MDEwOlJlcG9zaXRvcnk5MzE1NzM4MQ==-flat-UserMapper.java,4,8,4,7,11,4
482207,https://htmlpreview.github.io/?https://github.com/Christina96/boilerplate-sample-matches/blob/main/Java/jedis-MDEwOlJlcG9zaXRvcnk3MTU2MDU=-flat-BitCommandsTest.java-jedis-MDEwOlJlcG9zaXRvcnk3MTU2MDU=-flat-SetCommandsTest.java.html,0.32644628099173556,10,jedis-MDEwOlJlcG9zaXRvcnk3MTU2MDU=-flat-BitCommandsTest.java,jedis-MDEwOlJlcG9zaXRvcnk3MTU2MDU=-flat-SetCommandsTest.java,27,34,7,170,177,7
488721,https://htmlpreview.github.io/?https://github.com/Christina96/boilerplate-sample-matches/blob/main/Java/jedis-MDEwOlJlcG9zaXRvcnk3MTU2MDU=-flat-JsonObjectMapperTestUtil.java-Essentials-MDEwOlJlcG9zaXRvcnkxNzczNzU0-flat-ISettings_3.java.html,0.06267806267806268,11,jedis-MDEwOlJlcG9zaXRvcnk3MTU2MDU=-flat-JsonObjectMapperTestUtil.java,Essentials-MDEwOlJlcG9zaXRvcnkxNzczNzU0-flat-ISettings_3.java,1,11,10,1,11,10
493304,https://htmlpreview.github.io/?https://github.com/Christina96/boilerplate-sample-matches/blob/main/Java/Essentials-MDEwOlJlcG9zaXRvcnkxNzczNzU0-flat-SignPlayerListener.java-Essentials-MDEwOlJlcG9zaXRvcnkxNzczNzU0-flat-Commandsell.java.html,0.09876543209876543,12,Essentials-MDEwOlJlcG9zaXRvcnkxNzczNzU0-flat-SignPlayerListener.java,Essentials-MDEwOlJlcG9zaXRvcnkxNzczNzU0-flat-Commandsell.java,1,12,11,1,12,11
497443,https://htmlpreview.github.io/?https://github.com/Christina96/boilerplate-sample-matches/blob/main/Java/motan-MDEwOlJlcG9zaXRvcnk1NjY3OTUyMQ==-flat-MotanDigestUtil.java-ribbon-MDEwOlJlcG9zaXRvcnk3NjE2MTU4-flat-ReloadableClientConfig.java.html,0.06511627906976744,10,motan-MDEwOlJlcG9zaXRvcnk1NjY3OTUyMQ==-flat-MotanDigestUtil.java,ribbon-MDEwOlJlcG9zaXRvcnk3NjE2MTU4-flat-ReloadableClientConfig.java,18,23,5,242,247,5
498487,https://htmlpreview.github.io/?https://github.com/Christina96/boilerplate-sample-matches/blob/main/Java/ribbon-MDEwOlJlcG9zaXRvcnk3NjE2MTU4-flat-RibbonModule.java-segmentfault-lessons-MDEwOlJlcG9zaXRvcnk5MzE1NzM4MQ==-flat-UserRibbonController_98.java.html,0.2702702702702703,10,ribbon-MDEwOlJlcG9zaXRvcnk3NjE2MTU4-flat-RibbonModule.java,segmentfault-lessons-MDEwOlJlcG9zaXRvcnk5MzE1NzM4MQ==-flat-UserRibbonController_98.java,1,10,9,1,10,9
499152,https://htmlpreview.github.io/?https://github.com/Christina96/boilerplate-sample-matches/blob/main/Java/BungeeCord-MDEwOlJlcG9zaXRvcnk2MDg0MjEw-flat-ModuleManager.java-jedis-MDEwOlJlcG9zaXRvcnk3MTU2MDU=-flat-Connection.java.html,0.057667103538663174,22,BungeeCord-MDEwOlJlcG9zaXRvcnk2MDg0MjEw-flat-ModuleManager.java,jedis-MDEwOlJlcG9zaXRvcnk3MTU2MDU=-flat-Connection.java,2,24,22,7,28,21
499363,https://htmlpreview.github.io/?https://github.com/Christina96/boilerplate-sample-matches/blob/main/Java/google-api-java-client-samples-MDEwOlJlcG9zaXRvcnkyOTc0OTA1Mg==-flat-VerifyAssociationSession.java-Essentials-MDEwOlJlcG9zaXRvcnkxNzczNzU0-flat-Commandlightning.java.html,0.23655913978494625,11,google-api-java-client-samples-MDEwOlJlcG9zaXRvcnkyOTc0OTA1Mg==-flat-VerifyAssociationSession.java,Essentials-MDEwOlJlcG9zaXRvcnkxNzczNzU0-flat-Commandlightning.java,5,12,7,40,43,3
504616,https://htmlpreview.github.io/?https://github.com/Christina96/boilerplate-sample-matches/blob/main/Java/Essentials-MDEwOlJlcG9zaXRvcnkxNzczNzU0-flat-IEssentialsXMPP.java-jedis-MDEwOlJlcG9zaXRvcnk3MTU2MDU=-flat-CountMinSketchCommands.java.html,0.40476190476190477,17,Essentials-MDEwOlJlcG9zaXRvcnkxNzczNzU0-flat-IEssentialsXMPP.java,jedis-MDEwOlJlcG9zaXRvcnk3MTU2MDU=-flat-CountMinSketchCommands.java,12,16,4,10,14,4
512501,https://htmlpreview.github.io/?https://github.com/Christina96/boilerplate-sample-matches/blob/main/Java/Mybatis-PageHelper-MDEwOlJlcG9zaXRvcnkyMDY1MTY3Mg==-flat-RowBoundsTest.java-jedis-MDEwOlJlcG9zaXRvcnk3MTU2MDU=-flat-GeoCommandsTest.java.html,0.2578456318914334,14,Mybatis-PageHelper-MDEwOlJlcG9zaXRvcnkyMDY1MTY3Mg==-flat-RowBoundsTest.java,jedis-MDEwOlJlcG9zaXRvcnk3MTU2MDU=-flat-GeoCommandsTest.java,1,14,13,1,14,13
514702,https://htmlpreview.github.io/?https://github.com/Christina96/boilerplate-sample-matches/blob/main/Java/ribbon-MDEwOlJlcG9zaXRvcnk3NjE2MTU4-flat-ServerListRefreshTest.java-motan-MDEwOlJlcG9zaXRvcnk1NjY3OTUyMQ==-flat-DefaultHttpMeshTransport.java.html,0.23529411764705882,13,ribbon-MDEwOlJlcG9zaXRvcnk3NjE2MTU4-flat-ServerListRefreshTest.java,motan-MDEwOlJlcG9zaXRvcnk1NjY3OTUyMQ==-flat-DefaultHttpMeshTransport.java,38,42,4,28,35,7
515645,https://htmlpreview.github.io/?https://github.com/Christina96/boilerplate-sample-matches/blob/main/Java/BungeeCord-MDEwOlJlcG9zaXRvcnk2MDg0MjEw-flat-DefinedPacket.java-jedis-MDEwOlJlcG9zaXRvcnk3MTU2MDU=-flat-JedisSentinelPool.java.html,0.050314465408805034,10,BungeeCord-MDEwOlJlcG9zaXRvcnk2MDg0MjEw-flat-DefinedPacket.java,jedis-MDEwOlJlcG9zaXRvcnk3MTU2MDU=-flat-JedisSentinelPool.java,309,315,6,24,31,7
516567,https://htmlpreview.github.io/?https://github.com/Christina96/boilerplate-sample-matches/blob/main/Java/Mybatis-PageHelper-MDEwOlJlcG9zaXRvcnkyMDY1MTY3Mg==-flat-PageSerializable.java-motan-MDEwOlJlcG9zaXRvcnk1NjY3OTUyMQ==-flat-NettyMessage.java.html,0.31683168316831684,16,Mybatis-PageHelper-MDEwOlJlcG9zaXRvcnkyMDY1MTY3Mg==-flat-PageSerializable.java,motan-MDEwOlJlcG9zaXRvcnk1NjY3OTUyMQ==-flat-NettyMessage.java,21,34,13,14,27,13
517332,https://htmlpreview.github.io/?https://github.com/Christina96/boilerplate-sample-matches/blob/main/Java/motan-MDEwOlJlcG9zaXRvcnk1NjY3OTUyMQ==-flat-ZookeeperRegistryService.java-Essentials-MDEwOlJlcG9zaXRvcnkxNzczNzU0-flat-UUIDMap.java.html,0.07017543859649122,12,motan-MDEwOlJlcG9zaXRvcnk1NjY3OTUyMQ==-flat-ZookeeperRegistryService.java,Essentials-MDEwOlJlcG9zaXRvcnkxNzczNzU0-flat-UUIDMap.java,1,12,11,1,12,11
521049,https://htmlpreview.github.io/?https://github.com/Christina96/boilerplate-sample-matches/blob/main/Java/motan-MDEwOlJlcG9zaXRvcnk1NjY3OTUyMQ==-flat-AbstractServer.java-Essentials-MDEwOlJlcG9zaXRvcnkxNzczNzU0-flat-SignEntityListener.java.html,0.1375,11,motan-MDEwOlJlcG9zaXRvcnk1NjY3OTUyMQ==-flat-AbstractServer.java,Essentials-MDEwOlJlcG9zaXRvcnkxNzczNzU0-flat-SignEntityListener.java,1,11,10,1,12,11
521502,https://htmlpreview.github.io/?https://github.com/Christina96/boilerplate-sample-matches/blob/main/Java/BungeeCord-MDEwOlJlcG9zaXRvcnk2MDg0MjEw-flat-BungeeScheduler.java-google-api-java-client-samples-MDEwOlJlcG9zaXRvcnkyOTc0OTA1Mg==-flat-PlusSample.java.html,0.13385826771653545,17,BungeeCord-MDEwOlJlcG9zaXRvcnk2MDg0MjEw-flat-BungeeScheduler.java,google-api-java-client-samples-MDEwOlJlcG9zaXRvcnkyOTc0OTA1Mg==-flat-PlusSample.java,2,19,17,6,22,16
523372,https://htmlpreview.github.io/?https://github.com/Christina96/boilerplate-sample-matches/blob/main/Java/jedis-MDEwOlJlcG9zaXRvcnk3MTU2MDU=-flat-JsonSearchWithGsonTest.java-motan-MDEwOlJlcG9zaXRvcnk1NjY3OTUyMQ==-flat-ClusterTest.java.html,0.2288135593220339,16,jedis-MDEwOlJlcG9zaXRvcnk3MTU2MDU=-flat-JsonSearchWithGsonTest.java,motan-MDEwOlJlcG9zaXRvcnk1NjY3OTUyMQ==-flat-ClusterTest.java,29,33,4,55,59,4
525593,https://htmlpreview.github.io/?https://github.com/Christina96/boilerplate-sample-matches/blob/main/Java/ribbon-MDEwOlJlcG9zaXRvcnk3NjE2MTU4-flat-DynamicServerListLoadBalancer.java-Essentials-MDEwOlJlcG9zaXRvcnkxNzczNzU0-flat-Kit.java.html,0.08103727714748785,14,ribbon-MDEwOlJlcG9zaXRvcnk3NjE2MTU4-flat-DynamicServerListLoadBalancer.java,Essentials-MDEwOlJlcG9zaXRvcnkxNzczNzU0-flat-Kit.java,1,14,13,1,14,13
525865,https://htmlpreview.github.io/?https://github.com/Christina96/boilerplate-sample-matches/blob/main/Java/Mybatis-PageHelper-MDEwOlJlcG9zaXRvcnkyMDY1MTY3Mg==-flat-HerdDBDialect.java-ribbon-MDEwOlJlcG9zaXRvcnk3NjE2MTU4-flat-URLConnectionLoadBalancer.java.html,0.15286624203821655,12,Mybatis-PageHelper-MDEwOlJlcG9zaXRvcnkyMDY1MTY3Mg==-flat-HerdDBDialect.java,ribbon-MDEwOlJlcG9zaXRvcnk3NjE2MTU4-flat-URLConnectionLoadBalancer.java,1,12,11,1,12,11
526431,https://htmlpreview.github.io/?https://github.com/Christina96/boilerplate-sample-matches/blob/main/Java/segmentfault-lessons-MDEwOlJlcG9zaXRvcnk5MzE1NzM4MQ==-flat-ZuulProxyApplication_111.java-segmentfault-lessons-MDEwOlJlcG9zaXRvcnk5MzE1NzM4MQ==-flat-ZipkinServerApplication.java.html,1.0,12,segmentfault-lessons-MDEwOlJlcG9zaXRvcnk5MzE1NzM4MQ==-flat-ZuulProxyApplication_111.java,segmentfault-lessons-MDEwOlJlcG9zaXRvcnk5MzE1NzM4MQ==-flat-ZipkinServerApplication.java,1,11,10,1,11,10
527806,https://htmlpreview.github.io/?https://github.com/Christina96/boilerplate-sample-matches/blob/main/Java/motan-MDEwOlJlcG9zaXRvcnk1NjY3OTUyMQ==-flat-CompressRpcCodecTest.java-Essentials-MDEwOlJlcG9zaXRvcnkxNzczNzU0-flat-EssentialsConf.java.html,0.1011743450767841,10,motan-MDEwOlJlcG9zaXRvcnk1NjY3OTUyMQ==-flat-CompressRpcCodecTest.java,Essentials-MDEwOlJlcG9zaXRvcnkxNzczNzU0-flat-EssentialsConf.java,85,89,4,128,134,6
528394,https://htmlpreview.github.io/?https://github.com/Christina96/boilerplate-sample-matches/blob/main/Java/motan-MDEwOlJlcG9zaXRvcnk1NjY3OTUyMQ==-flat-NettyChannelHandler.java-jedis-MDEwOlJlcG9zaXRvcnk3MTU2MDU=-flat-ClusterShardedPublishSubscribeCommandsTest.java.html,0.18097447795823665,14,motan-MDEwOlJlcG9zaXRvcnk1NjY3OTUyMQ==-flat-NettyChannelHandler.java,jedis-MDEwOlJlcG9zaXRvcnk3MTU2MDU=-flat-ClusterShardedPublishSubscribeCommandsTest.java,1,14,13,1,14,13
532309,https://htmlpreview.github.io/?https://github.com/Christina96/boilerplate-sample-matches/blob/main/Java/jedis-MDEwOlJlcG9zaXRvcnk3MTU2MDU=-flat-TSInfo.java-VitamioBundle-MDEwOlJlcG9zaXRvcnk2MjkyMDI5-flat-VideoView.java.html,0.08361204013377926,11,jedis-MDEwOlJlcG9zaXRvcnk3MTU2MDU=-flat-TSInfo.java,VitamioBundle-MDEwOlJlcG9zaXRvcnk2MjkyMDI5-flat-VideoView.java,184,194,10,541,551,10
532701,https://htmlpreview.github.io/?https://github.com/Christina96/boilerplate-sample-matches/blob/main/Java/ribbon-MDEwOlJlcG9zaXRvcnk3NjE2MTU4-flat-DefaultClientConfigImplTest.java-jedis-MDEwOlJlcG9zaXRvcnk3MTU2MDU=-flat-ShardedPipelineTest.java.html,0.11618257261410789,14,ribbon-MDEwOlJlcG9zaXRvcnk3NjE2MTU4-flat-DefaultClientConfigImplTest.java,jedis-MDEwOlJlcG9zaXRvcnk3MTU2MDU=-flat-ShardedPipelineTest.java,51,57,6,34,41,7
533562,https://htmlpreview.github.io/?https://github.com/Christina96/boilerplate-sample-matches/blob/main/Java/segmentfault-lessons-MDEwOlJlcG9zaXRvcnk5MzE1NzM4MQ==-flat-FindCommandDemo.java-google-api-java-client-samples-MDEwOlJlcG9zaXRvcnkyOTc0OTA1Mg==-flat-CreateFloodlightReport.java.html,0.2631578947368421,10,segmentfault-lessons-MDEwOlJlcG9zaXRvcnk5MzE1NzM4MQ==-flat-FindCommandDemo.java,google-api-java-client-samples-MDEwOlJlcG9zaXRvcnkyOTc0OTA1Mg==-flat-CreateFloodlightReport.java,2,10,8,4,11,7
533606,https://htmlpreview.github.io/?https://github.com/Christina96/boilerplate-sample-matches/blob/main/Java/jedis-MDEwOlJlcG9zaXRvcnk3MTU2MDU=-flat-JsonSearchWithGsonTest.java-motan-MDEwOlJlcG9zaXRvcnk1NjY3OTUyMQ==-flat-MeshProxyUtilTest.java.html,0.3841059602649007,10,jedis-MDEwOlJlcG9zaXRvcnk3MTU2MDU=-flat-JsonSearchWithGsonTest.java,motan-MDEwOlJlcG9zaXRvcnk1NjY3OTUyMQ==-flat-MeshProxyUtilTest.java,47,51,4,77,80,3
534295,https://htmlpreview.github.io/?https://github.com/Christina96/boilerplate-sample-matches/blob/main/Java/segmentfault-lessons-MDEwOlJlcG9zaXRvcnk5MzE1NzM4MQ==-flat-UserRibbonController_30.java-BungeeCord-MDEwOlJlcG9zaXRvcnk2MDg0MjEw-flat-UpstreamBridge.java.html,0.05741626794258373,12,segmentfault-lessons-MDEwOlJlcG9zaXRvcnk5MzE1NzM4MQ==-flat-UserRibbonController_30.java,BungeeCord-MDEwOlJlcG9zaXRvcnk2MDg0MjEw-flat-UpstreamBridge.java,1,12,11,1,12,11
535224,https://htmlpreview.github.io/?https://github.com/Christina96/boilerplate-sample-matches/blob/main/Java/Essentials-MDEwOlJlcG9zaXRvcnkxNzczNzU0-flat-PrivilegesHandler.java-Mybatis-PageHelper-MDEwOlJlcG9zaXRvcnkyMDY1MTY3Mg==-flat-PageHelper.java.html,0.08163265306122448,10,Essentials-MDEwOlJlcG9zaXRvcnkxNzczNzU0-flat-PrivilegesHandler.java,Mybatis-PageHelper-MDEwOlJlcG9zaXRvcnkyMDY1MTY3Mg==-flat-PageHelper.java,2,12,10,10,19,9
538855,https://htmlpreview.github.io/?https://github.com/Christina96/boilerplate-sample-matches/blob/main/Java/motan-MDEwOlJlcG9zaXRvcnk1NjY3OTUyMQ==-flat-RegistryConfigTest.java-google-api-java-client-samples-MDEwOlJlcG9zaXRvcnkyOTc0OTA1Mg==-flat-GenerateReport.java.html,0.1643835616438356,12,motan-MDEwOlJlcG9zaXRvcnk1NjY3OTUyMQ==-flat-RegistryConfigTest.java,google-api-java-client-samples-MDEwOlJlcG9zaXRvcnkyOTc0OTA1Mg==-flat-GenerateReport.java,11,17,6,23,29,6
540480,https://htmlpreview.github.io/?https://github.com/Christina96/boilerplate-sample-matches/blob/main/Java/ribbon-MDEwOlJlcG9zaXRvcnk3NjE2MTU4-flat-URLConnectionLoadBalancer.java-Essentials-MDEwOlJlcG9zaXRvcnkxNzczNzU0-flat-PermissionsBukkitHandler.java.html,0.11904761904761904,10,ribbon-MDEwOlJlcG9zaXRvcnk3NjE2MTU4-flat-URLConnectionLoadBalancer.java,Essentials-MDEwOlJlcG9zaXRvcnkxNzczNzU0-flat-PermissionsBukkitHandler.java,9,18,9,2,12,10
541914,https://htmlpreview.github.io/?https://github.com/Christina96/boilerplate-sample-matches/blob/main/Java/motan-MDEwOlJlcG9zaXRvcnk1NjY3OTUyMQ==-flat-ServiceConfigBeanTest.java-motan-MDEwOlJlcG9zaXRvcnk1NjY3OTUyMQ==-flat-ClusterSupport.java.html,0.061196105702364396,12,motan-MDEwOlJlcG9zaXRvcnk1NjY3OTUyMQ==-flat-ServiceConfigBeanTest.java,motan-MDEwOlJlcG9zaXRvcnk1NjY3OTUyMQ==-flat-ClusterSupport.java,51,56,5,286,291,5
550696,https://htmlpreview.github.io/?https://github.com/Christina96/boilerplate-sample-matches/blob/main/Java/segmentfault-lessons-MDEwOlJlcG9zaXRvcnk5MzE1NzM4MQ==-flat-UserServiceClientApplication_95.java-ribbon-MDEwOlJlcG9zaXRvcnk3NjE2MTU4-flat-PollingServerListUpdater.java.html,0.14906832298136646,12,segmentfault-lessons-MDEwOlJlcG9zaXRvcnk5MzE1NzM4MQ==-flat-UserServiceClientApplication_95.java,ribbon-MDEwOlJlcG9zaXRvcnk3NjE2MTU4-flat-PollingServerListUpdater.java,1,12,11,1,12,11
551968,https://htmlpreview.github.io/?https://github.com/Christina96/boilerplate-sample-matches/blob/main/Java/Essentials-MDEwOlJlcG9zaXRvcnkxNzczNzU0-flat-EmergencyListener.java-ribbon-MDEwOlJlcG9zaXRvcnk3NjE2MTU4-flat-MovieServiceInterfaces.java.html,0.0625,11,Essentials-MDEwOlJlcG9zaXRvcnkxNzczNzU0-flat-EmergencyListener.java,ribbon-MDEwOlJlcG9zaXRvcnk3NjE2MTU4-flat-MovieServiceInterfaces.java,1,11,10,1,11,10
553637,https://htmlpreview.github.io/?https://github.com/Christina96/boilerplate-sample-matches/blob/main/Java/Mybatis-PageHelper-MDEwOlJlcG9zaXRvcnkyMDY1MTY3Mg==-flat-MybatisRowBoundsHelper.java-motan-MDEwOlJlcG9zaXRvcnk1NjY3OTUyMQ==-flat-AbstractMockRpcProtocol.java.html,0.10050251256281408,10,Mybatis-PageHelper-MDEwOlJlcG9zaXRvcnkyMDY1MTY3Mg==-flat-MybatisRowBoundsHelper.java,motan-MDEwOlJlcG9zaXRvcnk1NjY3OTUyMQ==-flat-AbstractMockRpcProtocol.java,2,11,9,12,21,9
556102,https://htmlpreview.github.io/?https://github.com/Christina96/boilerplate-sample-matches/blob/main/Java/segmentfault-lessons-MDEwOlJlcG9zaXRvcnk5MzE1NzM4MQ==-flat-WebSecurityConfiguration.java-google-api-java-client-samples-MDEwOlJlcG9zaXRvcnkyOTc0OTA1Mg==-flat-GenerateReport_12.java.html,0.15492957746478872,11,segmentfault-lessons-MDEwOlJlcG9zaXRvcnk5MzE1NzM4MQ==-flat-WebSecurityConfiguration.java,google-api-java-client-samples-MDEwOlJlcG9zaXRvcnkyOTc0OTA1Mg==-flat-GenerateReport_12.java,24,25,1,24,29,5
557816,https://htmlpreview.github.io/?https://github.com/Christina96/boilerplate-sample-matches/blob/main/Java/motan-MDEwOlJlcG9zaXRvcnk1NjY3OTUyMQ==-flat-IHello.java-jedis-MDEwOlJlcG9zaXRvcnk3MTU2MDU=-flat-ServerCommands.java.html,0.32098765432098764,13,motan-MDEwOlJlcG9zaXRvcnk1NjY3OTUyMQ==-flat-IHello.java,jedis-MDEwOlJlcG9zaXRvcnk3MTU2MDU=-flat-ServerCommands.java,18,23,5,17,22,5
558384,https://htmlpreview.github.io/?https://github.com/Christina96/boilerplate-sample-matches/blob/main/Java/jedis-MDEwOlJlcG9zaXRvcnk3MTU2MDU=-flat-JedisByteHashMapTest.java-jedis-MDEwOlJlcG9zaXRvcnk3MTU2MDU=-flat-AllKindOfValuesCommandsTest.java.html,0.05524079320113314,15,jedis-MDEwOlJlcG9zaXRvcnk3MTU2MDU=-flat-JedisByteHashMapTest.java,jedis-MDEwOlJlcG9zaXRvcnk3MTU2MDU=-flat-AllKindOfValuesCommandsTest.java,2,16,14,15,29,14
558480,https://htmlpreview.github.io/?https://github.com/Christina96/boilerplate-sample-matches/blob/main/Java/google-api-java-client-samples-MDEwOlJlcG9zaXRvcnkyOTc0OTA1Mg==-flat-Utils_2.java-jedis-MDEwOlJlcG9zaXRvcnk3MTU2MDU=-flat-JedisPoolTest.java.html,0.05099150141643059,18,google-api-java-client-samples-MDEwOlJlcG9zaXRvcnkyOTc0OTA1Mg==-flat-Utils_2.java,jedis-MDEwOlJlcG9zaXRvcnk3MTU2MDU=-flat-JedisPoolTest.java,2,19,17,3,20,17
558577,https://htmlpreview.github.io/?https://github.com/Christina96/boilerplate-sample-matches/blob/main/Java/BungeeCord-MDEwOlJlcG9zaXRvcnk2MDg0MjEw-flat-ConnectionThrottle.java-motan-MDEwOlJlcG9zaXRvcnk1NjY3OTUyMQ==-flat-AbstractRefererHandler.java.html,0.061452513966480445,11,BungeeCord-MDEwOlJlcG9zaXRvcnk2MDg0MjEw-flat-ConnectionThrottle.java,motan-MDEwOlJlcG9zaXRvcnk1NjY3OTUyMQ==-flat-AbstractRefererHandler.java,1,11,10,1,11,10
560569,https://htmlpreview.github.io/?https://github.com/Christina96/boilerplate-sample-matches/blob/main/Java/Mybatis-PageHelper-MDEwOlJlcG9zaXRvcnkyMDY1MTY3Mg==-flat-CountColumnTest.java-Essentials-MDEwOlJlcG9zaXRvcnkxNzczNzU0-flat-EmergencyListener.java.html,0.23076923076923078,12,Mybatis-PageHelper-MDEwOlJlcG9zaXRvcnkyMDY1MTY3Mg==-flat-CountColumnTest.java,Essentials-MDEwOlJlcG9zaXRvcnkxNzczNzU0-flat-EmergencyListener.java,2,12,10,3,14,11
561691,https://htmlpreview.github.io/?https://github.com/Christina96/boilerplate-sample-matches/blob/main/Java/segmentfault-lessons-MDEwOlJlcG9zaXRvcnk5MzE1NzM4MQ==-flat-SelectorClientDemo.java-motan-MDEwOlJlcG9zaXRvcnk1NjY3OTUyMQ==-flat-ClusterSupportTest.java.html,0.040145985401459854,11,segmentfault-lessons-MDEwOlJlcG9zaXRvcnk5MzE1NzM4MQ==-flat-SelectorClientDemo.java,motan-MDEwOlJlcG9zaXRvcnk1NjY3OTUyMQ==-flat-ClusterSupportTest.java,1,11,10,1,11,10
562334,https://htmlpreview.github.io/?https://github.com/Christina96/boilerplate-sample-matches/blob/main/Java/Essentials-MDEwOlJlcG9zaXRvcnkxNzczNzU0-flat-Warps.java-motan-MDEwOlJlcG9zaXRvcnk1NjY3OTUyMQ==-flat-Netty4HttpServer.java.html,0.12213740458015267,10,Essentials-MDEwOlJlcG9zaXRvcnkxNzczNzU0-flat-Warps.java,motan-MDEwOlJlcG9zaXRvcnk1NjY3OTUyMQ==-flat-Netty4HttpServer.java,28,38,10,101,108,7
567552,https://htmlpreview.github.io/?https://github.com/Christina96/boilerplate-sample-matches/blob/main/Java/BungeeCord-MDEwOlJlcG9zaXRvcnk2MDg0MjEw-flat-ProtocolConstants.java-VitamioBundle-MDEwOlJlcG9zaXRvcnk2MjkyMDI5-flat-VideoView.java.html,0.06276150627615062,30,BungeeCord-MDEwOlJlcG9zaXRvcnk2MDg0MjEw-flat-ProtocolConstants.java,VitamioBundle-MDEwOlJlcG9zaXRvcnk2MjkyMDI5-flat-VideoView.java,7,36,29,127,156,29
572544,https://htmlpreview.github.io/?https://github.com/Christina96/boilerplate-sample-matches/blob/main/Java/ribbon-MDEwOlJlcG9zaXRvcnk3NjE2MTU4-flat-NettyHttpLoadBalancerErrorHandler.java-ribbon-MDEwOlJlcG9zaXRvcnk3NjE2MTU4-flat-DefaultClientConfigImplTest.java.html,0.11428571428571428,10,ribbon-MDEwOlJlcG9zaXRvcnk3NjE2MTU4-flat-NettyHttpLoadBalancerErrorHandler.java,ribbon-MDEwOlJlcG9zaXRvcnk3NjE2MTU4-flat-DefaultClientConfigImplTest.java,1,10,9,1,10,9
574378,https://htmlpreview.github.io/?https://github.com/Christina96/boilerplate-sample-matches/blob/main/Java/Mybatis-PageHelper-MDEwOlJlcG9zaXRvcnkyMDY1MTY3Mg==-flat-TestParameterOne.java-Essentials-MDEwOlJlcG9zaXRvcnkxNzczNzU0-flat-SignBlockListener.java.html,0.049019607843137254,10,Mybatis-PageHelper-MDEwOlJlcG9zaXRvcnkyMDY1MTY3Mg==-flat-TestParameterOne.java,Essentials-MDEwOlJlcG9zaXRvcnkxNzczNzU0-flat-SignBlockListener.java,1,10,9,1,10,9
576801,https://htmlpreview.github.io/?https://github.com/Christina96/boilerplate-sample-matches/blob/main/Java/ribbon-MDEwOlJlcG9zaXRvcnk3NjE2MTU4-flat-EurekaNotificationServerListUpdater.java-Essentials-MDEwOlJlcG9zaXRvcnkxNzczNzU0-flat-Essentials.java.html,0.05144193296960249,19,ribbon-MDEwOlJlcG9zaXRvcnk3NjE2MTU4-flat-EurekaNotificationServerListUpdater.java,Essentials-MDEwOlJlcG9zaXRvcnkxNzczNzU0-flat-Essentials.java,2,20,18,52,71,19
578701,https://htmlpreview.github.io/?https://github.com/Christina96/boilerplate-sample-matches/blob/main/Java/google-api-java-client-samples-MDEwOlJlcG9zaXRvcnkyOTc0OTA1Mg==-flat-Utils.java-jedis-MDEwOlJlcG9zaXRvcnk3MTU2MDU=-flat-ScanParams.java.html,0.15037593984962405,10,google-api-java-client-samples-MDEwOlJlcG9zaXRvcnkyOTc0OTA1Mg==-flat-Utils.java,jedis-MDEwOlJlcG9zaXRvcnk3MTU2MDU=-flat-ScanParams.java,8,17,9,2,11,9
579521,https://htmlpreview.github.io/?https://github.com/Christina96/boilerplate-sample-matches/blob/main/Java/ribbon-MDEwOlJlcG9zaXRvcnk3NjE2MTU4-flat-ServerListLoabBalancerTest.java-BungeeCord-MDEwOlJlcG9zaXRvcnk2MDg0MjEw-flat-Commands.java.html,0.05030181086519115,11,ribbon-MDEwOlJlcG9zaXRvcnk3NjE2MTU4-flat-ServerListLoabBalancerTest.java,BungeeCord-MDEwOlJlcG9zaXRvcnk2MDg0MjEw-flat-Commands.java,21,31,10,436,448,12
581106,https://htmlpreview.github.io/?https://github.com/Christina96/boilerplate-sample-matches/blob/main/Java/segmentfault-lessons-MDEwOlJlcG9zaXRvcnk5MzE1NzM4MQ==-flat-UserMessageService.java-Essentials-MDEwOlJlcG9zaXRvcnkxNzczNzU0-flat-Economy_16.java.html,0.11267605633802817,11,segmentfault-lessons-MDEwOlJlcG9zaXRvcnk5MzE1NzM4MQ==-flat-UserMessageService.java,Essentials-MDEwOlJlcG9zaXRvcnkxNzczNzU0-flat-Economy_16.java,39,46,7,56,63,7
589040,https://htmlpreview.github.io/?https://github.com/Christina96/boilerplate-sample-matches/blob/main/Java/motan-MDEwOlJlcG9zaXRvcnk1NjY3OTUyMQ==-flat-BasicRefererConfigBean.java-motan-MDEwOlJlcG9zaXRvcnk1NjY3OTUyMQ==-flat-MotanFrameworkUtil.java.html,0.045871559633027525,10,motan-MDEwOlJlcG9zaXRvcnk1NjY3OTUyMQ==-flat-BasicRefererConfigBean.java,motan-MDEwOlJlcG9zaXRvcnk1NjY3OTUyMQ==-flat-MotanFrameworkUtil.java,30,34,4,99,103,4
592701,https://htmlpreview.github.io/?https://github.com/Christina96/boilerplate-sample-matches/blob/main/Java/jedis-MDEwOlJlcG9zaXRvcnk3MTU2MDU=-flat-RetryableCommandExecutor.java-jedis-MDEwOlJlcG9zaXRvcnk3MTU2MDU=-flat-AllKindOfValuesCommandsTest.java.html,0.01908957415565345,13,jedis-MDEwOlJlcG9zaXRvcnk3MTU2MDU=-flat-RetryableCommandExecutor.java,jedis-MDEwOlJlcG9zaXRvcnk3MTU2MDU=-flat-AllKindOfValuesCommandsTest.java,2,14,12,17,29,12
594253,https://htmlpreview.github.io/?https://github.com/Christina96/boilerplate-sample-matches/blob/main/Java/google-api-java-client-samples-MDEwOlJlcG9zaXRvcnkyOTc0OTA1Mg==-flat-CalendarButtons.java-motan-MDEwOlJlcG9zaXRvcnk1NjY3OTUyMQ==-flat-SelectUrlsTest.java.html,0.20276497695852536,11,google-api-java-client-samples-MDEwOlJlcG9zaXRvcnkyOTc0OTA1Mg==-flat-CalendarButtons.java,motan-MDEwOlJlcG9zaXRvcnk1NjY3OTUyMQ==-flat-SelectUrlsTest.java,1,11,10,1,11,10
598012,https://htmlpreview.github.io/?https://github.com/Christina96/boilerplate-sample-matches/blob/main/Java/VitamioBundle-MDEwOlJlcG9zaXRvcnk2MjkyMDI5-flat-VideoViewSubtitle.java-Essentials-MDEwOlJlcG9zaXRvcnkxNzczNzU0-flat-Economy_16.java.html,0.03992015968063872,10,VitamioBundle-MDEwOlJlcG9zaXRvcnk2MjkyMDI5-flat-VideoViewSubtitle.java,Essentials-MDEwOlJlcG9zaXRvcnkxNzczNzU0-flat-Economy_16.java,1,10,9,1,10,9
598124,https://htmlpreview.github.io/?https://github.com/Christina96/boilerplate-sample-matches/blob/main/Java/BungeeCord-MDEwOlJlcG9zaXRvcnk2MDg0MjEw-flat-ChatEvent.java-BungeeCord-MDEwOlJlcG9zaXRvcnk2MDg0MjEw-flat-EncryptionResponse.java.html,0.21052631578947367,12,BungeeCord-MDEwOlJlcG9zaXRvcnk2MDg0MjEw-flat-ChatEvent.java,BungeeCord-MDEwOlJlcG9zaXRvcnk2MDg0MjEw-flat-EncryptionResponse.java,1,11,10,1,11,10
598784,https://htmlpreview.github.io/?https://github.com/Christina96/boilerplate-sample-matches/blob/main/Java/motan-MDEwOlJlcG9zaXRvcnk1NjY3OTUyMQ==-flat-RefererConfig.java-motan-MDEwOlJlcG9zaXRvcnk1NjY3OTUyMQ==-flat-AbstractInterfaceConfig.java.html,0.15714285714285714,11,motan-MDEwOlJlcG9zaXRvcnk1NjY3OTUyMQ==-flat-RefererConfig.java,motan-MDEwOlJlcG9zaXRvcnk1NjY3OTUyMQ==-flat-AbstractInterfaceConfig.java,132,138,6,310,315,5
598809,https://htmlpreview.github.io/?https://github.com/Christina96/boilerplate-sample-matches/blob/main/Java/Essentials-MDEwOlJlcG9zaXRvcnkxNzczNzU0-flat-PermissionsReaderInterface.java-jedis-MDEwOlJlcG9zaXRvcnk3MTU2MDU=-flat-KeyPipelineCommands.java.html,0.5607476635514018,13,Essentials-MDEwOlJlcG9zaXRvcnkxNzczNzU0-flat-PermissionsReaderInterface.java,jedis-MDEwOlJlcG9zaXRvcnk3MTU2MDU=-flat-KeyPipelineCommands.java,28,31,3,15,18,3
599372,https://htmlpreview.github.io/?https://github.com/Christina96/boilerplate-sample-matches/blob/main/Java/jedis-MDEwOlJlcG9zaXRvcnk3MTU2MDU=-flat-ByteArrayComparatorTest.java-motan-MDEwOlJlcG9zaXRvcnk1NjY3OTUyMQ==-flat-BaseSerializeTest.java.html,0.08494208494208494,11,jedis-MDEwOlJlcG9zaXRvcnk3MTU2MDU=-flat-ByteArrayComparatorTest.java,motan-MDEwOlJlcG9zaXRvcnk1NjY3OTUyMQ==-flat-BaseSerializeTest.java,7,12,5,52,56,4
600678,https://htmlpreview.github.io/?https://github.com/Christina96/boilerplate-sample-matches/blob/main/Java/google-api-java-client-samples-MDEwOlJlcG9zaXRvcnkyOTc0OTA1Mg==-flat-CalendarGwtSample.java-BungeeCord-MDEwOlJlcG9zaXRvcnk2MDg0MjEw-flat-BungeeTitle.java.html,0.10569105691056911,13,google-api-java-client-samples-MDEwOlJlcG9zaXRvcnkyOTc0OTA1Mg==-flat-CalendarGwtSample.java,BungeeCord-MDEwOlJlcG9zaXRvcnk2MDg0MjEw-flat-BungeeTitle.java,2,14,12,4,17,13
605106,https://htmlpreview.github.io/?https://github.com/Christina96/boilerplate-sample-matches/blob/main/Java/motan-MDEwOlJlcG9zaXRvcnk1NjY3OTUyMQ==-flat-ConsulUtils.java-jedis-MDEwOlJlcG9zaXRvcnk3MTU2MDU=-flat-TSRangeParams.java.html,0.0641025641025641,10,motan-MDEwOlJlcG9zaXRvcnk1NjY3OTUyMQ==-flat-ConsulUtils.java,jedis-MDEwOlJlcG9zaXRvcnk3MTU2MDU=-flat-TSRangeParams.java,1,10,9,1,10,9
608222,https://htmlpreview.github.io/?https://github.com/Christina96/boilerplate-sample-matches/blob/main/Java/motan-MDEwOlJlcG9zaXRvcnk1NjY3OTUyMQ==-flat-MotanV2CodecTest.java-motan-MDEwOlJlcG9zaXRvcnk1NjY3OTUyMQ==-flat-RegistryConfig.java.html,0.07179487179487179,14,motan-MDEwOlJlcG9zaXRvcnk1NjY3OTUyMQ==-flat-MotanV2CodecTest.java,motan-MDEwOlJlcG9zaXRvcnk1NjY3OTUyMQ==-flat-RegistryConfig.java,2,15,13,3,16,13
608761,https://htmlpreview.github.io/?https://github.com/Christina96/boilerplate-sample-matches/blob/main/Java/Mybatis-PageHelper-MDEwOlJlcG9zaXRvcnkyMDY1MTY3Mg==-flat-HerdDBDialect.java-jedis-MDEwOlJlcG9zaXRvcnk3MTU2MDU=-flat-JedisSentinelPoolTest.java.html,0.09482758620689655,11,Mybatis-PageHelper-MDEwOlJlcG9zaXRvcnkyMDY1MTY3Mg==-flat-HerdDBDialect.java,jedis-MDEwOlJlcG9zaXRvcnk3MTU2MDU=-flat-JedisSentinelPoolTest.java,1,11,10,1,11,10
611391,https://htmlpreview.github.io/?https://github.com/Christina96/boilerplate-sample-matches/blob/main/Java/google-api-java-client-samples-MDEwOlJlcG9zaXRvcnkyOTc0OTA1Mg==-flat-View_20.java-motan-MDEwOlJlcG9zaXRvcnk1NjY3OTUyMQ==-flat-ProviderResource.java.html,0.2631578947368421,10,google-api-java-client-samples-MDEwOlJlcG9zaXRvcnkyOTc0OTA1Mg==-flat-View_20.java,motan-MDEwOlJlcG9zaXRvcnk1NjY3OTUyMQ==-flat-ProviderResource.java,5,11,6,14,17,3
613757,https://htmlpreview.github.io/?https://github.com/Christina96/boilerplate-sample-matches/blob/main/Java/BungeeCord-MDEwOlJlcG9zaXRvcnk2MDg0MjEw-flat-NativeZlib.java-motan-MDEwOlJlcG9zaXRvcnk1NjY3OTUyMQ==-flat-AbstractConfig.java.html,0.07667731629392971,12,BungeeCord-MDEwOlJlcG9zaXRvcnk2MDg0MjEw-flat-NativeZlib.java,motan-MDEwOlJlcG9zaXRvcnk1NjY3OTUyMQ==-flat-AbstractConfig.java,39,41,2,84,87,3
618866,https://htmlpreview.github.io/?https://github.com/Christina96/boilerplate-sample-matches/blob/main/Java/segmentfault-lessons-MDEwOlJlcG9zaXRvcnk5MzE1NzM4MQ==-flat-User_157.java-jedis-MDEwOlJlcG9zaXRvcnk3MTU2MDU=-flat-GeoRadiusResponse.java.html,0.19230769230769232,10,segmentfault-lessons-MDEwOlJlcG9zaXRvcnk5MzE1NzM4MQ==-flat-User_157.java,jedis-MDEwOlJlcG9zaXRvcnk3MTU2MDU=-flat-GeoRadiusResponse.java,28,35,7,30,37,7
625597,https://htmlpreview.github.io/?https://github.com/Christina96/boilerplate-sample-matches/blob/main/Java/Essentials-MDEwOlJlcG9zaXRvcnkxNzczNzU0-flat-Commandptime.java-jedis-MDEwOlJlcG9zaXRvcnk3MTU2MDU=-flat-SetCommandsTestBase.java.html,0.023612750885478158,10,Essentials-MDEwOlJlcG9zaXRvcnkxNzczNzU0-flat-Commandptime.java,jedis-MDEwOlJlcG9zaXRvcnk3MTU2MDU=-flat-SetCommandsTestBase.java,2,12,10,13,22,9
626527,https://htmlpreview.github.io/?https://github.com/Christina96/boilerplate-sample-matches/blob/main/Java/Mybatis-PageHelper-MDEwOlJlcG9zaXRvcnkyMDY1MTY3Mg==-flat-HerdDBDialect.java-Mybatis-PageHelper-MDEwOlJlcG9zaXRvcnkyMDY1MTY3Mg==-flat-TestAnnotations.java.html,0.17333333333333334,13,Mybatis-PageHelper-MDEwOlJlcG9zaXRvcnkyMDY1MTY3Mg==-flat-HerdDBDialect.java,Mybatis-PageHelper-MDEwOlJlcG9zaXRvcnkyMDY1MTY3Mg==-flat-TestAnnotations.java,4,15,11,2,14,12
629973,https://htmlpreview.github.io/?https://github.com/Christina96/boilerplate-sample-matches/blob/main/Java/Mybatis-PageHelper-MDEwOlJlcG9zaXRvcnkyMDY1MTY3Mg==-flat-TestIntMax.java-motan-MDEwOlJlcG9zaXRvcnk1NjY3OTUyMQ==-flat-HelloResource.java.html,0.19801980198019803,10,Mybatis-PageHelper-MDEwOlJlcG9zaXRvcnkyMDY1MTY3Mg==-flat-TestIntMax.java,motan-MDEwOlJlcG9zaXRvcnk1NjY3OTUyMQ==-flat-HelloResource.java,1,10,9,1,10,9
631458,https://htmlpreview.github.io/?https://github.com/Christina96/boilerplate-sample-matches/blob/main/Java/BungeeCord-MDEwOlJlcG9zaXRvcnk2MDg0MjEw-flat-HoverEvent.java-jedis-MDEwOlJlcG9zaXRvcnk3MTU2MDU=-flat-SortedSetCommandsTestBase.java.html,0.016351558507920288,16,BungeeCord-MDEwOlJlcG9zaXRvcnk2MDg0MjEw-flat-HoverEvent.java,jedis-MDEwOlJlcG9zaXRvcnk3MTU2MDU=-flat-SortedSetCommandsTestBase.java,1,16,15,1,16,15
632114,https://htmlpreview.github.io/?https://github.com/Christina96/boilerplate-sample-matches/blob/main/Java/jedis-MDEwOlJlcG9zaXRvcnk3MTU2MDU=-flat-GeoRadiusParam.java-motan-MDEwOlJlcG9zaXRvcnk1NjY3OTUyMQ==-flat-Point.java.html,0.04150943396226415,11,jedis-MDEwOlJlcG9zaXRvcnk3MTU2MDU=-flat-GeoRadiusParam.java,motan-MDEwOlJlcG9zaXRvcnk1NjY3OTUyMQ==-flat-Point.java,28,35,7,197,202,5
632938,https://htmlpreview.github.io/?https://github.com/Christina96/boilerplate-sample-matches/blob/main/Java/Mybatis-PageHelper-MDEwOlJlcG9zaXRvcnkyMDY1MTY3Mg==-flat-PageInterceptor.java-motan-MDEwOlJlcG9zaXRvcnk1NjY3OTUyMQ==-flat-NettyDecoder.java.html,0.06666666666666667,16,Mybatis-PageHelper-MDEwOlJlcG9zaXRvcnkyMDY1MTY3Mg==-flat-PageInterceptor.java,motan-MDEwOlJlcG9zaXRvcnk1NjY3OTUyMQ==-flat-NettyDecoder.java,1,16,15,1,16,15
636848,https://htmlpreview.github.io/?https://github.com/Christina96/boilerplate-sample-matches/blob/main/Java/ribbon-MDEwOlJlcG9zaXRvcnk3NjE2MTU4-flat-DefaultClientConfigImplTest.java-BungeeCord-MDEwOlJlcG9zaXRvcnk2MDg0MjEw-flat-JsonConfiguration.java.html,0.09282700421940929,11,ribbon-MDEwOlJlcG9zaXRvcnk3NjE2MTU4-flat-DefaultClientConfigImplTest.java,BungeeCord-MDEwOlJlcG9zaXRvcnk2MDg0MjEw-flat-JsonConfiguration.java,1,11,10,1,11,10
638779,https://htmlpreview.github.io/?https://github.com/Christina96/boilerplate-sample-matches/blob/main/Java/Mybatis-PageHelper-MDEwOlJlcG9zaXRvcnkyMDY1MTY3Mg==-flat-PageTest.java-ribbon-MDEwOlJlcG9zaXRvcnk3NjE2MTU4-flat-NFHttpClient.java.html,0.03571428571428571,10,Mybatis-PageHelper-MDEwOlJlcG9zaXRvcnkyMDY1MTY3Mg==-flat-PageTest.java,ribbon-MDEwOlJlcG9zaXRvcnk3NjE2MTU4-flat-NFHttpClient.java,1,10,9,1,10,9
639058,https://htmlpreview.github.io/?https://github.com/Christina96/boilerplate-sample-matches/blob/main/Java/google-api-java-client-samples-MDEwOlJlcG9zaXRvcnkyOTc0OTA1Mg==-flat-CalendarAppEngineSample.java-VitamioBundle-MDEwOlJlcG9zaXRvcnk2MjkyMDI5-flat-MediaScanner.java.html,0.03559870550161812,11,google-api-java-client-samples-MDEwOlJlcG9zaXRvcnkyOTc0OTA1Mg==-flat-CalendarAppEngineSample.java,VitamioBundle-MDEwOlJlcG9zaXRvcnk2MjkyMDI5-flat-MediaScanner.java,2,12,10,10,20,10
641711,https://htmlpreview.github.io/?https://github.com/Christina96/boilerplate-sample-matches/blob/main/Java/Mybatis-PageHelper-MDEwOlJlcG9zaXRvcnkyMDY1MTY3Mg==-flat-PageRowBoundsTest.java-motan-MDEwOlJlcG9zaXRvcnk1NjY3OTUyMQ==-flat-AbstractInterfaceConfig.java.html,0.03231017770597738,10,Mybatis-PageHelper-MDEwOlJlcG9zaXRvcnkyMDY1MTY3Mg==-flat-PageRowBoundsTest.java,motan-MDEwOlJlcG9zaXRvcnk1NjY3OTUyMQ==-flat-AbstractInterfaceConfig.java,1,10,9,1,10,9
644247,https://htmlpreview.github.io/?https://github.com/Christina96/boilerplate-sample-matches/blob/main/Java/Essentials-MDEwOlJlcG9zaXRvcnkxNzczNzU0-flat-Commandkit.java-BungeeCord-MDEwOlJlcG9zaXRvcnk2MDg0MjEw-flat-PluginManager.java.html,0.034055727554179564,11,Essentials-MDEwOlJlcG9zaXRvcnkxNzczNzU0-flat-Commandkit.java,BungeeCord-MDEwOlJlcG9zaXRvcnk2MDg0MjEw-flat-PluginManager.java,1,11,10,1,11,10
647033,https://htmlpreview.github.io/?https://github.com/Christina96/boilerplate-sample-matches/blob/main/Java/motan-MDEwOlJlcG9zaXRvcnk1NjY3OTUyMQ==-flat-CommandController.java-BungeeCord-MDEwOlJlcG9zaXRvcnk2MDg0MjEw-flat-HandlerBoss.java.html,0.06043956043956044,11,motan-MDEwOlJlcG9zaXRvcnk1NjY3OTUyMQ==-flat-CommandController.java,BungeeCord-MDEwOlJlcG9zaXRvcnk2MDg0MjEw-flat-HandlerBoss.java,1,11,10,1,11,10
651425,https://htmlpreview.github.io/?https://github.com/Christina96/boilerplate-sample-matches/blob/main/Java/motan-MDEwOlJlcG9zaXRvcnk1NjY3OTUyMQ==-flat-ConsulRegistryService.java-jedis-MDEwOlJlcG9zaXRvcnk3MTU2MDU=-flat-JedisClusterTest.java.html,0.022608695652173914,13,motan-MDEwOlJlcG9zaXRvcnk1NjY3OTUyMQ==-flat-ConsulRegistryService.java,jedis-MDEwOlJlcG9zaXRvcnk3MTU2MDU=-flat-JedisClusterTest.java,1,13,12,1,13,12
651573,https://htmlpreview.github.io/?https://github.com/Christina96/boilerplate-sample-matches/blob/main/Java/jedis-MDEwOlJlcG9zaXRvcnk3MTU2MDU=-flat-Query.java-ribbon-MDEwOlJlcG9zaXRvcnk3NjE2MTU4-flat-LoadBalancingHttpClient.java.html,0.11483253588516747,13,jedis-MDEwOlJlcG9zaXRvcnk3MTU2MDU=-flat-Query.java,ribbon-MDEwOlJlcG9zaXRvcnk3NjE2MTU4-flat-LoadBalancingHttpClient.java,347,357,10,96,106,10
651959,https://htmlpreview.github.io/?https://github.com/Christina96/boilerplate-sample-matches/blob/main/Java/BungeeCord-MDEwOlJlcG9zaXRvcnk2MDg0MjEw-flat-Respawn.java-jedis-MDEwOlJlcG9zaXRvcnk3MTU2MDU=-flat-ClusterCommandObjects.java.html,0.06968641114982578,10,BungeeCord-MDEwOlJlcG9zaXRvcnk2MDg0MjEw-flat-Respawn.java,jedis-MDEwOlJlcG9zaXRvcnk3MTU2MDU=-flat-ClusterCommandObjects.java,1,10,9,1,10,9
653413,https://htmlpreview.github.io/?https://github.com/Christina96/boilerplate-sample-matches/blob/main/Java/jedis-MDEwOlJlcG9zaXRvcnk3MTU2MDU=-flat-JedisCommandsTestBase.java-jedis-MDEwOlJlcG9zaXRvcnk3MTU2MDU=-flat-BinaryValuesCommandsTestBase.java.html,0.040968342644320296,11,jedis-MDEwOlJlcG9zaXRvcnk3MTU2MDU=-flat-JedisCommandsTestBase.java,jedis-MDEwOlJlcG9zaXRvcnk3MTU2MDU=-flat-BinaryValuesCommandsTestBase.java,17,24,7,47,53,6
654006,https://htmlpreview.github.io/?https://github.com/Christina96/boilerplate-sample-matches/blob/main/Java/motan-MDEwOlJlcG9zaXRvcnk1NjY3OTUyMQ==-flat-GrpcClientDemo.java-BungeeCord-MDEwOlJlcG9zaXRvcnk2MDg0MjEw-flat-DefinedPacket.java.html,0.0378657487091222,11,motan-MDEwOlJlcG9zaXRvcnk1NjY3OTUyMQ==-flat-GrpcClientDemo.java,BungeeCord-MDEwOlJlcG9zaXRvcnk2MDg0MjEw-flat-DefinedPacket.java,1,11,10,1,11,10
656428,https://htmlpreview.github.io/?https://github.com/Christina96/boilerplate-sample-matches/blob/main/Java/jedis-MDEwOlJlcG9zaXRvcnk3MTU2MDU=-flat-SetCommandsTestBase.java-jedis-MDEwOlJlcG9zaXRvcnk3MTU2MDU=-flat-GeoCommandsTestBase.java.html,0.41203400915631133,10,jedis-MDEwOlJlcG9zaXRvcnk3MTU2MDU=-flat-SetCommandsTestBase.java,jedis-MDEwOlJlcG9zaXRvcnk3MTU2MDU=-flat-GeoCommandsTestBase.java,244,252,8,358,362,4
656617,https://htmlpreview.github.io/?https://github.com/Christina96/boilerplate-sample-matches/blob/main/Java/motan-MDEwOlJlcG9zaXRvcnk1NjY3OTUyMQ==-flat-ConsistentHashLoadBalance.java-jedis-MDEwOlJlcG9zaXRvcnk3MTU2MDU=-flat-PublishSubscribeCommandsTest.java.html,0.02617801047120419,10,motan-MDEwOlJlcG9zaXRvcnk1NjY3OTUyMQ==-flat-ConsistentHashLoadBalance.java,jedis-MDEwOlJlcG9zaXRvcnk3MTU2MDU=-flat-PublishSubscribeCommandsTest.java,1,10,9,1,10,9
657427,https://htmlpreview.github.io/?https://github.com/Christina96/boilerplate-sample-matches/blob/main/Java/SpringPetClinic-MDEwOlJlcG9zaXRvcnkzMDkzNDMzNTE=-flat-Pet.java-BungeeCord-MDEwOlJlcG9zaXRvcnk2MDg0MjEw-flat-BungeeTitle.java.html,0.08921933085501858,12,SpringPetClinic-MDEwOlJlcG9zaXRvcnkzMDkzNDMzNTE=-flat-Pet.java,BungeeCord-MDEwOlJlcG9zaXRvcnk2MDg0MjEw-flat-BungeeTitle.java,1,12,11,1,12,11
658440,https://htmlpreview.github.io/?https://github.com/Christina96/boilerplate-sample-matches/blob/main/Java/motan-MDEwOlJlcG9zaXRvcnk1NjY3OTUyMQ==-flat-ServiceMockFilterTest.java-BungeeCord-MDEwOlJlcG9zaXRvcnk2MDg0MjEw-flat-UpstreamBridge.java.html,0.07868852459016394,14,motan-MDEwOlJlcG9zaXRvcnk1NjY3OTUyMQ==-flat-ServiceMockFilterTest.java,BungeeCord-MDEwOlJlcG9zaXRvcnk2MDg0MjEw-flat-UpstreamBridge.java,2,15,13,27,41,14
664898,https://htmlpreview.github.io/?https://github.com/Christina96/boilerplate-sample-matches/blob/main/Java/google-api-java-client-samples-MDEwOlJlcG9zaXRvcnkyOTc0OTA1Mg==-flat-AddAdUnitToPublisher.java-jedis-MDEwOlJlcG9zaXRvcnk3MTU2MDU=-flat-ObjectCommandsTest.java.html,0.11904761904761904,10,google-api-java-client-samples-MDEwOlJlcG9zaXRvcnkyOTc0OTA1Mg==-flat-AddAdUnitToPublisher.java,jedis-MDEwOlJlcG9zaXRvcnk3MTU2MDU=-flat-ObjectCommandsTest.java,34,38,4,72,76,4
668160,https://htmlpreview.github.io/?https://github.com/Christina96/boilerplate-sample-matches/blob/main/Java/ribbon-MDEwOlJlcG9zaXRvcnk3NjE2MTU4-flat-PredicateKey.java-jedis-MDEwOlJlcG9zaXRvcnk3MTU2MDU=-flat-GeoCoordinate.java.html,0.2972972972972973,11,ribbon-MDEwOlJlcG9zaXRvcnk3NjE2MTU4-flat-PredicateKey.java,jedis-MDEwOlJlcG9zaXRvcnk3MTU2MDU=-flat-GeoCoordinate.java,1,9,8,1,9,8
670036,https://htmlpreview.github.io/?https://github.com/Christina96/boilerplate-sample-matches/blob/main/Java/SpringPetClinic-MDEwOlJlcG9zaXRvcnkzMDkzNDMzNTE=-flat-ValidatorTests.java-Essentials-MDEwOlJlcG9zaXRvcnkxNzczNzU0-flat-SignSpawnmob.java.html,0.21052631578947367,10,SpringPetClinic-MDEwOlJlcG9zaXRvcnkzMDkzNDMzNTE=-flat-ValidatorTests.java,Essentials-MDEwOlJlcG9zaXRvcnkxNzczNzU0-flat-SignSpawnmob.java,25,28,3,25,27,2
670107,https://htmlpreview.github.io/?https://github.com/Christina96/boilerplate-sample-matches/blob/main/Java/ribbon-MDEwOlJlcG9zaXRvcnk3NjE2MTU4-flat-HelloUdpServerExternalResource.java-ribbon-MDEwOlJlcG9zaXRvcnk3NjE2MTU4-flat-LBBuilderTest.java.html,0.1059190031152648,17,ribbon-MDEwOlJlcG9zaXRvcnk3NjE2MTU4-flat-HelloUdpServerExternalResource.java,ribbon-MDEwOlJlcG9zaXRvcnk3NjE2MTU4-flat-LBBuilderTest.java,1,17,16,1,17,16
670631,https://htmlpreview.github.io/?https://github.com/Christina96/boilerplate-sample-matches/blob/main/Java/segmentfault-lessons-MDEwOlJlcG9zaXRvcnk5MzE1NzM4MQ==-flat-PersonControllerSpringBootTest.java-BungeeCord-MDEwOlJlcG9zaXRvcnk2MDg0MjEw-flat-Plugin.java.html,0.2033898305084746,12,segmentfault-lessons-MDEwOlJlcG9zaXRvcnk5MzE1NzM4MQ==-flat-PersonControllerSpringBootTest.java,BungeeCord-MDEwOlJlcG9zaXRvcnk2MDg0MjEw-flat-Plugin.java,1,12,11,1,12,11
670933,https://htmlpreview.github.io/?https://github.com/Christina96/boilerplate-sample-matches/blob/main/Java/Mybatis-PageHelper-MDEwOlJlcG9zaXRvcnkyMDY1MTY3Mg==-flat-TestDynamicIfTwoList.java-jedis-MDEwOlJlcG9zaXRvcnk3MTU2MDU=-flat-ClusterPipeliningTest.java.html,0.03757380568974772,13,Mybatis-PageHelper-MDEwOlJlcG9zaXRvcnkyMDY1MTY3Mg==-flat-TestDynamicIfTwoList.java,jedis-MDEwOlJlcG9zaXRvcnk3MTU2MDU=-flat-ClusterPipeliningTest.java,19,24,5,83,90,7
673589,https://htmlpreview.github.io/?https://github.com/Christina96/boilerplate-sample-matches/blob/main/Java/Mybatis-PageHelper-MDEwOlJlcG9zaXRvcnkyMDY1MTY3Mg==-flat-PageSizeZeroTest.java-google-api-java-client-samples-MDEwOlJlcG9zaXRvcnkyOTc0OTA1Mg==-flat-GenerateReportForHost.java.html,0.13157894736842105,10,Mybatis-PageHelper-MDEwOlJlcG9zaXRvcnkyMDY1MTY3Mg==-flat-PageSizeZeroTest.java,google-api-java-client-samples-MDEwOlJlcG9zaXRvcnkyOTc0OTA1Mg==-flat-GenerateReportForHost.java,1,10,9,1,10,9
674919,https://htmlpreview.github.io/?https://github.com/Christina96/boilerplate-sample-matches/blob/main/Java/motan-MDEwOlJlcG9zaXRvcnk1NjY3OTUyMQ==-flat-MockServer.java-motan-MDEwOlJlcG9zaXRvcnk1NjY3OTUyMQ==-flat-ConsulRegistry.java.html,0.03558718861209965,10,motan-MDEwOlJlcG9zaXRvcnk1NjY3OTUyMQ==-flat-MockServer.java,motan-MDEwOlJlcG9zaXRvcnk1NjY3OTUyMQ==-flat-ConsulRegistry.java,2,11,9,10,19,9
677695,https://htmlpreview.github.io/?https://github.com/Christina96/boilerplate-sample-matches/blob/main/Java/BungeeCord-MDEwOlJlcG9zaXRvcnk2MDg0MjEw-flat-KeybindComponentSerializer.java-motan-MDEwOlJlcG9zaXRvcnk1NjY3OTUyMQ==-flat-AbstractClient.java.html,0.2,10,BungeeCord-MDEwOlJlcG9zaXRvcnk2MDg0MjEw-flat-KeybindComponentSerializer.java,motan-MDEwOlJlcG9zaXRvcnk1NjY3OTUyMQ==-flat-AbstractClient.java,1,10,9,1,10,9
678269,https://htmlpreview.github.io/?https://github.com/Christina96/boilerplate-sample-matches/blob/main/Java/segmentfault-lessons-MDEwOlJlcG9zaXRvcnk5MzE1NzM4MQ==-flat-UserRibbonController_50.java-motan-MDEwOlJlcG9zaXRvcnk1NjY3OTUyMQ==-flat-RouteGuideUtil.java.html,0.25,12,segmentfault-lessons-MDEwOlJlcG9zaXRvcnk5MzE1NzM4MQ==-flat-UserRibbonController_50.java,motan-MDEwOlJlcG9zaXRvcnk1NjY3OTUyMQ==-flat-RouteGuideUtil.java,1,12,11,1,12,11
678467,https://htmlpreview.github.io/?https://github.com/Christina96/boilerplate-sample-matches/blob/main/Java/Mybatis-PageHelper-MDEwOlJlcG9zaXRvcnkyMDY1MTY3Mg==-flat-RemoveOrderTest.java-jedis-MDEwOlJlcG9zaXRvcnk3MTU2MDU=-flat-Query.java.html,0.03590664272890485,10,Mybatis-PageHelper-MDEwOlJlcG9zaXRvcnkyMDY1MTY3Mg==-flat-RemoveOrderTest.java,jedis-MDEwOlJlcG9zaXRvcnk3MTU2MDU=-flat-Query.java,1,10,9,1,10,9
678641,https://htmlpreview.github.io/?https://github.com/Christina96/boilerplate-sample-matches/blob/main/Java/segmentfault-lessons-MDEwOlJlcG9zaXRvcnk5MzE1NzM4MQ==-flat-User_153.java-ribbon-MDEwOlJlcG9zaXRvcnk3NjE2MTU4-flat-LoadBalancerContext.java.html,0.0764872521246459,12,segmentfault-lessons-MDEwOlJlcG9zaXRvcnk5MzE1NzM4MQ==-flat-User_153.java,ribbon-MDEwOlJlcG9zaXRvcnk3NjE2MTU4-flat-LoadBalancerContext.java,31,47,16,70,80,10
680095,https://htmlpreview.github.io/?https://github.com/Christina96/boilerplate-sample-matches/blob/main/Java/Essentials-MDEwOlJlcG9zaXRvcnkxNzczNzU0-flat-GlobalGroups.java-jedis-MDEwOlJlcG9zaXRvcnk3MTU2MDU=-flat-ResultSetBuilder.java.html,0.047619047619047616,16,Essentials-MDEwOlJlcG9zaXRvcnkxNzczNzU0-flat-GlobalGroups.java,jedis-MDEwOlJlcG9zaXRvcnk3MTU2MDU=-flat-ResultSetBuilder.java,9,24,15,2,17,15
681852,https://htmlpreview.github.io/?https://github.com/Christina96/boilerplate-sample-matches/blob/main/Java/Mybatis-PageHelper-MDEwOlJlcG9zaXRvcnkyMDY1MTY3Mg==-flat-CountColumnTest.java-jedis-MDEwOlJlcG9zaXRvcnk3MTU2MDU=-flat-SpellCheckTest.java.html,0.11834319526627218,10,Mybatis-PageHelper-MDEwOlJlcG9zaXRvcnkyMDY1MTY3Mg==-flat-CountColumnTest.java,jedis-MDEwOlJlcG9zaXRvcnk3MTU2MDU=-flat-SpellCheckTest.java,1,10,9,1,10,9
682215,https://htmlpreview.github.io/?https://github.com/Christina96/boilerplate-sample-matches/blob/main/Java/Mybatis-PageHelper-MDEwOlJlcG9zaXRvcnkyMDY1MTY3Mg==-flat-UsingDialectClassTest.java-ribbon-MDEwOlJlcG9zaXRvcnk3NjE2MTU4-flat-RxMovieServerTest.java.html,0.17261904761904762,10,Mybatis-PageHelper-MDEwOlJlcG9zaXRvcnkyMDY1MTY3Mg==-flat-UsingDialectClassTest.java,ribbon-MDEwOlJlcG9zaXRvcnk3NjE2MTU4-flat-RxMovieServerTest.java,40,44,4,78,81,3
688039,https://htmlpreview.github.io/?https://github.com/Christina96/boilerplate-sample-matches/blob/main/Java/SpringPetClinic-MDEwOlJlcG9zaXRvcnkzMDkzNDMzNTE=-flat-Person.java-segmentfault-lessons-MDEwOlJlcG9zaXRvcnk5MzE1NzM4MQ==-flat-Book_151.java.html,0.42857142857142855,15,SpringPetClinic-MDEwOlJlcG9zaXRvcnkzMDkzNDMzNTE=-flat-Person.java,segmentfault-lessons-MDEwOlJlcG9zaXRvcnk5MzE1NzM4MQ==-flat-Book_151.java,13,25,12,23,35,12
691523,https://htmlpreview.github.io/?https://github.com/Christina96/boilerplate-sample-matches/blob/main/Java/jedis-MDEwOlJlcG9zaXRvcnk3MTU2MDU=-flat-KeyPipelineCommands.java-Essentials-MDEwOlJlcG9zaXRvcnkxNzczNzU0-flat-Kit.java.html,0.03787878787878788,10,jedis-MDEwOlJlcG9zaXRvcnk3MTU2MDU=-flat-KeyPipelineCommands.java,Essentials-MDEwOlJlcG9zaXRvcnkxNzczNzU0-flat-Kit.java,1,10,9,1,10,9
