ID,Link,Tokens,File 1,File 2,Start 1,End 1,Detected Lines 1,Start 2,End 2,Detected Lines 2
0,https://htmlpreview.github.io/?https://github.com/Christina96/boilerplate-sample-matches/blob/main/Python/practical-python-MDEwOlJlcG9zaXRvcnkyNjY2MTM3MDQ=-flat-pcost_5.py-practical-python-MDEwOlJlcG9zaXRvcnkyNjY2MTM3MDQ=-flat-follow_90.py.html,18,practical-python-MDEwOlJlcG9zaXRvcnkyNjY2MTM3MDQ=-flat-pcost_5.py,practical-python-MDEwOlJlcG9zaXRvcnkyNjY2MTM3MDQ=-flat-follow_90.py,9,11,2,18,20,2
1,https://htmlpreview.github.io/?https://github.com/Christina96/boilerplate-sample-matches/blob/main/Python/Ultroid-MDEwOlJlcG9zaXRvcnkzNDEwMzg2MDI=-flat-devtools.py-Ultroid-MDEwOlJlcG9zaXRvcnkzNDEwMzg2MDI=-flat-bot.py.html,24,Ultroid-MDEwOlJlcG9zaXRvcnkzNDEwMzg2MDI=-flat-devtools.py,Ultroid-MDEwOlJlcG9zaXRvcnkzNDEwMzg2MDI=-flat-bot.py,75,82,7,198,203,5
2,https://htmlpreview.github.io/?https://github.com/Christina96/boilerplate-sample-matches/blob/main/Python/Ultroid-MDEwOlJlcG9zaXRvcnkzNDEwMzg2MDI=-flat-button.py-Ultroid-MDEwOlJlcG9zaXRvcnkzNDEwMzg2MDI=-flat-greetings.py.html,14,Ultroid-MDEwOlJlcG9zaXRvcnkzNDEwMzg2MDI=-flat-button.py,Ultroid-MDEwOlJlcG9zaXRvcnkzNDEwMzg2MDI=-flat-greetings.py,19,21,2,38,40,2
3,https://htmlpreview.github.io/?https://github.com/Christina96/boilerplate-sample-matches/blob/main/Python/esptool-MDEwOlJlcG9zaXRvcnkyMzczNjkxNA==-flat-esp_rfc2217_server.py-esptool-MDEwOlJlcG9zaXRvcnkyMzczNjkxNA==-flat-esp_rfc2217_server.py.html,19,esptool-MDEwOlJlcG9zaXRvcnkyMzczNjkxNA==-flat-esp_rfc2217_server.py,esptool-MDEwOlJlcG9zaXRvcnkyMzczNjkxNA==-flat-esp_rfc2217_server.py,132,138,6,140,146,6
4,https://htmlpreview.github.io/?https://github.com/Christina96/boilerplate-sample-matches/blob/main/Python/sonnet-MDEwOlJlcG9zaXRvcnk4NzA2NzIxMg==-flat-depthwise_conv_test.py-sonnet-MDEwOlJlcG9zaXRvcnk4NzA2NzIxMg==-flat-conv_test.py.html,105,sonnet-MDEwOlJlcG9zaXRvcnk4NzA2NzIxMg==-flat-depthwise_conv_test.py,sonnet-MDEwOlJlcG9zaXRvcnk4NzA2NzIxMg==-flat-conv_test.py,57,66,9,106,117,11
5,https://htmlpreview.github.io/?https://github.com/Christina96/boilerplate-sample-matches/blob/main/Python/esptool-MDEwOlJlcG9zaXRvcnkyMzczNjkxNA==-flat-__init__.py-esptool-MDEwOlJlcG9zaXRvcnkyMzczNjkxNA==-flat-__init__.py.html,13,esptool-MDEwOlJlcG9zaXRvcnkyMzczNjkxNA==-flat-__init__.py,esptool-MDEwOlJlcG9zaXRvcnkyMzczNjkxNA==-flat-__init__.py,500,501,1,725,726,1
6,https://htmlpreview.github.io/?https://github.com/Christina96/boilerplate-sample-matches/blob/main/Python/yolact-MDEwOlJlcG9zaXRvcnkxMzg3OTY2OTk=-flat-dcn_v2.py-yolact-MDEwOlJlcG9zaXRvcnkxMzg3OTY2OTk=-flat-dcn_v2.py.html,14,yolact-MDEwOlJlcG9zaXRvcnkxMzg3OTY2OTk=-flat-dcn_v2.py,yolact-MDEwOlJlcG9zaXRvcnkxMzg3OTY2OTk=-flat-dcn_v2.py,79,82,3,187,190,3
7,https://htmlpreview.github.io/?https://github.com/Christina96/boilerplate-sample-matches/blob/main/Python/Ultroid-MDEwOlJlcG9zaXRvcnkzNDEwMzg2MDI=-flat-tools.py-Ultroid-MDEwOlJlcG9zaXRvcnkzNDEwMzg2MDI=-flat-tools.py.html,14,Ultroid-MDEwOlJlcG9zaXRvcnkzNDEwMzg2MDI=-flat-tools.py,Ultroid-MDEwOlJlcG9zaXRvcnkzNDEwMzg2MDI=-flat-tools.py,681,684,3,663,666,3
8,https://htmlpreview.github.io/?https://github.com/Christina96/boilerplate-sample-matches/blob/main/Python/sonnet-MDEwOlJlcG9zaXRvcnk4NzA2NzIxMg==-flat-pad_test.py-sonnet-MDEwOlJlcG9zaXRvcnk4NzA2NzIxMg==-flat-pad_test.py.html,32,sonnet-MDEwOlJlcG9zaXRvcnk4NzA2NzIxMg==-flat-pad_test.py,sonnet-MDEwOlJlcG9zaXRvcnk4NzA2NzIxMg==-flat-pad_test.py,30,31,1,24,25,1
9,https://htmlpreview.github.io/?https://github.com/Christina96/boilerplate-sample-matches/blob/main/Python/seq2seq-MDEwOlJlcG9zaXRvcnk4MzczMjgwNg==-flat-rnn_encoder_test.py-seq2seq-MDEwOlJlcG9zaXRvcnk4MzczMjgwNg==-flat-rnn_encoder_test.py.html,22,seq2seq-MDEwOlJlcG9zaXRvcnk4MzczMjgwNg==-flat-rnn_encoder_test.py,seq2seq-MDEwOlJlcG9zaXRvcnk4MzczMjgwNg==-flat-rnn_encoder_test.py,127,129,2,129,131,2
10,https://htmlpreview.github.io/?https://github.com/Christina96/boilerplate-sample-matches/blob/main/Python/google-api-python-client-MDEwOlJlcG9zaXRvcnkxNTc0OTI2OQ==-flat-core_reporting_v3_reference.py-cookiecutter-pypackage-MDEwOlJlcG9zaXRvcnkxMTQwNzU2Nw==-flat-setup_0.py.html,12,google-api-python-client-MDEwOlJlcG9zaXRvcnkxNTc0OTI2OQ==-flat-core_reporting_v3_reference.py,cookiecutter-pypackage-MDEwOlJlcG9zaXRvcnkxMTQwNzU2Nw==-flat-setup_0.py,50,53,3,50,53,3
11,https://htmlpreview.github.io/?https://github.com/Christina96/boilerplate-sample-matches/blob/main/Python/Ultroid-MDEwOlJlcG9zaXRvcnkzNDEwMzg2MDI=-flat-giftools.py-Ultroid-MDEwOlJlcG9zaXRvcnkzNDEwMzg2MDI=-flat-giftools.py.html,38,Ultroid-MDEwOlJlcG9zaXRvcnkzNDEwMzg2MDI=-flat-giftools.py,Ultroid-MDEwOlJlcG9zaXRvcnkzNDEwMzg2MDI=-flat-giftools.py,12,16,4,70,74,4
12,https://htmlpreview.github.io/?https://github.com/Christina96/boilerplate-sample-matches/blob/main/Python/Ultroid-MDEwOlJlcG9zaXRvcnkzNDEwMzg2MDI=-flat-_inline.py-Ultroid-MDEwOlJlcG9zaXRvcnkzNDEwMzg2MDI=-flat-pmpermit.py.html,16,Ultroid-MDEwOlJlcG9zaXRvcnkzNDEwMzg2MDI=-flat-_inline.py,Ultroid-MDEwOlJlcG9zaXRvcnkzNDEwMzg2MDI=-flat-pmpermit.py,337,342,5,716,721,5
13,https://htmlpreview.github.io/?https://github.com/Christina96/boilerplate-sample-matches/blob/main/Python/yolact-MDEwOlJlcG9zaXRvcnkxMzg3OTY2OTk=-flat-dcn_v2.py-yolact-MDEwOlJlcG9zaXRvcnkxMzg3OTY2OTk=-flat-dcn_v2.py.html,14,yolact-MDEwOlJlcG9zaXRvcnkxMzg3OTY2OTk=-flat-dcn_v2.py,yolact-MDEwOlJlcG9zaXRvcnkxMzg3OTY2OTk=-flat-dcn_v2.py,219,220,1,220,221,1
14,https://htmlpreview.github.io/?https://github.com/Christina96/boilerplate-sample-matches/blob/main/Python/seq2seq-MDEwOlJlcG9zaXRvcnk4MzczMjgwNg==-flat-train_utils_test.py-seq2seq-MDEwOlJlcG9zaXRvcnk4MzczMjgwNg==-flat-train_utils_test.py.html,16,seq2seq-MDEwOlJlcG9zaXRvcnk4MzczMjgwNg==-flat-train_utils_test.py,seq2seq-MDEwOlJlcG9zaXRvcnk4MzczMjgwNg==-flat-train_utils_test.py,105,108,3,122,125,3
15,https://htmlpreview.github.io/?https://github.com/Christina96/boilerplate-sample-matches/blob/main/Python/esptool-MDEwOlJlcG9zaXRvcnkyMzczNjkxNA==-flat-operations_7.py-esptool-MDEwOlJlcG9zaXRvcnkyMzczNjkxNA==-flat-operations_12.py.html,443,esptool-MDEwOlJlcG9zaXRvcnkyMzczNjkxNA==-flat-operations_7.py,esptool-MDEwOlJlcG9zaXRvcnkyMzczNjkxNA==-flat-operations_12.py,380,439,59,380,439,59
16,https://htmlpreview.github.io/?https://github.com/Christina96/boilerplate-sample-matches/blob/main/Python/Ultroid-MDEwOlJlcG9zaXRvcnkzNDEwMzg2MDI=-flat-specialtools.py-esptool-MDEwOlJlcG9zaXRvcnkyMzczNjkxNA==-flat-bin_image.py.html,12,Ultroid-MDEwOlJlcG9zaXRvcnkzNDEwMzg2MDI=-flat-specialtools.py,esptool-MDEwOlJlcG9zaXRvcnkyMzczNjkxNA==-flat-bin_image.py,113,115,2,453,455,2
17,https://htmlpreview.github.io/?https://github.com/Christina96/boilerplate-sample-matches/blob/main/Python/sonnet-MDEwOlJlcG9zaXRvcnk4NzA2NzIxMg==-flat-write_test.py-sonnet-MDEwOlJlcG9zaXRvcnk4NzA2NzIxMg==-flat-write_test.py.html,30,sonnet-MDEwOlJlcG9zaXRvcnk4NzA2NzIxMg==-flat-write_test.py,sonnet-MDEwOlJlcG9zaXRvcnk4NzA2NzIxMg==-flat-write_test.py,36,41,5,73,78,5
18,https://htmlpreview.github.io/?https://github.com/Christina96/boilerplate-sample-matches/blob/main/Python/google-api-python-client-MDEwOlJlcG9zaXRvcnkxNTc0OTI2OQ==-flat-describe_9.py-google-api-python-client-MDEwOlJlcG9zaXRvcnkxNTc0OTI2OQ==-flat-describe.py.html,802,google-api-python-client-MDEwOlJlcG9zaXRvcnkxNTc0OTI2OQ==-flat-describe_9.py,google-api-python-client-MDEwOlJlcG9zaXRvcnkxNTc0OTI2OQ==-flat-describe.py,145,291,146,145,291,146
19,https://htmlpreview.github.io/?https://github.com/Christina96/boilerplate-sample-matches/blob/main/Python/esptool-MDEwOlJlcG9zaXRvcnkyMzczNjkxNA==-flat-mem_definition_36.py-esptool-MDEwOlJlcG9zaXRvcnkyMzczNjkxNA==-flat-mem_definition_26.py.html,46,esptool-MDEwOlJlcG9zaXRvcnkyMzczNjkxNA==-flat-mem_definition_36.py,esptool-MDEwOlJlcG9zaXRvcnkyMzczNjkxNA==-flat-mem_definition_26.py,10,20,10,5,15,10
20,https://htmlpreview.github.io/?https://github.com/Christina96/boilerplate-sample-matches/blob/main/Python/google-api-python-client-MDEwOlJlcG9zaXRvcnkxNTc0OTI2OQ==-flat-core_reporting_v3_reference.py-google-api-python-client-MDEwOlJlcG9zaXRvcnkxNTc0OTI2OQ==-flat-core_reporting_v3_reference.py.html,19,google-api-python-client-MDEwOlJlcG9zaXRvcnkxNTc0OTI2OQ==-flat-core_reporting_v3_reference.py,google-api-python-client-MDEwOlJlcG9zaXRvcnkxNTc0OTI2OQ==-flat-core_reporting_v3_reference.py,96,98,2,116,118,2
21,https://htmlpreview.github.io/?https://github.com/Christina96/boilerplate-sample-matches/blob/main/Python/Ultroid-MDEwOlJlcG9zaXRvcnkzNDEwMzg2MDI=-flat-mute.py-Ultroid-MDEwOlJlcG9zaXRvcnkzNDEwMzg2MDI=-flat-admintools.py.html,17,Ultroid-MDEwOlJlcG9zaXRvcnkzNDEwMzg2MDI=-flat-mute.py,Ultroid-MDEwOlJlcG9zaXRvcnkzNDEwMzg2MDI=-flat-admintools.py,90,93,3,203,205,2
22,https://htmlpreview.github.io/?https://github.com/Christina96/boilerplate-sample-matches/blob/main/Python/practical-python-MDEwOlJlcG9zaXRvcnkyNjY2MTM3MDQ=-flat-tableformat_57.py-practical-python-MDEwOlJlcG9zaXRvcnkyNjY2MTM3MDQ=-flat-tableformat_65.py.html,166,practical-python-MDEwOlJlcG9zaXRvcnkyNjY2MTM3MDQ=-flat-tableformat_57.py,practical-python-MDEwOlJlcG9zaXRvcnkyNjY2MTM3MDQ=-flat-tableformat_65.py,20,47,27,20,47,27
23,https://htmlpreview.github.io/?https://github.com/Christina96/boilerplate-sample-matches/blob/main/Python/sonnet-MDEwOlJlcG9zaXRvcnk4NzA2NzIxMg==-flat-axis_norm.py-sonnet-MDEwOlJlcG9zaXRvcnk4NzA2NzIxMg==-flat-group_norm.py.html,17,sonnet-MDEwOlJlcG9zaXRvcnk4NzA2NzIxMg==-flat-axis_norm.py,sonnet-MDEwOlJlcG9zaXRvcnk4NzA2NzIxMg==-flat-group_norm.py,29,33,4,29,34,5
24,https://htmlpreview.github.io/?https://github.com/Christina96/boilerplate-sample-matches/blob/main/Python/esptool-MDEwOlJlcG9zaXRvcnkyMzczNjkxNA==-flat-test_espsecure.py-esptool-MDEwOlJlcG9zaXRvcnkyMzczNjkxNA==-flat-test_imagegen.py.html,13,esptool-MDEwOlJlcG9zaXRvcnkyMzczNjkxNA==-flat-test_espsecure.py,esptool-MDEwOlJlcG9zaXRvcnkyMzczNjkxNA==-flat-test_imagegen.py,769,771,2,222,224,2
25,https://htmlpreview.github.io/?https://github.com/Christina96/boilerplate-sample-matches/blob/main/Python/esptool-MDEwOlJlcG9zaXRvcnkyMzczNjkxNA==-flat-emulate_efuse_controller_39.py-esptool-MDEwOlJlcG9zaXRvcnkyMzczNjkxNA==-flat-emulate_efuse_controller_29.py.html,144,esptool-MDEwOlJlcG9zaXRvcnkyMzczNjkxNA==-flat-emulate_efuse_controller_39.py,esptool-MDEwOlJlcG9zaXRvcnkyMzczNjkxNA==-flat-emulate_efuse_controller_29.py,49,67,18,48,65,17
26,https://htmlpreview.github.io/?https://github.com/Christina96/boilerplate-sample-matches/blob/main/Python/yolact-MDEwOlJlcG9zaXRvcnkxMzg3OTY2OTk=-flat-multibox_loss.py-yolact-MDEwOlJlcG9zaXRvcnkxMzg3OTY2OTk=-flat-multibox_loss.py.html,16,yolact-MDEwOlJlcG9zaXRvcnkxMzg3OTY2OTk=-flat-multibox_loss.py,yolact-MDEwOlJlcG9zaXRvcnkxMzg3OTY2OTk=-flat-multibox_loss.py,393,394,1,358,359,1
27,https://htmlpreview.github.io/?https://github.com/Christina96/boilerplate-sample-matches/blob/main/Python/sonnet-MDEwOlJlcG9zaXRvcnk4NzA2NzIxMg==-flat-distributed_batch_norm_test.py-sonnet-MDEwOlJlcG9zaXRvcnk4NzA2NzIxMg==-flat-batch_norm_test.py.html,83,sonnet-MDEwOlJlcG9zaXRvcnk4NzA2NzIxMg==-flat-distributed_batch_norm_test.py,sonnet-MDEwOlJlcG9zaXRvcnk4NzA2NzIxMg==-flat-batch_norm_test.py,84,98,14,199,213,14
28,https://htmlpreview.github.io/?https://github.com/Christina96/boilerplate-sample-matches/blob/main/Python/yolact-MDEwOlJlcG9zaXRvcnkxMzg3OTY2OTk=-flat-augment_bbox.py-google-api-python-client-MDEwOlJlcG9zaXRvcnkxNTc0OTI2OQ==-flat-_helpers.py.html,12,yolact-MDEwOlJlcG9zaXRvcnkxMzg3OTY2OTk=-flat-augment_bbox.py,google-api-python-client-MDEwOlJlcG9zaXRvcnkxNTc0OTI2OQ==-flat-_helpers.py,11,14,3,14,17,3
29,https://htmlpreview.github.io/?https://github.com/Christina96/boilerplate-sample-matches/blob/main/Python/esptool-MDEwOlJlcG9zaXRvcnkyMzczNjkxNA==-flat-test_espsecure.py-esptool-MDEwOlJlcG9zaXRvcnkyMzczNjkxNA==-flat-test_espsecure.py.html,20,esptool-MDEwOlJlcG9zaXRvcnkyMzczNjkxNA==-flat-test_espsecure.py,esptool-MDEwOlJlcG9zaXRvcnkyMzczNjkxNA==-flat-test_espsecure.py,337,347,10,370,380,10
30,https://htmlpreview.github.io/?https://github.com/Christina96/boilerplate-sample-matches/blob/main/Python/sonnet-MDEwOlJlcG9zaXRvcnk4NzA2NzIxMg==-flat-conv_test.py-sonnet-MDEwOlJlcG9zaXRvcnk4NzA2NzIxMg==-flat-conv_test.py.html,115,sonnet-MDEwOlJlcG9zaXRvcnk4NzA2NzIxMg==-flat-conv_test.py,sonnet-MDEwOlJlcG9zaXRvcnk4NzA2NzIxMg==-flat-conv_test.py,250,262,12,269,281,12
31,https://htmlpreview.github.io/?https://github.com/Christina96/boilerplate-sample-matches/blob/main/Python/yolact-MDEwOlJlcG9zaXRvcnkxMzg3OTY2OTk=-flat-make_grid.py-yolact-MDEwOlJlcG9zaXRvcnkxMzg3OTY2OTk=-flat-make_grid.py.html,25,yolact-MDEwOlJlcG9zaXRvcnkxMzg3OTY2OTk=-flat-make_grid.py,yolact-MDEwOlJlcG9zaXRvcnkxMzg3OTY2OTk=-flat-make_grid.py,48,55,7,56,63,7
32,https://htmlpreview.github.io/?https://github.com/Christina96/boilerplate-sample-matches/blob/main/Python/seq2seq-MDEwOlJlcG9zaXRvcnk4MzczMjgwNg==-flat-attention_decoder.py-seq2seq-MDEwOlJlcG9zaXRvcnk4MzczMjgwNg==-flat-beam_search_decoder.py.html,18,seq2seq-MDEwOlJlcG9zaXRvcnk4MzczMjgwNg==-flat-attention_decoder.py,seq2seq-MDEwOlJlcG9zaXRvcnk4MzczMjgwNg==-flat-beam_search_decoder.py,58,61,3,72,75,3
33,https://htmlpreview.github.io/?https://github.com/Christina96/boilerplate-sample-matches/blob/main/Python/google-api-python-client-MDEwOlJlcG9zaXRvcnkxNTc0OTI2OQ==-flat-describe_9.py-google-api-python-client-MDEwOlJlcG9zaXRvcnkxNTc0OTI2OQ==-flat-describe.py.html,1261,google-api-python-client-MDEwOlJlcG9zaXRvcnkxNTc0OTI2OQ==-flat-describe_9.py,google-api-python-client-MDEwOlJlcG9zaXRvcnkxNTc0OTI2OQ==-flat-describe.py,76,291,215,76,291,215
34,https://htmlpreview.github.io/?https://github.com/Christina96/boilerplate-sample-matches/blob/main/Python/Ultroid-MDEwOlJlcG9zaXRvcnkzNDEwMzg2MDI=-flat-calculator.py-Ultroid-MDEwOlJlcG9zaXRvcnkzNDEwMzg2MDI=-flat-calculator.py.html,13,Ultroid-MDEwOlJlcG9zaXRvcnkzNDEwMzg2MDI=-flat-calculator.py,Ultroid-MDEwOlJlcG9zaXRvcnkzNDEwMzg2MDI=-flat-calculator.py,59,61,2,55,57,2
35,https://htmlpreview.github.io/?https://github.com/Christina96/boilerplate-sample-matches/blob/main/Python/google-api-python-client-MDEwOlJlcG9zaXRvcnkxNTc0OTI2OQ==-flat-model.py-google-api-python-client-MDEwOlJlcG9zaXRvcnkxNTc0OTI2OQ==-flat-model.py.html,18,google-api-python-client-MDEwOlJlcG9zaXRvcnkxNTc0OTI2OQ==-flat-model.py,google-api-python-client-MDEwOlJlcG9zaXRvcnkxNTc0OTI2OQ==-flat-model.py,68,70,2,72,74,2
36,https://htmlpreview.github.io/?https://github.com/Christina96/boilerplate-sample-matches/blob/main/Python/Ultroid-MDEwOlJlcG9zaXRvcnkzNDEwMzg2MDI=-flat-connections.py-Ultroid-MDEwOlJlcG9zaXRvcnkzNDEwMzg2MDI=-flat-connections.py.html,17,Ultroid-MDEwOlJlcG9zaXRvcnkzNDEwMzg2MDI=-flat-connections.py,Ultroid-MDEwOlJlcG9zaXRvcnkzNDEwMzg2MDI=-flat-connections.py,49,52,3,52,55,3
37,https://htmlpreview.github.io/?https://github.com/Christina96/boilerplate-sample-matches/blob/main/Python/wxpy-MDEwOlJlcG9zaXRvcnk4MjU4ODU5Nw==-flat-groups.py-wxpy-MDEwOlJlcG9zaXRvcnk4MjU4ODU5Nw==-flat-messages.py.html,14,wxpy-MDEwOlJlcG9zaXRvcnk4MjU4ODU5Nw==-flat-groups.py,wxpy-MDEwOlJlcG9zaXRvcnk4MjU4ODU5Nw==-flat-messages.py,34,38,4,18,22,4
38,https://htmlpreview.github.io/?https://github.com/Christina96/boilerplate-sample-matches/blob/main/Python/Ultroid-MDEwOlJlcG9zaXRvcnkzNDEwMzg2MDI=-flat-audiotools.py-Ultroid-MDEwOlJlcG9zaXRvcnkzNDEwMzg2MDI=-flat-compressor.py.html,12,Ultroid-MDEwOlJlcG9zaXRvcnkzNDEwMzg2MDI=-flat-audiotools.py,Ultroid-MDEwOlJlcG9zaXRvcnkzNDEwMzg2MDI=-flat-compressor.py,62,65,3,41,44,3
39,https://htmlpreview.github.io/?https://github.com/Christina96/boilerplate-sample-matches/blob/main/Python/practical-python-MDEwOlJlcG9zaXRvcnkyNjY2MTM3MDQ=-flat-report_23.py-practical-python-MDEwOlJlcG9zaXRvcnkyNjY2MTM3MDQ=-flat-report_85.py.html,16,practical-python-MDEwOlJlcG9zaXRvcnkyNjY2MTM3MDQ=-flat-report_23.py,practical-python-MDEwOlJlcG9zaXRvcnkyNjY2MTM3MDQ=-flat-report_85.py,31,33,2,31,33,2
40,https://htmlpreview.github.io/?https://github.com/Christina96/boilerplate-sample-matches/blob/main/Python/esptool-MDEwOlJlcG9zaXRvcnkyMzczNjkxNA==-flat-test_espsecure_hsm.py-esptool-MDEwOlJlcG9zaXRvcnkyMzczNjkxNA==-flat-test_espsecure_hsm.py.html,16,esptool-MDEwOlJlcG9zaXRvcnkyMzczNjkxNA==-flat-test_espsecure_hsm.py,esptool-MDEwOlJlcG9zaXRvcnkyMzczNjkxNA==-flat-test_espsecure_hsm.py,166,169,3,180,183,3
41,https://htmlpreview.github.io/?https://github.com/Christina96/boilerplate-sample-matches/blob/main/Python/sonnet-MDEwOlJlcG9zaXRvcnk4NzA2NzIxMg==-flat-checkpoint_test.py-sonnet-MDEwOlJlcG9zaXRvcnk4NzA2NzIxMg==-flat-distribute_test.py.html,15,sonnet-MDEwOlJlcG9zaXRvcnk4NzA2NzIxMg==-flat-checkpoint_test.py,sonnet-MDEwOlJlcG9zaXRvcnk4NzA2NzIxMg==-flat-distribute_test.py,40,42,2,24,26,2
42,https://htmlpreview.github.io/?https://github.com/Christina96/boilerplate-sample-matches/blob/main/Python/esptool-MDEwOlJlcG9zaXRvcnkyMzczNjkxNA==-flat-test_espefuse.py-esptool-MDEwOlJlcG9zaXRvcnkyMzczNjkxNA==-flat-test_espefuse.py.html,38,esptool-MDEwOlJlcG9zaXRvcnkyMzczNjkxNA==-flat-test_espefuse.py,esptool-MDEwOlJlcG9zaXRvcnkyMzczNjkxNA==-flat-test_espefuse.py,574,591,17,592,609,17
43,https://htmlpreview.github.io/?https://github.com/Christina96/boilerplate-sample-matches/blob/main/Python/esptool-MDEwOlJlcG9zaXRvcnkyMzczNjkxNA==-flat-base_fields.py-esptool-MDEwOlJlcG9zaXRvcnkyMzczNjkxNA==-flat-base_fields.py.html,20,esptool-MDEwOlJlcG9zaXRvcnkyMzczNjkxNA==-flat-base_fields.py,esptool-MDEwOlJlcG9zaXRvcnkyMzczNjkxNA==-flat-base_fields.py,249,254,5,279,284,5
44,https://htmlpreview.github.io/?https://github.com/Christina96/boilerplate-sample-matches/blob/main/Python/practical-python-MDEwOlJlcG9zaXRvcnkyNjY2MTM3MDQ=-flat-fileparse_103.py-practical-python-MDEwOlJlcG9zaXRvcnkyNjY2MTM3MDQ=-flat-fileparse_62.py.html,35,practical-python-MDEwOlJlcG9zaXRvcnkyNjY2MTM3MDQ=-flat-fileparse_103.py,practical-python-MDEwOlJlcG9zaXRvcnkyNjY2MTM3MDQ=-flat-fileparse_62.py,7,12,5,6,11,5
45,https://htmlpreview.github.io/?https://github.com/Christina96/boilerplate-sample-matches/blob/main/Python/Ultroid-MDEwOlJlcG9zaXRvcnkzNDEwMzg2MDI=-flat-pmpermit.py-Ultroid-MDEwOlJlcG9zaXRvcnkzNDEwMzg2MDI=-flat-pmpermit.py.html,16,Ultroid-MDEwOlJlcG9zaXRvcnkzNDEwMzg2MDI=-flat-pmpermit.py,Ultroid-MDEwOlJlcG9zaXRvcnkzNDEwMzg2MDI=-flat-pmpermit.py,672,675,3,618,621,3
46,https://htmlpreview.github.io/?https://github.com/Christina96/boilerplate-sample-matches/blob/main/Python/esptool-MDEwOlJlcG9zaXRvcnkyMzczNjkxNA==-flat-emulate_efuse_controller_14.py-esptool-MDEwOlJlcG9zaXRvcnkyMzczNjkxNA==-flat-emulate_efuse_controller_44.py.html,23,esptool-MDEwOlJlcG9zaXRvcnkyMzczNjkxNA==-flat-emulate_efuse_controller_14.py,esptool-MDEwOlJlcG9zaXRvcnkyMzczNjkxNA==-flat-emulate_efuse_controller_44.py,19,25,6,19,25,6
47,https://htmlpreview.github.io/?https://github.com/Christina96/boilerplate-sample-matches/blob/main/Python/esptool-MDEwOlJlcG9zaXRvcnkyMzczNjkxNA==-flat-operations_12.py-esptool-MDEwOlJlcG9zaXRvcnkyMzczNjkxNA==-flat-operations_17.py.html,282,esptool-MDEwOlJlcG9zaXRvcnkyMzczNjkxNA==-flat-operations_12.py,esptool-MDEwOlJlcG9zaXRvcnkyMzczNjkxNA==-flat-operations_17.py,401,439,38,320,358,38
48,https://htmlpreview.github.io/?https://github.com/Christina96/boilerplate-sample-matches/blob/main/Python/Ultroid-MDEwOlJlcG9zaXRvcnkzNDEwMzg2MDI=-flat-mediatools.py-Ultroid-MDEwOlJlcG9zaXRvcnkzNDEwMzg2MDI=-flat-asstcmd.py.html,15,Ultroid-MDEwOlJlcG9zaXRvcnkzNDEwMzg2MDI=-flat-mediatools.py,Ultroid-MDEwOlJlcG9zaXRvcnkzNDEwMzg2MDI=-flat-asstcmd.py,27,29,2,21,23,2
49,https://htmlpreview.github.io/?https://github.com/Christina96/boilerplate-sample-matches/blob/main/Python/practical-python-MDEwOlJlcG9zaXRvcnkyNjY2MTM3MDQ=-flat-ticker_53.py-practical-python-MDEwOlJlcG9zaXRvcnkyNjY2MTM3MDQ=-flat-ticker_92.py.html,80,practical-python-MDEwOlJlcG9zaXRvcnkyNjY2MTM3MDQ=-flat-ticker_53.py,practical-python-MDEwOlJlcG9zaXRvcnkyNjY2MTM3MDQ=-flat-ticker_92.py,26,35,9,25,34,9
50,https://htmlpreview.github.io/?https://github.com/Christina96/boilerplate-sample-matches/blob/main/Python/sonnet-MDEwOlJlcG9zaXRvcnk4NzA2NzIxMg==-flat-recurrent_test.py-sonnet-MDEwOlJlcG9zaXRvcnk4NzA2NzIxMg==-flat-recurrent_test.py.html,22,sonnet-MDEwOlJlcG9zaXRvcnk4NzA2NzIxMg==-flat-recurrent_test.py,sonnet-MDEwOlJlcG9zaXRvcnk4NzA2NzIxMg==-flat-recurrent_test.py,299,300,1,302,303,1
51,https://htmlpreview.github.io/?https://github.com/Christina96/boilerplate-sample-matches/blob/main/Python/esptool-MDEwOlJlcG9zaXRvcnkyMzczNjkxNA==-flat-bin_image.py-esptool-MDEwOlJlcG9zaXRvcnkyMzczNjkxNA==-flat-bin_image.py.html,23,esptool-MDEwOlJlcG9zaXRvcnkyMzczNjkxNA==-flat-bin_image.py,esptool-MDEwOlJlcG9zaXRvcnkyMzczNjkxNA==-flat-bin_image.py,407,410,3,569,572,3
52,https://htmlpreview.github.io/?https://github.com/Christina96/boilerplate-sample-matches/blob/main/Python/Ultroid-MDEwOlJlcG9zaXRvcnkzNDEwMzg2MDI=-flat-_database.py-Ultroid-MDEwOlJlcG9zaXRvcnkzNDEwMzg2MDI=-flat-_database.py.html,12,Ultroid-MDEwOlJlcG9zaXRvcnkzNDEwMzg2MDI=-flat-_database.py,Ultroid-MDEwOlJlcG9zaXRvcnkzNDEwMzg2MDI=-flat-_database.py,44,45,1,171,172,1
53,https://htmlpreview.github.io/?https://github.com/Christina96/boilerplate-sample-matches/blob/main/Python/google-api-python-client-MDEwOlJlcG9zaXRvcnkxNTc0OTI2OQ==-flat-describe_9.py-google-api-python-client-MDEwOlJlcG9zaXRvcnkxNTc0OTI2OQ==-flat-describe.py.html,1323,google-api-python-client-MDEwOlJlcG9zaXRvcnkxNTc0OTI2OQ==-flat-describe_9.py,google-api-python-client-MDEwOlJlcG9zaXRvcnkxNTc0OTI2OQ==-flat-describe.py,64,291,227,64,291,227
54,https://htmlpreview.github.io/?https://github.com/Christina96/boilerplate-sample-matches/blob/main/Python/sonnet-MDEwOlJlcG9zaXRvcnk4NzA2NzIxMg==-flat-base_test.py-sonnet-MDEwOlJlcG9zaXRvcnk4NzA2NzIxMg==-flat-base_test.py.html,34,sonnet-MDEwOlJlcG9zaXRvcnk4NzA2NzIxMg==-flat-base_test.py,sonnet-MDEwOlJlcG9zaXRvcnk4NzA2NzIxMg==-flat-base_test.py,69,74,5,75,80,5
55,https://htmlpreview.github.io/?https://github.com/Christina96/boilerplate-sample-matches/blob/main/Python/esptool-MDEwOlJlcG9zaXRvcnkyMzczNjkxNA==-flat-bin_image.py-esptool-MDEwOlJlcG9zaXRvcnkyMzczNjkxNA==-flat-bin_image.py.html,12,esptool-MDEwOlJlcG9zaXRvcnkyMzczNjkxNA==-flat-bin_image.py,esptool-MDEwOlJlcG9zaXRvcnkyMzczNjkxNA==-flat-bin_image.py,437,442,5,588,593,5
56,https://htmlpreview.github.io/?https://github.com/Christina96/boilerplate-sample-matches/blob/main/Python/esptool-MDEwOlJlcG9zaXRvcnkyMzczNjkxNA==-flat-fields_15.py-esptool-MDEwOlJlcG9zaXRvcnkyMzczNjkxNA==-flat-fields_40.py.html,76,esptool-MDEwOlJlcG9zaXRvcnkyMzczNjkxNA==-flat-fields_15.py,esptool-MDEwOlJlcG9zaXRvcnkyMzczNjkxNA==-flat-fields_40.py,180,192,12,180,192,12
57,https://htmlpreview.github.io/?https://github.com/Christina96/boilerplate-sample-matches/blob/main/Python/yolact-MDEwOlJlcG9zaXRvcnkxMzg3OTY2OTk=-flat-coco.py-yolact-MDEwOlJlcG9zaXRvcnkxMzg3OTY2OTk=-flat-coco.py.html,16,yolact-MDEwOlJlcG9zaXRvcnkxMzg3OTY2OTk=-flat-coco.py,yolact-MDEwOlJlcG9zaXRvcnkxMzg3OTY2OTk=-flat-coco.py,133,134,1,132,133,1
58,https://htmlpreview.github.io/?https://github.com/Christina96/boilerplate-sample-matches/blob/main/Python/esptool-MDEwOlJlcG9zaXRvcnkyMzczNjkxNA==-flat-test_espsecure.py-esptool-MDEwOlJlcG9zaXRvcnkyMzczNjkxNA==-flat-test_espsecure.py.html,28,esptool-MDEwOlJlcG9zaXRvcnkyMzczNjkxNA==-flat-test_espsecure.py,esptool-MDEwOlJlcG9zaXRvcnkyMzczNjkxNA==-flat-test_espsecure.py,168,177,9,114,123,9
59,https://htmlpreview.github.io/?https://github.com/Christina96/boilerplate-sample-matches/blob/main/Python/seq2seq-MDEwOlJlcG9zaXRvcnk4MzczMjgwNg==-flat-model_base.py-seq2seq-MDEwOlJlcG9zaXRvcnk4MzczMjgwNg==-flat-pipeline_test.py.html,12,seq2seq-MDEwOlJlcG9zaXRvcnk4MzczMjgwNg==-flat-model_base.py,seq2seq-MDEwOlJlcG9zaXRvcnk4MzczMjgwNg==-flat-pipeline_test.py,61,62,1,33,34,1
60,https://htmlpreview.github.io/?https://github.com/Christina96/boilerplate-sample-matches/blob/main/Python/yolact-MDEwOlJlcG9zaXRvcnkxMzg3OTY2OTk=-flat-detection.py-yolact-MDEwOlJlcG9zaXRvcnkxMzg3OTY2OTk=-flat-detection.py.html,12,yolact-MDEwOlJlcG9zaXRvcnkxMzg3OTY2OTk=-flat-detection.py,yolact-MDEwOlJlcG9zaXRvcnkxMzg3OTY2OTk=-flat-detection.py,23,24,1,24,25,1
61,https://htmlpreview.github.io/?https://github.com/Christina96/boilerplate-sample-matches/blob/main/Python/cookiecutter-pypackage-MDEwOlJlcG9zaXRvcnkxMTQwNzU2Nw==-flat-test_{{cookiecutter.project_slug}}.py-cookiecutter-pypackage-MDEwOlJlcG9zaXRvcnkxMTQwNzU2Nw==-flat-test_bake_project.py.html,16,cookiecutter-pypackage-MDEwOlJlcG9zaXRvcnkxMTQwNzU2Nw==-flat-test_{{cookiecutter.project_slug}}.py,cookiecutter-pypackage-MDEwOlJlcG9zaXRvcnkxMTQwNzU2Nw==-flat-test_bake_project.py,68,70,2,192,194,2
62,https://htmlpreview.github.io/?https://github.com/Christina96/boilerplate-sample-matches/blob/main/Python/cookiecutter-pypackage-MDEwOlJlcG9zaXRvcnkxMTQwNzU2Nw==-flat-conf.py-esptool-MDEwOlJlcG9zaXRvcnkyMzczNjkxNA==-flat-conf.py.html,19,cookiecutter-pypackage-MDEwOlJlcG9zaXRvcnkxMTQwNzU2Nw==-flat-conf.py,esptool-MDEwOlJlcG9zaXRvcnkyMzczNjkxNA==-flat-conf.py,3,5,2,6,8,2
63,https://htmlpreview.github.io/?https://github.com/Christina96/boilerplate-sample-matches/blob/main/Python/esptool-MDEwOlJlcG9zaXRvcnkyMzczNjkxNA==-flat-esp32c2.py-esptool-MDEwOlJlcG9zaXRvcnkyMzczNjkxNA==-flat-esp32c3.py.html,16,esptool-MDEwOlJlcG9zaXRvcnkyMzczNjkxNA==-flat-esp32c2.py,esptool-MDEwOlJlcG9zaXRvcnkyMzczNjkxNA==-flat-esp32c3.py,10,14,4,19,22,3
64,https://htmlpreview.github.io/?https://github.com/Christina96/boilerplate-sample-matches/blob/main/Python/Ultroid-MDEwOlJlcG9zaXRvcnkzNDEwMzg2MDI=-flat-channelhacks.py-Ultroid-MDEwOlJlcG9zaXRvcnkzNDEwMzg2MDI=-flat-devtools.py.html,13,Ultroid-MDEwOlJlcG9zaXRvcnkzNDEwMzg2MDI=-flat-channelhacks.py,Ultroid-MDEwOlJlcG9zaXRvcnkzNDEwMzg2MDI=-flat-devtools.py,187,191,4,139,143,4
65,https://htmlpreview.github.io/?https://github.com/Christina96/boilerplate-sample-matches/blob/main/Python/Ultroid-MDEwOlJlcG9zaXRvcnkzNDEwMzg2MDI=-flat-loader_1.py-Ultroid-MDEwOlJlcG9zaXRvcnkzNDEwMzg2MDI=-flat-loader_1.py.html,12,Ultroid-MDEwOlJlcG9zaXRvcnkzNDEwMzg2MDI=-flat-loader_1.py,Ultroid-MDEwOlJlcG9zaXRvcnkzNDEwMzg2MDI=-flat-loader_1.py,70,71,1,72,73,1
66,https://htmlpreview.github.io/?https://github.com/Christina96/boilerplate-sample-matches/blob/main/Python/esptool-MDEwOlJlcG9zaXRvcnkyMzczNjkxNA==-flat-util_48.py-practical-python-MDEwOlJlcG9zaXRvcnkyNjY2MTM3MDQ=-flat-pcost_5.py.html,13,esptool-MDEwOlJlcG9zaXRvcnkyMzczNjkxNA==-flat-util_48.py,practical-python-MDEwOlJlcG9zaXRvcnkyNjY2MTM3MDQ=-flat-pcost_5.py,43,45,2,3,5,2
67,https://htmlpreview.github.io/?https://github.com/Christina96/boilerplate-sample-matches/blob/main/Python/esptool-MDEwOlJlcG9zaXRvcnkyMzczNjkxNA==-flat-operations_42.py-esptool-MDEwOlJlcG9zaXRvcnkyMzczNjkxNA==-flat-operations_22.py.html,17,esptool-MDEwOlJlcG9zaXRvcnkyMzczNjkxNA==-flat-operations_42.py,esptool-MDEwOlJlcG9zaXRvcnkyMzczNjkxNA==-flat-operations_22.py,407,410,3,328,331,3
68,https://htmlpreview.github.io/?https://github.com/Christina96/boilerplate-sample-matches/blob/main/Python/esptool-MDEwOlJlcG9zaXRvcnkyMzczNjkxNA==-flat-__init__.py-esptool-MDEwOlJlcG9zaXRvcnkyMzczNjkxNA==-flat-__init__.py.html,12,esptool-MDEwOlJlcG9zaXRvcnkyMzczNjkxNA==-flat-__init__.py,esptool-MDEwOlJlcG9zaXRvcnkyMzczNjkxNA==-flat-__init__.py,363,367,4,418,422,4
69,https://htmlpreview.github.io/?https://github.com/Christina96/boilerplate-sample-matches/blob/main/Python/sonnet-MDEwOlJlcG9zaXRvcnk4NzA2NzIxMg==-flat-batch_norm_test.py-sonnet-MDEwOlJlcG9zaXRvcnk4NzA2NzIxMg==-flat-batch_norm_test.py.html,37,sonnet-MDEwOlJlcG9zaXRvcnk4NzA2NzIxMg==-flat-batch_norm_test.py,sonnet-MDEwOlJlcG9zaXRvcnk4NzA2NzIxMg==-flat-batch_norm_test.py,43,45,2,31,33,2
70,https://htmlpreview.github.io/?https://github.com/Christina96/boilerplate-sample-matches/blob/main/Python/Ultroid-MDEwOlJlcG9zaXRvcnkzNDEwMzg2MDI=-flat-tools.py-Ultroid-MDEwOlJlcG9zaXRvcnkzNDEwMzg2MDI=-flat-ytdl.py.html,18,Ultroid-MDEwOlJlcG9zaXRvcnkzNDEwMzg2MDI=-flat-tools.py,Ultroid-MDEwOlJlcG9zaXRvcnkzNDEwMzg2MDI=-flat-ytdl.py,333,339,6,180,186,6
71,https://htmlpreview.github.io/?https://github.com/Christina96/boilerplate-sample-matches/blob/main/Python/sonnet-MDEwOlJlcG9zaXRvcnk4NzA2NzIxMg==-flat-bias_test.py-sonnet-MDEwOlJlcG9zaXRvcnk4NzA2NzIxMg==-flat-bias_test.py.html,27,sonnet-MDEwOlJlcG9zaXRvcnk4NzA2NzIxMg==-flat-bias_test.py,sonnet-MDEwOlJlcG9zaXRvcnk4NzA2NzIxMg==-flat-bias_test.py,36,38,2,46,48,2
72,https://htmlpreview.github.io/?https://github.com/Christina96/boilerplate-sample-matches/blob/main/Python/esptool-MDEwOlJlcG9zaXRvcnkyMzczNjkxNA==-flat-esp32s3.py-esptool-MDEwOlJlcG9zaXRvcnkyMzczNjkxNA==-flat-esp32s2.py.html,27,esptool-MDEwOlJlcG9zaXRvcnkyMzczNjkxNA==-flat-esp32s3.py,esptool-MDEwOlJlcG9zaXRvcnkyMzczNjkxNA==-flat-esp32s2.py,233,237,4,222,226,4
73,https://htmlpreview.github.io/?https://github.com/Christina96/boilerplate-sample-matches/blob/main/Python/Ultroid-MDEwOlJlcG9zaXRvcnkzNDEwMzg2MDI=-flat-utilities.py-Ultroid-MDEwOlJlcG9zaXRvcnkzNDEwMzg2MDI=-flat-downloadupload.py.html,12,Ultroid-MDEwOlJlcG9zaXRvcnkzNDEwMzg2MDI=-flat-utilities.py,Ultroid-MDEwOlJlcG9zaXRvcnkzNDEwMzg2MDI=-flat-downloadupload.py,465,468,3,35,38,3
74,https://htmlpreview.github.io/?https://github.com/Christina96/boilerplate-sample-matches/blob/main/Python/esptool-MDEwOlJlcG9zaXRvcnkyMzczNjkxNA==-flat-loader.py-esptool-MDEwOlJlcG9zaXRvcnkyMzczNjkxNA==-flat-loader.py.html,26,esptool-MDEwOlJlcG9zaXRvcnkyMzczNjkxNA==-flat-loader.py,esptool-MDEwOlJlcG9zaXRvcnkyMzczNjkxNA==-flat-loader.py,591,593,2,737,739,2
75,https://htmlpreview.github.io/?https://github.com/Christina96/boilerplate-sample-matches/blob/main/Python/Ultroid-MDEwOlJlcG9zaXRvcnkzNDEwMzg2MDI=-flat-_help_11.py-Ultroid-MDEwOlJlcG9zaXRvcnkzNDEwMzg2MDI=-flat-_help_11.py.html,13,Ultroid-MDEwOlJlcG9zaXRvcnkzNDEwMzg2MDI=-flat-_help_11.py,Ultroid-MDEwOlJlcG9zaXRvcnkzNDEwMzg2MDI=-flat-_help_11.py,48,51,3,90,93,3
76,https://htmlpreview.github.io/?https://github.com/Christina96/boilerplate-sample-matches/blob/main/Python/esptool-MDEwOlJlcG9zaXRvcnkyMzczNjkxNA==-flat-execute_efuse_script.py-esptool-MDEwOlJlcG9zaXRvcnkyMzczNjkxNA==-flat-execute_efuse_script_45.py.html,24,esptool-MDEwOlJlcG9zaXRvcnkyMzczNjkxNA==-flat-execute_efuse_script.py,esptool-MDEwOlJlcG9zaXRvcnkyMzczNjkxNA==-flat-execute_efuse_script_45.py,30,32,2,40,42,2
77,https://htmlpreview.github.io/?https://github.com/Christina96/boilerplate-sample-matches/blob/main/Python/seq2seq-MDEwOlJlcG9zaXRvcnk4MzczMjgwNg==-flat-utils.py-sonnet-MDEwOlJlcG9zaXRvcnk4NzA2NzIxMg==-flat-resnet_7.py.html,12,seq2seq-MDEwOlJlcG9zaXRvcnk4MzczMjgwNg==-flat-utils.py,sonnet-MDEwOlJlcG9zaXRvcnk4NzA2NzIxMg==-flat-resnet_7.py,54,57,3,100,103,3
78,https://htmlpreview.github.io/?https://github.com/Christina96/boilerplate-sample-matches/blob/main/Python/Ultroid-MDEwOlJlcG9zaXRvcnkzNDEwMzg2MDI=-flat-calculator.py-Ultroid-MDEwOlJlcG9zaXRvcnkzNDEwMzg2MDI=-flat-games.py.html,21,Ultroid-MDEwOlJlcG9zaXRvcnkzNDEwMzg2MDI=-flat-calculator.py,Ultroid-MDEwOlJlcG9zaXRvcnkzNDEwMzg2MDI=-flat-games.py,5,14,9,119,128,9
79,https://htmlpreview.github.io/?https://github.com/Christina96/boilerplate-sample-matches/blob/main/Python/google-api-python-client-MDEwOlJlcG9zaXRvcnkxNTc0OTI2OQ==-flat-generate_report.py-google-api-python-client-MDEwOlJlcG9zaXRvcnkxNTc0OTI2OQ==-flat-get_all_custom_channels_for_ad_unit.py.html,17,google-api-python-client-MDEwOlJlcG9zaXRvcnkxNTc0OTI2OQ==-flat-generate_report.py,google-api-python-client-MDEwOlJlcG9zaXRvcnkxNTc0OTI2OQ==-flat-get_all_custom_channels_for_ad_unit.py,21,26,5,24,29,5
80,https://htmlpreview.github.io/?https://github.com/Christina96/boilerplate-sample-matches/blob/main/Python/esptool-MDEwOlJlcG9zaXRvcnkyMzczNjkxNA==-flat-bin_image.py-esptool-MDEwOlJlcG9zaXRvcnkyMzczNjkxNA==-flat-bin_image.py.html,31,esptool-MDEwOlJlcG9zaXRvcnkyMzczNjkxNA==-flat-bin_image.py,esptool-MDEwOlJlcG9zaXRvcnkyMzczNjkxNA==-flat-bin_image.py,461,464,3,489,492,3
81,https://htmlpreview.github.io/?https://github.com/Christina96/boilerplate-sample-matches/blob/main/Python/google-api-python-client-MDEwOlJlcG9zaXRvcnkxNTc0OTI2OQ==-flat-test_json_model.py-wxpy-MDEwOlJlcG9zaXRvcnk4MjU4ODU5Nw==-flat-test_bot.py.html,15,google-api-python-client-MDEwOlJlcG9zaXRvcnkxNTc0OTI2OQ==-flat-test_json_model.py,wxpy-MDEwOlJlcG9zaXRvcnk4MjU4ODU5Nw==-flat-test_bot.py,122,125,3,53,56,3
82,https://htmlpreview.github.io/?https://github.com/Christina96/boilerplate-sample-matches/blob/main/Python/esptool-MDEwOlJlcG9zaXRvcnkyMzczNjkxNA==-flat-operations_42.py-esptool-MDEwOlJlcG9zaXRvcnkyMzczNjkxNA==-flat-operations_32.py.html,15,esptool-MDEwOlJlcG9zaXRvcnkyMzczNjkxNA==-flat-operations_42.py,esptool-MDEwOlJlcG9zaXRvcnkyMzczNjkxNA==-flat-operations_32.py,33,41,8,23,31,8
83,https://htmlpreview.github.io/?https://github.com/Christina96/boilerplate-sample-matches/blob/main/Python/esptool-MDEwOlJlcG9zaXRvcnkyMzczNjkxNA==-flat-fields_20.py-esptool-MDEwOlJlcG9zaXRvcnkyMzczNjkxNA==-flat-fields.py.html,25,esptool-MDEwOlJlcG9zaXRvcnkyMzczNjkxNA==-flat-fields_20.py,esptool-MDEwOlJlcG9zaXRvcnkyMzczNjkxNA==-flat-fields.py,39,45,6,52,58,6
84,https://htmlpreview.github.io/?https://github.com/Christina96/boilerplate-sample-matches/blob/main/Python/seq2seq-MDEwOlJlcG9zaXRvcnk4MzczMjgwNg==-flat-decoder_test.py-seq2seq-MDEwOlJlcG9zaXRvcnk4MzczMjgwNg==-flat-decoder_test.py.html,20,seq2seq-MDEwOlJlcG9zaXRvcnk4MzczMjgwNg==-flat-decoder_test.py,seq2seq-MDEwOlJlcG9zaXRvcnk4MzczMjgwNg==-flat-decoder_test.py,35,37,2,76,78,2
85,https://htmlpreview.github.io/?https://github.com/Christina96/boilerplate-sample-matches/blob/main/Python/yolact-MDEwOlJlcG9zaXRvcnkxMzg3OTY2OTk=-flat-optimize_bboxes.py-yolact-MDEwOlJlcG9zaXRvcnkxMzg3OTY2OTk=-flat-bbox_recall.py.html,27,yolact-MDEwOlJlcG9zaXRvcnkxMzg3OTY2OTk=-flat-optimize_bboxes.py,yolact-MDEwOlJlcG9zaXRvcnkxMzg3OTY2OTk=-flat-bbox_recall.py,44,45,1,45,47,2
86,https://htmlpreview.github.io/?https://github.com/Christina96/boilerplate-sample-matches/blob/main/Python/esptool-MDEwOlJlcG9zaXRvcnkyMzczNjkxNA==-flat-__init__.py-esptool-MDEwOlJlcG9zaXRvcnkyMzczNjkxNA==-flat-__init__.py.html,67,esptool-MDEwOlJlcG9zaXRvcnkyMzczNjkxNA==-flat-__init__.py,esptool-MDEwOlJlcG9zaXRvcnkyMzczNjkxNA==-flat-__init__.py,176,191,15,195,210,15
87,https://htmlpreview.github.io/?https://github.com/Christina96/boilerplate-sample-matches/blob/main/Python/esphome-docs-MDEwOlJlcG9zaXRvcnkxMzMyMjM0NjE=-flat-schema_doc.py-Ultroid-MDEwOlJlcG9zaXRvcnkzNDEwMzg2MDI=-flat-tools_13.py.html,12,esphome-docs-MDEwOlJlcG9zaXRvcnkxMzMyMjM0NjE=-flat-schema_doc.py,Ultroid-MDEwOlJlcG9zaXRvcnkzNDEwMzg2MDI=-flat-tools_13.py,780,782,2,208,210,2
88,https://htmlpreview.github.io/?https://github.com/Christina96/boilerplate-sample-matches/blob/main/Python/sonnet-MDEwOlJlcG9zaXRvcnk4NzA2NzIxMg==-flat-recurrent_test.py-Ultroid-MDEwOlJlcG9zaXRvcnkzNDEwMzg2MDI=-flat-info.py.html,14,sonnet-MDEwOlJlcG9zaXRvcnk4NzA2NzIxMg==-flat-recurrent_test.py,Ultroid-MDEwOlJlcG9zaXRvcnkzNDEwMzg2MDI=-flat-info.py,376,378,2,89,91,2
89,https://htmlpreview.github.io/?https://github.com/Christina96/boilerplate-sample-matches/blob/main/Python/esptool-MDEwOlJlcG9zaXRvcnkyMzczNjkxNA==-flat-mem_definition_41.py-esptool-MDEwOlJlcG9zaXRvcnkyMzczNjkxNA==-flat-mem_definition_11.py.html,15,esptool-MDEwOlJlcG9zaXRvcnkyMzczNjkxNA==-flat-mem_definition_41.py,esptool-MDEwOlJlcG9zaXRvcnkyMzczNjkxNA==-flat-mem_definition_11.py,118,121,3,146,149,3
90,https://htmlpreview.github.io/?https://github.com/Christina96/boilerplate-sample-matches/blob/main/Python/google-api-python-client-MDEwOlJlcG9zaXRvcnkxNTc0OTI2OQ==-flat-describe_9.py-google-api-python-client-MDEwOlJlcG9zaXRvcnkxNTc0OTI2OQ==-flat-describe.py.html,868,google-api-python-client-MDEwOlJlcG9zaXRvcnkxNTc0OTI2OQ==-flat-describe_9.py,google-api-python-client-MDEwOlJlcG9zaXRvcnkxNTc0OTI2OQ==-flat-describe.py,134,291,157,134,291,157
91,https://htmlpreview.github.io/?https://github.com/Christina96/boilerplate-sample-matches/blob/main/Python/yolact-MDEwOlJlcG9zaXRvcnkxMzg3OTY2OTk=-flat-yolact.py-yolact-MDEwOlJlcG9zaXRvcnkxMzg3OTY2OTk=-flat-box_utils.py.html,20,yolact-MDEwOlJlcG9zaXRvcnkxMzg3OTY2OTk=-flat-yolact.py,yolact-MDEwOlJlcG9zaXRvcnkxMzg3OTY2OTk=-flat-box_utils.py,103,105,2,68,70,2
92,https://htmlpreview.github.io/?https://github.com/Christina96/boilerplate-sample-matches/blob/main/Python/yolact-MDEwOlJlcG9zaXRvcnkxMzg3OTY2OTk=-flat-coco.py-yolact-MDEwOlJlcG9zaXRvcnkxMzg3OTY2OTk=-flat-coco.py.html,16,yolact-MDEwOlJlcG9zaXRvcnkxMzg3OTY2OTk=-flat-coco.py,yolact-MDEwOlJlcG9zaXRvcnkxMzg3OTY2OTk=-flat-coco.py,69,70,1,101,102,1
93,https://htmlpreview.github.io/?https://github.com/Christina96/boilerplate-sample-matches/blob/main/Python/wxpy-MDEwOlJlcG9zaXRvcnk4MjU4ODU5Nw==-flat-test_bot.py-wxpy-MDEwOlJlcG9zaXRvcnk4MjU4ODU5Nw==-flat-test_bot.py.html,14,wxpy-MDEwOlJlcG9zaXRvcnk4MjU4ODU5Nw==-flat-test_bot.py,wxpy-MDEwOlJlcG9zaXRvcnk4MjU4ODU5Nw==-flat-test_bot.py,27,29,2,39,41,2
94,https://htmlpreview.github.io/?https://github.com/Christina96/boilerplate-sample-matches/blob/main/Python/esptool-MDEwOlJlcG9zaXRvcnkyMzczNjkxNA==-flat-test_esptool.py-esptool-MDEwOlJlcG9zaXRvcnkyMzczNjkxNA==-flat-test_esptool.py.html,22,esptool-MDEwOlJlcG9zaXRvcnkyMzczNjkxNA==-flat-test_esptool.py,esptool-MDEwOlJlcG9zaXRvcnkyMzczNjkxNA==-flat-test_esptool.py,270,272,2,732,734,2
95,https://htmlpreview.github.io/?https://github.com/Christina96/boilerplate-sample-matches/blob/main/Python/yolact-MDEwOlJlcG9zaXRvcnkxMzg3OTY2OTk=-flat-run_coco_eval.py-yolact-MDEwOlJlcG9zaXRvcnkxMzg3OTY2OTk=-flat-run_coco_eval.py.html,25,yolact-MDEwOlJlcG9zaXRvcnkxMzg3OTY2OTk=-flat-run_coco_eval.py,yolact-MDEwOlJlcG9zaXRvcnkxMzg3OTY2OTk=-flat-run_coco_eval.py,21,25,4,27,30,3
96,https://htmlpreview.github.io/?https://github.com/Christina96/boilerplate-sample-matches/blob/main/Python/Ultroid-MDEwOlJlcG9zaXRvcnkzNDEwMzg2MDI=-flat-echo.py-Ultroid-MDEwOlJlcG9zaXRvcnkzNDEwMzg2MDI=-flat-inlinestuff.py.html,14,Ultroid-MDEwOlJlcG9zaXRvcnkzNDEwMzg2MDI=-flat-echo.py,Ultroid-MDEwOlJlcG9zaXRvcnkzNDEwMzg2MDI=-flat-inlinestuff.py,33,35,2,313,315,2
97,https://htmlpreview.github.io/?https://github.com/Christina96/boilerplate-sample-matches/blob/main/Python/esptool-MDEwOlJlcG9zaXRvcnkyMzczNjkxNA==-flat-esp32s3.py-esptool-MDEwOlJlcG9zaXRvcnkyMzczNjkxNA==-flat-esp32s2.py.html,110,esptool-MDEwOlJlcG9zaXRvcnkyMzczNjkxNA==-flat-esp32s3.py,esptool-MDEwOlJlcG9zaXRvcnkyMzczNjkxNA==-flat-esp32s2.py,220,237,17,209,226,17
98,https://htmlpreview.github.io/?https://github.com/Christina96/boilerplate-sample-matches/blob/main/Python/Ultroid-MDEwOlJlcG9zaXRvcnkzNDEwMzg2MDI=-flat-sudo.py-Ultroid-MDEwOlJlcG9zaXRvcnkzNDEwMzg2MDI=-flat-sudo.py.html,38,Ultroid-MDEwOlJlcG9zaXRvcnkzNDEwMzg2MDI=-flat-sudo.py,Ultroid-MDEwOlJlcG9zaXRvcnkzNDEwMzg2MDI=-flat-sudo.py,22,28,6,60,66,6
99,https://htmlpreview.github.io/?https://github.com/Christina96/boilerplate-sample-matches/blob/main/Python/sonnet-MDEwOlJlcG9zaXRvcnk4NzA2NzIxMg==-flat-vqvae.py-sonnet-MDEwOlJlcG9zaXRvcnk4NzA2NzIxMg==-flat-vqvae.py.html,121,sonnet-MDEwOlJlcG9zaXRvcnk4NzA2NzIxMg==-flat-vqvae.py,sonnet-MDEwOlJlcG9zaXRvcnk4NzA2NzIxMg==-flat-vqvae.py,24,34,10,81,91,10
100,https://htmlpreview.github.io/?https://github.com/Christina96/boilerplate-sample-matches/blob/main/Python/yolact-MDEwOlJlcG9zaXRvcnkxMzg3OTY2OTk=-flat-logger.py-yolact-MDEwOlJlcG9zaXRvcnkxMzg3OTY2OTk=-flat-logger.py.html,28,yolact-MDEwOlJlcG9zaXRvcnkxMzg3OTY2OTk=-flat-logger.py,yolact-MDEwOlJlcG9zaXRvcnkxMzg3OTY2OTk=-flat-logger.py,51,54,3,66,69,3
101,https://htmlpreview.github.io/?https://github.com/Christina96/boilerplate-sample-matches/blob/main/Python/Ultroid-MDEwOlJlcG9zaXRvcnkzNDEwMzg2MDI=-flat-ytdl.py-Ultroid-MDEwOlJlcG9zaXRvcnkzNDEwMzg2MDI=-flat-ytdl.py.html,17,Ultroid-MDEwOlJlcG9zaXRvcnkzNDEwMzg2MDI=-flat-ytdl.py,Ultroid-MDEwOlJlcG9zaXRvcnkzNDEwMzg2MDI=-flat-ytdl.py,150,155,5,173,178,5
102,https://htmlpreview.github.io/?https://github.com/Christina96/boilerplate-sample-matches/blob/main/Python/sonnet-MDEwOlJlcG9zaXRvcnk4NzA2NzIxMg==-flat-once_test.py-sonnet-MDEwOlJlcG9zaXRvcnk4NzA2NzIxMg==-flat-once_test.py.html,13,sonnet-MDEwOlJlcG9zaXRvcnk4NzA2NzIxMg==-flat-once_test.py,sonnet-MDEwOlJlcG9zaXRvcnk4NzA2NzIxMg==-flat-once_test.py,12,14,2,65,67,2
103,https://htmlpreview.github.io/?https://github.com/Christina96/boilerplate-sample-matches/blob/main/Python/Ultroid-MDEwOlJlcG9zaXRvcnkzNDEwMzg2MDI=-flat-_help_11.py-Ultroid-MDEwOlJlcG9zaXRvcnkzNDEwMzg2MDI=-flat-_wspr.py.html,47,Ultroid-MDEwOlJlcG9zaXRvcnkzNDEwMzg2MDI=-flat-_help_11.py,Ultroid-MDEwOlJlcG9zaXRvcnkzNDEwMzg2MDI=-flat-_wspr.py,118,123,5,36,41,5
104,https://htmlpreview.github.io/?https://github.com/Christina96/boilerplate-sample-matches/blob/main/Python/esptool-MDEwOlJlcG9zaXRvcnkyMzczNjkxNA==-flat-esp32s2.py-esptool-MDEwOlJlcG9zaXRvcnkyMzczNjkxNA==-flat-esp32h2beta1.py.html,15,esptool-MDEwOlJlcG9zaXRvcnkyMzczNjkxNA==-flat-esp32s2.py,esptool-MDEwOlJlcG9zaXRvcnkyMzczNjkxNA==-flat-esp32h2beta1.py,44,47,3,40,43,3
105,https://htmlpreview.github.io/?https://github.com/Christina96/boilerplate-sample-matches/blob/main/Python/sonnet-MDEwOlJlcG9zaXRvcnk4NzA2NzIxMg==-flat-checkpoint_test.py-esptool-MDEwOlJlcG9zaXRvcnkyMzczNjkxNA==-flat-test_imagegen.py.html,14,sonnet-MDEwOlJlcG9zaXRvcnk4NzA2NzIxMg==-flat-checkpoint_test.py,esptool-MDEwOlJlcG9zaXRvcnkyMzczNjkxNA==-flat-test_imagegen.py,16,18,2,143,144,1
106,https://htmlpreview.github.io/?https://github.com/Christina96/boilerplate-sample-matches/blob/main/Python/google-api-python-client-MDEwOlJlcG9zaXRvcnkxNTc0OTI2OQ==-flat-describe_9.py-sonnet-MDEwOlJlcG9zaXRvcnk4NzA2NzIxMg==-flat-momentum.py.html,18,google-api-python-client-MDEwOlJlcG9zaXRvcnkxNTc0OTI2OQ==-flat-describe_9.py,sonnet-MDEwOlJlcG9zaXRvcnk4NzA2NzIxMg==-flat-momentum.py,229,231,2,44,46,2
107,https://htmlpreview.github.io/?https://github.com/Christina96/boilerplate-sample-matches/blob/main/Python/sonnet-MDEwOlJlcG9zaXRvcnk4NzA2NzIxMg==-flat-momentum_test.py-sonnet-MDEwOlJlcG9zaXRvcnk4NzA2NzIxMg==-flat-momentum_test.py.html,47,sonnet-MDEwOlJlcG9zaXRvcnk4NzA2NzIxMg==-flat-momentum_test.py,sonnet-MDEwOlJlcG9zaXRvcnk4NzA2NzIxMg==-flat-momentum_test.py,100,102,2,103,105,2
108,https://htmlpreview.github.io/?https://github.com/Christina96/boilerplate-sample-matches/blob/main/Python/seq2seq-MDEwOlJlcG9zaXRvcnk4MzczMjgwNg==-flat-generate_beam_viz.py-google-api-python-client-MDEwOlJlcG9zaXRvcnkxNTc0OTI2OQ==-flat-schema.py.html,20,seq2seq-MDEwOlJlcG9zaXRvcnk4MzczMjgwNg==-flat-generate_beam_viz.py,google-api-python-client-MDEwOlJlcG9zaXRvcnkxNTc0OTI2OQ==-flat-schema.py,51,53,2,49,51,2
109,https://htmlpreview.github.io/?https://github.com/Christina96/boilerplate-sample-matches/blob/main/Python/sonnet-MDEwOlJlcG9zaXRvcnk4NzA2NzIxMg==-flat-recurrent.py-sonnet-MDEwOlJlcG9zaXRvcnk4NzA2NzIxMg==-flat-recurrent.py.html,12,sonnet-MDEwOlJlcG9zaXRvcnk4NzA2NzIxMg==-flat-recurrent.py,sonnet-MDEwOlJlcG9zaXRvcnk4NzA2NzIxMg==-flat-recurrent.py,534,537,3,525,528,3
110,https://htmlpreview.github.io/?https://github.com/Christina96/boilerplate-sample-matches/blob/main/Python/Ultroid-MDEwOlJlcG9zaXRvcnkzNDEwMzg2MDI=-flat-pdftools.py-Ultroid-MDEwOlJlcG9zaXRvcnkzNDEwMzg2MDI=-flat-pdftools.py.html,129,Ultroid-MDEwOlJlcG9zaXRvcnkzNDEwMzg2MDI=-flat-pdftools.py,Ultroid-MDEwOlJlcG9zaXRvcnkzNDEwMzg2MDI=-flat-pdftools.py,185,200,15,254,269,15
111,https://htmlpreview.github.io/?https://github.com/Christina96/boilerplate-sample-matches/blob/main/Python/practical-python-MDEwOlJlcG9zaXRvcnkyNjY2MTM3MDQ=-flat-report_50.py-esptool-MDEwOlJlcG9zaXRvcnkyMzczNjkxNA==-flat-__init__.py.html,14,practical-python-MDEwOlJlcG9zaXRvcnkyNjY2MTM3MDQ=-flat-report_50.py,esptool-MDEwOlJlcG9zaXRvcnkyMzczNjkxNA==-flat-__init__.py,22,24,2,340,342,2
112,https://htmlpreview.github.io/?https://github.com/Christina96/boilerplate-sample-matches/blob/main/Python/esptool-MDEwOlJlcG9zaXRvcnkyMzczNjkxNA==-flat-cmds.py-esptool-MDEwOlJlcG9zaXRvcnkyMzczNjkxNA==-flat-bin_image.py.html,13,esptool-MDEwOlJlcG9zaXRvcnkyMzczNjkxNA==-flat-cmds.py,esptool-MDEwOlJlcG9zaXRvcnkyMzczNjkxNA==-flat-bin_image.py,970,974,4,720,723,3
113,https://htmlpreview.github.io/?https://github.com/Christina96/boilerplate-sample-matches/blob/main/Python/esptool-MDEwOlJlcG9zaXRvcnkyMzczNjkxNA==-flat-esp32s3.py-esptool-MDEwOlJlcG9zaXRvcnkyMzczNjkxNA==-flat-esp32s2.py.html,23,esptool-MDEwOlJlcG9zaXRvcnkyMzczNjkxNA==-flat-esp32s3.py,esptool-MDEwOlJlcG9zaXRvcnkyMzczNjkxNA==-flat-esp32s2.py,167,173,6,148,154,6
114,https://htmlpreview.github.io/?https://github.com/Christina96/boilerplate-sample-matches/blob/main/Python/sonnet-MDEwOlJlcG9zaXRvcnk4NzA2NzIxMg==-flat-depthwise_conv.py-sonnet-MDEwOlJlcG9zaXRvcnk4NzA2NzIxMg==-flat-axis_norm.py.html,24,sonnet-MDEwOlJlcG9zaXRvcnk4NzA2NzIxMg==-flat-depthwise_conv.py,sonnet-MDEwOlJlcG9zaXRvcnk4NzA2NzIxMg==-flat-axis_norm.py,48,52,4,74,78,4
115,https://htmlpreview.github.io/?https://github.com/Christina96/boilerplate-sample-matches/blob/main/Python/sonnet-MDEwOlJlcG9zaXRvcnk4NzA2NzIxMg==-flat-rmsprop_test.py-sonnet-MDEwOlJlcG9zaXRvcnk4NzA2NzIxMg==-flat-momentum_test.py.html,44,sonnet-MDEwOlJlcG9zaXRvcnk4NzA2NzIxMg==-flat-rmsprop_test.py,sonnet-MDEwOlJlcG9zaXRvcnk4NzA2NzIxMg==-flat-momentum_test.py,66,69,3,86,89,3
116,https://htmlpreview.github.io/?https://github.com/Christina96/boilerplate-sample-matches/blob/main/Python/esptool-MDEwOlJlcG9zaXRvcnkyMzczNjkxNA==-flat-__init___49.py-esptool-MDEwOlJlcG9zaXRvcnkyMzczNjkxNA==-flat-__init___49.py.html,12,esptool-MDEwOlJlcG9zaXRvcnkyMzczNjkxNA==-flat-__init___49.py,esptool-MDEwOlJlcG9zaXRvcnkyMzczNjkxNA==-flat-__init___49.py,344,349,5,508,513,5
117,https://htmlpreview.github.io/?https://github.com/Christina96/boilerplate-sample-matches/blob/main/Python/sonnet-MDEwOlJlcG9zaXRvcnk4NzA2NzIxMg==-flat-resnet_7.py-sonnet-MDEwOlJlcG9zaXRvcnk4NzA2NzIxMg==-flat-resnet_7.py.html,113,sonnet-MDEwOlJlcG9zaXRvcnk4NzA2NzIxMg==-flat-resnet_7.py,sonnet-MDEwOlJlcG9zaXRvcnk4NzA2NzIxMg==-flat-resnet_7.py,14,32,18,81,99,18
118,https://htmlpreview.github.io/?https://github.com/Christina96/boilerplate-sample-matches/blob/main/Python/Ultroid-MDEwOlJlcG9zaXRvcnkzNDEwMzg2MDI=-flat-admintools.py-Ultroid-MDEwOlJlcG9zaXRvcnkzNDEwMzg2MDI=-flat-admins.py.html,18,Ultroid-MDEwOlJlcG9zaXRvcnkzNDEwMzg2MDI=-flat-admintools.py,Ultroid-MDEwOlJlcG9zaXRvcnkzNDEwMzg2MDI=-flat-admins.py,121,126,5,79,84,5
119,https://htmlpreview.github.io/?https://github.com/Christina96/boilerplate-sample-matches/blob/main/Python/esptool-MDEwOlJlcG9zaXRvcnkyMzczNjkxNA==-flat-emulate_efuse_controller_34.py-esptool-MDEwOlJlcG9zaXRvcnkyMzczNjkxNA==-flat-emulate_efuse_controller_39.py.html,31,esptool-MDEwOlJlcG9zaXRvcnkyMzczNjkxNA==-flat-emulate_efuse_controller_34.py,esptool-MDEwOlJlcG9zaXRvcnkyMzczNjkxNA==-flat-emulate_efuse_controller_39.py,17,25,8,18,26,8
120,https://htmlpreview.github.io/?https://github.com/Christina96/boilerplate-sample-matches/blob/main/Python/seq2seq-MDEwOlJlcG9zaXRvcnk4MzczMjgwNg==-flat-helper.py-seq2seq-MDEwOlJlcG9zaXRvcnk4MzczMjgwNg==-flat-helper.py.html,20,seq2seq-MDEwOlJlcG9zaXRvcnk4MzczMjgwNg==-flat-helper.py,seq2seq-MDEwOlJlcG9zaXRvcnk4MzczMjgwNg==-flat-helper.py,125,127,2,283,285,2
121,https://htmlpreview.github.io/?https://github.com/Christina96/boilerplate-sample-matches/blob/main/Python/esptool-MDEwOlJlcG9zaXRvcnkyMzczNjkxNA==-flat-test_esptool.py-esptool-MDEwOlJlcG9zaXRvcnkyMzczNjkxNA==-flat-test_esptool.py.html,13,esptool-MDEwOlJlcG9zaXRvcnkyMzczNjkxNA==-flat-test_esptool.py,esptool-MDEwOlJlcG9zaXRvcnkyMzczNjkxNA==-flat-test_esptool.py,243,248,5,217,222,5
122,https://htmlpreview.github.io/?https://github.com/Christina96/boilerplate-sample-matches/blob/main/Python/sonnet-MDEwOlJlcG9zaXRvcnk4NzA2NzIxMg==-flat-recurrent_test.py-sonnet-MDEwOlJlcG9zaXRvcnk4NzA2NzIxMg==-flat-recurrent_test.py.html,14,sonnet-MDEwOlJlcG9zaXRvcnk4NzA2NzIxMg==-flat-recurrent_test.py,sonnet-MDEwOlJlcG9zaXRvcnk4NzA2NzIxMg==-flat-recurrent_test.py,42,44,2,429,431,2
123,https://htmlpreview.github.io/?https://github.com/Christina96/boilerplate-sample-matches/blob/main/Python/Ultroid-MDEwOlJlcG9zaXRvcnkzNDEwMzg2MDI=-flat-_database.py-Ultroid-MDEwOlJlcG9zaXRvcnkzNDEwMzg2MDI=-flat-_database.py.html,17,Ultroid-MDEwOlJlcG9zaXRvcnkzNDEwMzg2MDI=-flat-_database.py,Ultroid-MDEwOlJlcG9zaXRvcnkzNDEwMzg2MDI=-flat-_database.py,243,247,4,230,234,4
124,https://htmlpreview.github.io/?https://github.com/Christina96/boilerplate-sample-matches/blob/main/Python/sonnet-MDEwOlJlcG9zaXRvcnk4NzA2NzIxMg==-flat-initializers_3.py-sonnet-MDEwOlJlcG9zaXRvcnk4NzA2NzIxMg==-flat-initializers_3.py.html,25,sonnet-MDEwOlJlcG9zaXRvcnk4NzA2NzIxMg==-flat-initializers_3.py,sonnet-MDEwOlJlcG9zaXRvcnk4NzA2NzIxMg==-flat-initializers_3.py,49,53,4,65,69,4
125,https://htmlpreview.github.io/?https://github.com/Christina96/boilerplate-sample-matches/blob/main/Python/esptool-MDEwOlJlcG9zaXRvcnkyMzczNjkxNA==-flat-emulate_efuse_controller_29.py-esptool-MDEwOlJlcG9zaXRvcnkyMzczNjkxNA==-flat-emulate_efuse_controller_14.py.html,98,esptool-MDEwOlJlcG9zaXRvcnkyMzczNjkxNA==-flat-emulate_efuse_controller_29.py,esptool-MDEwOlJlcG9zaXRvcnkyMzczNjkxNA==-flat-emulate_efuse_controller_14.py,56,65,9,56,65,9
126,https://htmlpreview.github.io/?https://github.com/Christina96/boilerplate-sample-matches/blob/main/Python/sonnet-MDEwOlJlcG9zaXRvcnk4NzA2NzIxMg==-flat-mlp_test.py-sonnet-MDEwOlJlcG9zaXRvcnk4NzA2NzIxMg==-flat-mlp_test.py.html,44,sonnet-MDEwOlJlcG9zaXRvcnk4NzA2NzIxMg==-flat-mlp_test.py,sonnet-MDEwOlJlcG9zaXRvcnk4NzA2NzIxMg==-flat-mlp_test.py,65,71,6,75,81,6
127,https://htmlpreview.github.io/?https://github.com/Christina96/boilerplate-sample-matches/blob/main/Python/sonnet-MDEwOlJlcG9zaXRvcnk4NzA2NzIxMg==-flat-base.py-sonnet-MDEwOlJlcG9zaXRvcnk4NzA2NzIxMg==-flat-base.py.html,16,sonnet-MDEwOlJlcG9zaXRvcnk4NzA2NzIxMg==-flat-base.py,sonnet-MDEwOlJlcG9zaXRvcnk4NzA2NzIxMg==-flat-base.py,34,35,1,36,37,1
128,https://htmlpreview.github.io/?https://github.com/Christina96/boilerplate-sample-matches/blob/main/Python/sonnet-MDEwOlJlcG9zaXRvcnk4NzA2NzIxMg==-flat-distribute_test.py-sonnet-MDEwOlJlcG9zaXRvcnk4NzA2NzIxMg==-flat-distribute_test.py.html,12,sonnet-MDEwOlJlcG9zaXRvcnk4NzA2NzIxMg==-flat-distribute_test.py,sonnet-MDEwOlJlcG9zaXRvcnk4NzA2NzIxMg==-flat-distribute_test.py,15,17,2,43,45,2
129,https://htmlpreview.github.io/?https://github.com/Christina96/boilerplate-sample-matches/blob/main/Python/esptool-MDEwOlJlcG9zaXRvcnkyMzczNjkxNA==-flat-bin_image.py-esptool-MDEwOlJlcG9zaXRvcnkyMzczNjkxNA==-flat-bin_image.py.html,41,esptool-MDEwOlJlcG9zaXRvcnkyMzczNjkxNA==-flat-bin_image.py,esptool-MDEwOlJlcG9zaXRvcnkyMzczNjkxNA==-flat-bin_image.py,411,416,5,572,576,4
130,https://htmlpreview.github.io/?https://github.com/Christina96/boilerplate-sample-matches/blob/main/Python/yolact-MDEwOlJlcG9zaXRvcnkxMzg3OTY2OTk=-flat-dcn_v2.py-yolact-MDEwOlJlcG9zaXRvcnkxMzg3OTY2OTk=-flat-dcn_v2.py.html,12,yolact-MDEwOlJlcG9zaXRvcnkxMzg3OTY2OTk=-flat-dcn_v2.py,yolact-MDEwOlJlcG9zaXRvcnkxMzg3OTY2OTk=-flat-dcn_v2.py,114,118,4,161,165,4
131,https://htmlpreview.github.io/?https://github.com/Christina96/boilerplate-sample-matches/blob/main/Python/esptool-MDEwOlJlcG9zaXRvcnkyMzczNjkxNA==-flat-base_fields.py-esptool-MDEwOlJlcG9zaXRvcnkyMzczNjkxNA==-flat-esp32h2beta1.py.html,14,esptool-MDEwOlJlcG9zaXRvcnkyMzczNjkxNA==-flat-base_fields.py,esptool-MDEwOlJlcG9zaXRvcnkyMzczNjkxNA==-flat-esp32h2beta1.py,128,130,2,110,112,2
132,https://htmlpreview.github.io/?https://github.com/Christina96/boilerplate-sample-matches/blob/main/Python/esptool-MDEwOlJlcG9zaXRvcnkyMzczNjkxNA==-flat-operations_12.py-esptool-MDEwOlJlcG9zaXRvcnkyMzczNjkxNA==-flat-operations_42.py.html,969,esptool-MDEwOlJlcG9zaXRvcnkyMzczNjkxNA==-flat-operations_12.py,esptool-MDEwOlJlcG9zaXRvcnkyMzczNjkxNA==-flat-operations_42.py,287,439,152,287,439,152
133,https://htmlpreview.github.io/?https://github.com/Christina96/boilerplate-sample-matches/blob/main/Python/google-api-python-client-MDEwOlJlcG9zaXRvcnkxNTc0OTI2OQ==-flat-describe_9.py-google-api-python-client-MDEwOlJlcG9zaXRvcnkxNTc0OTI2OQ==-flat-describe.py.html,12,google-api-python-client-MDEwOlJlcG9zaXRvcnkxNTc0OTI2OQ==-flat-describe_9.py,google-api-python-client-MDEwOlJlcG9zaXRvcnkxNTc0OTI2OQ==-flat-describe.py,231,233,2,231,233,2
134,https://htmlpreview.github.io/?https://github.com/Christina96/boilerplate-sample-matches/blob/main/Python/Ultroid-MDEwOlJlcG9zaXRvcnkzNDEwMzg2MDI=-flat-globaltools.py-Ultroid-MDEwOlJlcG9zaXRvcnkzNDEwMzg2MDI=-flat-blacklist.py.html,24,Ultroid-MDEwOlJlcG9zaXRvcnkzNDEwMzg2MDI=-flat-globaltools.py,Ultroid-MDEwOlJlcG9zaXRvcnkzNDEwMzg2MDI=-flat-blacklist.py,52,55,3,25,28,3
135,https://htmlpreview.github.io/?https://github.com/Christina96/boilerplate-sample-matches/blob/main/Python/sonnet-MDEwOlJlcG9zaXRvcnk4NzA2NzIxMg==-flat-depthwise_conv_test.py-sonnet-MDEwOlJlcG9zaXRvcnk4NzA2NzIxMg==-flat-depthwise_conv_test.py.html,128,sonnet-MDEwOlJlcG9zaXRvcnk4NzA2NzIxMg==-flat-depthwise_conv_test.py,sonnet-MDEwOlJlcG9zaXRvcnk4NzA2NzIxMg==-flat-depthwise_conv_test.py,119,132,13,134,147,13
136,https://htmlpreview.github.io/?https://github.com/Christina96/boilerplate-sample-matches/blob/main/Python/yolact-MDEwOlJlcG9zaXRvcnkxMzg3OTY2OTk=-flat-config.py-yolact-MDEwOlJlcG9zaXRvcnkxMzg3OTY2OTk=-flat-config.py.html,24,yolact-MDEwOlJlcG9zaXRvcnkxMzg3OTY2OTk=-flat-config.py,yolact-MDEwOlJlcG9zaXRvcnkxMzg3OTY2OTk=-flat-config.py,339,340,1,401,402,1
137,https://htmlpreview.github.io/?https://github.com/Christina96/boilerplate-sample-matches/blob/main/Python/sonnet-MDEwOlJlcG9zaXRvcnk4NzA2NzIxMg==-flat-recurrent.py-sonnet-MDEwOlJlcG9zaXRvcnk4NzA2NzIxMg==-flat-recurrent.py.html,24,sonnet-MDEwOlJlcG9zaXRvcnk4NzA2NzIxMg==-flat-recurrent.py,sonnet-MDEwOlJlcG9zaXRvcnk4NzA2NzIxMg==-flat-recurrent.py,524,530,6,533,539,6
138,https://htmlpreview.github.io/?https://github.com/Christina96/boilerplate-sample-matches/blob/main/Python/yolact-MDEwOlJlcG9zaXRvcnkxMzg3OTY2OTk=-flat-box_utils.py-yolact-MDEwOlJlcG9zaXRvcnkxMzg3OTY2OTk=-flat-box_utils.py.html,30,yolact-MDEwOlJlcG9zaXRvcnkxMzg3OTY2OTk=-flat-box_utils.py,yolact-MDEwOlJlcG9zaXRvcnkxMzg3OTY2OTk=-flat-box_utils.py,151,153,2,153,155,2
139,https://htmlpreview.github.io/?https://github.com/Christina96/boilerplate-sample-matches/blob/main/Python/Ultroid-MDEwOlJlcG9zaXRvcnkzNDEwMzg2MDI=-flat-search.py-Ultroid-MDEwOlJlcG9zaXRvcnkzNDEwMzg2MDI=-flat-callbackstuffs.py.html,13,Ultroid-MDEwOlJlcG9zaXRvcnkzNDEwMzg2MDI=-flat-search.py,Ultroid-MDEwOlJlcG9zaXRvcnkzNDEwMzg2MDI=-flat-callbackstuffs.py,143,144,1,1146,1147,1
140,https://htmlpreview.github.io/?https://github.com/Christina96/boilerplate-sample-matches/blob/main/Python/sonnet-MDEwOlJlcG9zaXRvcnk4NzA2NzIxMg==-flat-initializers_3.py-sonnet-MDEwOlJlcG9zaXRvcnk4NzA2NzIxMg==-flat-initializers_3.py.html,33,sonnet-MDEwOlJlcG9zaXRvcnk4NzA2NzIxMg==-flat-initializers_3.py,sonnet-MDEwOlJlcG9zaXRvcnk4NzA2NzIxMg==-flat-initializers_3.py,24,27,3,52,55,3
141,https://htmlpreview.github.io/?https://github.com/Christina96/boilerplate-sample-matches/blob/main/Python/sonnet-MDEwOlJlcG9zaXRvcnk4NzA2NzIxMg==-flat-goldens.py-sonnet-MDEwOlJlcG9zaXRvcnk4NzA2NzIxMg==-flat-goldens.py.html,15,sonnet-MDEwOlJlcG9zaXRvcnk4NzA2NzIxMg==-flat-goldens.py,sonnet-MDEwOlJlcG9zaXRvcnk4NzA2NzIxMg==-flat-goldens.py,330,333,3,342,344,2
142,https://htmlpreview.github.io/?https://github.com/Christina96/boilerplate-sample-matches/blob/main/Python/esptool-MDEwOlJlcG9zaXRvcnkyMzczNjkxNA==-flat-__init___49.py-esptool-MDEwOlJlcG9zaXRvcnkyMzczNjkxNA==-flat-__init___2.py.html,15,esptool-MDEwOlJlcG9zaXRvcnkyMzczNjkxNA==-flat-__init___49.py,esptool-MDEwOlJlcG9zaXRvcnkyMzczNjkxNA==-flat-__init___2.py,397,402,5,149,155,6
143,https://htmlpreview.github.io/?https://github.com/Christina96/boilerplate-sample-matches/blob/main/Python/yolact-MDEwOlJlcG9zaXRvcnkxMzg3OTY2OTk=-flat-make_grid.py-yolact-MDEwOlJlcG9zaXRvcnkxMzg3OTY2OTk=-flat-make_grid.py.html,25,yolact-MDEwOlJlcG9zaXRvcnkxMzg3OTY2OTk=-flat-make_grid.py,yolact-MDEwOlJlcG9zaXRvcnkxMzg3OTY2OTk=-flat-make_grid.py,60,66,6,52,59,7
144,https://htmlpreview.github.io/?https://github.com/Christina96/boilerplate-sample-matches/blob/main/Python/sonnet-MDEwOlJlcG9zaXRvcnk4NzA2NzIxMg==-flat-group_norm_test.py-esptool-MDEwOlJlcG9zaXRvcnkyMzczNjkxNA==-flat-fields_30.py.html,14,sonnet-MDEwOlJlcG9zaXRvcnk4NzA2NzIxMg==-flat-group_norm_test.py,esptool-MDEwOlJlcG9zaXRvcnkyMzczNjkxNA==-flat-fields_30.py,66,69,3,122,124,2
145,https://htmlpreview.github.io/?https://github.com/Christina96/boilerplate-sample-matches/blob/main/Python/Ultroid-MDEwOlJlcG9zaXRvcnkzNDEwMzg2MDI=-flat-usage.py-Ultroid-MDEwOlJlcG9zaXRvcnkzNDEwMzg2MDI=-flat-usage.py.html,12,Ultroid-MDEwOlJlcG9zaXRvcnkzNDEwMzg2MDI=-flat-usage.py,Ultroid-MDEwOlJlcG9zaXRvcnkzNDEwMzg2MDI=-flat-usage.py,115,116,1,51,52,1
146,https://htmlpreview.github.io/?https://github.com/Christina96/boilerplate-sample-matches/blob/main/Python/google-api-python-client-MDEwOlJlcG9zaXRvcnkxNTc0OTI2OQ==-flat-test_discovery.py-sonnet-MDEwOlJlcG9zaXRvcnk4NzA2NzIxMg==-flat-functional_mlp_mnist.py.html,13,google-api-python-client-MDEwOlJlcG9zaXRvcnkxNTc0OTI2OQ==-flat-test_discovery.py,sonnet-MDEwOlJlcG9zaXRvcnk4NzA2NzIxMg==-flat-functional_mlp_mnist.py,1878,1880,2,58,60,2
147,https://htmlpreview.github.io/?https://github.com/Christina96/boilerplate-sample-matches/blob/main/Python/Ultroid-MDEwOlJlcG9zaXRvcnkzNDEwMzg2MDI=-flat-tools.py-Ultroid-MDEwOlJlcG9zaXRvcnkzNDEwMzg2MDI=-flat-inlinestuff.py.html,15,Ultroid-MDEwOlJlcG9zaXRvcnkzNDEwMzg2MDI=-flat-tools.py,Ultroid-MDEwOlJlcG9zaXRvcnkzNDEwMzg2MDI=-flat-inlinestuff.py,167,168,1,141,142,1
148,https://htmlpreview.github.io/?https://github.com/Christina96/boilerplate-sample-matches/blob/main/Python/Ultroid-MDEwOlJlcG9zaXRvcnkzNDEwMzg2MDI=-flat-forcesub_db.py-Ultroid-MDEwOlJlcG9zaXRvcnkzNDEwMzg2MDI=-flat-forcesub_db.py.html,14,Ultroid-MDEwOlJlcG9zaXRvcnkzNDEwMzg2MDI=-flat-forcesub_db.py,Ultroid-MDEwOlJlcG9zaXRvcnkzNDEwMzg2MDI=-flat-forcesub_db.py,9,11,2,13,15,2
149,https://htmlpreview.github.io/?https://github.com/Christina96/boilerplate-sample-matches/blob/main/Python/esptool-MDEwOlJlcG9zaXRvcnkyMzczNjkxNA==-flat-mem_definition_26.py-esptool-MDEwOlJlcG9zaXRvcnkyMzczNjkxNA==-flat-mem_definition_11.py.html,423,esptool-MDEwOlJlcG9zaXRvcnkyMzczNjkxNA==-flat-mem_definition_26.py,esptool-MDEwOlJlcG9zaXRvcnkyMzczNjkxNA==-flat-mem_definition_11.py,54,88,34,89,123,34
150,https://htmlpreview.github.io/?https://github.com/Christina96/boilerplate-sample-matches/blob/main/Python/Ultroid-MDEwOlJlcG9zaXRvcnkzNDEwMzg2MDI=-flat-blacklist.py-Ultroid-MDEwOlJlcG9zaXRvcnkzNDEwMzg2MDI=-flat-blacklist.py.html,13,Ultroid-MDEwOlJlcG9zaXRvcnkzNDEwMzg2MDI=-flat-blacklist.py,Ultroid-MDEwOlJlcG9zaXRvcnkzNDEwMzg2MDI=-flat-blacklist.py,19,20,1,31,32,1
151,https://htmlpreview.github.io/?https://github.com/Christina96/boilerplate-sample-matches/blob/main/Python/sonnet-MDEwOlJlcG9zaXRvcnk4NzA2NzIxMg==-flat-rmsprop_test.py-sonnet-MDEwOlJlcG9zaXRvcnk4NzA2NzIxMg==-flat-embed_test.py.html,12,sonnet-MDEwOlJlcG9zaXRvcnk4NzA2NzIxMg==-flat-rmsprop_test.py,sonnet-MDEwOlJlcG9zaXRvcnk4NzA2NzIxMg==-flat-embed_test.py,127,128,1,44,45,1
152,https://htmlpreview.github.io/?https://github.com/Christina96/boilerplate-sample-matches/blob/main/Python/practical-python-MDEwOlJlcG9zaXRvcnkyNjY2MTM3MDQ=-flat-report_32.py-practical-python-MDEwOlJlcG9zaXRvcnkyNjY2MTM3MDQ=-flat-report_85.py.html,37,practical-python-MDEwOlJlcG9zaXRvcnkyNjY2MTM3MDQ=-flat-report_32.py,practical-python-MDEwOlJlcG9zaXRvcnkyNjY2MTM3MDQ=-flat-report_85.py,9,11,2,9,11,2
153,https://htmlpreview.github.io/?https://github.com/Christina96/boilerplate-sample-matches/blob/main/Python/practical-python-MDEwOlJlcG9zaXRvcnkyNjY2MTM3MDQ=-flat-report_105.py-practical-python-MDEwOlJlcG9zaXRvcnkyNjY2MTM3MDQ=-flat-report_11.py.html,47,practical-python-MDEwOlJlcG9zaXRvcnkyNjY2MTM3MDQ=-flat-report_105.py,practical-python-MDEwOlJlcG9zaXRvcnkyNjY2MTM3MDQ=-flat-report_11.py,12,19,7,12,19,7
154,https://htmlpreview.github.io/?https://github.com/Christina96/boilerplate-sample-matches/blob/main/Python/sonnet-MDEwOlJlcG9zaXRvcnk4NzA2NzIxMg==-flat-build_test_11.py-sonnet-MDEwOlJlcG9zaXRvcnk4NzA2NzIxMg==-flat-saved_model_test.py.html,12,sonnet-MDEwOlJlcG9zaXRvcnk4NzA2NzIxMg==-flat-build_test_11.py,sonnet-MDEwOlJlcG9zaXRvcnk4NzA2NzIxMg==-flat-saved_model_test.py,19,21,2,33,34,1
155,https://htmlpreview.github.io/?https://github.com/Christina96/boilerplate-sample-matches/blob/main/Python/Ultroid-MDEwOlJlcG9zaXRvcnkzNDEwMzg2MDI=-flat-callbackstuffs.py-Ultroid-MDEwOlJlcG9zaXRvcnkzNDEwMzg2MDI=-flat-callbackstuffs.py.html,161,Ultroid-MDEwOlJlcG9zaXRvcnkzNDEwMzg2MDI=-flat-callbackstuffs.py,Ultroid-MDEwOlJlcG9zaXRvcnkzNDEwMzg2MDI=-flat-callbackstuffs.py,514,545,31,543,574,31
156,https://htmlpreview.github.io/?https://github.com/Christina96/boilerplate-sample-matches/blob/main/Python/google-api-python-client-MDEwOlJlcG9zaXRvcnkxNTc0OTI2OQ==-flat-main_1.py-sonnet-MDEwOlJlcG9zaXRvcnk4NzA2NzIxMg==-flat-conv_transpose_test.py.html,12,google-api-python-client-MDEwOlJlcG9zaXRvcnkxNTc0OTI2OQ==-flat-main_1.py,sonnet-MDEwOlJlcG9zaXRvcnk4NzA2NzIxMg==-flat-conv_transpose_test.py,46,48,2,197,199,2
157,https://htmlpreview.github.io/?https://github.com/Christina96/boilerplate-sample-matches/blob/main/Python/Ultroid-MDEwOlJlcG9zaXRvcnkzNDEwMzg2MDI=-flat-BaseClient.py-Ultroid-MDEwOlJlcG9zaXRvcnkzNDEwMzg2MDI=-flat-admintools.py.html,12,Ultroid-MDEwOlJlcG9zaXRvcnkzNDEwMzg2MDI=-flat-BaseClient.py,Ultroid-MDEwOlJlcG9zaXRvcnkzNDEwMzg2MDI=-flat-admintools.py,20,23,3,74,77,3
158,https://htmlpreview.github.io/?https://github.com/Christina96/boilerplate-sample-matches/blob/main/Python/esptool-MDEwOlJlcG9zaXRvcnkyMzczNjkxNA==-flat-test_espsecure.py-esptool-MDEwOlJlcG9zaXRvcnkyMzczNjkxNA==-flat-test_espsecure.py.html,21,esptool-MDEwOlJlcG9zaXRvcnkyMzczNjkxNA==-flat-test_espsecure.py,esptool-MDEwOlJlcG9zaXRvcnkyMzczNjkxNA==-flat-test_espsecure.py,273,277,4,226,230,4
159,https://htmlpreview.github.io/?https://github.com/Christina96/boilerplate-sample-matches/blob/main/Python/google-api-python-client-MDEwOlJlcG9zaXRvcnkxNTc0OTI2OQ==-flat-management_v3_reference.py-google-api-python-client-MDEwOlJlcG9zaXRvcnkxNTc0OTI2OQ==-flat-management_v3_reference.py.html,14,google-api-python-client-MDEwOlJlcG9zaXRvcnkxNTc0OTI2OQ==-flat-management_v3_reference.py,google-api-python-client-MDEwOlJlcG9zaXRvcnkxNTc0OTI2OQ==-flat-management_v3_reference.py,152,155,3,184,187,3
160,https://htmlpreview.github.io/?https://github.com/Christina96/boilerplate-sample-matches/blob/main/Python/sonnet-MDEwOlJlcG9zaXRvcnk4NzA2NzIxMg==-flat-conv_transpose.py-sonnet-MDEwOlJlcG9zaXRvcnk4NzA2NzIxMg==-flat-conv_transpose.py.html,16,sonnet-MDEwOlJlcG9zaXRvcnk4NzA2NzIxMg==-flat-conv_transpose.py,sonnet-MDEwOlJlcG9zaXRvcnk4NzA2NzIxMg==-flat-conv_transpose.py,192,194,2,166,168,2
161,https://htmlpreview.github.io/?https://github.com/Christina96/boilerplate-sample-matches/blob/main/Python/esphome-docs-MDEwOlJlcG9zaXRvcnkxMzMyMjM0NjE=-flat-schema_doc.py-esphome-docs-MDEwOlJlcG9zaXRvcnkxMzMyMjM0NjE=-flat-schema_doc.py.html,18,esphome-docs-MDEwOlJlcG9zaXRvcnkxMzMyMjM0NjE=-flat-schema_doc.py,esphome-docs-MDEwOlJlcG9zaXRvcnkxMzMyMjM0NjE=-flat-schema_doc.py,670,675,5,752,757,5
162,https://htmlpreview.github.io/?https://github.com/Christina96/boilerplate-sample-matches/blob/main/Python/esptool-MDEwOlJlcG9zaXRvcnkyMzczNjkxNA==-flat-fields_10.py-esptool-MDEwOlJlcG9zaXRvcnkyMzczNjkxNA==-flat-fields_5.py.html,989,esptool-MDEwOlJlcG9zaXRvcnkyMzczNjkxNA==-flat-fields_10.py,esptool-MDEwOlJlcG9zaXRvcnkyMzczNjkxNA==-flat-fields_5.py,266,397,131,231,362,131
163,https://htmlpreview.github.io/?https://github.com/Christina96/boilerplate-sample-matches/blob/main/Python/Ultroid-MDEwOlJlcG9zaXRvcnkzNDEwMzg2MDI=-flat-callbackstuffs.py-Ultroid-MDEwOlJlcG9zaXRvcnkzNDEwMzg2MDI=-flat-callbackstuffs.py.html,33,Ultroid-MDEwOlJlcG9zaXRvcnkzNDEwMzg2MDI=-flat-callbackstuffs.py,Ultroid-MDEwOlJlcG9zaXRvcnkzNDEwMzg2MDI=-flat-callbackstuffs.py,643,650,7,672,679,7
164,https://htmlpreview.github.io/?https://github.com/Christina96/boilerplate-sample-matches/blob/main/Python/esptool-MDEwOlJlcG9zaXRvcnkyMzczNjkxNA==-flat-mem_definition_21.py-esptool-MDEwOlJlcG9zaXRvcnkyMzczNjkxNA==-flat-mem_definition_16.py.html,31,esptool-MDEwOlJlcG9zaXRvcnkyMzczNjkxNA==-flat-mem_definition_21.py,esptool-MDEwOlJlcG9zaXRvcnkyMzczNjkxNA==-flat-mem_definition_16.py,103,106,3,90,93,3
165,https://htmlpreview.github.io/?https://github.com/Christina96/boilerplate-sample-matches/blob/main/Python/esptool-MDEwOlJlcG9zaXRvcnkyMzczNjkxNA==-flat-esp32h2.py-esptool-MDEwOlJlcG9zaXRvcnkyMzczNjkxNA==-flat-esp32h2beta2.py.html,13,esptool-MDEwOlJlcG9zaXRvcnkyMzczNjkxNA==-flat-esp32h2.py,esptool-MDEwOlJlcG9zaXRvcnkyMzczNjkxNA==-flat-esp32h2beta2.py,47,49,2,21,23,2
166,https://htmlpreview.github.io/?https://github.com/Christina96/boilerplate-sample-matches/blob/main/Python/sonnet-MDEwOlJlcG9zaXRvcnk4NzA2NzIxMg==-flat-reshape_test.py-sonnet-MDEwOlJlcG9zaXRvcnk4NzA2NzIxMg==-flat-bias_test.py.html,16,sonnet-MDEwOlJlcG9zaXRvcnk4NzA2NzIxMg==-flat-reshape_test.py,sonnet-MDEwOlJlcG9zaXRvcnk4NzA2NzIxMg==-flat-bias_test.py,19,20,1,23,24,1
167,https://htmlpreview.github.io/?https://github.com/Christina96/boilerplate-sample-matches/blob/main/Python/seq2seq-MDEwOlJlcG9zaXRvcnk4MzczMjgwNg==-flat-rnn_cell_test.py-seq2seq-MDEwOlJlcG9zaXRvcnk4MzczMjgwNg==-flat-rnn_cell_test.py.html,20,seq2seq-MDEwOlJlcG9zaXRvcnk4MzczMjgwNg==-flat-rnn_cell_test.py,seq2seq-MDEwOlJlcG9zaXRvcnk4MzczMjgwNg==-flat-rnn_cell_test.py,76,78,2,89,92,3
168,https://htmlpreview.github.io/?https://github.com/Christina96/boilerplate-sample-matches/blob/main/Python/sonnet-MDEwOlJlcG9zaXRvcnk4NzA2NzIxMg==-flat-conv_transpose_test.py-sonnet-MDEwOlJlcG9zaXRvcnk4NzA2NzIxMg==-flat-depthwise_conv_test.py.html,45,sonnet-MDEwOlJlcG9zaXRvcnk4NzA2NzIxMg==-flat-conv_transpose_test.py,sonnet-MDEwOlJlcG9zaXRvcnk4NzA2NzIxMg==-flat-depthwise_conv_test.py,10,17,7,9,16,7
169,https://htmlpreview.github.io/?https://github.com/Christina96/boilerplate-sample-matches/blob/main/Python/esptool-MDEwOlJlcG9zaXRvcnkyMzczNjkxNA==-flat-test_espsecure_hsm.py-esptool-MDEwOlJlcG9zaXRvcnkyMzczNjkxNA==-flat-test_espsecure.py.html,14,esptool-MDEwOlJlcG9zaXRvcnkyMzczNjkxNA==-flat-test_espsecure_hsm.py,esptool-MDEwOlJlcG9zaXRvcnkyMzczNjkxNA==-flat-test_espsecure.py,143,147,4,350,354,4
170,https://htmlpreview.github.io/?https://github.com/Christina96/boilerplate-sample-matches/blob/main/Python/Ultroid-MDEwOlJlcG9zaXRvcnkzNDEwMzg2MDI=-flat-_decorators.py-Ultroid-MDEwOlJlcG9zaXRvcnkzNDEwMzg2MDI=-flat-_decorators.py.html,16,Ultroid-MDEwOlJlcG9zaXRvcnkzNDEwMzg2MDI=-flat-_decorators.py,Ultroid-MDEwOlJlcG9zaXRvcnkzNDEwMzg2MDI=-flat-_decorators.py,151,153,2,152,155,3
171,https://htmlpreview.github.io/?https://github.com/Christina96/boilerplate-sample-matches/blob/main/Python/sonnet-MDEwOlJlcG9zaXRvcnk4NzA2NzIxMg==-flat-conv_transpose_test.py-sonnet-MDEwOlJlcG9zaXRvcnk4NzA2NzIxMg==-flat-conv_transpose_test.py.html,12,sonnet-MDEwOlJlcG9zaXRvcnk4NzA2NzIxMg==-flat-conv_transpose_test.py,sonnet-MDEwOlJlcG9zaXRvcnk4NzA2NzIxMg==-flat-conv_transpose_test.py,165,168,3,214,217,3
172,https://htmlpreview.github.io/?https://github.com/Christina96/boilerplate-sample-matches/blob/main/Python/Ultroid-MDEwOlJlcG9zaXRvcnkzNDEwMzg2MDI=-flat-ytdl.py-Ultroid-MDEwOlJlcG9zaXRvcnkzNDEwMzg2MDI=-flat-callbackstuffs.py.html,12,Ultroid-MDEwOlJlcG9zaXRvcnkzNDEwMzg2MDI=-flat-ytdl.py,Ultroid-MDEwOlJlcG9zaXRvcnkzNDEwMzg2MDI=-flat-callbackstuffs.py,18,24,6,425,431,6
173,https://htmlpreview.github.io/?https://github.com/Christina96/boilerplate-sample-matches/blob/main/Python/seq2seq-MDEwOlJlcG9zaXRvcnk4MzczMjgwNg==-flat-input_pipeline_test.py-seq2seq-MDEwOlJlcG9zaXRvcnk4MzczMjgwNg==-flat-input_pipeline_test.py.html,94,seq2seq-MDEwOlJlcG9zaXRvcnk4MzczMjgwNg==-flat-input_pipeline_test.py,seq2seq-MDEwOlJlcG9zaXRvcnk4MzczMjgwNg==-flat-input_pipeline_test.py,55,63,8,85,93,8
174,https://htmlpreview.github.io/?https://github.com/Christina96/boilerplate-sample-matches/blob/main/Python/esphome-docs-MDEwOlJlcG9zaXRvcnkxMzMyMjM0NjE=-flat-conf.py-sonnet-MDEwOlJlcG9zaXRvcnk4NzA2NzIxMg==-flat-conf.py.html,12,esphome-docs-MDEwOlJlcG9zaXRvcnkxMzMyMjM0NjE=-flat-conf.py,sonnet-MDEwOlJlcG9zaXRvcnk4NzA2NzIxMg==-flat-conf.py,22,27,5,12,17,5
175,https://htmlpreview.github.io/?https://github.com/Christina96/boilerplate-sample-matches/blob/main/Python/sonnet-MDEwOlJlcG9zaXRvcnk4NzA2NzIxMg==-flat-descriptors.py-sonnet-MDEwOlJlcG9zaXRvcnk4NzA2NzIxMg==-flat-descriptors.py.html,16,sonnet-MDEwOlJlcG9zaXRvcnk4NzA2NzIxMg==-flat-descriptors.py,sonnet-MDEwOlJlcG9zaXRvcnk4NzA2NzIxMg==-flat-descriptors.py,195,196,1,198,199,1
176,https://htmlpreview.github.io/?https://github.com/Christina96/boilerplate-sample-matches/blob/main/Python/Ultroid-MDEwOlJlcG9zaXRvcnkzNDEwMzg2MDI=-flat-broadcast.py-Ultroid-MDEwOlJlcG9zaXRvcnkzNDEwMzg2MDI=-flat-broadcast.py.html,16,Ultroid-MDEwOlJlcG9zaXRvcnkzNDEwMzg2MDI=-flat-broadcast.py,Ultroid-MDEwOlJlcG9zaXRvcnkzNDEwMzg2MDI=-flat-broadcast.py,46,48,2,75,77,2
177,https://htmlpreview.github.io/?https://github.com/Christina96/boilerplate-sample-matches/blob/main/Python/seq2seq-MDEwOlJlcG9zaXRvcnk4MzczMjgwNg==-flat-train_utils_test.py-seq2seq-MDEwOlJlcG9zaXRvcnk4MzczMjgwNg==-flat-train_utils_test.py.html,22,seq2seq-MDEwOlJlcG9zaXRvcnk4MzczMjgwNg==-flat-train_utils_test.py,seq2seq-MDEwOlJlcG9zaXRvcnk4MzczMjgwNg==-flat-train_utils_test.py,83,85,2,85,86,1
178,https://htmlpreview.github.io/?https://github.com/Christina96/boilerplate-sample-matches/blob/main/Python/wxpy-MDEwOlJlcG9zaXRvcnk4MjU4ODU5Nw==-flat-bot.py-wxpy-MDEwOlJlcG9zaXRvcnk4MjU4ODU5Nw==-flat-bot.py.html,12,wxpy-MDEwOlJlcG9zaXRvcnk4MjU4ODU5Nw==-flat-bot.py,wxpy-MDEwOlJlcG9zaXRvcnk4MjU4ODU5Nw==-flat-bot.py,141,145,4,160,164,4
179,https://htmlpreview.github.io/?https://github.com/Christina96/boilerplate-sample-matches/blob/main/Python/esphome-docs-MDEwOlJlcG9zaXRvcnkxMzMyMjM0NjE=-flat-github.py-esphome-docs-MDEwOlJlcG9zaXRvcnkxMzMyMjM0NjE=-flat-github.py.html,17,esphome-docs-MDEwOlJlcG9zaXRvcnkxMzMyMjM0NjE=-flat-github.py,esphome-docs-MDEwOlJlcG9zaXRvcnkxMzMyMjM0NjE=-flat-github.py,184,186,2,190,192,2
180,https://htmlpreview.github.io/?https://github.com/Christina96/boilerplate-sample-matches/blob/main/Python/google-api-python-client-MDEwOlJlcG9zaXRvcnkxNTc0OTI2OQ==-flat-http.py-google-api-python-client-MDEwOlJlcG9zaXRvcnkxNTc0OTI2OQ==-flat-http.py.html,12,google-api-python-client-MDEwOlJlcG9zaXRvcnkxNTc0OTI2OQ==-flat-http.py,google-api-python-client-MDEwOlJlcG9zaXRvcnkxNTc0OTI2OQ==-flat-http.py,126,128,2,469,471,2
181,https://htmlpreview.github.io/?https://github.com/Christina96/boilerplate-sample-matches/blob/main/Python/sonnet-MDEwOlJlcG9zaXRvcnk4NzA2NzIxMg==-flat-reshape_test.py-sonnet-MDEwOlJlcG9zaXRvcnk4NzA2NzIxMg==-flat-bias_test.py.html,14,sonnet-MDEwOlJlcG9zaXRvcnk4NzA2NzIxMg==-flat-reshape_test.py,sonnet-MDEwOlJlcG9zaXRvcnk4NzA2NzIxMg==-flat-bias_test.py,47,48,1,27,28,1
182,https://htmlpreview.github.io/?https://github.com/Christina96/boilerplate-sample-matches/blob/main/Python/Ultroid-MDEwOlJlcG9zaXRvcnkzNDEwMzg2MDI=-flat-_termux.py-Ultroid-MDEwOlJlcG9zaXRvcnkzNDEwMzg2MDI=-flat-_termux.py.html,22,Ultroid-MDEwOlJlcG9zaXRvcnkzNDEwMzg2MDI=-flat-_termux.py,Ultroid-MDEwOlJlcG9zaXRvcnkzNDEwMzg2MDI=-flat-_termux.py,73,76,3,95,98,3
183,https://htmlpreview.github.io/?https://github.com/Christina96/boilerplate-sample-matches/blob/main/Python/sonnet-MDEwOlJlcG9zaXRvcnk4NzA2NzIxMg==-flat-mixed_precision_test.py-sonnet-MDEwOlJlcG9zaXRvcnk4NzA2NzIxMg==-flat-mixed_precision_test.py.html,13,sonnet-MDEwOlJlcG9zaXRvcnk4NzA2NzIxMg==-flat-mixed_precision_test.py,sonnet-MDEwOlJlcG9zaXRvcnk4NzA2NzIxMg==-flat-mixed_precision_test.py,234,235,1,235,236,1
184,https://htmlpreview.github.io/?https://github.com/Christina96/boilerplate-sample-matches/blob/main/Python/sonnet-MDEwOlJlcG9zaXRvcnk4NzA2NzIxMg==-flat-recurrent.py-seq2seq-MDEwOlJlcG9zaXRvcnk4MzczMjgwNg==-flat-parallel_data_provider.py.html,13,sonnet-MDEwOlJlcG9zaXRvcnk4NzA2NzIxMg==-flat-recurrent.py,seq2seq-MDEwOlJlcG9zaXRvcnk4MzczMjgwNg==-flat-parallel_data_provider.py,196,200,4,45,49,4
185,https://htmlpreview.github.io/?https://github.com/Christina96/boilerplate-sample-matches/blob/main/Python/esptool-MDEwOlJlcG9zaXRvcnkyMzczNjkxNA==-flat-fields_15.py-yolact-MDEwOlJlcG9zaXRvcnkxMzg3OTY2OTk=-flat-eval.py.html,16,esptool-MDEwOlJlcG9zaXRvcnkyMzczNjkxNA==-flat-fields_15.py,yolact-MDEwOlJlcG9zaXRvcnkxMzg3OTY2OTk=-flat-eval.py,278,280,2,461,463,2
186,https://htmlpreview.github.io/?https://github.com/Christina96/boilerplate-sample-matches/blob/main/Python/sonnet-MDEwOlJlcG9zaXRvcnk4NzA2NzIxMg==-flat-mlp_test.py-sonnet-MDEwOlJlcG9zaXRvcnk4NzA2NzIxMg==-flat-mlp_test.py.html,18,sonnet-MDEwOlJlcG9zaXRvcnk4NzA2NzIxMg==-flat-mlp_test.py,sonnet-MDEwOlJlcG9zaXRvcnk4NzA2NzIxMg==-flat-mlp_test.py,81,83,2,97,99,2
187,https://htmlpreview.github.io/?https://github.com/Christina96/boilerplate-sample-matches/blob/main/Python/google-api-python-client-MDEwOlJlcG9zaXRvcnkxNTc0OTI2OQ==-flat-noxfile.py-esphome-docs-MDEwOlJlcG9zaXRvcnkxMzMyMjM0NjE=-flat-conf.py.html,15,google-api-python-client-MDEwOlJlcG9zaXRvcnkxNTc0OTI2OQ==-flat-noxfile.py,esphome-docs-MDEwOlJlcG9zaXRvcnkxMzMyMjM0NjE=-flat-conf.py,4,10,6,21,27,6
188,https://htmlpreview.github.io/?https://github.com/Christina96/boilerplate-sample-matches/blob/main/Python/sonnet-MDEwOlJlcG9zaXRvcnk4NzA2NzIxMg==-flat-goldens.py-sonnet-MDEwOlJlcG9zaXRvcnk4NzA2NzIxMg==-flat-goldens.py.html,35,sonnet-MDEwOlJlcG9zaXRvcnk4NzA2NzIxMg==-flat-goldens.py,sonnet-MDEwOlJlcG9zaXRvcnk4NzA2NzIxMg==-flat-goldens.py,256,261,5,238,243,5
189,https://htmlpreview.github.io/?https://github.com/Christina96/boilerplate-sample-matches/blob/main/Python/google-api-python-client-MDEwOlJlcG9zaXRvcnkxNTc0OTI2OQ==-flat-test_discovery.py-google-api-python-client-MDEwOlJlcG9zaXRvcnkxNTc0OTI2OQ==-flat-test_discovery.py.html,13,google-api-python-client-MDEwOlJlcG9zaXRvcnkxNTc0OTI2OQ==-flat-test_discovery.py,google-api-python-client-MDEwOlJlcG9zaXRvcnkxNTc0OTI2OQ==-flat-test_discovery.py,453,456,3,547,551,4
190,https://htmlpreview.github.io/?https://github.com/Christina96/boilerplate-sample-matches/blob/main/Python/google-api-python-client-MDEwOlJlcG9zaXRvcnkxNTc0OTI2OQ==-flat-test_json_model.py-google-api-python-client-MDEwOlJlcG9zaXRvcnkxNTc0OTI2OQ==-flat-test_json_model.py.html,14,google-api-python-client-MDEwOlJlcG9zaXRvcnkxNTc0OTI2OQ==-flat-test_json_model.py,google-api-python-client-MDEwOlJlcG9zaXRvcnkxNTc0OTI2OQ==-flat-test_json_model.py,68,70,2,90,92,2
191,https://htmlpreview.github.io/?https://github.com/Christina96/boilerplate-sample-matches/blob/main/Python/esptool-MDEwOlJlcG9zaXRvcnkyMzczNjkxNA==-flat-esp8266.py-esptool-MDEwOlJlcG9zaXRvcnkyMzczNjkxNA==-flat-esp32.py.html,19,esptool-MDEwOlJlcG9zaXRvcnkyMzczNjkxNA==-flat-esp8266.py,esptool-MDEwOlJlcG9zaXRvcnkyMzczNjkxNA==-flat-esp32.py,75,78,3,142,145,3
192,https://htmlpreview.github.io/?https://github.com/Christina96/boilerplate-sample-matches/blob/main/Python/sonnet-MDEwOlJlcG9zaXRvcnk4NzA2NzIxMg==-flat-recurrent.py-sonnet-MDEwOlJlcG9zaXRvcnk4NzA2NzIxMg==-flat-recurrent.py.html,19,sonnet-MDEwOlJlcG9zaXRvcnk4NzA2NzIxMg==-flat-recurrent.py,sonnet-MDEwOlJlcG9zaXRvcnk4NzA2NzIxMg==-flat-recurrent.py,57,59,2,189,190,1
193,https://htmlpreview.github.io/?https://github.com/Christina96/boilerplate-sample-matches/blob/main/Python/sonnet-MDEwOlJlcG9zaXRvcnk4NzA2NzIxMg==-flat-replicator_test.py-sonnet-MDEwOlJlcG9zaXRvcnk4NzA2NzIxMg==-flat-replicator_test.py.html,58,sonnet-MDEwOlJlcG9zaXRvcnk4NzA2NzIxMg==-flat-replicator_test.py,sonnet-MDEwOlJlcG9zaXRvcnk4NzA2NzIxMg==-flat-replicator_test.py,110,116,6,117,123,6
194,https://htmlpreview.github.io/?https://github.com/Christina96/boilerplate-sample-matches/blob/main/Python/seq2seq-MDEwOlJlcG9zaXRvcnk4MzczMjgwNg==-flat-bridges_test.py-Ultroid-MDEwOlJlcG9zaXRvcnkzNDEwMzg2MDI=-flat-gdrive.py.html,12,seq2seq-MDEwOlJlcG9zaXRvcnk4MzczMjgwNg==-flat-bridges_test.py,Ultroid-MDEwOlJlcG9zaXRvcnkzNDEwMzg2MDI=-flat-gdrive.py,62,64,2,84,86,2
195,https://htmlpreview.github.io/?https://github.com/Christina96/boilerplate-sample-matches/blob/main/Python/sonnet-MDEwOlJlcG9zaXRvcnk4NzA2NzIxMg==-flat-base_test.py-sonnet-MDEwOlJlcG9zaXRvcnk4NzA2NzIxMg==-flat-base_test.py.html,22,sonnet-MDEwOlJlcG9zaXRvcnk4NzA2NzIxMg==-flat-base_test.py,sonnet-MDEwOlJlcG9zaXRvcnk4NzA2NzIxMg==-flat-base_test.py,86,90,4,313,317,4
196,https://htmlpreview.github.io/?https://github.com/Christina96/boilerplate-sample-matches/blob/main/Python/esptool-MDEwOlJlcG9zaXRvcnkyMzczNjkxNA==-flat-esp32.py-esptool-MDEwOlJlcG9zaXRvcnkyMzczNjkxNA==-flat-esp32.py.html,12,esptool-MDEwOlJlcG9zaXRvcnkyMzczNjkxNA==-flat-esp32.py,esptool-MDEwOlJlcG9zaXRvcnkyMzczNjkxNA==-flat-esp32.py,160,162,2,165,167,2
197,https://htmlpreview.github.io/?https://github.com/Christina96/boilerplate-sample-matches/blob/main/Python/Ultroid-MDEwOlJlcG9zaXRvcnkzNDEwMzg2MDI=-flat-pmpermit.py-esptool-MDEwOlJlcG9zaXRvcnkyMzczNjkxNA==-flat-test_imagegen.py.html,13,Ultroid-MDEwOlJlcG9zaXRvcnkzNDEwMzg2MDI=-flat-pmpermit.py,esptool-MDEwOlJlcG9zaXRvcnkyMzczNjkxNA==-flat-test_imagegen.py,42,48,6,262,268,6
198,https://htmlpreview.github.io/?https://github.com/Christina96/boilerplate-sample-matches/blob/main/Python/google-api-python-client-MDEwOlJlcG9zaXRvcnkxNTc0OTI2OQ==-flat-model.py-wxpy-MDEwOlJlcG9zaXRvcnk4MjU4ODU5Nw==-flat-member.py.html,17,google-api-python-client-MDEwOlJlcG9zaXRvcnkxNTc0OTI2OQ==-flat-model.py,wxpy-MDEwOlJlcG9zaXRvcnk4MjU4ODU5Nw==-flat-member.py,151,154,3,17,20,3
199,https://htmlpreview.github.io/?https://github.com/Christina96/boilerplate-sample-matches/blob/main/Python/Ultroid-MDEwOlJlcG9zaXRvcnkzNDEwMzg2MDI=-flat-resize.py-sonnet-MDEwOlJlcG9zaXRvcnk4NzA2NzIxMg==-flat-control_test.py.html,12,Ultroid-MDEwOlJlcG9zaXRvcnkzNDEwMzg2MDI=-flat-resize.py,sonnet-MDEwOlJlcG9zaXRvcnk4NzA2NzIxMg==-flat-control_test.py,39,40,1,30,31,1
200,https://htmlpreview.github.io/?https://github.com/Christina96/boilerplate-sample-matches/blob/main/Python/google-api-python-client-MDEwOlJlcG9zaXRvcnkxNTc0OTI2OQ==-flat-test_json_model.py-google-api-python-client-MDEwOlJlcG9zaXRvcnkxNTc0OTI2OQ==-flat-test_json_model.py.html,18,google-api-python-client-MDEwOlJlcG9zaXRvcnkxNTc0OTI2OQ==-flat-test_json_model.py,google-api-python-client-MDEwOlJlcG9zaXRvcnkxNTc0OTI2OQ==-flat-test_json_model.py,196,201,5,200,205,5
201,https://htmlpreview.github.io/?https://github.com/Christina96/boilerplate-sample-matches/blob/main/Python/sonnet-MDEwOlJlcG9zaXRvcnk4NzA2NzIxMg==-flat-recurrent.py-sonnet-MDEwOlJlcG9zaXRvcnk4NzA2NzIxMg==-flat-recurrent.py.html,167,sonnet-MDEwOlJlcG9zaXRvcnk4NzA2NzIxMg==-flat-recurrent.py,sonnet-MDEwOlJlcG9zaXRvcnk4NzA2NzIxMg==-flat-recurrent.py,594,620,26,619,646,27
202,https://htmlpreview.github.io/?https://github.com/Christina96/boilerplate-sample-matches/blob/main/Python/Ultroid-MDEwOlJlcG9zaXRvcnkzNDEwMzg2MDI=-flat-pmpermit.py-Ultroid-MDEwOlJlcG9zaXRvcnkzNDEwMzg2MDI=-flat-pmpermit.py.html,13,Ultroid-MDEwOlJlcG9zaXRvcnkzNDEwMzg2MDI=-flat-pmpermit.py,Ultroid-MDEwOlJlcG9zaXRvcnkzNDEwMzg2MDI=-flat-pmpermit.py,201,203,2,270,272,2
203,https://htmlpreview.github.io/?https://github.com/Christina96/boilerplate-sample-matches/blob/main/Python/esptool-MDEwOlJlcG9zaXRvcnkyMzczNjkxNA==-flat-fields_25.py-esptool-MDEwOlJlcG9zaXRvcnkyMzczNjkxNA==-flat-fields_5.py.html,14,esptool-MDEwOlJlcG9zaXRvcnkyMzczNjkxNA==-flat-fields_25.py,esptool-MDEwOlJlcG9zaXRvcnkyMzczNjkxNA==-flat-fields_5.py,292,293,1,301,302,1
204,https://htmlpreview.github.io/?https://github.com/Christina96/boilerplate-sample-matches/blob/main/Python/esptool-MDEwOlJlcG9zaXRvcnkyMzczNjkxNA==-flat-esp8266.py-esptool-MDEwOlJlcG9zaXRvcnkyMzczNjkxNA==-flat-esp32.py.html,15,esptool-MDEwOlJlcG9zaXRvcnkyMzczNjkxNA==-flat-esp8266.py,esptool-MDEwOlJlcG9zaXRvcnkyMzczNjkxNA==-flat-esp32.py,33,38,5,53,57,4
205,https://htmlpreview.github.io/?https://github.com/Christina96/boilerplate-sample-matches/blob/main/Python/esptool-MDEwOlJlcG9zaXRvcnkyMzczNjkxNA==-flat-test_espsecure.py-esptool-MDEwOlJlcG9zaXRvcnkyMzczNjkxNA==-flat-test_espsecure.py.html,14,esptool-MDEwOlJlcG9zaXRvcnkyMzczNjkxNA==-flat-test_espsecure.py,esptool-MDEwOlJlcG9zaXRvcnkyMzczNjkxNA==-flat-test_espsecure.py,423,426,3,508,511,3
206,https://htmlpreview.github.io/?https://github.com/Christina96/boilerplate-sample-matches/blob/main/Python/esphome-docs-MDEwOlJlcG9zaXRvcnkxMzMyMjM0NjE=-flat-schema_doc.py-google-api-python-client-MDEwOlJlcG9zaXRvcnkxNTc0OTI2OQ==-flat-discovery.py.html,17,esphome-docs-MDEwOlJlcG9zaXRvcnkxMzMyMjM0NjE=-flat-schema_doc.py,google-api-python-client-MDEwOlJlcG9zaXRvcnkxNTc0OTI2OQ==-flat-discovery.py,322,324,2,734,736,2
207,https://htmlpreview.github.io/?https://github.com/Christina96/boilerplate-sample-matches/blob/main/Python/esptool-MDEwOlJlcG9zaXRvcnkyMzczNjkxNA==-flat-fields_15.py-esptool-MDEwOlJlcG9zaXRvcnkyMzczNjkxNA==-flat-fields_25.py.html,167,esptool-MDEwOlJlcG9zaXRvcnkyMzczNjkxNA==-flat-fields_15.py,esptool-MDEwOlJlcG9zaXRvcnkyMzczNjkxNA==-flat-fields_25.py,294,316,22,294,316,22
208,https://htmlpreview.github.io/?https://github.com/Christina96/boilerplate-sample-matches/blob/main/Python/sonnet-MDEwOlJlcG9zaXRvcnk4NzA2NzIxMg==-flat-moving_averages_test.py-sonnet-MDEwOlJlcG9zaXRvcnk4NzA2NzIxMg==-flat-moving_averages_test.py.html,14,sonnet-MDEwOlJlcG9zaXRvcnk4NzA2NzIxMg==-flat-moving_averages_test.py,sonnet-MDEwOlJlcG9zaXRvcnk4NzA2NzIxMg==-flat-moving_averages_test.py,52,53,1,21,22,1
209,https://htmlpreview.github.io/?https://github.com/Christina96/boilerplate-sample-matches/blob/main/Python/google-api-python-client-MDEwOlJlcG9zaXRvcnkxNTc0OTI2OQ==-flat-test_discovery.py-google-api-python-client-MDEwOlJlcG9zaXRvcnkxNTc0OTI2OQ==-flat-test_discovery.py.html,15,google-api-python-client-MDEwOlJlcG9zaXRvcnkxNTc0OTI2OQ==-flat-test_discovery.py,google-api-python-client-MDEwOlJlcG9zaXRvcnkxNTc0OTI2OQ==-flat-test_discovery.py,213,218,5,248,253,5
210,https://htmlpreview.github.io/?https://github.com/Christina96/boilerplate-sample-matches/blob/main/Python/sonnet-MDEwOlJlcG9zaXRvcnk4NzA2NzIxMg==-flat-axis_norm.py-sonnet-MDEwOlJlcG9zaXRvcnk4NzA2NzIxMg==-flat-group_norm.py.html,22,sonnet-MDEwOlJlcG9zaXRvcnk4NzA2NzIxMg==-flat-axis_norm.py,sonnet-MDEwOlJlcG9zaXRvcnk4NzA2NzIxMg==-flat-group_norm.py,28,33,5,28,34,6
211,https://htmlpreview.github.io/?https://github.com/Christina96/boilerplate-sample-matches/blob/main/Python/google-api-python-client-MDEwOlJlcG9zaXRvcnkxNTc0OTI2OQ==-flat-describe_9.py-google-api-python-client-MDEwOlJlcG9zaXRvcnkxNTc0OTI2OQ==-flat-describe.py.html,14,google-api-python-client-MDEwOlJlcG9zaXRvcnkxNTc0OTI2OQ==-flat-describe_9.py,google-api-python-client-MDEwOlJlcG9zaXRvcnkxNTc0OTI2OQ==-flat-describe.py,197,199,2,197,199,2
212,https://htmlpreview.github.io/?https://github.com/Christina96/boilerplate-sample-matches/blob/main/Python/Ultroid-MDEwOlJlcG9zaXRvcnkzNDEwMzg2MDI=-flat-ytdl_7.py-Ultroid-MDEwOlJlcG9zaXRvcnkzNDEwMzg2MDI=-flat-inlinestuff.py.html,12,Ultroid-MDEwOlJlcG9zaXRvcnkzNDEwMzg2MDI=-flat-ytdl_7.py,Ultroid-MDEwOlJlcG9zaXRvcnkzNDEwMzg2MDI=-flat-inlinestuff.py,38,42,4,290,294,4
213,https://htmlpreview.github.io/?https://github.com/Christina96/boilerplate-sample-matches/blob/main/Python/seq2seq-MDEwOlJlcG9zaXRvcnk4MzczMjgwNg==-flat-parallel_data_provider.py-seq2seq-MDEwOlJlcG9zaXRvcnk4MzczMjgwNg==-flat-parallel_data_provider.py.html,45,seq2seq-MDEwOlJlcG9zaXRvcnk4MzczMjgwNg==-flat-parallel_data_provider.py,seq2seq-MDEwOlJlcG9zaXRvcnk4MzczMjgwNg==-flat-parallel_data_provider.py,19,28,9,33,42,9
214,https://htmlpreview.github.io/?https://github.com/Christina96/boilerplate-sample-matches/blob/main/Python/wxpy-MDEwOlJlcG9zaXRvcnk4MjU4ODU5Nw==-flat-message.py-esptool-MDEwOlJlcG9zaXRvcnkyMzczNjkxNA==-flat-emulate_efuse_controller_base.py.html,16,wxpy-MDEwOlJlcG9zaXRvcnk4MjU4ODU5Nw==-flat-message.py,esptool-MDEwOlJlcG9zaXRvcnkyMzczNjkxNA==-flat-emulate_efuse_controller_base.py,162,164,2,78,80,2
215,https://htmlpreview.github.io/?https://github.com/Christina96/boilerplate-sample-matches/blob/main/Python/Ultroid-MDEwOlJlcG9zaXRvcnkzNDEwMzg2MDI=-flat-inlinestuff.py-sonnet-MDEwOlJlcG9zaXRvcnk4NzA2NzIxMg==-flat-utils.py.html,16,Ultroid-MDEwOlJlcG9zaXRvcnkzNDEwMzg2MDI=-flat-inlinestuff.py,sonnet-MDEwOlJlcG9zaXRvcnk4NzA2NzIxMg==-flat-utils.py,216,218,2,54,56,2
216,https://htmlpreview.github.io/?https://github.com/Christina96/boilerplate-sample-matches/blob/main/Python/Ultroid-MDEwOlJlcG9zaXRvcnkzNDEwMzg2MDI=-flat-ytdl_7.py-Ultroid-MDEwOlJlcG9zaXRvcnkzNDEwMzg2MDI=-flat-misc.py.html,13,Ultroid-MDEwOlJlcG9zaXRvcnkzNDEwMzg2MDI=-flat-ytdl_7.py,Ultroid-MDEwOlJlcG9zaXRvcnkzNDEwMzg2MDI=-flat-misc.py,214,215,1,223,224,1
217,https://htmlpreview.github.io/?https://github.com/Christina96/boilerplate-sample-matches/blob/main/Python/Ultroid-MDEwOlJlcG9zaXRvcnkzNDEwMzg2MDI=-flat-tools.py-google-api-python-client-MDEwOlJlcG9zaXRvcnkxNTc0OTI2OQ==-flat-sample_tools.py.html,13,Ultroid-MDEwOlJlcG9zaXRvcnkzNDEwMzg2MDI=-flat-tools.py,google-api-python-client-MDEwOlJlcG9zaXRvcnkxNTc0OTI2OQ==-flat-sample_tools.py,20,23,3,11,14,3
218,https://htmlpreview.github.io/?https://github.com/Christina96/boilerplate-sample-matches/blob/main/Python/seq2seq-MDEwOlJlcG9zaXRvcnk4MzczMjgwNg==-flat-hooks.py-seq2seq-MDEwOlJlcG9zaXRvcnk4MzczMjgwNg==-flat-train.py.html,12,seq2seq-MDEwOlJlcG9zaXRvcnk4MzczMjgwNg==-flat-hooks.py,seq2seq-MDEwOlJlcG9zaXRvcnk4MzczMjgwNg==-flat-train.py,76,77,1,161,163,2
219,https://htmlpreview.github.io/?https://github.com/Christina96/boilerplate-sample-matches/blob/main/Python/Ultroid-MDEwOlJlcG9zaXRvcnkzNDEwMzg2MDI=-flat-resize.py-Ultroid-MDEwOlJlcG9zaXRvcnkzNDEwMzg2MDI=-flat-stickertools.py.html,12,Ultroid-MDEwOlJlcG9zaXRvcnkzNDEwMzg2MDI=-flat-resize.py,Ultroid-MDEwOlJlcG9zaXRvcnkzNDEwMzg2MDI=-flat-stickertools.py,39,40,1,354,355,1
220,https://htmlpreview.github.io/?https://github.com/Christina96/boilerplate-sample-matches/blob/main/Python/practical-python-MDEwOlJlcG9zaXRvcnkyNjY2MTM3MDQ=-flat-stocksim.py-practical-python-MDEwOlJlcG9zaXRvcnkyNjY2MTM3MDQ=-flat-stocksim.py.html,30,practical-python-MDEwOlJlcG9zaXRvcnkyNjY2MTM3MDQ=-flat-stocksim.py,practical-python-MDEwOlJlcG9zaXRvcnkyNjY2MTM3MDQ=-flat-stocksim.py,114,116,2,120,122,2
221,https://htmlpreview.github.io/?https://github.com/Christina96/boilerplate-sample-matches/blob/main/Python/sonnet-MDEwOlJlcG9zaXRvcnk4NzA2NzIxMg==-flat-haiku_test.py-sonnet-MDEwOlJlcG9zaXRvcnk4NzA2NzIxMg==-flat-haiku_test.py.html,14,sonnet-MDEwOlJlcG9zaXRvcnk4NzA2NzIxMg==-flat-haiku_test.py,sonnet-MDEwOlJlcG9zaXRvcnk4NzA2NzIxMg==-flat-haiku_test.py,10,11,1,82,83,1
222,https://htmlpreview.github.io/?https://github.com/Christina96/boilerplate-sample-matches/blob/main/Python/seq2seq-MDEwOlJlcG9zaXRvcnk4MzczMjgwNg==-flat-decoder_test.py-seq2seq-MDEwOlJlcG9zaXRvcnk4MzczMjgwNg==-flat-decoder_test.py.html,20,seq2seq-MDEwOlJlcG9zaXRvcnk4MzczMjgwNg==-flat-decoder_test.py,seq2seq-MDEwOlJlcG9zaXRvcnk4MzczMjgwNg==-flat-decoder_test.py,29,31,2,70,72,2
223,https://htmlpreview.github.io/?https://github.com/Christina96/boilerplate-sample-matches/blob/main/Python/Ultroid-MDEwOlJlcG9zaXRvcnkzNDEwMzg2MDI=-flat-mute.py-Ultroid-MDEwOlJlcG9zaXRvcnkzNDEwMzg2MDI=-flat-ytdl_7.py.html,14,Ultroid-MDEwOlJlcG9zaXRvcnkzNDEwMzg2MDI=-flat-mute.py,Ultroid-MDEwOlJlcG9zaXRvcnkzNDEwMzg2MDI=-flat-ytdl_7.py,73,77,4,134,138,4
224,https://htmlpreview.github.io/?https://github.com/Christina96/boilerplate-sample-matches/blob/main/Python/Ultroid-MDEwOlJlcG9zaXRvcnkzNDEwMzg2MDI=-flat-globaltools.py-Ultroid-MDEwOlJlcG9zaXRvcnkzNDEwMzg2MDI=-flat-globaltools.py.html,52,Ultroid-MDEwOlJlcG9zaXRvcnkzNDEwMzg2MDI=-flat-globaltools.py,Ultroid-MDEwOlJlcG9zaXRvcnkzNDEwMzg2MDI=-flat-globaltools.py,142,157,15,225,240,15
225,https://htmlpreview.github.io/?https://github.com/Christina96/boilerplate-sample-matches/blob/main/Python/google-api-python-client-MDEwOlJlcG9zaXRvcnkxNTc0OTI2OQ==-flat-test_discovery.py-google-api-python-client-MDEwOlJlcG9zaXRvcnkxNTc0OTI2OQ==-flat-test_discovery.py.html,21,google-api-python-client-MDEwOlJlcG9zaXRvcnkxNTc0OTI2OQ==-flat-test_discovery.py,google-api-python-client-MDEwOlJlcG9zaXRvcnkxNTc0OTI2OQ==-flat-test_discovery.py,529,534,5,889,894,5
226,https://htmlpreview.github.io/?https://github.com/Christina96/boilerplate-sample-matches/blob/main/Python/yolact-MDEwOlJlcG9zaXRvcnkxMzg3OTY2OTk=-flat-augmentations.py-yolact-MDEwOlJlcG9zaXRvcnkxMzg3OTY2OTk=-flat-augmentations.py.html,15,yolact-MDEwOlJlcG9zaXRvcnkxMzg3OTY2OTk=-flat-augmentations.py,yolact-MDEwOlJlcG9zaXRvcnkxMzg3OTY2OTk=-flat-augmentations.py,101,102,1,102,103,1
227,https://htmlpreview.github.io/?https://github.com/Christina96/boilerplate-sample-matches/blob/main/Python/wxpy-MDEwOlJlcG9zaXRvcnk4MjU4ODU5Nw==-flat-bot.py-wxpy-MDEwOlJlcG9zaXRvcnk4MjU4ODU5Nw==-flat-message.py.html,14,wxpy-MDEwOlJlcG9zaXRvcnk4MjU4ODU5Nw==-flat-bot.py,wxpy-MDEwOlJlcG9zaXRvcnk4MjU4ODU5Nw==-flat-message.py,208,210,2,101,103,2
228,https://htmlpreview.github.io/?https://github.com/Christina96/boilerplate-sample-matches/blob/main/Python/esptool-MDEwOlJlcG9zaXRvcnkyMzczNjkxNA==-flat-fields_40.py-esptool-MDEwOlJlcG9zaXRvcnkyMzczNjkxNA==-flat-fields_25.py.html,18,esptool-MDEwOlJlcG9zaXRvcnkyMzczNjkxNA==-flat-fields_40.py,esptool-MDEwOlJlcG9zaXRvcnkyMzczNjkxNA==-flat-fields_25.py,101,105,4,101,105,4
229,https://htmlpreview.github.io/?https://github.com/Christina96/boilerplate-sample-matches/blob/main/Python/sonnet-MDEwOlJlcG9zaXRvcnk4NzA2NzIxMg==-flat-conv_transpose_test.py-sonnet-MDEwOlJlcG9zaXRvcnk4NzA2NzIxMg==-flat-depthwise_conv_test.py.html,105,sonnet-MDEwOlJlcG9zaXRvcnk4NzA2NzIxMg==-flat-conv_transpose_test.py,sonnet-MDEwOlJlcG9zaXRvcnk4NzA2NzIxMg==-flat-depthwise_conv_test.py,75,86,11,57,66,9
230,https://htmlpreview.github.io/?https://github.com/Christina96/boilerplate-sample-matches/blob/main/Python/sonnet-MDEwOlJlcG9zaXRvcnk4NzA2NzIxMg==-flat-momentum_test.py-sonnet-MDEwOlJlcG9zaXRvcnk4NzA2NzIxMg==-flat-adam_test.py.html,42,sonnet-MDEwOlJlcG9zaXRvcnk4NzA2NzIxMg==-flat-momentum_test.py,sonnet-MDEwOlJlcG9zaXRvcnk4NzA2NzIxMg==-flat-adam_test.py,140,143,3,110,113,3
231,https://htmlpreview.github.io/?https://github.com/Christina96/boilerplate-sample-matches/blob/main/Python/yolact-MDEwOlJlcG9zaXRvcnkxMzg3OTY2OTk=-flat-make_grid.py-yolact-MDEwOlJlcG9zaXRvcnkxMzg3OTY2OTk=-flat-make_grid.py.html,14,yolact-MDEwOlJlcG9zaXRvcnkxMzg3OTY2OTk=-flat-make_grid.py,yolact-MDEwOlJlcG9zaXRvcnkxMzg3OTY2OTk=-flat-make_grid.py,55,59,4,51,55,4
232,https://htmlpreview.github.io/?https://github.com/Christina96/boilerplate-sample-matches/blob/main/Python/esptool-MDEwOlJlcG9zaXRvcnkyMzczNjkxNA==-flat-__init__.py-seq2seq-MDEwOlJlcG9zaXRvcnk4MzczMjgwNg==-flat-generate_vocab.py.html,15,esptool-MDEwOlJlcG9zaXRvcnkyMzczNjkxNA==-flat-__init__.py,seq2seq-MDEwOlJlcG9zaXRvcnk4MzczMjgwNg==-flat-generate_vocab.py,1161,1164,3,26,29,3
233,https://htmlpreview.github.io/?https://github.com/Christina96/boilerplate-sample-matches/blob/main/Python/google-api-python-client-MDEwOlJlcG9zaXRvcnkxNTc0OTI2OQ==-flat-http.py-google-api-python-client-MDEwOlJlcG9zaXRvcnkxNTc0OTI2OQ==-flat-discovery.py.html,27,google-api-python-client-MDEwOlJlcG9zaXRvcnkxNTc0OTI2OQ==-flat-http.py,google-api-python-client-MDEwOlJlcG9zaXRvcnkxNTc0OTI2OQ==-flat-discovery.py,641,644,3,608,611,3
234,https://htmlpreview.github.io/?https://github.com/Christina96/boilerplate-sample-matches/blob/main/Python/yolact-MDEwOlJlcG9zaXRvcnkxMzg3OTY2OTk=-flat-output_utils.py-yolact-MDEwOlJlcG9zaXRvcnkxMzg3OTY2OTk=-flat-multibox_loss.py.html,16,yolact-MDEwOlJlcG9zaXRvcnkxMzg3OTY2OTk=-flat-output_utils.py,yolact-MDEwOlJlcG9zaXRvcnkxMzg3OTY2OTk=-flat-multibox_loss.py,1,4,3,1,4,3
235,https://htmlpreview.github.io/?https://github.com/Christina96/boilerplate-sample-matches/blob/main/Python/sonnet-MDEwOlJlcG9zaXRvcnk4NzA2NzIxMg==-flat-utils_test.py-sonnet-MDEwOlJlcG9zaXRvcnk4NzA2NzIxMg==-flat-mlp_test.py.html,12,sonnet-MDEwOlJlcG9zaXRvcnk4NzA2NzIxMg==-flat-utils_test.py,sonnet-MDEwOlJlcG9zaXRvcnk4NzA2NzIxMg==-flat-mlp_test.py,106,107,1,28,29,1
236,https://htmlpreview.github.io/?https://github.com/Christina96/boilerplate-sample-matches/blob/main/Python/practical-python-MDEwOlJlcG9zaXRvcnkyNjY2MTM3MDQ=-flat-test_stock_78.py-practical-python-MDEwOlJlcG9zaXRvcnkyNjY2MTM3MDQ=-flat-test_stock_112.py.html,18,practical-python-MDEwOlJlcG9zaXRvcnkyNjY2MTM3MDQ=-flat-test_stock_78.py,practical-python-MDEwOlJlcG9zaXRvcnkyNjY2MTM3MDQ=-flat-test_stock_112.py,18,21,3,18,21,3
237,https://htmlpreview.github.io/?https://github.com/Christina96/boilerplate-sample-matches/blob/main/Python/sonnet-MDEwOlJlcG9zaXRvcnk4NzA2NzIxMg==-flat-replicator_test.py-sonnet-MDEwOlJlcG9zaXRvcnk4NzA2NzIxMg==-flat-replicator_test.py.html,36,sonnet-MDEwOlJlcG9zaXRvcnk4NzA2NzIxMg==-flat-replicator_test.py,sonnet-MDEwOlJlcG9zaXRvcnk4NzA2NzIxMg==-flat-replicator_test.py,49,55,6,41,47,6
238,https://htmlpreview.github.io/?https://github.com/Christina96/boilerplate-sample-matches/blob/main/Python/seq2seq-MDEwOlJlcG9zaXRvcnk4MzczMjgwNg==-flat-generate_beam_viz.py-seq2seq-MDEwOlJlcG9zaXRvcnk4MzczMjgwNg==-flat-generate_beam_viz.py.html,18,seq2seq-MDEwOlJlcG9zaXRvcnk4MzczMjgwNg==-flat-generate_beam_viz.py,seq2seq-MDEwOlJlcG9zaXRvcnk4MzczMjgwNg==-flat-generate_beam_viz.py,59,61,2,60,62,2
239,https://htmlpreview.github.io/?https://github.com/Christina96/boilerplate-sample-matches/blob/main/Python/sonnet-MDEwOlJlcG9zaXRvcnk4NzA2NzIxMg==-flat-util_test.py-sonnet-MDEwOlJlcG9zaXRvcnk4NzA2NzIxMg==-flat-util_test.py.html,46,sonnet-MDEwOlJlcG9zaXRvcnk4NzA2NzIxMg==-flat-util_test.py,sonnet-MDEwOlJlcG9zaXRvcnk4NzA2NzIxMg==-flat-util_test.py,14,21,7,31,38,7
240,https://htmlpreview.github.io/?https://github.com/Christina96/boilerplate-sample-matches/blob/main/Python/esptool-MDEwOlJlcG9zaXRvcnkyMzczNjkxNA==-flat-test_espefuse.py-esptool-MDEwOlJlcG9zaXRvcnkyMzczNjkxNA==-flat-test_espefuse.py.html,15,esptool-MDEwOlJlcG9zaXRvcnkyMzczNjkxNA==-flat-test_espefuse.py,esptool-MDEwOlJlcG9zaXRvcnkyMzczNjkxNA==-flat-test_espefuse.py,462,466,4,309,313,4
241,https://htmlpreview.github.io/?https://github.com/Christina96/boilerplate-sample-matches/blob/main/Python/sonnet-MDEwOlJlcG9zaXRvcnk4NzA2NzIxMg==-flat-batch_norm_test.py-esptool-MDEwOlJlcG9zaXRvcnkyMzczNjkxNA==-flat-test_esptool.py.html,12,sonnet-MDEwOlJlcG9zaXRvcnk4NzA2NzIxMg==-flat-batch_norm_test.py,esptool-MDEwOlJlcG9zaXRvcnkyMzczNjkxNA==-flat-test_esptool.py,81,83,2,605,607,2
242,https://htmlpreview.github.io/?https://github.com/Christina96/boilerplate-sample-matches/blob/main/Python/Ultroid-MDEwOlJlcG9zaXRvcnkzNDEwMzg2MDI=-flat-info.py-Ultroid-MDEwOlJlcG9zaXRvcnkzNDEwMzg2MDI=-flat-info.py.html,25,Ultroid-MDEwOlJlcG9zaXRvcnkzNDEwMzg2MDI=-flat-info.py,Ultroid-MDEwOlJlcG9zaXRvcnkzNDEwMzg2MDI=-flat-info.py,56,59,3,61,64,3
243,https://htmlpreview.github.io/?https://github.com/Christina96/boilerplate-sample-matches/blob/main/Python/sonnet-MDEwOlJlcG9zaXRvcnk4NzA2NzIxMg==-flat-conv_transpose_test.py-sonnet-MDEwOlJlcG9zaXRvcnk4NzA2NzIxMg==-flat-conv_transpose_test.py.html,12,sonnet-MDEwOlJlcG9zaXRvcnk4NzA2NzIxMg==-flat-conv_transpose_test.py,sonnet-MDEwOlJlcG9zaXRvcnk4NzA2NzIxMg==-flat-conv_transpose_test.py,57,60,3,200,203,3
244,https://htmlpreview.github.io/?https://github.com/Christina96/boilerplate-sample-matches/blob/main/Python/esptool-MDEwOlJlcG9zaXRvcnkyMzczNjkxNA==-flat-reset.py-yolact-MDEwOlJlcG9zaXRvcnkxMzg3OTY2OTk=-flat-eval.py.html,14,esptool-MDEwOlJlcG9zaXRvcnkyMzczNjkxNA==-flat-reset.py,yolact-MDEwOlJlcG9zaXRvcnkxMzg3OTY2OTk=-flat-eval.py,79,82,3,569,572,3
245,https://htmlpreview.github.io/?https://github.com/Christina96/boilerplate-sample-matches/blob/main/Python/esptool-MDEwOlJlcG9zaXRvcnkyMzczNjkxNA==-flat-__init__.py-esptool-MDEwOlJlcG9zaXRvcnkyMzczNjkxNA==-flat-__init__.py.html,32,esptool-MDEwOlJlcG9zaXRvcnkyMzczNjkxNA==-flat-__init__.py,esptool-MDEwOlJlcG9zaXRvcnkyMzczNjkxNA==-flat-__init__.py,332,339,7,578,585,7
246,https://htmlpreview.github.io/?https://github.com/Christina96/boilerplate-sample-matches/blob/main/Python/esptool-MDEwOlJlcG9zaXRvcnkyMzczNjkxNA==-flat-base_fields.py-esptool-MDEwOlJlcG9zaXRvcnkyMzczNjkxNA==-flat-base_fields.py.html,16,esptool-MDEwOlJlcG9zaXRvcnkyMzczNjkxNA==-flat-base_fields.py,esptool-MDEwOlJlcG9zaXRvcnkyMzczNjkxNA==-flat-base_fields.py,134,136,2,141,143,2
247,https://htmlpreview.github.io/?https://github.com/Christina96/boilerplate-sample-matches/blob/main/Python/Ultroid-MDEwOlJlcG9zaXRvcnkzNDEwMzg2MDI=-flat-_decorators.py-Ultroid-MDEwOlJlcG9zaXRvcnkzNDEwMzg2MDI=-flat-__init__.py.html,16,Ultroid-MDEwOlJlcG9zaXRvcnkzNDEwMzg2MDI=-flat-_decorators.py,Ultroid-MDEwOlJlcG9zaXRvcnkzNDEwMzg2MDI=-flat-__init__.py,41,43,2,30,32,2
248,https://htmlpreview.github.io/?https://github.com/Christina96/boilerplate-sample-matches/blob/main/Python/google-api-python-client-MDEwOlJlcG9zaXRvcnkxNTc0OTI2OQ==-flat-describe_9.py-google-api-python-client-MDEwOlJlcG9zaXRvcnkxNTc0OTI2OQ==-flat-describe.py.html,729,google-api-python-client-MDEwOlJlcG9zaXRvcnkxNTc0OTI2OQ==-flat-describe_9.py,google-api-python-client-MDEwOlJlcG9zaXRvcnkxNTc0OTI2OQ==-flat-describe.py,158,291,133,158,291,133
249,https://htmlpreview.github.io/?https://github.com/Christina96/boilerplate-sample-matches/blob/main/Python/Ultroid-MDEwOlJlcG9zaXRvcnkzNDEwMzg2MDI=-flat-specialtools.py-Ultroid-MDEwOlJlcG9zaXRvcnkzNDEwMzg2MDI=-flat-loader_1.py.html,13,Ultroid-MDEwOlJlcG9zaXRvcnkzNDEwMzg2MDI=-flat-specialtools.py,Ultroid-MDEwOlJlcG9zaXRvcnkzNDEwMzg2MDI=-flat-loader_1.py,174,177,3,67,70,3
250,https://htmlpreview.github.io/?https://github.com/Christina96/boilerplate-sample-matches/blob/main/Python/google-api-python-client-MDEwOlJlcG9zaXRvcnkxNTc0OTI2OQ==-flat-get_all_url_channels.py-google-api-python-client-MDEwOlJlcG9zaXRvcnkxNTc0OTI2OQ==-flat-get_all_ad_units.py.html,36,google-api-python-client-MDEwOlJlcG9zaXRvcnkxNTc0OTI2OQ==-flat-get_all_url_channels.py,google-api-python-client-MDEwOlJlcG9zaXRvcnkxNTc0OTI2OQ==-flat-get_all_ad_units.py,26,35,9,26,35,9
251,https://htmlpreview.github.io/?https://github.com/Christina96/boilerplate-sample-matches/blob/main/Python/Ultroid-MDEwOlJlcG9zaXRvcnkzNDEwMzg2MDI=-flat-stickertools.py-Ultroid-MDEwOlJlcG9zaXRvcnkzNDEwMzg2MDI=-flat-misc_15.py.html,13,Ultroid-MDEwOlJlcG9zaXRvcnkzNDEwMzg2MDI=-flat-stickertools.py,Ultroid-MDEwOlJlcG9zaXRvcnkzNDEwMzg2MDI=-flat-misc_15.py,184,187,3,16,19,3
252,https://htmlpreview.github.io/?https://github.com/Christina96/boilerplate-sample-matches/blob/main/Python/google-api-python-client-MDEwOlJlcG9zaXRvcnkxNTc0OTI2OQ==-flat-updatediscoveryartifacts.py-seq2seq-MDEwOlJlcG9zaXRvcnk4MzczMjgwNg==-flat-profile.py.html,12,google-api-python-client-MDEwOlJlcG9zaXRvcnkxNTc0OTI2OQ==-flat-updatediscoveryartifacts.py,seq2seq-MDEwOlJlcG9zaXRvcnk4MzczMjgwNg==-flat-profile.py,20,23,3,123,126,3
253,https://htmlpreview.github.io/?https://github.com/Christina96/boilerplate-sample-matches/blob/main/Python/sonnet-MDEwOlJlcG9zaXRvcnk4NzA2NzIxMg==-flat-initializers_test.py-sonnet-MDEwOlJlcG9zaXRvcnk4NzA2NzIxMg==-flat-initializers_test.py.html,35,sonnet-MDEwOlJlcG9zaXRvcnk4NzA2NzIxMg==-flat-initializers_test.py,sonnet-MDEwOlJlcG9zaXRvcnk4NzA2NzIxMg==-flat-initializers_test.py,373,378,5,352,357,5
254,https://htmlpreview.github.io/?https://github.com/Christina96/boilerplate-sample-matches/blob/main/Python/seq2seq-MDEwOlJlcG9zaXRvcnk4MzczMjgwNg==-flat-hooks_test.py-seq2seq-MDEwOlJlcG9zaXRvcnk4MzczMjgwNg==-flat-hooks_test.py.html,32,seq2seq-MDEwOlJlcG9zaXRvcnk4MzczMjgwNg==-flat-hooks_test.py,seq2seq-MDEwOlJlcG9zaXRvcnk4MzczMjgwNg==-flat-hooks_test.py,41,44,3,79,82,3
255,https://htmlpreview.github.io/?https://github.com/Christina96/boilerplate-sample-matches/blob/main/Python/sonnet-MDEwOlJlcG9zaXRvcnk4NzA2NzIxMg==-flat-rmsprop_test.py-yolact-MDEwOlJlcG9zaXRvcnkxMzg3OTY2OTk=-flat-test.py.html,16,sonnet-MDEwOlJlcG9zaXRvcnk4NzA2NzIxMg==-flat-rmsprop_test.py,yolact-MDEwOlJlcG9zaXRvcnkxMzg3OTY2OTk=-flat-test.py,6,8,2,33,35,2
256,https://htmlpreview.github.io/?https://github.com/Christina96/boilerplate-sample-matches/blob/main/Python/esptool-MDEwOlJlcG9zaXRvcnkyMzczNjkxNA==-flat-bin_image.py-esptool-MDEwOlJlcG9zaXRvcnkyMzczNjkxNA==-flat-bin_image.py.html,52,esptool-MDEwOlJlcG9zaXRvcnkyMzczNjkxNA==-flat-bin_image.py,esptool-MDEwOlJlcG9zaXRvcnkyMzczNjkxNA==-flat-bin_image.py,433,443,10,584,594,10
257,https://htmlpreview.github.io/?https://github.com/Christina96/boilerplate-sample-matches/blob/main/Python/sonnet-MDEwOlJlcG9zaXRvcnk4NzA2NzIxMg==-flat-control_test.py-sonnet-MDEwOlJlcG9zaXRvcnk4NzA2NzIxMg==-flat-control_test.py.html,20,sonnet-MDEwOlJlcG9zaXRvcnk4NzA2NzIxMg==-flat-control_test.py,sonnet-MDEwOlJlcG9zaXRvcnk4NzA2NzIxMg==-flat-control_test.py,28,30,2,17,19,2
258,https://htmlpreview.github.io/?https://github.com/Christina96/boilerplate-sample-matches/blob/main/Python/yolact-MDEwOlJlcG9zaXRvcnkxMzg3OTY2OTk=-flat-augmentations.py-yolact-MDEwOlJlcG9zaXRvcnkxMzg3OTY2OTk=-flat-augmentations.py.html,28,yolact-MDEwOlJlcG9zaXRvcnkxMzg3OTY2OTk=-flat-augmentations.py,yolact-MDEwOlJlcG9zaXRvcnkxMzg3OTY2OTk=-flat-augmentations.py,350,354,4,385,389,4
259,https://htmlpreview.github.io/?https://github.com/Christina96/boilerplate-sample-matches/blob/main/Python/seq2seq-MDEwOlJlcG9zaXRvcnk4MzczMjgwNg==-flat-rnn_cell_test.py-seq2seq-MDEwOlJlcG9zaXRvcnk4MzczMjgwNg==-flat-rnn_cell_test.py.html,20,seq2seq-MDEwOlJlcG9zaXRvcnk4MzczMjgwNg==-flat-rnn_cell_test.py,seq2seq-MDEwOlJlcG9zaXRvcnk4MzczMjgwNg==-flat-rnn_cell_test.py,24,25,1,25,26,1
260,https://htmlpreview.github.io/?https://github.com/Christina96/boilerplate-sample-matches/blob/main/Python/wxpy-MDEwOlJlcG9zaXRvcnk4MjU4ODU5Nw==-flat-chats.py-wxpy-MDEwOlJlcG9zaXRvcnk4MjU4ODU5Nw==-flat-chats.py.html,13,wxpy-MDEwOlJlcG9zaXRvcnk4MjU4ODU5Nw==-flat-chats.py,wxpy-MDEwOlJlcG9zaXRvcnk4MjU4ODU5Nw==-flat-chats.py,64,66,2,66,68,2
261,https://htmlpreview.github.io/?https://github.com/Christina96/boilerplate-sample-matches/blob/main/Python/google-api-python-client-MDEwOlJlcG9zaXRvcnkxNTc0OTI2OQ==-flat-samples-index.py-practical-python-MDEwOlJlcG9zaXRvcnkyNjY2MTM3MDQ=-flat-typedproperty.py.html,16,google-api-python-client-MDEwOlJlcG9zaXRvcnkxNTc0OTI2OQ==-flat-samples-index.py,practical-python-MDEwOlJlcG9zaXRvcnkyNjY2MTM3MDQ=-flat-typedproperty.py,82,84,2,18,20,2
262,https://htmlpreview.github.io/?https://github.com/Christina96/boilerplate-sample-matches/blob/main/Python/practical-python-MDEwOlJlcG9zaXRvcnkyNjY2MTM3MDQ=-flat-typedproperty_60.py-practical-python-MDEwOlJlcG9zaXRvcnkyNjY2MTM3MDQ=-flat-typedproperty.py.html,70,practical-python-MDEwOlJlcG9zaXRvcnkyNjY2MTM3MDQ=-flat-typedproperty_60.py,practical-python-MDEwOlJlcG9zaXRvcnkyNjY2MTM3MDQ=-flat-typedproperty.py,14,24,10,14,24,10
263,https://htmlpreview.github.io/?https://github.com/Christina96/boilerplate-sample-matches/blob/main/Python/esptool-MDEwOlJlcG9zaXRvcnkyMzczNjkxNA==-flat-cmds.py-esptool-MDEwOlJlcG9zaXRvcnkyMzczNjkxNA==-flat-cmds.py.html,45,esptool-MDEwOlJlcG9zaXRvcnkyMzczNjkxNA==-flat-cmds.py,esptool-MDEwOlJlcG9zaXRvcnkyMzczNjkxNA==-flat-cmds.py,228,236,8,235,243,8
264,https://htmlpreview.github.io/?https://github.com/Christina96/boilerplate-sample-matches/blob/main/Python/esptool-MDEwOlJlcG9zaXRvcnkyMzczNjkxNA==-flat-test_esptool.py-esptool-MDEwOlJlcG9zaXRvcnkyMzczNjkxNA==-flat-test_esptool.py.html,16,esptool-MDEwOlJlcG9zaXRvcnkyMzczNjkxNA==-flat-test_esptool.py,esptool-MDEwOlJlcG9zaXRvcnkyMzczNjkxNA==-flat-test_esptool.py,267,269,2,483,485,2
265,https://htmlpreview.github.io/?https://github.com/Christina96/boilerplate-sample-matches/blob/main/Python/google-api-python-client-MDEwOlJlcG9zaXRvcnkxNTc0OTI2OQ==-flat-test_discovery.py-google-api-python-client-MDEwOlJlcG9zaXRvcnkxNTc0OTI2OQ==-flat-test_discovery.py.html,13,google-api-python-client-MDEwOlJlcG9zaXRvcnkxNTc0OTI2OQ==-flat-test_discovery.py,google-api-python-client-MDEwOlJlcG9zaXRvcnkxNTc0OTI2OQ==-flat-test_discovery.py,897,901,4,944,948,4
266,https://htmlpreview.github.io/?https://github.com/Christina96/boilerplate-sample-matches/blob/main/Python/sonnet-MDEwOlJlcG9zaXRvcnk4NzA2NzIxMg==-flat-vqvae_test.py-sonnet-MDEwOlJlcG9zaXRvcnk4NzA2NzIxMg==-flat-vqvae_test.py.html,55,sonnet-MDEwOlJlcG9zaXRvcnk4NzA2NzIxMg==-flat-vqvae_test.py,sonnet-MDEwOlJlcG9zaXRvcnk4NzA2NzIxMg==-flat-vqvae_test.py,38,49,11,9,20,11
267,https://htmlpreview.github.io/?https://github.com/Christina96/boilerplate-sample-matches/blob/main/Python/esptool-MDEwOlJlcG9zaXRvcnkyMzczNjkxNA==-flat-fields_5.py-esptool-MDEwOlJlcG9zaXRvcnkyMzczNjkxNA==-flat-fields_15.py.html,62,esptool-MDEwOlJlcG9zaXRvcnkyMzczNjkxNA==-flat-fields_5.py,esptool-MDEwOlJlcG9zaXRvcnkyMzczNjkxNA==-flat-fields_15.py,218,228,10,218,228,10
268,https://htmlpreview.github.io/?https://github.com/Christina96/boilerplate-sample-matches/blob/main/Python/sonnet-MDEwOlJlcG9zaXRvcnk4NzA2NzIxMg==-flat-conv.py-sonnet-MDEwOlJlcG9zaXRvcnk4NzA2NzIxMg==-flat-cifar10_convnet.py.html,16,sonnet-MDEwOlJlcG9zaXRvcnk4NzA2NzIxMg==-flat-conv.py,sonnet-MDEwOlJlcG9zaXRvcnk4NzA2NzIxMg==-flat-cifar10_convnet.py,52,55,3,59,62,3
269,https://htmlpreview.github.io/?https://github.com/Christina96/boilerplate-sample-matches/blob/main/Python/Ultroid-MDEwOlJlcG9zaXRvcnkzNDEwMzg2MDI=-flat-bot.py-Ultroid-MDEwOlJlcG9zaXRvcnkzNDEwMzg2MDI=-flat-bot.py.html,24,Ultroid-MDEwOlJlcG9zaXRvcnkzNDEwMzg2MDI=-flat-bot.py,Ultroid-MDEwOlJlcG9zaXRvcnkzNDEwMzg2MDI=-flat-bot.py,97,101,4,111,115,4
270,https://htmlpreview.github.io/?https://github.com/Christina96/boilerplate-sample-matches/blob/main/Python/Ultroid-MDEwOlJlcG9zaXRvcnkzNDEwMzg2MDI=-flat-utilities.py-Ultroid-MDEwOlJlcG9zaXRvcnkzNDEwMzg2MDI=-flat-utilities.py.html,23,Ultroid-MDEwOlJlcG9zaXRvcnkzNDEwMzg2MDI=-flat-utilities.py,Ultroid-MDEwOlJlcG9zaXRvcnkzNDEwMzg2MDI=-flat-utilities.py,110,115,5,118,123,5
271,https://htmlpreview.github.io/?https://github.com/Christina96/boilerplate-sample-matches/blob/main/Python/esptool-MDEwOlJlcG9zaXRvcnkyMzczNjkxNA==-flat-test_espsecure.py-esptool-MDEwOlJlcG9zaXRvcnkyMzczNjkxNA==-flat-test_imagegen.py.html,13,esptool-MDEwOlJlcG9zaXRvcnkyMzczNjkxNA==-flat-test_espsecure.py,esptool-MDEwOlJlcG9zaXRvcnkyMzczNjkxNA==-flat-test_imagegen.py,772,773,1,311,313,2
272,https://htmlpreview.github.io/?https://github.com/Christina96/boilerplate-sample-matches/blob/main/Python/esptool-MDEwOlJlcG9zaXRvcnkyMzczNjkxNA==-flat-test_esptool.py-esptool-MDEwOlJlcG9zaXRvcnkyMzczNjkxNA==-flat-test_esptool.py.html,17,esptool-MDEwOlJlcG9zaXRvcnkyMzczNjkxNA==-flat-test_esptool.py,esptool-MDEwOlJlcG9zaXRvcnkyMzczNjkxNA==-flat-test_esptool.py,672,676,4,737,741,4
273,https://htmlpreview.github.io/?https://github.com/Christina96/boilerplate-sample-matches/blob/main/Python/google-api-python-client-MDEwOlJlcG9zaXRvcnkxNTc0OTI2OQ==-flat-test_json_model.py-google-api-python-client-MDEwOlJlcG9zaXRvcnkxNTc0OTI2OQ==-flat-test_protobuf_model.py.html,42,google-api-python-client-MDEwOlJlcG9zaXRvcnkxNTc0OTI2OQ==-flat-test_json_model.py,google-api-python-client-MDEwOlJlcG9zaXRvcnkxNTc0OTI2OQ==-flat-test_protobuf_model.py,26,31,5,28,33,5
274,https://htmlpreview.github.io/?https://github.com/Christina96/boilerplate-sample-matches/blob/main/Python/Ultroid-MDEwOlJlcG9zaXRvcnkzNDEwMzg2MDI=-flat-stickertools.py-Ultroid-MDEwOlJlcG9zaXRvcnkzNDEwMzg2MDI=-flat-ziptools.py.html,23,Ultroid-MDEwOlJlcG9zaXRvcnkzNDEwMzg2MDI=-flat-stickertools.py,Ultroid-MDEwOlJlcG9zaXRvcnkzNDEwMzg2MDI=-flat-ziptools.py,37,44,7,9,16,7
275,https://htmlpreview.github.io/?https://github.com/Christina96/boilerplate-sample-matches/blob/main/Python/seq2seq-MDEwOlJlcG9zaXRvcnk4MzczMjgwNg==-flat-data_test.py-seq2seq-MDEwOlJlcG9zaXRvcnk4MzczMjgwNg==-flat-data_test.py.html,46,seq2seq-MDEwOlJlcG9zaXRvcnk4MzczMjgwNg==-flat-data_test.py,seq2seq-MDEwOlJlcG9zaXRvcnk4MzczMjgwNg==-flat-data_test.py,54,61,7,87,92,5
276,https://htmlpreview.github.io/?https://github.com/Christina96/boilerplate-sample-matches/blob/main/Python/google-api-python-client-MDEwOlJlcG9zaXRvcnkxNTc0OTI2OQ==-flat-generate_report.py-google-api-python-client-MDEwOlJlcG9zaXRvcnkxNTc0OTI2OQ==-flat-generate_report_with_paging.py.html,45,google-api-python-client-MDEwOlJlcG9zaXRvcnkxNTc0OTI2OQ==-flat-generate_report.py,google-api-python-client-MDEwOlJlcG9zaXRvcnkxNTc0OTI2OQ==-flat-generate_report_with_paging.py,38,52,14,33,47,14
277,https://htmlpreview.github.io/?https://github.com/Christina96/boilerplate-sample-matches/blob/main/Python/Ultroid-MDEwOlJlcG9zaXRvcnkzNDEwMzg2MDI=-flat-callbackstuffs.py-Ultroid-MDEwOlJlcG9zaXRvcnkzNDEwMzg2MDI=-flat-callbackstuffs.py.html,22,Ultroid-MDEwOlJlcG9zaXRvcnkzNDEwMzg2MDI=-flat-callbackstuffs.py,Ultroid-MDEwOlJlcG9zaXRvcnkzNDEwMzg2MDI=-flat-callbackstuffs.py,595,599,4,1092,1095,3
278,https://htmlpreview.github.io/?https://github.com/Christina96/boilerplate-sample-matches/blob/main/Python/sonnet-MDEwOlJlcG9zaXRvcnk4NzA2NzIxMg==-flat-function_test.py-wxpy-MDEwOlJlcG9zaXRvcnk4MjU4ODU5Nw==-flat-conf.py.html,15,sonnet-MDEwOlJlcG9zaXRvcnk4NzA2NzIxMg==-flat-function_test.py,wxpy-MDEwOlJlcG9zaXRvcnk4MjU4ODU5Nw==-flat-conf.py,9,12,3,23,26,3
279,https://htmlpreview.github.io/?https://github.com/Christina96/boilerplate-sample-matches/blob/main/Python/esptool-MDEwOlJlcG9zaXRvcnkyMzczNjkxNA==-flat-execute_efuse_script_45.py-esptool-MDEwOlJlcG9zaXRvcnkyMzczNjkxNA==-flat-execute_efuse_script_45.py.html,26,esptool-MDEwOlJlcG9zaXRvcnkyMzczNjkxNA==-flat-execute_efuse_script_45.py,esptool-MDEwOlJlcG9zaXRvcnkyMzczNjkxNA==-flat-execute_efuse_script_45.py,41,42,1,19,21,2
280,https://htmlpreview.github.io/?https://github.com/Christina96/boilerplate-sample-matches/blob/main/Python/sonnet-MDEwOlJlcG9zaXRvcnk4NzA2NzIxMg==-flat-adam_test.py-sonnet-MDEwOlJlcG9zaXRvcnk4NzA2NzIxMg==-flat-momentum_test.py.html,26,sonnet-MDEwOlJlcG9zaXRvcnk4NzA2NzIxMg==-flat-adam_test.py,sonnet-MDEwOlJlcG9zaXRvcnk4NzA2NzIxMg==-flat-momentum_test.py,5,7,2,5,7,2
281,https://htmlpreview.github.io/?https://github.com/Christina96/boilerplate-sample-matches/blob/main/Python/Ultroid-MDEwOlJlcG9zaXRvcnkzNDEwMzg2MDI=-flat-loader_1.py-Ultroid-MDEwOlJlcG9zaXRvcnkzNDEwMzg2MDI=-flat-loader_1.py.html,12,Ultroid-MDEwOlJlcG9zaXRvcnkzNDEwMzg2MDI=-flat-loader_1.py,Ultroid-MDEwOlJlcG9zaXRvcnkzNDEwMzg2MDI=-flat-loader_1.py,70,71,1,38,39,1
282,https://htmlpreview.github.io/?https://github.com/Christina96/boilerplate-sample-matches/blob/main/Python/Ultroid-MDEwOlJlcG9zaXRvcnkzNDEwMzg2MDI=-flat-_supporter.py-Ultroid-MDEwOlJlcG9zaXRvcnkzNDEwMzg2MDI=-flat-_supporter.py.html,26,Ultroid-MDEwOlJlcG9zaXRvcnkzNDEwMzg2MDI=-flat-_supporter.py,Ultroid-MDEwOlJlcG9zaXRvcnkzNDEwMzg2MDI=-flat-_supporter.py,19,23,4,35,39,4
283,https://htmlpreview.github.io/?https://github.com/Christina96/boilerplate-sample-matches/blob/main/Python/esptool-MDEwOlJlcG9zaXRvcnkyMzczNjkxNA==-flat-bin_image.py-esptool-MDEwOlJlcG9zaXRvcnkyMzczNjkxNA==-flat-operations_27.py.html,12,esptool-MDEwOlJlcG9zaXRvcnkyMzczNjkxNA==-flat-bin_image.py,esptool-MDEwOlJlcG9zaXRvcnkyMzczNjkxNA==-flat-operations_27.py,824,825,1,349,350,1
284,https://htmlpreview.github.io/?https://github.com/Christina96/boilerplate-sample-matches/blob/main/Python/google-api-python-client-MDEwOlJlcG9zaXRvcnkxNTc0OTI2OQ==-flat-blogger.py-google-api-python-client-MDEwOlJlcG9zaXRvcnkxNTc0OTI2OQ==-flat-blogger.py.html,14,google-api-python-client-MDEwOlJlcG9zaXRvcnkxNTc0OTI2OQ==-flat-blogger.py,google-api-python-client-MDEwOlJlcG9zaXRvcnkxNTc0OTI2OQ==-flat-blogger.py,18,19,1,21,22,1
285,https://htmlpreview.github.io/?https://github.com/Christina96/boilerplate-sample-matches/blob/main/Python/google-api-python-client-MDEwOlJlcG9zaXRvcnkxNTc0OTI2OQ==-flat-describe_9.py-google-api-python-client-MDEwOlJlcG9zaXRvcnkxNTc0OTI2OQ==-flat-describe.py.html,207,google-api-python-client-MDEwOlJlcG9zaXRvcnkxNTc0OTI2OQ==-flat-describe_9.py,google-api-python-client-MDEwOlJlcG9zaXRvcnkxNTc0OTI2OQ==-flat-describe.py,256,291,35,256,291,35
286,https://htmlpreview.github.io/?https://github.com/Christina96/boilerplate-sample-matches/blob/main/Python/esptool-MDEwOlJlcG9zaXRvcnkyMzczNjkxNA==-flat-test_espsecure.py-esptool-MDEwOlJlcG9zaXRvcnkyMzczNjkxNA==-flat-test_espsecure.py.html,58,esptool-MDEwOlJlcG9zaXRvcnkyMzczNjkxNA==-flat-test_espsecure.py,esptool-MDEwOlJlcG9zaXRvcnkyMzczNjkxNA==-flat-test_espsecure.py,149,162,13,362,375,13
287,https://htmlpreview.github.io/?https://github.com/Christina96/boilerplate-sample-matches/blob/main/Python/google-api-python-client-MDEwOlJlcG9zaXRvcnkxNTc0OTI2OQ==-flat-test_discovery.py-google-api-python-client-MDEwOlJlcG9zaXRvcnkxNTc0OTI2OQ==-flat-test_discovery.py.html,30,google-api-python-client-MDEwOlJlcG9zaXRvcnkxNTc0OTI2OQ==-flat-test_discovery.py,google-api-python-client-MDEwOlJlcG9zaXRvcnkxNTc0OTI2OQ==-flat-test_discovery.py,284,289,5,297,302,5
288,https://htmlpreview.github.io/?https://github.com/Christina96/boilerplate-sample-matches/blob/main/Python/seq2seq-MDEwOlJlcG9zaXRvcnk4MzczMjgwNg==-flat-metrics_test.py-seq2seq-MDEwOlJlcG9zaXRvcnk4MzczMjgwNg==-flat-metrics_test.py.html,32,seq2seq-MDEwOlJlcG9zaXRvcnk4MzczMjgwNg==-flat-metrics_test.py,seq2seq-MDEwOlJlcG9zaXRvcnk4MzczMjgwNg==-flat-metrics_test.py,86,92,6,120,126,6
289,https://htmlpreview.github.io/?https://github.com/Christina96/boilerplate-sample-matches/blob/main/Python/Ultroid-MDEwOlJlcG9zaXRvcnkzNDEwMzg2MDI=-flat-FastTelethon.py-esptool-MDEwOlJlcG9zaXRvcnkyMzczNjkxNA==-flat-__init___2.py.html,12,Ultroid-MDEwOlJlcG9zaXRvcnkzNDEwMzg2MDI=-flat-FastTelethon.py,esptool-MDEwOlJlcG9zaXRvcnkyMzczNjkxNA==-flat-__init___2.py,228,231,3,168,171,3
290,https://htmlpreview.github.io/?https://github.com/Christina96/boilerplate-sample-matches/blob/main/Python/Ultroid-MDEwOlJlcG9zaXRvcnkzNDEwMzg2MDI=-flat-converter.py-Ultroid-MDEwOlJlcG9zaXRvcnkzNDEwMzg2MDI=-flat-afk_12.py.html,13,Ultroid-MDEwOlJlcG9zaXRvcnkzNDEwMzg2MDI=-flat-converter.py,Ultroid-MDEwOlJlcG9zaXRvcnkzNDEwMzg2MDI=-flat-afk_12.py,22,28,6,14,20,6
291,https://htmlpreview.github.io/?https://github.com/Christina96/boilerplate-sample-matches/blob/main/Python/google-api-python-client-MDEwOlJlcG9zaXRvcnkxNTc0OTI2OQ==-flat-test_channel.py-google-api-python-client-MDEwOlJlcG9zaXRvcnkxNTc0OTI2OQ==-flat-test_channel.py.html,35,google-api-python-client-MDEwOlJlcG9zaXRvcnkxNTc0OTI2OQ==-flat-test_channel.py,google-api-python-client-MDEwOlJlcG9zaXRvcnkxNTc0OTI2OQ==-flat-test_channel.py,8,18,10,85,95,10
292,https://htmlpreview.github.io/?https://github.com/Christina96/boilerplate-sample-matches/blob/main/Python/sonnet-MDEwOlJlcG9zaXRvcnk4NzA2NzIxMg==-flat-distributed_batch_norm.py-wxpy-MDEwOlJlcG9zaXRvcnk4MjU4ODU5Nw==-flat-misc.py.html,14,sonnet-MDEwOlJlcG9zaXRvcnk4NzA2NzIxMg==-flat-distributed_batch_norm.py,wxpy-MDEwOlJlcG9zaXRvcnk4MjU4ODU5Nw==-flat-misc.py,49,51,2,160,162,2
293,https://htmlpreview.github.io/?https://github.com/Christina96/boilerplate-sample-matches/blob/main/Python/seq2seq-MDEwOlJlcG9zaXRvcnk4MzczMjgwNg==-flat-input_pipeline.py-seq2seq-MDEwOlJlcG9zaXRvcnk4MzczMjgwNg==-flat-basic_seq2seq.py.html,17,seq2seq-MDEwOlJlcG9zaXRvcnk4MzczMjgwNg==-flat-input_pipeline.py,seq2seq-MDEwOlJlcG9zaXRvcnk4MzczMjgwNg==-flat-basic_seq2seq.py,86,89,3,32,35,3
294,https://htmlpreview.github.io/?https://github.com/Christina96/boilerplate-sample-matches/blob/main/Python/esphome-docs-MDEwOlJlcG9zaXRvcnkxMzMyMjM0NjE=-flat-github.py-esphome-docs-MDEwOlJlcG9zaXRvcnkxMzMyMjM0NjE=-flat-github.py.html,23,esphome-docs-MDEwOlJlcG9zaXRvcnkxMzMyMjM0NjE=-flat-github.py,esphome-docs-MDEwOlJlcG9zaXRvcnkxMzMyMjM0NjE=-flat-github.py,150,154,4,197,201,4
295,https://htmlpreview.github.io/?https://github.com/Christina96/boilerplate-sample-matches/blob/main/Python/sonnet-MDEwOlJlcG9zaXRvcnk4NzA2NzIxMg==-flat-linear_test.py-sonnet-MDEwOlJlcG9zaXRvcnk4NzA2NzIxMg==-flat-linear_test.py.html,21,sonnet-MDEwOlJlcG9zaXRvcnk4NzA2NzIxMg==-flat-linear_test.py,sonnet-MDEwOlJlcG9zaXRvcnk4NzA2NzIxMg==-flat-linear_test.py,19,21,2,45,47,2
296,https://htmlpreview.github.io/?https://github.com/Christina96/boilerplate-sample-matches/blob/main/Python/google-api-python-client-MDEwOlJlcG9zaXRvcnkxNTc0OTI2OQ==-flat-discovery.py-esptool-MDEwOlJlcG9zaXRvcnkyMzczNjkxNA==-flat-mem_definition_41.py.html,14,google-api-python-client-MDEwOlJlcG9zaXRvcnkxNTc0OTI2OQ==-flat-discovery.py,esptool-MDEwOlJlcG9zaXRvcnkyMzczNjkxNA==-flat-mem_definition_41.py,740,742,2,128,129,1
297,https://htmlpreview.github.io/?https://github.com/Christina96/boilerplate-sample-matches/blob/main/Python/esptool-MDEwOlJlcG9zaXRvcnkyMzczNjkxNA==-flat-cmds.py-sonnet-MDEwOlJlcG9zaXRvcnk4NzA2NzIxMg==-flat-optimizer_tests.py.html,13,esptool-MDEwOlJlcG9zaXRvcnkyMzczNjkxNA==-flat-cmds.py,sonnet-MDEwOlJlcG9zaXRvcnk4NzA2NzIxMg==-flat-optimizer_tests.py,775,776,1,16,17,1
298,https://htmlpreview.github.io/?https://github.com/Christina96/boilerplate-sample-matches/blob/main/Python/yolact-MDEwOlJlcG9zaXRvcnkxMzg3OTY2OTk=-flat-output_utils.py-Ultroid-MDEwOlJlcG9zaXRvcnkzNDEwMzg2MDI=-flat-callbackstuffs.py.html,12,yolact-MDEwOlJlcG9zaXRvcnkxMzg3OTY2OTk=-flat-output_utils.py,Ultroid-MDEwOlJlcG9zaXRvcnkzNDEwMzg2MDI=-flat-callbackstuffs.py,12,14,2,385,387,2
299,https://htmlpreview.github.io/?https://github.com/Christina96/boilerplate-sample-matches/blob/main/Python/sonnet-MDEwOlJlcG9zaXRvcnk4NzA2NzIxMg==-flat-axis_norm.py-sonnet-MDEwOlJlcG9zaXRvcnk4NzA2NzIxMg==-flat-group_norm.py.html,24,sonnet-MDEwOlJlcG9zaXRvcnk4NzA2NzIxMg==-flat-axis_norm.py,sonnet-MDEwOlJlcG9zaXRvcnk4NzA2NzIxMg==-flat-group_norm.py,44,47,3,39,42,3
300,https://htmlpreview.github.io/?https://github.com/Christina96/boilerplate-sample-matches/blob/main/Python/esptool-MDEwOlJlcG9zaXRvcnkyMzczNjkxNA==-flat-bin_image.py-esptool-MDEwOlJlcG9zaXRvcnkyMzczNjkxNA==-flat-loader.py.html,22,esptool-MDEwOlJlcG9zaXRvcnkyMzczNjkxNA==-flat-bin_image.py,esptool-MDEwOlJlcG9zaXRvcnkyMzczNjkxNA==-flat-loader.py,8,16,8,11,19,8
301,https://htmlpreview.github.io/?https://github.com/Christina96/boilerplate-sample-matches/blob/main/Python/Ultroid-MDEwOlJlcG9zaXRvcnkzNDEwMzg2MDI=-flat-_chatactions.py-Ultroid-MDEwOlJlcG9zaXRvcnkzNDEwMzg2MDI=-flat-_chatactions.py.html,68,Ultroid-MDEwOlJlcG9zaXRvcnkzNDEwMzg2MDI=-flat-_chatactions.py,Ultroid-MDEwOlJlcG9zaXRvcnkzNDEwMzg2MDI=-flat-_chatactions.py,95,106,11,135,147,12
302,https://htmlpreview.github.io/?https://github.com/Christina96/boilerplate-sample-matches/blob/main/Python/yolact-MDEwOlJlcG9zaXRvcnkxMzg3OTY2OTk=-flat-bbox_recall.py-yolact-MDEwOlJlcG9zaXRvcnkxMzg3OTY2OTk=-flat-logger.py.html,12,yolact-MDEwOlJlcG9zaXRvcnkxMzg3OTY2OTk=-flat-bbox_recall.py,yolact-MDEwOlJlcG9zaXRvcnkxMzg3OTY2OTk=-flat-logger.py,65,67,2,193,195,2
303,https://htmlpreview.github.io/?https://github.com/Christina96/boilerplate-sample-matches/blob/main/Python/seq2seq-MDEwOlJlcG9zaXRvcnk4MzczMjgwNg==-flat-generate_toy_data.py-seq2seq-MDEwOlJlcG9zaXRvcnk4MzczMjgwNg==-flat-generate_toy_data.py.html,16,seq2seq-MDEwOlJlcG9zaXRvcnk4MzczMjgwNg==-flat-generate_toy_data.py,seq2seq-MDEwOlJlcG9zaXRvcnk4MzczMjgwNg==-flat-generate_toy_data.py,37,39,2,44,45,1
304,https://htmlpreview.github.io/?https://github.com/Christina96/boilerplate-sample-matches/blob/main/Python/yolact-MDEwOlJlcG9zaXRvcnkxMzg3OTY2OTk=-flat-make_grid.py-yolact-MDEwOlJlcG9zaXRvcnkxMzg3OTY2OTk=-flat-make_grid.py.html,12,yolact-MDEwOlJlcG9zaXRvcnkxMzg3OTY2OTk=-flat-make_grid.py,yolact-MDEwOlJlcG9zaXRvcnkxMzg3OTY2OTk=-flat-make_grid.py,36,37,1,35,36,1
305,https://htmlpreview.github.io/?https://github.com/Christina96/boilerplate-sample-matches/blob/main/Python/sonnet-MDEwOlJlcG9zaXRvcnk4NzA2NzIxMg==-flat-conv_test.py-sonnet-MDEwOlJlcG9zaXRvcnk4NzA2NzIxMg==-flat-resnet_7.py.html,12,sonnet-MDEwOlJlcG9zaXRvcnk4NzA2NzIxMg==-flat-conv_test.py,sonnet-MDEwOlJlcG9zaXRvcnk4NzA2NzIxMg==-flat-resnet_7.py,39,42,3,115,118,3
306,https://htmlpreview.github.io/?https://github.com/Christina96/boilerplate-sample-matches/blob/main/Python/Ultroid-MDEwOlJlcG9zaXRvcnkzNDEwMzg2MDI=-flat-admintools.py-Ultroid-MDEwOlJlcG9zaXRvcnkzNDEwMzg2MDI=-flat-admintools.py.html,24,Ultroid-MDEwOlJlcG9zaXRvcnkzNDEwMzg2MDI=-flat-admintools.py,Ultroid-MDEwOlJlcG9zaXRvcnkzNDEwMzg2MDI=-flat-admintools.py,140,146,6,231,237,6
307,https://htmlpreview.github.io/?https://github.com/Christina96/boilerplate-sample-matches/blob/main/Python/google-api-python-client-MDEwOlJlcG9zaXRvcnkxNTc0OTI2OQ==-flat-test_json_model.py-google-api-python-client-MDEwOlJlcG9zaXRvcnkxNTc0OTI2OQ==-flat-test_json_model.py.html,17,google-api-python-client-MDEwOlJlcG9zaXRvcnkxNTc0OTI2OQ==-flat-test_json_model.py,google-api-python-client-MDEwOlJlcG9zaXRvcnkxNTc0OTI2OQ==-flat-test_json_model.py,150,152,2,157,159,2
308,https://htmlpreview.github.io/?https://github.com/Christina96/boilerplate-sample-matches/blob/main/Python/Ultroid-MDEwOlJlcG9zaXRvcnkzNDEwMzg2MDI=-flat-callbackstuffs.py-Ultroid-MDEwOlJlcG9zaXRvcnkzNDEwMzg2MDI=-flat-callbackstuffs.py.html,20,Ultroid-MDEwOlJlcG9zaXRvcnkzNDEwMzg2MDI=-flat-callbackstuffs.py,Ultroid-MDEwOlJlcG9zaXRvcnkzNDEwMzg2MDI=-flat-callbackstuffs.py,746,750,4,872,876,4
309,https://htmlpreview.github.io/?https://github.com/Christina96/boilerplate-sample-matches/blob/main/Python/esptool-MDEwOlJlcG9zaXRvcnkyMzczNjkxNA==-flat-bin_image.py-esptool-MDEwOlJlcG9zaXRvcnkyMzczNjkxNA==-flat-bin_image.py.html,14,esptool-MDEwOlJlcG9zaXRvcnkyMzczNjkxNA==-flat-bin_image.py,esptool-MDEwOlJlcG9zaXRvcnkyMzczNjkxNA==-flat-bin_image.py,648,651,3,639,642,3
310,https://htmlpreview.github.io/?https://github.com/Christina96/boilerplate-sample-matches/blob/main/Python/Ultroid-MDEwOlJlcG9zaXRvcnkzNDEwMzg2MDI=-flat-_inline.py-Ultroid-MDEwOlJlcG9zaXRvcnkzNDEwMzg2MDI=-flat-pmpermit.py.html,21,Ultroid-MDEwOlJlcG9zaXRvcnkzNDEwMzg2MDI=-flat-_inline.py,Ultroid-MDEwOlJlcG9zaXRvcnkzNDEwMzg2MDI=-flat-pmpermit.py,348,356,8,727,735,8
311,https://htmlpreview.github.io/?https://github.com/Christina96/boilerplate-sample-matches/blob/main/Python/esphome-docs-MDEwOlJlcG9zaXRvcnkxMzMyMjM0NjE=-flat-markdown.py-sonnet-MDEwOlJlcG9zaXRvcnk4NzA2NzIxMg==-flat-batch_norm_test.py.html,13,esphome-docs-MDEwOlJlcG9zaXRvcnkxMzMyMjM0NjE=-flat-markdown.py,sonnet-MDEwOlJlcG9zaXRvcnk4NzA2NzIxMg==-flat-batch_norm_test.py,83,85,2,200,202,2
312,https://htmlpreview.github.io/?https://github.com/Christina96/boilerplate-sample-matches/blob/main/Python/esptool-MDEwOlJlcG9zaXRvcnkyMzczNjkxNA==-flat-test_esptool.py-esptool-MDEwOlJlcG9zaXRvcnkyMzczNjkxNA==-flat-test_esptool.py.html,44,esptool-MDEwOlJlcG9zaXRvcnkyMzczNjkxNA==-flat-test_esptool.py,esptool-MDEwOlJlcG9zaXRvcnkyMzczNjkxNA==-flat-test_esptool.py,222,232,10,248,258,10
313,https://htmlpreview.github.io/?https://github.com/Christina96/boilerplate-sample-matches/blob/main/Python/google-api-python-client-MDEwOlJlcG9zaXRvcnkxNTc0OTI2OQ==-flat-test_http.py-google-api-python-client-MDEwOlJlcG9zaXRvcnkxNTc0OTI2OQ==-flat-test_http.py.html,12,google-api-python-client-MDEwOlJlcG9zaXRvcnkxNTc0OTI2OQ==-flat-test_http.py,google-api-python-client-MDEwOlJlcG9zaXRvcnkxNTc0OTI2OQ==-flat-test_http.py,95,97,2,112,114,2
314,https://htmlpreview.github.io/?https://github.com/Christina96/boilerplate-sample-matches/blob/main/Python/sonnet-MDEwOlJlcG9zaXRvcnk4NzA2NzIxMg==-flat-recurrent.py-sonnet-MDEwOlJlcG9zaXRvcnk4NzA2NzIxMg==-flat-recurrent.py.html,54,sonnet-MDEwOlJlcG9zaXRvcnk4NzA2NzIxMg==-flat-recurrent.py,sonnet-MDEwOlJlcG9zaXRvcnk4NzA2NzIxMg==-flat-recurrent.py,657,664,7,706,713,7
315,https://htmlpreview.github.io/?https://github.com/Christina96/boilerplate-sample-matches/blob/main/Python/Ultroid-MDEwOlJlcG9zaXRvcnkzNDEwMzg2MDI=-flat-inlinestuff.py-Ultroid-MDEwOlJlcG9zaXRvcnkzNDEwMzg2MDI=-flat-inlinestuff.py.html,17,Ultroid-MDEwOlJlcG9zaXRvcnkzNDEwMzg2MDI=-flat-inlinestuff.py,Ultroid-MDEwOlJlcG9zaXRvcnkzNDEwMzg2MDI=-flat-inlinestuff.py,67,71,4,489,493,4
316,https://htmlpreview.github.io/?https://github.com/Christina96/boilerplate-sample-matches/blob/main/Python/yolact-MDEwOlJlcG9zaXRvcnkxMzg3OTY2OTk=-flat-augment_bbox.py-yolact-MDEwOlJlcG9zaXRvcnkxMzg3OTY2OTk=-flat-augmentations.py.html,26,yolact-MDEwOlJlcG9zaXRvcnkxMzg3OTY2OTk=-flat-augment_bbox.py,yolact-MDEwOlJlcG9zaXRvcnkxMzg3OTY2OTk=-flat-augmentations.py,84,87,3,205,208,3
317,https://htmlpreview.github.io/?https://github.com/Christina96/boilerplate-sample-matches/blob/main/Python/practical-python-MDEwOlJlcG9zaXRvcnkyNjY2MTM3MDQ=-flat-test_stock_100.py-practical-python-MDEwOlJlcG9zaXRvcnkyNjY2MTM3MDQ=-flat-test_stock_78.py.html,158,practical-python-MDEwOlJlcG9zaXRvcnkyNjY2MTM3MDQ=-flat-test_stock_100.py,practical-python-MDEwOlJlcG9zaXRvcnkyNjY2MTM3MDQ=-flat-test_stock_78.py,1,21,20,1,21,20
318,https://htmlpreview.github.io/?https://github.com/Christina96/boilerplate-sample-matches/blob/main/Python/google-api-python-client-MDEwOlJlcG9zaXRvcnkxNTc0OTI2OQ==-flat-get_all_custom_channels_for_ad_unit.py-google-api-python-client-MDEwOlJlcG9zaXRvcnkxNTc0OTI2OQ==-flat-create_instance.py.html,16,google-api-python-client-MDEwOlJlcG9zaXRvcnkxNTc0OTI2OQ==-flat-get_all_custom_channels_for_ad_unit.py,google-api-python-client-MDEwOlJlcG9zaXRvcnkxNTc0OTI2OQ==-flat-create_instance.py,9,13,4,104,106,2
319,https://htmlpreview.github.io/?https://github.com/Christina96/boilerplate-sample-matches/blob/main/Python/esptool-MDEwOlJlcG9zaXRvcnkyMzczNjkxNA==-flat-test_espefuse.py-esptool-MDEwOlJlcG9zaXRvcnkyMzczNjkxNA==-flat-test_espefuse.py.html,20,esptool-MDEwOlJlcG9zaXRvcnkyMzczNjkxNA==-flat-test_espefuse.py,esptool-MDEwOlJlcG9zaXRvcnkyMzczNjkxNA==-flat-test_espefuse.py,344,349,5,361,366,5
320,https://htmlpreview.github.io/?https://github.com/Christina96/boilerplate-sample-matches/blob/main/Python/esphome-docs-MDEwOlJlcG9zaXRvcnkxMzMyMjM0NjE=-flat-schema_doc.py-esphome-docs-MDEwOlJlcG9zaXRvcnkxMzMyMjM0NjE=-flat-schema_doc.py.html,12,esphome-docs-MDEwOlJlcG9zaXRvcnkxMzMyMjM0NjE=-flat-schema_doc.py,esphome-docs-MDEwOlJlcG9zaXRvcnkxMzMyMjM0NjE=-flat-schema_doc.py,91,94,3,116,119,3
321,https://htmlpreview.github.io/?https://github.com/Christina96/boilerplate-sample-matches/blob/main/Python/esptool-MDEwOlJlcG9zaXRvcnkyMzczNjkxNA==-flat-emulate_efuse_controller_39.py-esptool-MDEwOlJlcG9zaXRvcnkyMzczNjkxNA==-flat-base_fields.py.html,14,esptool-MDEwOlJlcG9zaXRvcnkyMzczNjkxNA==-flat-emulate_efuse_controller_39.py,esptool-MDEwOlJlcG9zaXRvcnkyMzczNjkxNA==-flat-base_fields.py,103,105,2,538,540,2
322,https://htmlpreview.github.io/?https://github.com/Christina96/boilerplate-sample-matches/blob/main/Python/Ultroid-MDEwOlJlcG9zaXRvcnkzNDEwMzg2MDI=-flat-ytdl_7.py-Ultroid-MDEwOlJlcG9zaXRvcnkzNDEwMzg2MDI=-flat-ytdl_7.py.html,14,Ultroid-MDEwOlJlcG9zaXRvcnkzNDEwMzg2MDI=-flat-ytdl_7.py,Ultroid-MDEwOlJlcG9zaXRvcnkzNDEwMzg2MDI=-flat-ytdl_7.py,204,206,2,157,159,2
323,https://htmlpreview.github.io/?https://github.com/Christina96/boilerplate-sample-matches/blob/main/Python/google-api-python-client-MDEwOlJlcG9zaXRvcnkxNTc0OTI2OQ==-flat-test_http.py-google-api-python-client-MDEwOlJlcG9zaXRvcnkxNTc0OTI2OQ==-flat-test_http.py.html,16,google-api-python-client-MDEwOlJlcG9zaXRvcnkxNTc0OTI2OQ==-flat-test_http.py,google-api-python-client-MDEwOlJlcG9zaXRvcnkxNTc0OTI2OQ==-flat-test_http.py,170,174,4,258,262,4
324,https://htmlpreview.github.io/?https://github.com/Christina96/boilerplate-sample-matches/blob/main/Python/esptool-MDEwOlJlcG9zaXRvcnkyMzczNjkxNA==-flat-base_operations.py-esptool-MDEwOlJlcG9zaXRvcnkyMzczNjkxNA==-flat-base_operations.py.html,24,esptool-MDEwOlJlcG9zaXRvcnkyMzczNjkxNA==-flat-base_operations.py,esptool-MDEwOlJlcG9zaXRvcnkyMzczNjkxNA==-flat-base_operations.py,440,444,4,509,513,4
325,https://htmlpreview.github.io/?https://github.com/Christina96/boilerplate-sample-matches/blob/main/Python/yolact-MDEwOlJlcG9zaXRvcnkxMzg3OTY2OTk=-flat-test.py-yolact-MDEwOlJlcG9zaXRvcnkxMzg3OTY2OTk=-flat-test.py.html,12,yolact-MDEwOlJlcG9zaXRvcnkxMzg3OTY2OTk=-flat-test.py,yolact-MDEwOlJlcG9zaXRvcnkxMzg3OTY2OTk=-flat-test.py,139,140,1,167,169,2
326,https://htmlpreview.github.io/?https://github.com/Christina96/boilerplate-sample-matches/blob/main/Python/sonnet-MDEwOlJlcG9zaXRvcnk4NzA2NzIxMg==-flat-recurrent.py-sonnet-MDEwOlJlcG9zaXRvcnk4NzA2NzIxMg==-flat-resnet_7.py.html,12,sonnet-MDEwOlJlcG9zaXRvcnk4NzA2NzIxMg==-flat-recurrent.py,sonnet-MDEwOlJlcG9zaXRvcnk4NzA2NzIxMg==-flat-resnet_7.py,529,531,2,30,32,2
327,https://htmlpreview.github.io/?https://github.com/Christina96/boilerplate-sample-matches/blob/main/Python/esptool-MDEwOlJlcG9zaXRvcnkyMzczNjkxNA==-flat-operations_22.py-esptool-MDEwOlJlcG9zaXRvcnkyMzczNjkxNA==-flat-operations_32.py.html,45,esptool-MDEwOlJlcG9zaXRvcnkyMzczNjkxNA==-flat-operations_22.py,esptool-MDEwOlJlcG9zaXRvcnkyMzczNjkxNA==-flat-operations_32.py,144,154,10,143,153,10
328,https://htmlpreview.github.io/?https://github.com/Christina96/boilerplate-sample-matches/blob/main/Python/esptool-MDEwOlJlcG9zaXRvcnkyMzczNjkxNA==-flat-test_espefuse.py-google-api-python-client-MDEwOlJlcG9zaXRvcnkxNTc0OTI2OQ==-flat-test_http.py.html,17,esptool-MDEwOlJlcG9zaXRvcnkyMzczNjkxNA==-flat-test_espefuse.py,google-api-python-client-MDEwOlJlcG9zaXRvcnkxNTc0OTI2OQ==-flat-test_http.py,1514,1517,3,1221,1224,3
329,https://htmlpreview.github.io/?https://github.com/Christina96/boilerplate-sample-matches/blob/main/Python/practical-python-MDEwOlJlcG9zaXRvcnkyNjY2MTM3MDQ=-flat-report_18.py-practical-python-MDEwOlJlcG9zaXRvcnkyNjY2MTM3MDQ=-flat-report_85.py.html,27,practical-python-MDEwOlJlcG9zaXRvcnkyNjY2MTM3MDQ=-flat-report_18.py,practical-python-MDEwOlJlcG9zaXRvcnkyNjY2MTM3MDQ=-flat-report_85.py,8,10,2,10,11,1
330,https://htmlpreview.github.io/?https://github.com/Christina96/boilerplate-sample-matches/blob/main/Python/Ultroid-MDEwOlJlcG9zaXRvcnkzNDEwMzg2MDI=-flat-chats.py-Ultroid-MDEwOlJlcG9zaXRvcnkzNDEwMzg2MDI=-flat-utilities.py.html,16,Ultroid-MDEwOlJlcG9zaXRvcnkzNDEwMzg2MDI=-flat-chats.py,Ultroid-MDEwOlJlcG9zaXRvcnkzNDEwMzg2MDI=-flat-utilities.py,337,340,3,154,158,4
331,https://htmlpreview.github.io/?https://github.com/Christina96/boilerplate-sample-matches/blob/main/Python/esphome-docs-MDEwOlJlcG9zaXRvcnkxMzMyMjM0NjE=-flat-conf.py-esptool-MDEwOlJlcG9zaXRvcnkyMzczNjkxNA==-flat-setup.py.html,12,esphome-docs-MDEwOlJlcG9zaXRvcnkxMzMyMjM0NjE=-flat-conf.py,esptool-MDEwOlJlcG9zaXRvcnkyMzczNjkxNA==-flat-setup.py,61,66,5,72,77,5
332,https://htmlpreview.github.io/?https://github.com/Christina96/boilerplate-sample-matches/blob/main/Python/sonnet-MDEwOlJlcG9zaXRvcnk4NzA2NzIxMg==-flat-momentum_test.py-sonnet-MDEwOlJlcG9zaXRvcnk4NzA2NzIxMg==-flat-rmsprop_test.py.html,70,sonnet-MDEwOlJlcG9zaXRvcnk4NzA2NzIxMg==-flat-momentum_test.py,sonnet-MDEwOlJlcG9zaXRvcnk4NzA2NzIxMg==-flat-rmsprop_test.py,29,34,5,33,38,5
333,https://htmlpreview.github.io/?https://github.com/Christina96/boilerplate-sample-matches/blob/main/Python/sonnet-MDEwOlJlcG9zaXRvcnk4NzA2NzIxMg==-flat-replicator_test.py-sonnet-MDEwOlJlcG9zaXRvcnk4NzA2NzIxMg==-flat-distributed_batch_norm_test.py.html,24,sonnet-MDEwOlJlcG9zaXRvcnk4NzA2NzIxMg==-flat-replicator_test.py,sonnet-MDEwOlJlcG9zaXRvcnk4NzA2NzIxMg==-flat-distributed_batch_norm_test.py,153,157,4,105,109,4
334,https://htmlpreview.github.io/?https://github.com/Christina96/boilerplate-sample-matches/blob/main/Python/seq2seq-MDEwOlJlcG9zaXRvcnk4MzczMjgwNg==-flat-attention_decoder.py-seq2seq-MDEwOlJlcG9zaXRvcnk4MzczMjgwNg==-flat-beam_search.py.html,22,seq2seq-MDEwOlJlcG9zaXRvcnk4MzczMjgwNg==-flat-attention_decoder.py,seq2seq-MDEwOlJlcG9zaXRvcnk4MzczMjgwNg==-flat-beam_search.py,9,15,6,15,21,6
335,https://htmlpreview.github.io/?https://github.com/Christina96/boilerplate-sample-matches/blob/main/Python/yolact-MDEwOlJlcG9zaXRvcnkxMzg3OTY2OTk=-flat-augmentations.py-yolact-MDEwOlJlcG9zaXRvcnkxMzg3OTY2OTk=-flat-augmentations.py.html,16,yolact-MDEwOlJlcG9zaXRvcnkxMzg3OTY2OTk=-flat-augmentations.py,yolact-MDEwOlJlcG9zaXRvcnkxMzg3OTY2OTk=-flat-augmentations.py,51,53,2,49,51,2
336,https://htmlpreview.github.io/?https://github.com/Christina96/boilerplate-sample-matches/blob/main/Python/esptool-MDEwOlJlcG9zaXRvcnkyMzczNjkxNA==-flat-operations_27.py-esptool-MDEwOlJlcG9zaXRvcnkyMzczNjkxNA==-flat-operations_22.py.html,79,esptool-MDEwOlJlcG9zaXRvcnkyMzczNjkxNA==-flat-operations_27.py,esptool-MDEwOlJlcG9zaXRvcnkyMzczNjkxNA==-flat-operations_22.py,238,253,15,239,254,15
337,https://htmlpreview.github.io/?https://github.com/Christina96/boilerplate-sample-matches/blob/main/Python/Ultroid-MDEwOlJlcG9zaXRvcnkzNDEwMzg2MDI=-flat-executor.py-Ultroid-MDEwOlJlcG9zaXRvcnkzNDEwMzg2MDI=-flat-executor.py.html,41,Ultroid-MDEwOlJlcG9zaXRvcnkzNDEwMzg2MDI=-flat-executor.py,Ultroid-MDEwOlJlcG9zaXRvcnkzNDEwMzg2MDI=-flat-executor.py,24,30,6,32,38,6
338,https://htmlpreview.github.io/?https://github.com/Christina96/boilerplate-sample-matches/blob/main/Python/Ultroid-MDEwOlJlcG9zaXRvcnkzNDEwMzg2MDI=-flat-tools.py-Ultroid-MDEwOlJlcG9zaXRvcnkzNDEwMzg2MDI=-flat-tools.py.html,22,Ultroid-MDEwOlJlcG9zaXRvcnkzNDEwMzg2MDI=-flat-tools.py,Ultroid-MDEwOlJlcG9zaXRvcnkzNDEwMzg2MDI=-flat-tools.py,106,108,2,107,109,2
339,https://htmlpreview.github.io/?https://github.com/Christina96/boilerplate-sample-matches/blob/main/Python/sonnet-MDEwOlJlcG9zaXRvcnk4NzA2NzIxMg==-flat-recurrent_test.py-sonnet-MDEwOlJlcG9zaXRvcnk4NzA2NzIxMg==-flat-recurrent_test.py.html,28,sonnet-MDEwOlJlcG9zaXRvcnk4NzA2NzIxMg==-flat-recurrent_test.py,sonnet-MDEwOlJlcG9zaXRvcnk4NzA2NzIxMg==-flat-recurrent_test.py,34,36,2,46,48,2
340,https://htmlpreview.github.io/?https://github.com/Christina96/boilerplate-sample-matches/blob/main/Python/seq2seq-MDEwOlJlcG9zaXRvcnk4MzczMjgwNg==-flat-data_test.py-seq2seq-MDEwOlJlcG9zaXRvcnk4MzczMjgwNg==-flat-data_test.py.html,42,seq2seq-MDEwOlJlcG9zaXRvcnk4MzczMjgwNg==-flat-data_test.py,seq2seq-MDEwOlJlcG9zaXRvcnk4MzczMjgwNg==-flat-data_test.py,55,61,6,88,92,4
341,https://htmlpreview.github.io/?https://github.com/Christina96/boilerplate-sample-matches/blob/main/Python/Ultroid-MDEwOlJlcG9zaXRvcnkzNDEwMzg2MDI=-flat-gdrive.py-google-api-python-client-MDEwOlJlcG9zaXRvcnkxNTc0OTI2OQ==-flat-schema.py.html,13,Ultroid-MDEwOlJlcG9zaXRvcnkzNDEwMzg2MDI=-flat-gdrive.py,google-api-python-client-MDEwOlJlcG9zaXRvcnkxNTc0OTI2OQ==-flat-schema.py,80,81,1,66,67,1
342,https://htmlpreview.github.io/?https://github.com/Christina96/boilerplate-sample-matches/blob/main/Python/google-api-python-client-MDEwOlJlcG9zaXRvcnkxNTc0OTI2OQ==-flat-main_2.py-yolact-MDEwOlJlcG9zaXRvcnkxMzg3OTY2OTk=-flat-eval.py.html,14,google-api-python-client-MDEwOlJlcG9zaXRvcnkxNTc0OTI2OQ==-flat-main_2.py,yolact-MDEwOlJlcG9zaXRvcnkxMzg3OTY2OTk=-flat-eval.py,25,26,1,609,610,1
343,https://htmlpreview.github.io/?https://github.com/Christina96/boilerplate-sample-matches/blob/main/Python/yolact-MDEwOlJlcG9zaXRvcnkxMzg3OTY2OTk=-flat-augmentations.py-yolact-MDEwOlJlcG9zaXRvcnkxMzg3OTY2OTk=-flat-augmentations.py.html,18,yolact-MDEwOlJlcG9zaXRvcnkxMzg3OTY2OTk=-flat-augmentations.py,yolact-MDEwOlJlcG9zaXRvcnkxMzg3OTY2OTk=-flat-augmentations.py,27,28,1,315,316,1
344,https://htmlpreview.github.io/?https://github.com/Christina96/boilerplate-sample-matches/blob/main/Python/Ultroid-MDEwOlJlcG9zaXRvcnkzNDEwMzg2MDI=-flat-ytdl_7.py-Ultroid-MDEwOlJlcG9zaXRvcnkzNDEwMzg2MDI=-flat-ytdl_7.py.html,16,Ultroid-MDEwOlJlcG9zaXRvcnkzNDEwMzg2MDI=-flat-ytdl_7.py,Ultroid-MDEwOlJlcG9zaXRvcnkzNDEwMzg2MDI=-flat-ytdl_7.py,165,166,1,212,213,1
345,https://htmlpreview.github.io/?https://github.com/Christina96/boilerplate-sample-matches/blob/main/Python/Ultroid-MDEwOlJlcG9zaXRvcnkzNDEwMzg2MDI=-flat-helper.py-Ultroid-MDEwOlJlcG9zaXRvcnkzNDEwMzg2MDI=-flat-helper.py.html,12,Ultroid-MDEwOlJlcG9zaXRvcnkzNDEwMzg2MDI=-flat-helper.py,Ultroid-MDEwOlJlcG9zaXRvcnkzNDEwMzg2MDI=-flat-helper.py,446,447,1,482,483,1
346,https://htmlpreview.github.io/?https://github.com/Christina96/boilerplate-sample-matches/blob/main/Python/sonnet-MDEwOlJlcG9zaXRvcnk4NzA2NzIxMg==-flat-function_test.py-sonnet-MDEwOlJlcG9zaXRvcnk4NzA2NzIxMg==-flat-function_test.py.html,14,sonnet-MDEwOlJlcG9zaXRvcnk4NzA2NzIxMg==-flat-function_test.py,sonnet-MDEwOlJlcG9zaXRvcnk4NzA2NzIxMg==-flat-function_test.py,82,83,1,81,82,1
347,https://htmlpreview.github.io/?https://github.com/Christina96/boilerplate-sample-matches/blob/main/Python/sonnet-MDEwOlJlcG9zaXRvcnk4NzA2NzIxMg==-flat-xla_test.py-sonnet-MDEwOlJlcG9zaXRvcnk4NzA2NzIxMg==-flat-xla_test.py.html,15,sonnet-MDEwOlJlcG9zaXRvcnk4NzA2NzIxMg==-flat-xla_test.py,sonnet-MDEwOlJlcG9zaXRvcnk4NzA2NzIxMg==-flat-xla_test.py,11,14,3,34,37,3
348,https://htmlpreview.github.io/?https://github.com/Christina96/boilerplate-sample-matches/blob/main/Python/sonnet-MDEwOlJlcG9zaXRvcnk4NzA2NzIxMg==-flat-group_norm_test.py-sonnet-MDEwOlJlcG9zaXRvcnk4NzA2NzIxMg==-flat-axis_norm_test.py.html,69,sonnet-MDEwOlJlcG9zaXRvcnk4NzA2NzIxMg==-flat-group_norm_test.py,sonnet-MDEwOlJlcG9zaXRvcnk4NzA2NzIxMg==-flat-axis_norm_test.py,32,40,8,29,36,7
349,https://htmlpreview.github.io/?https://github.com/Christina96/boilerplate-sample-matches/blob/main/Python/Ultroid-MDEwOlJlcG9zaXRvcnkzNDEwMzg2MDI=-flat-button.py-Ultroid-MDEwOlJlcG9zaXRvcnkzNDEwMzg2MDI=-flat-filter.py.html,77,Ultroid-MDEwOlJlcG9zaXRvcnkzNDEwMzg2MDI=-flat-button.py,Ultroid-MDEwOlJlcG9zaXRvcnkzNDEwMzg2MDI=-flat-filter.py,20,31,11,24,35,11
350,https://htmlpreview.github.io/?https://github.com/Christina96/boilerplate-sample-matches/blob/main/Python/esptool-MDEwOlJlcG9zaXRvcnkyMzczNjkxNA==-flat-test_imagegen.py-esptool-MDEwOlJlcG9zaXRvcnkyMzczNjkxNA==-flat-test_imagegen.py.html,16,esptool-MDEwOlJlcG9zaXRvcnkyMzczNjkxNA==-flat-test_imagegen.py,esptool-MDEwOlJlcG9zaXRvcnkyMzczNjkxNA==-flat-test_imagegen.py,237,243,6,256,262,6
351,https://htmlpreview.github.io/?https://github.com/Christina96/boilerplate-sample-matches/blob/main/Python/Ultroid-MDEwOlJlcG9zaXRvcnkzNDEwMzg2MDI=-flat-tools_13.py-Ultroid-MDEwOlJlcG9zaXRvcnkzNDEwMzg2MDI=-flat-utilities.py.html,16,Ultroid-MDEwOlJlcG9zaXRvcnkzNDEwMzg2MDI=-flat-tools_13.py,Ultroid-MDEwOlJlcG9zaXRvcnkzNDEwMzg2MDI=-flat-utilities.py,46,49,3,167,170,3
352,https://htmlpreview.github.io/?https://github.com/Christina96/boilerplate-sample-matches/blob/main/Python/google-api-python-client-MDEwOlJlcG9zaXRvcnkxNTc0OTI2OQ==-flat-sample_tools.py-esptool-MDEwOlJlcG9zaXRvcnkyMzczNjkxNA==-flat-cmds.py.html,14,google-api-python-client-MDEwOlJlcG9zaXRvcnkxNTc0OTI2OQ==-flat-sample_tools.py,esptool-MDEwOlJlcG9zaXRvcnkyMzczNjkxNA==-flat-cmds.py,37,38,1,433,434,1
353,https://htmlpreview.github.io/?https://github.com/Christina96/boilerplate-sample-matches/blob/main/Python/practical-python-MDEwOlJlcG9zaXRvcnkyNjY2MTM3MDQ=-flat-portfolio_13.py-practical-python-MDEwOlJlcG9zaXRvcnkyNjY2MTM3MDQ=-flat-portfolio_108.py.html,204,practical-python-MDEwOlJlcG9zaXRvcnkyNjY2MTM3MDQ=-flat-portfolio_13.py,practical-python-MDEwOlJlcG9zaXRvcnkyNjY2MTM3MDQ=-flat-portfolio_108.py,7,34,27,7,34,27
354,https://htmlpreview.github.io/?https://github.com/Christina96/boilerplate-sample-matches/blob/main/Python/seq2seq-MDEwOlJlcG9zaXRvcnk4MzczMjgwNg==-flat-decoder_test.py-seq2seq-MDEwOlJlcG9zaXRvcnk4MzczMjgwNg==-flat-decoder_test.py.html,65,seq2seq-MDEwOlJlcG9zaXRvcnk4MzczMjgwNg==-flat-decoder_test.py,seq2seq-MDEwOlJlcG9zaXRvcnk4MzczMjgwNg==-flat-decoder_test.py,64,69,5,88,95,7
355,https://htmlpreview.github.io/?https://github.com/Christina96/boilerplate-sample-matches/blob/main/Python/esptool-MDEwOlJlcG9zaXRvcnkyMzczNjkxNA==-flat-esp32.py-esptool-MDEwOlJlcG9zaXRvcnkyMzczNjkxNA==-flat-esp8266.py.html,22,esptool-MDEwOlJlcG9zaXRvcnkyMzczNjkxNA==-flat-esp32.py,esptool-MDEwOlJlcG9zaXRvcnkyMzczNjkxNA==-flat-esp8266.py,39,45,6,18,24,6
356,https://htmlpreview.github.io/?https://github.com/Christina96/boilerplate-sample-matches/blob/main/Python/yolact-MDEwOlJlcG9zaXRvcnkxMzg3OTY2OTk=-flat-test.py-yolact-MDEwOlJlcG9zaXRvcnkxMzg3OTY2OTk=-flat-test.py.html,22,yolact-MDEwOlJlcG9zaXRvcnkxMzg3OTY2OTk=-flat-test.py,yolact-MDEwOlJlcG9zaXRvcnkxMzg3OTY2OTk=-flat-test.py,77,78,1,100,101,1
357,https://htmlpreview.github.io/?https://github.com/Christina96/boilerplate-sample-matches/blob/main/Python/google-api-python-client-MDEwOlJlcG9zaXRvcnkxNTc0OTI2OQ==-flat-describe_9.py-google-api-python-client-MDEwOlJlcG9zaXRvcnkxNTc0OTI2OQ==-flat-describe.py.html,520,google-api-python-client-MDEwOlJlcG9zaXRvcnkxNTc0OTI2OQ==-flat-describe_9.py,google-api-python-client-MDEwOlJlcG9zaXRvcnkxNTc0OTI2OQ==-flat-describe.py,192,291,99,192,291,99
358,https://htmlpreview.github.io/?https://github.com/Christina96/boilerplate-sample-matches/blob/main/Python/google-api-python-client-MDEwOlJlcG9zaXRvcnkxNTc0OTI2OQ==-flat-test_discovery_cache.py-esptool-MDEwOlJlcG9zaXRvcnkyMzczNjkxNA==-flat-test_espefuse.py.html,13,google-api-python-client-MDEwOlJlcG9zaXRvcnkxNTc0OTI2OQ==-flat-test_discovery_cache.py,esptool-MDEwOlJlcG9zaXRvcnkyMzczNjkxNA==-flat-test_espefuse.py,13,17,4,387,391,4
359,https://htmlpreview.github.io/?https://github.com/Christina96/boilerplate-sample-matches/blob/main/Python/google-api-python-client-MDEwOlJlcG9zaXRvcnkxNTc0OTI2OQ==-flat-test_json_model.py-yolact-MDEwOlJlcG9zaXRvcnkxMzg3OTY2OTk=-flat-parse_eval.py.html,16,google-api-python-client-MDEwOlJlcG9zaXRvcnkxNTc0OTI2OQ==-flat-test_json_model.py,yolact-MDEwOlJlcG9zaXRvcnkxMzg3OTY2OTk=-flat-parse_eval.py,124,126,2,30,32,2
360,https://htmlpreview.github.io/?https://github.com/Christina96/boilerplate-sample-matches/blob/main/Python/Ultroid-MDEwOlJlcG9zaXRvcnkzNDEwMzg2MDI=-flat-inlinestuff.py-Ultroid-MDEwOlJlcG9zaXRvcnkzNDEwMzg2MDI=-flat-inlinestuff.py.html,18,Ultroid-MDEwOlJlcG9zaXRvcnkzNDEwMzg2MDI=-flat-inlinestuff.py,Ultroid-MDEwOlJlcG9zaXRvcnkzNDEwMzg2MDI=-flat-inlinestuff.py,319,323,4,357,361,4
361,https://htmlpreview.github.io/?https://github.com/Christina96/boilerplate-sample-matches/blob/main/Python/yolact-MDEwOlJlcG9zaXRvcnkxMzg3OTY2OTk=-flat-augmentations.py-yolact-MDEwOlJlcG9zaXRvcnkxMzg3OTY2OTk=-flat-augmentations.py.html,16,yolact-MDEwOlJlcG9zaXRvcnkxMzg3OTY2OTk=-flat-augmentations.py,yolact-MDEwOlJlcG9zaXRvcnkxMzg3OTY2OTk=-flat-augmentations.py,43,45,2,42,44,2
362,https://htmlpreview.github.io/?https://github.com/Christina96/boilerplate-sample-matches/blob/main/Python/sonnet-MDEwOlJlcG9zaXRvcnk4NzA2NzIxMg==-flat-initializers_test.py-sonnet-MDEwOlJlcG9zaXRvcnk4NzA2NzIxMg==-flat-initializers_test.py.html,25,sonnet-MDEwOlJlcG9zaXRvcnk4NzA2NzIxMg==-flat-initializers_test.py,sonnet-MDEwOlJlcG9zaXRvcnk4NzA2NzIxMg==-flat-initializers_test.py,46,49,3,71,74,3
363,https://htmlpreview.github.io/?https://github.com/Christina96/boilerplate-sample-matches/blob/main/Python/seq2seq-MDEwOlJlcG9zaXRvcnk4MzczMjgwNg==-flat-metric_specs.py-seq2seq-MDEwOlJlcG9zaXRvcnk4MzczMjgwNg==-flat-decode_text.py.html,50,seq2seq-MDEwOlJlcG9zaXRvcnk4MzczMjgwNg==-flat-metric_specs.py,seq2seq-MDEwOlJlcG9zaXRvcnk4MzczMjgwNg==-flat-decode_text.py,37,44,7,47,54,7
364,https://htmlpreview.github.io/?https://github.com/Christina96/boilerplate-sample-matches/blob/main/Python/sonnet-MDEwOlJlcG9zaXRvcnk4NzA2NzIxMg==-flat-axis_norm_test.py-sonnet-MDEwOlJlcG9zaXRvcnk4NzA2NzIxMg==-flat-linear_test.py.html,18,sonnet-MDEwOlJlcG9zaXRvcnk4NzA2NzIxMg==-flat-axis_norm_test.py,sonnet-MDEwOlJlcG9zaXRvcnk4NzA2NzIxMg==-flat-linear_test.py,18,20,2,61,63,2
365,https://htmlpreview.github.io/?https://github.com/Christina96/boilerplate-sample-matches/blob/main/Python/yolact-MDEwOlJlcG9zaXRvcnkxMzg3OTY2OTk=-flat-eval.py-esptool-MDEwOlJlcG9zaXRvcnkyMzczNjkxNA==-flat-__init___2.py.html,12,yolact-MDEwOlJlcG9zaXRvcnkxMzg3OTY2OTk=-flat-eval.py,esptool-MDEwOlJlcG9zaXRvcnkyMzczNjkxNA==-flat-__init___2.py,218,220,2,221,223,2
366,https://htmlpreview.github.io/?https://github.com/Christina96/boilerplate-sample-matches/blob/main/Python/sonnet-MDEwOlJlcG9zaXRvcnk4NzA2NzIxMg==-flat-checkpoint_test.py-esptool-MDEwOlJlcG9zaXRvcnkyMzczNjkxNA==-flat-loader.py.html,17,sonnet-MDEwOlJlcG9zaXRvcnk4NzA2NzIxMg==-flat-checkpoint_test.py,esptool-MDEwOlJlcG9zaXRvcnkyMzczNjkxNA==-flat-loader.py,224,226,2,531,533,2
367,https://htmlpreview.github.io/?https://github.com/Christina96/boilerplate-sample-matches/blob/main/Python/google-api-python-client-MDEwOlJlcG9zaXRvcnkxNTc0OTI2OQ==-flat-appengine_memcache.py-yolact-MDEwOlJlcG9zaXRvcnkxMzg3OTY2OTk=-flat-augmentations.py.html,13,google-api-python-client-MDEwOlJlcG9zaXRvcnkxNTc0OTI2OQ==-flat-appengine_memcache.py,yolact-MDEwOlJlcG9zaXRvcnkxMzg3OTY2OTk=-flat-augmentations.py,9,11,2,292,294,2
368,https://htmlpreview.github.io/?https://github.com/Christina96/boilerplate-sample-matches/blob/main/Python/yolact-MDEwOlJlcG9zaXRvcnkxMzg3OTY2OTk=-flat-multibox_loss.py-yolact-MDEwOlJlcG9zaXRvcnkxMzg3OTY2OTk=-flat-multibox_loss.py.html,20,yolact-MDEwOlJlcG9zaXRvcnkxMzg3OTY2OTk=-flat-multibox_loss.py,yolact-MDEwOlJlcG9zaXRvcnkxMzg3OTY2OTk=-flat-multibox_loss.py,198,200,2,170,172,2
369,https://htmlpreview.github.io/?https://github.com/Christina96/boilerplate-sample-matches/blob/main/Python/google-api-python-client-MDEwOlJlcG9zaXRvcnkxNTc0OTI2OQ==-flat-create_instance.py-Ultroid-MDEwOlJlcG9zaXRvcnkzNDEwMzg2MDI=-flat-ytdl_7.py.html,12,google-api-python-client-MDEwOlJlcG9zaXRvcnkxNTc0OTI2OQ==-flat-create_instance.py,Ultroid-MDEwOlJlcG9zaXRvcnkzNDEwMzg2MDI=-flat-ytdl_7.py,50,54,4,147,151,4
370,https://htmlpreview.github.io/?https://github.com/Christina96/boilerplate-sample-matches/blob/main/Python/Ultroid-MDEwOlJlcG9zaXRvcnkzNDEwMzg2MDI=-flat-channelhacks.py-Ultroid-MDEwOlJlcG9zaXRvcnkzNDEwMzg2MDI=-flat-channelhacks.py.html,22,Ultroid-MDEwOlJlcG9zaXRvcnkzNDEwMzg2MDI=-flat-channelhacks.py,Ultroid-MDEwOlJlcG9zaXRvcnkzNDEwMzg2MDI=-flat-channelhacks.py,86,91,5,152,157,5
371,https://htmlpreview.github.io/?https://github.com/Christina96/boilerplate-sample-matches/blob/main/Python/esptool-MDEwOlJlcG9zaXRvcnkyMzczNjkxNA==-flat-fields_40.py-esptool-MDEwOlJlcG9zaXRvcnkyMzczNjkxNA==-flat-fields_35.py.html,329,esptool-MDEwOlJlcG9zaXRvcnkyMzczNjkxNA==-flat-fields_40.py,esptool-MDEwOlJlcG9zaXRvcnkyMzczNjkxNA==-flat-fields_35.py,24,73,49,24,73,49
372,https://htmlpreview.github.io/?https://github.com/Christina96/boilerplate-sample-matches/blob/main/Python/esptool-MDEwOlJlcG9zaXRvcnkyMzczNjkxNA==-flat-test_imagegen.py-google-api-python-client-MDEwOlJlcG9zaXRvcnkxNTc0OTI2OQ==-flat-test_json_model.py.html,13,esptool-MDEwOlJlcG9zaXRvcnkyMzczNjkxNA==-flat-test_imagegen.py,google-api-python-client-MDEwOlJlcG9zaXRvcnkxNTc0OTI2OQ==-flat-test_json_model.py,208,210,2,215,217,2
373,https://htmlpreview.github.io/?https://github.com/Christina96/boilerplate-sample-matches/blob/main/Python/esptool-MDEwOlJlcG9zaXRvcnkyMzczNjkxNA==-flat-operations_12.py-Ultroid-MDEwOlJlcG9zaXRvcnkzNDEwMzg2MDI=-flat-_decorators.py.html,12,esptool-MDEwOlJlcG9zaXRvcnkyMzczNjkxNA==-flat-operations_12.py,Ultroid-MDEwOlJlcG9zaXRvcnkzNDEwMzg2MDI=-flat-_decorators.py,12,18,6,16,22,6
374,https://htmlpreview.github.io/?https://github.com/Christina96/boilerplate-sample-matches/blob/main/Python/google-api-python-client-MDEwOlJlcG9zaXRvcnkxNTc0OTI2OQ==-flat-discovery.py-google-api-python-client-MDEwOlJlcG9zaXRvcnkxNTc0OTI2OQ==-flat-discovery.py.html,12,google-api-python-client-MDEwOlJlcG9zaXRvcnkxNTc0OTI2OQ==-flat-discovery.py,google-api-python-client-MDEwOlJlcG9zaXRvcnkxNTc0OTI2OQ==-flat-discovery.py,118,121,3,242,245,3
375,https://htmlpreview.github.io/?https://github.com/Christina96/boilerplate-sample-matches/blob/main/Python/Ultroid-MDEwOlJlcG9zaXRvcnkzNDEwMzg2MDI=-flat-pmpermit.py-Ultroid-MDEwOlJlcG9zaXRvcnkzNDEwMzg2MDI=-flat-pmpermit.py.html,17,Ultroid-MDEwOlJlcG9zaXRvcnkzNDEwMzg2MDI=-flat-pmpermit.py,Ultroid-MDEwOlJlcG9zaXRvcnkzNDEwMzg2MDI=-flat-pmpermit.py,769,770,1,751,752,1
376,https://htmlpreview.github.io/?https://github.com/Christina96/boilerplate-sample-matches/blob/main/Python/esptool-MDEwOlJlcG9zaXRvcnkyMzczNjkxNA==-flat-mem_definition_36.py-esptool-MDEwOlJlcG9zaXRvcnkyMzczNjkxNA==-flat-mem_definition_36.py.html,32,esptool-MDEwOlJlcG9zaXRvcnkyMzczNjkxNA==-flat-mem_definition_36.py,esptool-MDEwOlJlcG9zaXRvcnkyMzczNjkxNA==-flat-mem_definition_36.py,85,91,6,95,101,6
377,https://htmlpreview.github.io/?https://github.com/Christina96/boilerplate-sample-matches/blob/main/Python/yolact-MDEwOlJlcG9zaXRvcnkxMzg3OTY2OTk=-flat-make_grid.py-yolact-MDEwOlJlcG9zaXRvcnkxMzg3OTY2OTk=-flat-make_grid.py.html,14,yolact-MDEwOlJlcG9zaXRvcnkxMzg3OTY2OTk=-flat-make_grid.py,yolact-MDEwOlJlcG9zaXRvcnkxMzg3OTY2OTk=-flat-make_grid.py,55,59,4,63,66,3
378,https://htmlpreview.github.io/?https://github.com/Christina96/boilerplate-sample-matches/blob/main/Python/esptool-MDEwOlJlcG9zaXRvcnkyMzczNjkxNA==-flat-esp8266.py-esptool-MDEwOlJlcG9zaXRvcnkyMzczNjkxNA==-flat-esp8266.py.html,13,esptool-MDEwOlJlcG9zaXRvcnkyMzczNjkxNA==-flat-esp8266.py,esptool-MDEwOlJlcG9zaXRvcnkyMzczNjkxNA==-flat-esp8266.py,50,51,1,52,53,1
379,https://htmlpreview.github.io/?https://github.com/Christina96/boilerplate-sample-matches/blob/main/Python/google-api-python-client-MDEwOlJlcG9zaXRvcnkxNTc0OTI2OQ==-flat-audit.py-esptool-MDEwOlJlcG9zaXRvcnkyMzczNjkxNA==-flat-test_imagegen.py.html,12,google-api-python-client-MDEwOlJlcG9zaXRvcnkxNTc0OTI2OQ==-flat-audit.py,esptool-MDEwOlJlcG9zaXRvcnkyMzczNjkxNA==-flat-test_imagegen.py,30,32,2,247,249,2
380,https://htmlpreview.github.io/?https://github.com/Christina96/boilerplate-sample-matches/blob/main/Python/esptool-MDEwOlJlcG9zaXRvcnkyMzczNjkxNA==-flat-cmds.py-google-api-python-client-MDEwOlJlcG9zaXRvcnkxNTc0OTI2OQ==-flat-core_reporting_v3_reference.py.html,14,esptool-MDEwOlJlcG9zaXRvcnkyMzczNjkxNA==-flat-cmds.py,google-api-python-client-MDEwOlJlcG9zaXRvcnkxNTc0OTI2OQ==-flat-core_reporting_v3_reference.py,495,498,3,118,120,2
