ID,Link,Similarity,Tokens,File 1,File 2,Start 1,End 1,Detected Lines 1,Start 2,End 2,Detected Lines 2
169,https://htmlpreview.github.io/?https://github.com/Christina96/boilerplate-sample-matches/blob/main/Python/seq2seq-MDEwOlJlcG9zaXRvcnk4MzczMjgwNg==-flat-vocab_test.py-sonnet-MDEwOlJlcG9zaXRvcnk4NzA2NzIxMg==-flat-recurrent_test.py.html,0.11077191452245966,13,seq2seq-MDEwOlJlcG9zaXRvcnk4MzczMjgwNg==-flat-vocab_test.py,sonnet-MDEwOlJlcG9zaXRvcnk4NzA2NzIxMg==-flat-recurrent_test.py,36,40,4,355,357,2
189,https://htmlpreview.github.io/?https://github.com/Christina96/boilerplate-sample-matches/blob/main/Python/sonnet-MDEwOlJlcG9zaXRvcnk4NzA2NzIxMg==-flat-momentum.py-sonnet-MDEwOlJlcG9zaXRvcnk4NzA2NzIxMg==-flat-recurrent.py.html,0.034957627118644065,10,sonnet-MDEwOlJlcG9zaXRvcnk4NzA2NzIxMg==-flat-momentum.py,sonnet-MDEwOlJlcG9zaXRvcnk4NzA2NzIxMg==-flat-recurrent.py,46,49,3,447,450,3
221,https://htmlpreview.github.io/?https://github.com/Christina96/boilerplate-sample-matches/blob/main/Python/yolact-MDEwOlJlcG9zaXRvcnkxMzg3OTY2OTk=-flat-logger.py-esptool-MDEwOlJlcG9zaXRvcnkyMzczNjkxNA==-flat-fields_12.py.html,0.036193029490616625,9,yolact-MDEwOlJlcG9zaXRvcnkxMzg3OTY2OTk=-flat-logger.py,esptool-MDEwOlJlcG9zaXRvcnkyMzczNjkxNA==-flat-fields_12.py,56,59,3,47,49,2
269,https://htmlpreview.github.io/?https://github.com/Christina96/boilerplate-sample-matches/blob/main/Python/yolact-MDEwOlJlcG9zaXRvcnkxMzg3OTY2OTk=-flat-make_grid.py-yolact-MDEwOlJlcG9zaXRvcnkxMzg3OTY2OTk=-flat-coco.py.html,0.10443864229765012,12,yolact-MDEwOlJlcG9zaXRvcnkxMzg3OTY2OTk=-flat-make_grid.py,yolact-MDEwOlJlcG9zaXRvcnkxMzg3OTY2OTk=-flat-coco.py,67,69,2,77,79,2
296,https://htmlpreview.github.io/?https://github.com/Christina96/boilerplate-sample-matches/blob/main/Python/sonnet-MDEwOlJlcG9zaXRvcnk4NzA2NzIxMg==-flat-depthwise_conv_test.py-esptool-MDEwOlJlcG9zaXRvcnkyMzczNjkxNA==-flat-__init___48.py.html,0.03384841795437822,9,sonnet-MDEwOlJlcG9zaXRvcnk4NzA2NzIxMg==-flat-depthwise_conv_test.py,esptool-MDEwOlJlcG9zaXRvcnkyMzczNjkxNA==-flat-__init___48.py,159,160,1,526,529,3
799,https://htmlpreview.github.io/?https://github.com/Christina96/boilerplate-sample-matches/blob/main/Python/esptool-MDEwOlJlcG9zaXRvcnkyMzczNjkxNA==-flat-mem_definition_31.py-esptool-MDEwOlJlcG9zaXRvcnkyMzczNjkxNA==-flat-test_espefuse.py.html,0.012903225806451613,12,esptool-MDEwOlJlcG9zaXRvcnkyMzczNjkxNA==-flat-mem_definition_31.py,esptool-MDEwOlJlcG9zaXRvcnkyMzczNjkxNA==-flat-test_espefuse.py,83,85,2,8,10,2
1284,https://htmlpreview.github.io/?https://github.com/Christina96/boilerplate-sample-matches/blob/main/Python/sonnet-MDEwOlJlcG9zaXRvcnk4NzA2NzIxMg==-flat-util_test.py-yolact-MDEwOlJlcG9zaXRvcnkxMzg3OTY2OTk=-flat-multibox_loss.py.html,0.1290704558910598,9,sonnet-MDEwOlJlcG9zaXRvcnk4NzA2NzIxMg==-flat-util_test.py,yolact-MDEwOlJlcG9zaXRvcnkxMzg3OTY2OTk=-flat-multibox_loss.py,15,19,4,149,150,1
1428,https://htmlpreview.github.io/?https://github.com/Christina96/boilerplate-sample-matches/blob/main/Python/seq2seq-MDEwOlJlcG9zaXRvcnk4MzczMjgwNg==-flat-utils.py-Ultroid-MDEwOlJlcG9zaXRvcnkzNDEwMzg2MDI=-flat-specialtools.py.html,0.028391167192429023,9,seq2seq-MDEwOlJlcG9zaXRvcnk4MzczMjgwNg==-flat-utils.py,Ultroid-MDEwOlJlcG9zaXRvcnkzNDEwMzg2MDI=-flat-specialtools.py,8,10,2,180,183,3
1468,https://htmlpreview.github.io/?https://github.com/Christina96/boilerplate-sample-matches/blob/main/Python/google-api-python-client-MDEwOlJlcG9zaXRvcnkxNTc0OTI2OQ==-flat-test_json_model.py-yolact-MDEwOlJlcG9zaXRvcnkxMzg3OTY2OTk=-flat-backbone.py.html,0.10485736314572089,11,google-api-python-client-MDEwOlJlcG9zaXRvcnkxNTc0OTI2OQ==-flat-test_json_model.py,yolact-MDEwOlJlcG9zaXRvcnkxMzg3OTY2OTk=-flat-backbone.py,93,100,7,47,49,2
1544,https://htmlpreview.github.io/?https://github.com/Christina96/boilerplate-sample-matches/blob/main/Python/Ultroid-MDEwOlJlcG9zaXRvcnkzNDEwMzg2MDI=-flat-forcesubscribe.py-Ultroid-MDEwOlJlcG9zaXRvcnkzNDEwMzg2MDI=-flat-callbackstuffs.py.html,0.05735354362965998,9,Ultroid-MDEwOlJlcG9zaXRvcnkzNDEwMzg2MDI=-flat-forcesubscribe.py,Ultroid-MDEwOlJlcG9zaXRvcnkzNDEwMzg2MDI=-flat-callbackstuffs.py,26,29,3,1131,1134,3
1628,https://htmlpreview.github.io/?https://github.com/Christina96/boilerplate-sample-matches/blob/main/Python/yolact-MDEwOlJlcG9zaXRvcnkxMzg3OTY2OTk=-flat-box_utils.py-esptool-MDEwOlJlcG9zaXRvcnkyMzczNjkxNA==-flat-fields_32.py.html,0.08545727136431784,9,yolact-MDEwOlJlcG9zaXRvcnkxMzg3OTY2OTk=-flat-box_utils.py,esptool-MDEwOlJlcG9zaXRvcnkyMzczNjkxNA==-flat-fields_32.py,116,118,2,133,134,1
2816,https://htmlpreview.github.io/?https://github.com/Christina96/boilerplate-sample-matches/blob/main/Python/yolact-MDEwOlJlcG9zaXRvcnkxMzg3OTY2OTk=-flat-multibox_loss.py-google-api-python-client-MDEwOlJlcG9zaXRvcnkxNTc0OTI2OQ==-flat-http.py.html,0.07849604221635884,10,yolact-MDEwOlJlcG9zaXRvcnkxMzg3OTY2OTk=-flat-multibox_loss.py,google-api-python-client-MDEwOlJlcG9zaXRvcnkxNTc0OTI2OQ==-flat-http.py,213,218,5,778,785,7
3468,https://htmlpreview.github.io/?https://github.com/Christina96/boilerplate-sample-matches/blob/main/Python/Ultroid-MDEwOlJlcG9zaXRvcnkzNDEwMzg2MDI=-flat-stickertools.py-esptool-MDEwOlJlcG9zaXRvcnkyMzczNjkxNA==-flat-loader.py.html,0.058022922636103154,9,Ultroid-MDEwOlJlcG9zaXRvcnkzNDEwMzg2MDI=-flat-stickertools.py,esptool-MDEwOlJlcG9zaXRvcnkyMzczNjkxNA==-flat-loader.py,1,8,7,10,24,14
3608,https://htmlpreview.github.io/?https://github.com/Christina96/boilerplate-sample-matches/blob/main/Python/Ultroid-MDEwOlJlcG9zaXRvcnkzNDEwMzg2MDI=-flat-qrcode.py-esptool-MDEwOlJlcG9zaXRvcnkyMzczNjkxNA==-flat-operations.py.html,0.04951856946354883,9,Ultroid-MDEwOlJlcG9zaXRvcnkzNDEwMzg2MDI=-flat-qrcode.py,esptool-MDEwOlJlcG9zaXRvcnkyMzczNjkxNA==-flat-operations.py,51,53,2,96,104,8
3702,https://htmlpreview.github.io/?https://github.com/Christina96/boilerplate-sample-matches/blob/main/Python/sonnet-MDEwOlJlcG9zaXRvcnk4NzA2NzIxMg==-flat-checkpoint_test.py-google-api-python-client-MDEwOlJlcG9zaXRvcnkxNTc0OTI2OQ==-flat-http.py.html,0.02702702702702703,15,sonnet-MDEwOlJlcG9zaXRvcnk4NzA2NzIxMg==-flat-checkpoint_test.py,google-api-python-client-MDEwOlJlcG9zaXRvcnkxNTc0OTI2OQ==-flat-http.py,12,20,8,184,193,9
3878,https://htmlpreview.github.io/?https://github.com/Christina96/boilerplate-sample-matches/blob/main/Python/Ultroid-MDEwOlJlcG9zaXRvcnkzNDEwMzg2MDI=-flat-downloadupload.py-esptool-MDEwOlJlcG9zaXRvcnkyMzczNjkxNA==-flat-bin_image.py.html,0.03270042194092827,11,Ultroid-MDEwOlJlcG9zaXRvcnkzNDEwMzg2MDI=-flat-downloadupload.py,esptool-MDEwOlJlcG9zaXRvcnkyMzczNjkxNA==-flat-bin_image.py,138,145,7,498,503,5
4316,https://htmlpreview.github.io/?https://github.com/Christina96/boilerplate-sample-matches/blob/main/Python/Ultroid-MDEwOlJlcG9zaXRvcnkzNDEwMzg2MDI=-flat-fileshare.py-Ultroid-MDEwOlJlcG9zaXRvcnkzNDEwMzg2MDI=-flat-ziptools.py.html,0.0392156862745098,9,Ultroid-MDEwOlJlcG9zaXRvcnkzNDEwMzg2MDI=-flat-fileshare.py,Ultroid-MDEwOlJlcG9zaXRvcnkzNDEwMzg2MDI=-flat-ziptools.py,4,9,5,1,16,15
4917,https://htmlpreview.github.io/?https://github.com/Christina96/boilerplate-sample-matches/blob/main/Python/Ultroid-MDEwOlJlcG9zaXRvcnkzNDEwMzg2MDI=-flat-fakeaction.py-sonnet-MDEwOlJlcG9zaXRvcnk4NzA2NzIxMg==-flat-util_test.py.html,0.04426559356136821,11,Ultroid-MDEwOlJlcG9zaXRvcnkzNDEwMzg2MDI=-flat-fakeaction.py,sonnet-MDEwOlJlcG9zaXRvcnk4NzA2NzIxMg==-flat-util_test.py,10,12,2,50,52,2
5518,https://htmlpreview.github.io/?https://github.com/Christina96/boilerplate-sample-matches/blob/main/Python/esptool-MDEwOlJlcG9zaXRvcnkyMzczNjkxNA==-flat-__init__.py-yolact-MDEwOlJlcG9zaXRvcnkxMzg3OTY2OTk=-flat-eval.py.html,0.07495881383855024,19,esptool-MDEwOlJlcG9zaXRvcnkyMzczNjkxNA==-flat-__init__.py,yolact-MDEwOlJlcG9zaXRvcnkxMzg3OTY2OTk=-flat-eval.py,137,159,22,71,79,8
5548,https://htmlpreview.github.io/?https://github.com/Christina96/boilerplate-sample-matches/blob/main/Python/google-api-python-client-MDEwOlJlcG9zaXRvcnkxNTc0OTI2OQ==-flat-hello_analytics_api_v3.py-yolact-MDEwOlJlcG9zaXRvcnkxMzg3OTY2OTk=-flat-test.py.html,0.08275862068965517,11,google-api-python-client-MDEwOlJlcG9zaXRvcnkxNTc0OTI2OQ==-flat-hello_analytics_api_v3.py,yolact-MDEwOlJlcG9zaXRvcnkxMzg3OTY2OTk=-flat-test.py,41,45,4,173,176,3
5792,https://htmlpreview.github.io/?https://github.com/Christina96/boilerplate-sample-matches/blob/main/Python/Ultroid-MDEwOlJlcG9zaXRvcnkzNDEwMzg2MDI=-flat-pdftools.py-yolact-MDEwOlJlcG9zaXRvcnkxMzg3OTY2OTk=-flat-eval.py.html,0.07267441860465117,10,Ultroid-MDEwOlJlcG9zaXRvcnkzNDEwMzg2MDI=-flat-pdftools.py,yolact-MDEwOlJlcG9zaXRvcnkxMzg3OTY2OTk=-flat-eval.py,51,53,2,210,211,1
5979,https://htmlpreview.github.io/?https://github.com/Christina96/boilerplate-sample-matches/blob/main/Python/seq2seq-MDEwOlJlcG9zaXRvcnk4MzczMjgwNg==-flat-decoder_test.py-esphome-docs-MDEwOlJlcG9zaXRvcnkxMzMyMjM0NjE=-flat-schema_doc.py.html,0.08867427568042142,9,seq2seq-MDEwOlJlcG9zaXRvcnk4MzczMjgwNg==-flat-decoder_test.py,esphome-docs-MDEwOlJlcG9zaXRvcnkxMzMyMjM0NjE=-flat-schema_doc.py,113,115,2,56,80,24
6342,https://htmlpreview.github.io/?https://github.com/Christina96/boilerplate-sample-matches/blob/main/Python/Ultroid-MDEwOlJlcG9zaXRvcnkzNDEwMzg2MDI=-flat-callbackstuffs.py-esptool-MDEwOlJlcG9zaXRvcnkyMzczNjkxNA==-flat-__init___48.py.html,0.06776556776556776,10,Ultroid-MDEwOlJlcG9zaXRvcnkzNDEwMzg2MDI=-flat-callbackstuffs.py,esptool-MDEwOlJlcG9zaXRvcnkyMzczNjkxNA==-flat-__init___48.py,52,61,9,66,68,2
6380,https://htmlpreview.github.io/?https://github.com/Christina96/boilerplate-sample-matches/blob/main/Python/seq2seq-MDEwOlJlcG9zaXRvcnk4MzczMjgwNg==-flat-generate_vocab.py-sonnet-MDEwOlJlcG9zaXRvcnk4NzA2NzIxMg==-flat-momentum_test.py.html,0.05555555555555555,9,seq2seq-MDEwOlJlcG9zaXRvcnk4MzczMjgwNg==-flat-generate_vocab.py,sonnet-MDEwOlJlcG9zaXRvcnk4NzA2NzIxMg==-flat-momentum_test.py,2,8,6,1,5,4
6978,https://htmlpreview.github.io/?https://github.com/Christina96/boilerplate-sample-matches/blob/main/Python/seq2seq-MDEwOlJlcG9zaXRvcnk4MzczMjgwNg==-flat-pipeline_test.py-practical-python-MDEwOlJlcG9zaXRvcnkyNjY2MTM3MDQ=-flat-stocksim.py.html,0.16533333333333333,12,seq2seq-MDEwOlJlcG9zaXRvcnk4MzczMjgwNg==-flat-pipeline_test.py,practical-python-MDEwOlJlcG9zaXRvcnkyNjY2MTM3MDQ=-flat-stocksim.py,106,107,1,89,89,0
7005,https://htmlpreview.github.io/?https://github.com/Christina96/boilerplate-sample-matches/blob/main/Python/sonnet-MDEwOlJlcG9zaXRvcnk4NzA2NzIxMg==-flat-cifar10_convnet_test.py-Ultroid-MDEwOlJlcG9zaXRvcnkzNDEwMzg2MDI=-flat-ziptools.py.html,0.0379746835443038,9,sonnet-MDEwOlJlcG9zaXRvcnk4NzA2NzIxMg==-flat-cifar10_convnet_test.py,Ultroid-MDEwOlJlcG9zaXRvcnkzNDEwMzg2MDI=-flat-ziptools.py,18,20,2,100,109,9
7181,https://htmlpreview.github.io/?https://github.com/Christina96/boilerplate-sample-matches/blob/main/Python/seq2seq-MDEwOlJlcG9zaXRvcnk4MzczMjgwNg==-flat-hooks_test.py-seq2seq-MDEwOlJlcG9zaXRvcnk4MzczMjgwNg==-flat-rnn_cell_test.py.html,0.12753623188405797,9,seq2seq-MDEwOlJlcG9zaXRvcnk4MzczMjgwNg==-flat-hooks_test.py,seq2seq-MDEwOlJlcG9zaXRvcnk4MzczMjgwNg==-flat-rnn_cell_test.py,68,97,29,8,97,89
7304,https://htmlpreview.github.io/?https://github.com/Christina96/boilerplate-sample-matches/blob/main/Python/sonnet-MDEwOlJlcG9zaXRvcnk4NzA2NzIxMg==-flat-pickle_test.py-sonnet-MDEwOlJlcG9zaXRvcnk4NzA2NzIxMg==-flat-simple_mnist_test.py.html,0.2222222222222222,9,sonnet-MDEwOlJlcG9zaXRvcnk4NzA2NzIxMg==-flat-pickle_test.py,sonnet-MDEwOlJlcG9zaXRvcnk4NzA2NzIxMg==-flat-simple_mnist_test.py,16,18,2,15,16,1
7387,https://htmlpreview.github.io/?https://github.com/Christina96/boilerplate-sample-matches/blob/main/Python/Ultroid-MDEwOlJlcG9zaXRvcnkzNDEwMzg2MDI=-flat-snips_db.py-esptool-MDEwOlJlcG9zaXRvcnkyMzczNjkxNA==-flat-esp8266.py.html,0.0851063829787234,10,Ultroid-MDEwOlJlcG9zaXRvcnkzNDEwMzg2MDI=-flat-snips_db.py,esptool-MDEwOlJlcG9zaXRvcnkyMzczNjkxNA==-flat-esp8266.py,8,13,5,86,91,5
7512,https://htmlpreview.github.io/?https://github.com/Christina96/boilerplate-sample-matches/blob/main/Python/esptool-MDEwOlJlcG9zaXRvcnkyMzczNjkxNA==-flat-mem_definition.py-esptool-MDEwOlJlcG9zaXRvcnkyMzczNjkxNA==-flat-mem_definition_11.py.html,0.7708333333333334,26,esptool-MDEwOlJlcG9zaXRvcnkyMzczNjkxNA==-flat-mem_definition.py,esptool-MDEwOlJlcG9zaXRvcnkyMzczNjkxNA==-flat-mem_definition_11.py,68,75,7,86,93,7
7646,https://htmlpreview.github.io/?https://github.com/Christina96/boilerplate-sample-matches/blob/main/Python/google-api-python-client-MDEwOlJlcG9zaXRvcnkxNTc0OTI2OQ==-flat-describe.py-esphome-docs-MDEwOlJlcG9zaXRvcnkxMzMyMjM0NjE=-flat-lint.py.html,0.05333333333333334,9,google-api-python-client-MDEwOlJlcG9zaXRvcnkxNTc0OTI2OQ==-flat-describe.py,esphome-docs-MDEwOlJlcG9zaXRvcnkxMzMyMjM0NjE=-flat-lint.py,243,249,6,78,82,4
7947,https://htmlpreview.github.io/?https://github.com/Christina96/boilerplate-sample-matches/blob/main/Python/esptool-MDEwOlJlcG9zaXRvcnkyMzczNjkxNA==-flat-esp_rfc2217_server.py-google-api-python-client-MDEwOlJlcG9zaXRvcnkxNTc0OTI2OQ==-flat-test_http.py.html,0.0667107001321004,12,esptool-MDEwOlJlcG9zaXRvcnkyMzczNjkxNA==-flat-esp_rfc2217_server.py,google-api-python-client-MDEwOlJlcG9zaXRvcnkxNTc0OTI2OQ==-flat-test_http.py,165,167,2,369,372,3
8314,https://htmlpreview.github.io/?https://github.com/Christina96/boilerplate-sample-matches/blob/main/Python/google-api-python-client-MDEwOlJlcG9zaXRvcnkxNTc0OTI2OQ==-flat-management_v3_reference.py-esptool-MDEwOlJlcG9zaXRvcnkyMzczNjkxNA==-flat-__init___45.py.html,0.0428481411468179,10,google-api-python-client-MDEwOlJlcG9zaXRvcnkxNTc0OTI2OQ==-flat-management_v3_reference.py,esptool-MDEwOlJlcG9zaXRvcnkyMzczNjkxNA==-flat-__init___45.py,36,67,31,672,681,9
8537,https://htmlpreview.github.io/?https://github.com/Christina96/boilerplate-sample-matches/blob/main/Python/Ultroid-MDEwOlJlcG9zaXRvcnkzNDEwMzg2MDI=-flat-filter_db.py-Ultroid-MDEwOlJlcG9zaXRvcnkzNDEwMzg2MDI=-flat-notes_db.py.html,0.6235294117647059,10,Ultroid-MDEwOlJlcG9zaXRvcnkzNDEwMzg2MDI=-flat-filter_db.py,Ultroid-MDEwOlJlcG9zaXRvcnkzNDEwMzg2MDI=-flat-notes_db.py,11,18,7,11,18,7
9095,https://htmlpreview.github.io/?https://github.com/Christina96/boilerplate-sample-matches/blob/main/Python/seq2seq-MDEwOlJlcG9zaXRvcnk4MzczMjgwNg==-flat-generate_vocab.py-Ultroid-MDEwOlJlcG9zaXRvcnkzNDEwMzg2MDI=-flat-_decorators.py.html,0.07191780821917808,10,seq2seq-MDEwOlJlcG9zaXRvcnk4MzczMjgwNg==-flat-generate_vocab.py,Ultroid-MDEwOlJlcG9zaXRvcnkzNDEwMzg2MDI=-flat-_decorators.py,33,39,6,54,57,3
9702,https://htmlpreview.github.io/?https://github.com/Christina96/boilerplate-sample-matches/blob/main/Python/Ultroid-MDEwOlJlcG9zaXRvcnkzNDEwMzg2MDI=-flat-_decorators.py-Ultroid-MDEwOlJlcG9zaXRvcnkzNDEwMzg2MDI=-flat-admintools.py.html,0.04212055192447349,9,Ultroid-MDEwOlJlcG9zaXRvcnkzNDEwMzg2MDI=-flat-_decorators.py,Ultroid-MDEwOlJlcG9zaXRvcnkzNDEwMzg2MDI=-flat-admintools.py,131,141,10,237,238,1
9941,https://htmlpreview.github.io/?https://github.com/Christina96/boilerplate-sample-matches/blob/main/Python/wxpy-MDEwOlJlcG9zaXRvcnk4MjU4ODU5Nw==-flat-conf.py-esptool-MDEwOlJlcG9zaXRvcnkyMzczNjkxNA==-flat-mem_definition_6.py.html,0.14760147601476015,10,wxpy-MDEwOlJlcG9zaXRvcnk4MjU4ODU5Nw==-flat-conf.py,esptool-MDEwOlJlcG9zaXRvcnkyMzczNjkxNA==-flat-mem_definition_6.py,44,55,11,58,68,10
10244,https://htmlpreview.github.io/?https://github.com/Christina96/boilerplate-sample-matches/blob/main/Python/Ultroid-MDEwOlJlcG9zaXRvcnkzNDEwMzg2MDI=-flat-utils.py-esphome-docs-MDEwOlJlcG9zaXRvcnkxMzMyMjM0NjE=-flat-github.py.html,0.053973013493253376,9,Ultroid-MDEwOlJlcG9zaXRvcnkzNDEwMzg2MDI=-flat-utils.py,esphome-docs-MDEwOlJlcG9zaXRvcnkxMzMyMjM0NjE=-flat-github.py,20,20,0,101,103,2
10345,https://htmlpreview.github.io/?https://github.com/Christina96/boilerplate-sample-matches/blob/main/Python/Ultroid-MDEwOlJlcG9zaXRvcnkzNDEwMzg2MDI=-flat-__main__.py-seq2seq-MDEwOlJlcG9zaXRvcnk4MzczMjgwNg==-flat-vocab.py.html,0.06716417910447761,9,Ultroid-MDEwOlJlcG9zaXRvcnkzNDEwMzg2MDI=-flat-__main__.py,seq2seq-MDEwOlJlcG9zaXRvcnk4MzczMjgwNg==-flat-vocab.py,33,36,3,41,43,2
11489,https://htmlpreview.github.io/?https://github.com/Christina96/boilerplate-sample-matches/blob/main/Python/google-api-python-client-MDEwOlJlcG9zaXRvcnkxNTc0OTI2OQ==-flat-updatediscoveryartifacts.py-wxpy-MDEwOlJlcG9zaXRvcnk4MjU4ODU5Nw==-flat-console.py.html,0.13620071684587814,9,google-api-python-client-MDEwOlJlcG9zaXRvcnkxNTc0OTI2OQ==-flat-updatediscoveryartifacts.py,wxpy-MDEwOlJlcG9zaXRvcnk4MjU4ODU5Nw==-flat-console.py,13,15,2,35,40,5
11615,https://htmlpreview.github.io/?https://github.com/Christina96/boilerplate-sample-matches/blob/main/Python/google-api-python-client-MDEwOlJlcG9zaXRvcnkxNTc0OTI2OQ==-flat-readme_gen.py-Ultroid-MDEwOlJlcG9zaXRvcnkzNDEwMzg2MDI=-flat-fileshare.py.html,0.06642066420664207,9,google-api-python-client-MDEwOlJlcG9zaXRvcnkxNTc0OTI2OQ==-flat-readme_gen.py,Ultroid-MDEwOlJlcG9zaXRvcnkzNDEwMzg2MDI=-flat-fileshare.py,11,15,4,65,66,1
11790,https://htmlpreview.github.io/?https://github.com/Christina96/boilerplate-sample-matches/blob/main/Python/google-api-python-client-MDEwOlJlcG9zaXRvcnkxNTc0OTI2OQ==-flat-basic.py-sonnet-MDEwOlJlcG9zaXRvcnk4NzA2NzIxMg==-flat-reshape_test.py.html,0.030816640986132512,10,google-api-python-client-MDEwOlJlcG9zaXRvcnkxNTc0OTI2OQ==-flat-basic.py,sonnet-MDEwOlJlcG9zaXRvcnk4NzA2NzIxMg==-flat-reshape_test.py,9,11,2,108,110,2
11970,https://htmlpreview.github.io/?https://github.com/Christina96/boilerplate-sample-matches/blob/main/Python/seq2seq-MDEwOlJlcG9zaXRvcnk4MzczMjgwNg==-flat-basic_seq2seq.py-seq2seq-MDEwOlJlcG9zaXRvcnk4MzczMjgwNg==-flat-helper.py.html,0.04072883172561629,9,seq2seq-MDEwOlJlcG9zaXRvcnk4MzczMjgwNg==-flat-basic_seq2seq.py,seq2seq-MDEwOlJlcG9zaXRvcnk4MzczMjgwNg==-flat-helper.py,43,47,4,284,286,2
12279,https://htmlpreview.github.io/?https://github.com/Christina96/boilerplate-sample-matches/blob/main/Python/google-api-python-client-MDEwOlJlcG9zaXRvcnkxNTc0OTI2OQ==-flat-maps_engine.py-yolact-MDEwOlJlcG9zaXRvcnkxMzg3OTY2OTk=-flat-yolact.py.html,0.04094689699296225,9,google-api-python-client-MDEwOlJlcG9zaXRvcnkxNTc0OTI2OQ==-flat-maps_engine.py,yolact-MDEwOlJlcG9zaXRvcnkxMzg3OTY2OTk=-flat-yolact.py,19,20,1,407,409,2
12707,https://htmlpreview.github.io/?https://github.com/Christina96/boilerplate-sample-matches/blob/main/Python/Ultroid-MDEwOlJlcG9zaXRvcnkzNDEwMzg2MDI=-flat-pdftools.py-google-api-python-client-MDEwOlJlcG9zaXRvcnkxNTc0OTI2OQ==-flat-discovery.py.html,0.07577174929840973,9,Ultroid-MDEwOlJlcG9zaXRvcnkzNDEwMzg2MDI=-flat-pdftools.py,google-api-python-client-MDEwOlJlcG9zaXRvcnkxNTc0OTI2OQ==-flat-discovery.py,197,200,3,51,54,3
12717,https://htmlpreview.github.io/?https://github.com/Christina96/boilerplate-sample-matches/blob/main/Python/google-api-python-client-MDEwOlJlcG9zaXRvcnkxNTc0OTI2OQ==-flat-describe_9.py-esptool-MDEwOlJlcG9zaXRvcnkyMzczNjkxNA==-flat-__init___48.py.html,0.09134088417975886,9,google-api-python-client-MDEwOlJlcG9zaXRvcnkxNTc0OTI2OQ==-flat-describe_9.py,esptool-MDEwOlJlcG9zaXRvcnkyMzczNjkxNA==-flat-__init___48.py,110,115,5,627,631,4
12860,https://htmlpreview.github.io/?https://github.com/Christina96/boilerplate-sample-matches/blob/main/Python/cookiecutter-pypackage-MDEwOlJlcG9zaXRvcnkxMTQwNzU2Nw==-flat-conf_1.py-seq2seq-MDEwOlJlcG9zaXRvcnk4MzczMjgwNg==-flat-train_utils_test.py.html,0.04986149584487535,9,cookiecutter-pypackage-MDEwOlJlcG9zaXRvcnkxMTQwNzU2Nw==-flat-conf_1.py,seq2seq-MDEwOlJlcG9zaXRvcnk4MzczMjgwNg==-flat-train_utils_test.py,13,15,2,74,78,4
13821,https://htmlpreview.github.io/?https://github.com/Christina96/boilerplate-sample-matches/blob/main/Python/wxpy-MDEwOlJlcG9zaXRvcnk4MjU4ODU5Nw==-flat-xiaoi.py-esptool-MDEwOlJlcG9zaXRvcnkyMzczNjkxNA==-flat-esp_rfc2217_server.py.html,0.10619469026548672,9,wxpy-MDEwOlJlcG9zaXRvcnk4MjU4ODU5Nw==-flat-xiaoi.py,esptool-MDEwOlJlcG9zaXRvcnkyMzczNjkxNA==-flat-esp_rfc2217_server.py,32,33,1,168,170,2
14146,https://htmlpreview.github.io/?https://github.com/Christina96/boilerplate-sample-matches/blob/main/Python/esptool-MDEwOlJlcG9zaXRvcnkyMzczNjkxNA==-flat-reset.py-sonnet-MDEwOlJlcG9zaXRvcnk4NzA2NzIxMg==-flat-linear_test.py.html,0.0932475884244373,10,esptool-MDEwOlJlcG9zaXRvcnkyMzczNjkxNA==-flat-reset.py,sonnet-MDEwOlJlcG9zaXRvcnk4NzA2NzIxMg==-flat-linear_test.py,51,55,4,21,24,3
14861,https://htmlpreview.github.io/?https://github.com/Christina96/boilerplate-sample-matches/blob/main/Python/seq2seq-MDEwOlJlcG9zaXRvcnk4MzczMjgwNg==-flat-rnn_encoder.py-seq2seq-MDEwOlJlcG9zaXRvcnk4MzczMjgwNg==-flat-seq2seq_model.py.html,0.1485884101040119,9,seq2seq-MDEwOlJlcG9zaXRvcnk4MzczMjgwNg==-flat-rnn_encoder.py,seq2seq-MDEwOlJlcG9zaXRvcnk4MzczMjgwNg==-flat-seq2seq_model.py,46,48,2,19,20,1
15299,https://htmlpreview.github.io/?https://github.com/Christina96/boilerplate-sample-matches/blob/main/Python/google-api-python-client-MDEwOlJlcG9zaXRvcnkxNTc0OTI2OQ==-flat-coordinate.py-Ultroid-MDEwOlJlcG9zaXRvcnkzNDEwMzg2MDI=-flat-_decorators.py.html,0.08664259927797834,10,google-api-python-client-MDEwOlJlcG9zaXRvcnkxNTc0OTI2OQ==-flat-coordinate.py,Ultroid-MDEwOlJlcG9zaXRvcnkzNDEwMzg2MDI=-flat-_decorators.py,41,46,5,130,135,5
15381,https://htmlpreview.github.io/?https://github.com/Christina96/boilerplate-sample-matches/blob/main/Python/google-api-python-client-MDEwOlJlcG9zaXRvcnkxNTc0OTI2OQ==-flat-describe.py-Ultroid-MDEwOlJlcG9zaXRvcnkzNDEwMzg2MDI=-flat-stickertools.py.html,0.10028653295128939,9,google-api-python-client-MDEwOlJlcG9zaXRvcnkxNTc0OTI2OQ==-flat-describe.py,Ultroid-MDEwOlJlcG9zaXRvcnkzNDEwMzg2MDI=-flat-stickertools.py,103,106,3,255,260,5
15384,https://htmlpreview.github.io/?https://github.com/Christina96/boilerplate-sample-matches/blob/main/Python/google-api-python-client-MDEwOlJlcG9zaXRvcnkxNTc0OTI2OQ==-flat-describe.py-Ultroid-MDEwOlJlcG9zaXRvcnkzNDEwMzg2MDI=-flat-stickertools.py.html,0.10028653295128939,9,google-api-python-client-MDEwOlJlcG9zaXRvcnkxNTc0OTI2OQ==-flat-describe.py,Ultroid-MDEwOlJlcG9zaXRvcnkzNDEwMzg2MDI=-flat-stickertools.py,191,194,3,445,450,5
16012,https://htmlpreview.github.io/?https://github.com/Christina96/boilerplate-sample-matches/blob/main/Python/seq2seq-MDEwOlJlcG9zaXRvcnk4MzczMjgwNg==-flat-attention_decoder.py-Ultroid-MDEwOlJlcG9zaXRvcnkzNDEwMzg2MDI=-flat-audiotools.py.html,0.037422037422037424,9,seq2seq-MDEwOlJlcG9zaXRvcnk4MzczMjgwNg==-flat-attention_decoder.py,Ultroid-MDEwOlJlcG9zaXRvcnkzNDEwMzg2MDI=-flat-audiotools.py,64,67,3,58,62,4
16386,https://htmlpreview.github.io/?https://github.com/Christina96/boilerplate-sample-matches/blob/main/Python/sonnet-MDEwOlJlcG9zaXRvcnk4NzA2NzIxMg==-flat-vqvae.py-sonnet-MDEwOlJlcG9zaXRvcnk4NzA2NzIxMg==-flat-mlp_test.py.html,0.06779661016949153,10,sonnet-MDEwOlJlcG9zaXRvcnk4NzA2NzIxMg==-flat-vqvae.py,sonnet-MDEwOlJlcG9zaXRvcnk4NzA2NzIxMg==-flat-mlp_test.py,52,79,27,36,45,9
16671,https://htmlpreview.github.io/?https://github.com/Christina96/boilerplate-sample-matches/blob/main/Python/seq2seq-MDEwOlJlcG9zaXRvcnk4MzczMjgwNg==-flat-beam_search_decoder.py-seq2seq-MDEwOlJlcG9zaXRvcnk4MzczMjgwNg==-flat-rnn_encoder_test.py.html,0.06296851574212893,11,seq2seq-MDEwOlJlcG9zaXRvcnk4MzczMjgwNg==-flat-beam_search_decoder.py,seq2seq-MDEwOlJlcG9zaXRvcnk4MzczMjgwNg==-flat-rnn_encoder_test.py,83,87,4,11,15,4
16844,https://htmlpreview.github.io/?https://github.com/Christina96/boilerplate-sample-matches/blob/main/Python/sonnet-MDEwOlJlcG9zaXRvcnk4NzA2NzIxMg==-flat-vqvae.py-sonnet-MDEwOlJlcG9zaXRvcnk4NzA2NzIxMg==-flat-conv_test.py.html,0.09594882729211088,9,sonnet-MDEwOlJlcG9zaXRvcnk4NzA2NzIxMg==-flat-vqvae.py,sonnet-MDEwOlJlcG9zaXRvcnk4NzA2NzIxMg==-flat-conv_test.py,85,88,3,127,128,1
16909,https://htmlpreview.github.io/?https://github.com/Christina96/boilerplate-sample-matches/blob/main/Python/Ultroid-MDEwOlJlcG9zaXRvcnkzNDEwMzg2MDI=-flat-_wspr.py-sonnet-MDEwOlJlcG9zaXRvcnk4NzA2NzIxMg==-flat-haiku_test.py.html,0.038502673796791446,9,Ultroid-MDEwOlJlcG9zaXRvcnkzNDEwMzg2MDI=-flat-_wspr.py,sonnet-MDEwOlJlcG9zaXRvcnk4NzA2NzIxMg==-flat-haiku_test.py,166,169,3,135,137,2
17263,https://htmlpreview.github.io/?https://github.com/Christina96/boilerplate-sample-matches/blob/main/Python/sonnet-MDEwOlJlcG9zaXRvcnk4NzA2NzIxMg==-flat-bias.py-esptool-MDEwOlJlcG9zaXRvcnkyMzczNjkxNA==-flat-bin_image.py.html,0.02261904761904762,10,sonnet-MDEwOlJlcG9zaXRvcnk4NzA2NzIxMg==-flat-bias.py,esptool-MDEwOlJlcG9zaXRvcnkyMzczNjkxNA==-flat-bin_image.py,10,13,3,535,538,3
17621,https://htmlpreview.github.io/?https://github.com/Christina96/boilerplate-sample-matches/blob/main/Python/esptool-MDEwOlJlcG9zaXRvcnkyMzczNjkxNA==-flat-operations_30.py-google-api-python-client-MDEwOlJlcG9zaXRvcnkxNTc0OTI2OQ==-flat-http.py.html,0.025399426464563703,10,esptool-MDEwOlJlcG9zaXRvcnkyMzczNjkxNA==-flat-operations_30.py,google-api-python-client-MDEwOlJlcG9zaXRvcnkxNTc0OTI2OQ==-flat-http.py,306,311,5,270,273,3
17679,https://htmlpreview.github.io/?https://github.com/Christina96/boilerplate-sample-matches/blob/main/Python/google-api-python-client-MDEwOlJlcG9zaXRvcnkxNTc0OTI2OQ==-flat-generate_report_with_paging.py-wxpy-MDEwOlJlcG9zaXRvcnk4MjU4ODU5Nw==-flat-misc.py.html,0.03377110694183865,9,google-api-python-client-MDEwOlJlcG9zaXRvcnkxNTc0OTI2OQ==-flat-generate_report_with_paging.py,wxpy-MDEwOlJlcG9zaXRvcnk4MjU4ODU5Nw==-flat-misc.py,8,12,4,206,211,5
17980,https://htmlpreview.github.io/?https://github.com/Christina96/boilerplate-sample-matches/blob/main/Python/esptool-MDEwOlJlcG9zaXRvcnkyMzczNjkxNA==-flat-mem_definition_31.py-Ultroid-MDEwOlJlcG9zaXRvcnkzNDEwMzg2MDI=-flat-misc_3.py.html,0.06956521739130435,14,esptool-MDEwOlJlcG9zaXRvcnkyMzczNjkxNA==-flat-mem_definition_31.py,Ultroid-MDEwOlJlcG9zaXRvcnkzNDEwMzg2MDI=-flat-misc_3.py,29,41,12,190,196,6
18001,https://htmlpreview.github.io/?https://github.com/Christina96/boilerplate-sample-matches/blob/main/Python/seq2seq-MDEwOlJlcG9zaXRvcnk4MzczMjgwNg==-flat-attention_test.py-Ultroid-MDEwOlJlcG9zaXRvcnkzNDEwMzg2MDI=-flat-stickermanager.py.html,0.04330708661417323,11,seq2seq-MDEwOlJlcG9zaXRvcnk4MzczMjgwNg==-flat-attention_test.py,Ultroid-MDEwOlJlcG9zaXRvcnkzNDEwMzg2MDI=-flat-stickermanager.py,38,40,2,94,97,3
18512,https://htmlpreview.github.io/?https://github.com/Christina96/boilerplate-sample-matches/blob/main/Python/sonnet-MDEwOlJlcG9zaXRvcnk4NzA2NzIxMg==-flat-parallel_linear.py-yolact-MDEwOlJlcG9zaXRvcnkxMzg3OTY2OTk=-flat-backbone.py.html,0.021482277121374866,10,sonnet-MDEwOlJlcG9zaXRvcnk4NzA2NzIxMg==-flat-parallel_linear.py,yolact-MDEwOlJlcG9zaXRvcnkxMzg3OTY2OTk=-flat-backbone.py,41,43,2,205,206,1
18622,https://htmlpreview.github.io/?https://github.com/Christina96/boilerplate-sample-matches/blob/main/Python/Ultroid-MDEwOlJlcG9zaXRvcnkzNDEwMzg2MDI=-flat-imagetools.py-esphome-docs-MDEwOlJlcG9zaXRvcnkxMzMyMjM0NjE=-flat-schema_doc.py.html,0.0925764192139738,10,Ultroid-MDEwOlJlcG9zaXRvcnkzNDEwMzg2MDI=-flat-imagetools.py,esphome-docs-MDEwOlJlcG9zaXRvcnkxMzMyMjM0NjE=-flat-schema_doc.py,193,195,2,533,536,3
19120,https://htmlpreview.github.io/?https://github.com/Christina96/boilerplate-sample-matches/blob/main/Python/seq2seq-MDEwOlJlcG9zaXRvcnk4MzczMjgwNg==-flat-conv_encoder_test.py-google-api-python-client-MDEwOlJlcG9zaXRvcnkxNTc0OTI2OQ==-flat-http.py.html,0.0201805629314923,10,seq2seq-MDEwOlJlcG9zaXRvcnk4MzczMjgwNg==-flat-conv_encoder_test.py,google-api-python-client-MDEwOlJlcG9zaXRvcnkxNTc0OTI2OQ==-flat-http.py,11,14,3,260,264,4
19304,https://htmlpreview.github.io/?https://github.com/Christina96/boilerplate-sample-matches/blob/main/Python/google-api-python-client-MDEwOlJlcG9zaXRvcnkxNTc0OTI2OQ==-flat-owlbot.py-sonnet-MDEwOlJlcG9zaXRvcnk4NzA2NzIxMg==-flat-optimizer_utils.py.html,0.15384615384615385,9,google-api-python-client-MDEwOlJlcG9zaXRvcnkxNTc0OTI2OQ==-flat-owlbot.py,sonnet-MDEwOlJlcG9zaXRvcnk4NzA2NzIxMg==-flat-optimizer_utils.py,6,10,4,33,35,2
20320,https://htmlpreview.github.io/?https://github.com/Christina96/boilerplate-sample-matches/blob/main/Python/yolact-MDEwOlJlcG9zaXRvcnkxMzg3OTY2OTk=-flat-functions.py-sonnet-MDEwOlJlcG9zaXRvcnk4NzA2NzIxMg==-flat-checkpoint_test.py.html,0.019138755980861243,10,yolact-MDEwOlJlcG9zaXRvcnkxMzg3OTY2OTk=-flat-functions.py,sonnet-MDEwOlJlcG9zaXRvcnk4NzA2NzIxMg==-flat-checkpoint_test.py,1,9,8,4,12,8
20714,https://htmlpreview.github.io/?https://github.com/Christina96/boilerplate-sample-matches/blob/main/Python/Ultroid-MDEwOlJlcG9zaXRvcnkzNDEwMzg2MDI=-flat-_help_12.py-Ultroid-MDEwOlJlcG9zaXRvcnkzNDEwMzg2MDI=-flat-chats.py.html,0.04561003420752566,11,Ultroid-MDEwOlJlcG9zaXRvcnkzNDEwMzg2MDI=-flat-_help_12.py,Ultroid-MDEwOlJlcG9zaXRvcnkzNDEwMzg2MDI=-flat-chats.py,27,30,3,106,111,5
20755,https://htmlpreview.github.io/?https://github.com/Christina96/boilerplate-sample-matches/blob/main/Python/sonnet-MDEwOlJlcG9zaXRvcnk4NzA2NzIxMg==-flat-pickle_test.py-sonnet-MDEwOlJlcG9zaXRvcnk4NzA2NzIxMg==-flat-reshape_test.py.html,0.02616279069767442,9,sonnet-MDEwOlJlcG9zaXRvcnk4NzA2NzIxMg==-flat-pickle_test.py,sonnet-MDEwOlJlcG9zaXRvcnk4NzA2NzIxMg==-flat-reshape_test.py,20,22,2,83,84,1
20948,https://htmlpreview.github.io/?https://github.com/Christina96/boilerplate-sample-matches/blob/main/Python/sonnet-MDEwOlJlcG9zaXRvcnk4NzA2NzIxMg==-flat-batch_apply_test.py-esptool-MDEwOlJlcG9zaXRvcnkyMzczNjkxNA==-flat-base_operations.py.html,0.06831395348837209,9,sonnet-MDEwOlJlcG9zaXRvcnk4NzA2NzIxMg==-flat-batch_apply_test.py,esptool-MDEwOlJlcG9zaXRvcnkyMzczNjkxNA==-flat-base_operations.py,78,81,3,74,85,11
20993,https://htmlpreview.github.io/?https://github.com/Christina96/boilerplate-sample-matches/blob/main/Python/seq2seq-MDEwOlJlcG9zaXRvcnk4MzczMjgwNg==-flat-beam_search_decoder.py-yolact-MDEwOlJlcG9zaXRvcnkxMzg3OTY2OTk=-flat-bbox_recall.py.html,0.036072144288577156,9,seq2seq-MDEwOlJlcG9zaXRvcnk4MzczMjgwNg==-flat-beam_search_decoder.py,yolact-MDEwOlJlcG9zaXRvcnkxMzg3OTY2OTk=-flat-bbox_recall.py,33,35,2,13,15,2
21010,https://htmlpreview.github.io/?https://github.com/Christina96/boilerplate-sample-matches/blob/main/Python/esptool-MDEwOlJlcG9zaXRvcnkyMzczNjkxNA==-flat-emulate_efuse_controller.py-esptool-MDEwOlJlcG9zaXRvcnkyMzczNjkxNA==-flat-emulate_efuse_controller_base.py.html,0.17052023121387283,9,esptool-MDEwOlJlcG9zaXRvcnkyMzczNjkxNA==-flat-emulate_efuse_controller.py,esptool-MDEwOlJlcG9zaXRvcnkyMzczNjkxNA==-flat-emulate_efuse_controller_base.py,36,39,3,39,41,2
21059,https://htmlpreview.github.io/?https://github.com/Christina96/boilerplate-sample-matches/blob/main/Python/sonnet-MDEwOlJlcG9zaXRvcnk4NzA2NzIxMg==-flat-embed_test.py-Ultroid-MDEwOlJlcG9zaXRvcnkzNDEwMzg2MDI=-flat-imagetools.py.html,0.08541973490427099,11,sonnet-MDEwOlJlcG9zaXRvcnk4NzA2NzIxMg==-flat-embed_test.py,Ultroid-MDEwOlJlcG9zaXRvcnkzNDEwMzg2MDI=-flat-imagetools.py,19,21,2,71,75,4
21105,https://htmlpreview.github.io/?https://github.com/Christina96/boilerplate-sample-matches/blob/main/Python/Ultroid-MDEwOlJlcG9zaXRvcnkzNDEwMzg2MDI=-flat-imagetools.py-yolact-MDEwOlJlcG9zaXRvcnkxMzg3OTY2OTk=-flat-multibox_loss.py.html,0.13623354321694334,10,Ultroid-MDEwOlJlcG9zaXRvcnkzNDEwMzg2MDI=-flat-imagetools.py,yolact-MDEwOlJlcG9zaXRvcnkxMzg3OTY2OTk=-flat-multibox_loss.py,184,188,4,357,366,9
21312,https://htmlpreview.github.io/?https://github.com/Christina96/boilerplate-sample-matches/blob/main/Python/Ultroid-MDEwOlJlcG9zaXRvcnkzNDEwMzg2MDI=-flat-polls.py-yolact-MDEwOlJlcG9zaXRvcnkxMzg3OTY2OTk=-flat-logger.py.html,0.023952095808383235,10,Ultroid-MDEwOlJlcG9zaXRvcnkzNDEwMzg2MDI=-flat-polls.py,yolact-MDEwOlJlcG9zaXRvcnkxMzg3OTY2OTk=-flat-logger.py,37,38,1,289,291,2
21513,https://htmlpreview.github.io/?https://github.com/Christina96/boilerplate-sample-matches/blob/main/Python/Ultroid-MDEwOlJlcG9zaXRvcnkzNDEwMzg2MDI=-flat-chats.py-yolact-MDEwOlJlcG9zaXRvcnkxMzg3OTY2OTk=-flat-eval.py.html,0.02204261572373255,10,Ultroid-MDEwOlJlcG9zaXRvcnkzNDEwMzg2MDI=-flat-chats.py,yolact-MDEwOlJlcG9zaXRvcnkxMzg3OTY2OTk=-flat-eval.py,110,111,1,210,211,1
22065,https://htmlpreview.github.io/?https://github.com/Christina96/boilerplate-sample-matches/blob/main/Python/Ultroid-MDEwOlJlcG9zaXRvcnkzNDEwMzg2MDI=-flat-misc_3.py-esptool-MDEwOlJlcG9zaXRvcnkyMzczNjkxNA==-flat-bin_image.py.html,0.045662100456621,11,Ultroid-MDEwOlJlcG9zaXRvcnkzNDEwMzg2MDI=-flat-misc_3.py,esptool-MDEwOlJlcG9zaXRvcnkyMzczNjkxNA==-flat-bin_image.py,109,110,1,551,554,3
22263,https://htmlpreview.github.io/?https://github.com/Christina96/boilerplate-sample-matches/blob/main/Python/Ultroid-MDEwOlJlcG9zaXRvcnkzNDEwMzg2MDI=-flat-qrcode.py-Ultroid-MDEwOlJlcG9zaXRvcnkzNDEwMzg2MDI=-flat-callbackstuffs.py.html,0.062393162393162394,9,Ultroid-MDEwOlJlcG9zaXRvcnkzNDEwMzg2MDI=-flat-qrcode.py,Ultroid-MDEwOlJlcG9zaXRvcnkzNDEwMzg2MDI=-flat-callbackstuffs.py,33,36,3,512,517,5
22314,https://htmlpreview.github.io/?https://github.com/Christina96/boilerplate-sample-matches/blob/main/Python/yolact-MDEwOlJlcG9zaXRvcnkxMzg3OTY2OTk=-flat-backbone.py-yolact-MDEwOlJlcG9zaXRvcnkxMzg3OTY2OTk=-flat-eval.py.html,0.0612736660929432,10,yolact-MDEwOlJlcG9zaXRvcnkxMzg3OTY2OTk=-flat-backbone.py,yolact-MDEwOlJlcG9zaXRvcnkxMzg3OTY2OTk=-flat-eval.py,220,221,1,763,766,3
22621,https://htmlpreview.github.io/?https://github.com/Christina96/boilerplate-sample-matches/blob/main/Python/Ultroid-MDEwOlJlcG9zaXRvcnkzNDEwMzg2MDI=-flat-autoban.py-yolact-MDEwOlJlcG9zaXRvcnkxMzg3OTY2OTk=-flat-backbone.py.html,0.021810250817884406,10,Ultroid-MDEwOlJlcG9zaXRvcnkzNDEwMzg2MDI=-flat-autoban.py,yolact-MDEwOlJlcG9zaXRvcnkxMzg3OTY2OTk=-flat-backbone.py,38,39,1,147,150,3
22830,https://htmlpreview.github.io/?https://github.com/Christina96/boilerplate-sample-matches/blob/main/Python/sonnet-MDEwOlJlcG9zaXRvcnk4NzA2NzIxMg==-flat-group_norm.py-esptool-MDEwOlJlcG9zaXRvcnkyMzczNjkxNA==-flat-__init___45.py.html,0.016704631738800303,11,sonnet-MDEwOlJlcG9zaXRvcnk4NzA2NzIxMg==-flat-group_norm.py,esptool-MDEwOlJlcG9zaXRvcnkyMzczNjkxNA==-flat-__init___45.py,67,69,2,612,625,13
23093,https://htmlpreview.github.io/?https://github.com/Christina96/boilerplate-sample-matches/blob/main/Python/esptool-MDEwOlJlcG9zaXRvcnkyMzczNjkxNA==-flat-emulate_efuse_controller_13.py-sonnet-MDEwOlJlcG9zaXRvcnk4NzA2NzIxMg==-flat-base_test.py.html,0.027190332326283987,9,esptool-MDEwOlJlcG9zaXRvcnkyMzczNjkxNA==-flat-emulate_efuse_controller_13.py,sonnet-MDEwOlJlcG9zaXRvcnk4NzA2NzIxMg==-flat-base_test.py,46,50,4,43,45,2
23282,https://htmlpreview.github.io/?https://github.com/Christina96/boilerplate-sample-matches/blob/main/Python/seq2seq-MDEwOlJlcG9zaXRvcnk4MzczMjgwNg==-flat-utils.py-esptool-MDEwOlJlcG9zaXRvcnkyMzczNjkxNA==-flat-emulate_efuse_controller_33.py.html,0.19555555555555557,12,seq2seq-MDEwOlJlcG9zaXRvcnk4MzczMjgwNg==-flat-utils.py,esptool-MDEwOlJlcG9zaXRvcnkyMzczNjkxNA==-flat-emulate_efuse_controller_33.py,8,11,3,31,35,4
23410,https://htmlpreview.github.io/?https://github.com/Christina96/boilerplate-sample-matches/blob/main/Python/seq2seq-MDEwOlJlcG9zaXRvcnk4MzczMjgwNg==-flat-helper.py-yolact-MDEwOlJlcG9zaXRvcnkxMzg3OTY2OTk=-flat-train.py.html,0.07138607971445568,18,seq2seq-MDEwOlJlcG9zaXRvcnk4MzczMjgwNg==-flat-helper.py,yolact-MDEwOlJlcG9zaXRvcnkxMzg3OTY2OTk=-flat-train.py,1,18,17,1,18,17
23607,https://htmlpreview.github.io/?https://github.com/Christina96/boilerplate-sample-matches/blob/main/Python/sonnet-MDEwOlJlcG9zaXRvcnk4NzA2NzIxMg==-flat-haiku_test.py-esptool-MDEwOlJlcG9zaXRvcnkyMzczNjkxNA==-flat-operations_40.py.html,0.043072505384063174,9,sonnet-MDEwOlJlcG9zaXRvcnk4NzA2NzIxMg==-flat-haiku_test.py,esptool-MDEwOlJlcG9zaXRvcnkyMzczNjkxNA==-flat-operations_40.py,117,134,17,379,405,26
23761,https://htmlpreview.github.io/?https://github.com/Christina96/boilerplate-sample-matches/blob/main/Python/sonnet-MDEwOlJlcG9zaXRvcnk4NzA2NzIxMg==-flat-reshape.py-sonnet-MDEwOlJlcG9zaXRvcnk4NzA2NzIxMg==-flat-depthwise_conv.py.html,0.11411411411411411,9,sonnet-MDEwOlJlcG9zaXRvcnk4NzA2NzIxMg==-flat-reshape.py,sonnet-MDEwOlJlcG9zaXRvcnk4NzA2NzIxMg==-flat-depthwise_conv.py,61,62,1,18,21,3
24057,https://htmlpreview.github.io/?https://github.com/Christina96/boilerplate-sample-matches/blob/main/Python/sonnet-MDEwOlJlcG9zaXRvcnk4NzA2NzIxMg==-flat-util_test.py-seq2seq-MDEwOlJlcG9zaXRvcnk4MzczMjgwNg==-flat-input_pipeline.py.html,0.020179372197309416,9,sonnet-MDEwOlJlcG9zaXRvcnk4NzA2NzIxMg==-flat-util_test.py,seq2seq-MDEwOlJlcG9zaXRvcnk4MzczMjgwNg==-flat-input_pipeline.py,69,70,1,141,143,2
24349,https://htmlpreview.github.io/?https://github.com/Christina96/boilerplate-sample-matches/blob/main/Python/esptool-MDEwOlJlcG9zaXRvcnkyMzczNjkxNA==-flat-mem_definition_base.py-seq2seq-MDEwOlJlcG9zaXRvcnk4MzczMjgwNg==-flat-hooks.py.html,0.09208972845336481,11,esptool-MDEwOlJlcG9zaXRvcnkyMzczNjkxNA==-flat-mem_definition_base.py,seq2seq-MDEwOlJlcG9zaXRvcnk4MzczMjgwNg==-flat-hooks.py,122,126,4,129,132,3
25029,https://htmlpreview.github.io/?https://github.com/Christina96/boilerplate-sample-matches/blob/main/Python/esptool-MDEwOlJlcG9zaXRvcnkyMzczNjkxNA==-flat-esp32h2beta1.py-seq2seq-MDEwOlJlcG9zaXRvcnk4MzczMjgwNg==-flat-hooks.py.html,0.04884004884004884,11,esptool-MDEwOlJlcG9zaXRvcnkyMzczNjkxNA==-flat-esp32h2beta1.py,seq2seq-MDEwOlJlcG9zaXRvcnk4MzczMjgwNg==-flat-hooks.py,107,110,3,129,132,3
25252,https://htmlpreview.github.io/?https://github.com/Christina96/boilerplate-sample-matches/blob/main/Python/seq2seq-MDEwOlJlcG9zaXRvcnk4MzczMjgwNg==-flat-example_config_test.py-Ultroid-MDEwOlJlcG9zaXRvcnkzNDEwMzg2MDI=-flat-autopic.py.html,0.06766917293233082,9,seq2seq-MDEwOlJlcG9zaXRvcnk4MzczMjgwNg==-flat-example_config_test.py,Ultroid-MDEwOlJlcG9zaXRvcnkzNDEwMzg2MDI=-flat-autopic.py,4,12,8,1,9,8
26302,https://htmlpreview.github.io/?https://github.com/Christina96/boilerplate-sample-matches/blob/main/Python/google-api-python-client-MDEwOlJlcG9zaXRvcnkxNTc0OTI2OQ==-flat-main_4.py-google-api-python-client-MDEwOlJlcG9zaXRvcnkxNTc0OTI2OQ==-flat-changesummary_test.py.html,0.09655172413793103,9,google-api-python-client-MDEwOlJlcG9zaXRvcnkxNTc0OTI2OQ==-flat-main_4.py,google-api-python-client-MDEwOlJlcG9zaXRvcnkxNTc0OTI2OQ==-flat-changesummary_test.py,12,16,4,7,10,3
26993,https://htmlpreview.github.io/?https://github.com/Christina96/boilerplate-sample-matches/blob/main/Python/sonnet-MDEwOlJlcG9zaXRvcnk4NzA2NzIxMg==-flat-batch_norm.py-esptool-MDEwOlJlcG9zaXRvcnkyMzczNjkxNA==-flat-operations_40.py.html,0.0659536541889483,9,sonnet-MDEwOlJlcG9zaXRvcnk4NzA2NzIxMg==-flat-batch_norm.py,esptool-MDEwOlJlcG9zaXRvcnkyMzczNjkxNA==-flat-operations_40.py,114,117,3,279,283,4
27010,https://htmlpreview.github.io/?https://github.com/Christina96/boilerplate-sample-matches/blob/main/Python/seq2seq-MDEwOlJlcG9zaXRvcnk4MzczMjgwNg==-flat-pooling_encoder_test.py-seq2seq-MDEwOlJlcG9zaXRvcnk4MzczMjgwNg==-flat-pipeline_test.py.html,0.16846652267818574,10,seq2seq-MDEwOlJlcG9zaXRvcnk4MzczMjgwNg==-flat-pooling_encoder_test.py,seq2seq-MDEwOlJlcG9zaXRvcnk4MzczMjgwNg==-flat-pipeline_test.py,8,12,4,20,23,3
27041,https://htmlpreview.github.io/?https://github.com/Christina96/boilerplate-sample-matches/blob/main/Python/sonnet-MDEwOlJlcG9zaXRvcnk4NzA2NzIxMg==-flat-resnet_8.py-sonnet-MDEwOlJlcG9zaXRvcnk4NzA2NzIxMg==-flat-recurrent.py.html,0.060873400970445524,9,sonnet-MDEwOlJlcG9zaXRvcnk4NzA2NzIxMg==-flat-resnet_8.py,sonnet-MDEwOlJlcG9zaXRvcnk4NzA2NzIxMg==-flat-recurrent.py,105,107,2,561,562,1
27180,https://htmlpreview.github.io/?https://github.com/Christina96/boilerplate-sample-matches/blob/main/Python/seq2seq-MDEwOlJlcG9zaXRvcnk4MzczMjgwNg==-flat-conv_encoder_test.py-seq2seq-MDEwOlJlcG9zaXRvcnk4MzczMjgwNg==-flat-metrics_test.py.html,0.06077348066298342,11,seq2seq-MDEwOlJlcG9zaXRvcnk4MzczMjgwNg==-flat-conv_encoder_test.py,seq2seq-MDEwOlJlcG9zaXRvcnk4MzczMjgwNg==-flat-metrics_test.py,1,9,8,4,12,8
27246,https://htmlpreview.github.io/?https://github.com/Christina96/boilerplate-sample-matches/blob/main/Python/sonnet-MDEwOlJlcG9zaXRvcnk4NzA2NzIxMg==-flat-metrics.py-sonnet-MDEwOlJlcG9zaXRvcnk4NzA2NzIxMg==-flat-base.py.html,0.03389830508474576,9,sonnet-MDEwOlJlcG9zaXRvcnk4NzA2NzIxMg==-flat-metrics.py,sonnet-MDEwOlJlcG9zaXRvcnk4NzA2NzIxMg==-flat-base.py,41,44,3,80,82,2
27326,https://htmlpreview.github.io/?https://github.com/Christina96/boilerplate-sample-matches/blob/main/Python/sonnet-MDEwOlJlcG9zaXRvcnk4NzA2NzIxMg==-flat-saved_model_test.py-sonnet-MDEwOlJlcG9zaXRvcnk4NzA2NzIxMg==-flat-bias.py.html,0.0782608695652174,9,sonnet-MDEwOlJlcG9zaXRvcnk4NzA2NzIxMg==-flat-saved_model_test.py,sonnet-MDEwOlJlcG9zaXRvcnk4NzA2NzIxMg==-flat-bias.py,2,9,7,1,8,7
28231,https://htmlpreview.github.io/?https://github.com/Christina96/boilerplate-sample-matches/blob/main/Python/Ultroid-MDEwOlJlcG9zaXRvcnkzNDEwMzg2MDI=-flat-qrcode.py-Ultroid-MDEwOlJlcG9zaXRvcnkzNDEwMzg2MDI=-flat-calculator.py.html,0.079002079002079,10,Ultroid-MDEwOlJlcG9zaXRvcnkzNDEwMzg2MDI=-flat-qrcode.py,Ultroid-MDEwOlJlcG9zaXRvcnkzNDEwMzg2MDI=-flat-calculator.py,41,44,3,43,46,3
29102,https://htmlpreview.github.io/?https://github.com/Christina96/boilerplate-sample-matches/blob/main/Python/Ultroid-MDEwOlJlcG9zaXRvcnkzNDEwMzg2MDI=-flat-games.py-esptool-MDEwOlJlcG9zaXRvcnkyMzczNjkxNA==-flat-fields_12.py.html,0.043134435657800146,9,Ultroid-MDEwOlJlcG9zaXRvcnkzNDEwMzg2MDI=-flat-games.py,esptool-MDEwOlJlcG9zaXRvcnkyMzczNjkxNA==-flat-fields_12.py,236,238,2,281,284,3
29410,https://htmlpreview.github.io/?https://github.com/Christina96/boilerplate-sample-matches/blob/main/Python/esptool-MDEwOlJlcG9zaXRvcnkyMzczNjkxNA==-flat-__init___47.py-Ultroid-MDEwOlJlcG9zaXRvcnkzNDEwMzg2MDI=-flat-gDrive.py.html,0.05442176870748299,12,esptool-MDEwOlJlcG9zaXRvcnkyMzczNjkxNA==-flat-__init___47.py,Ultroid-MDEwOlJlcG9zaXRvcnkzNDEwMzg2MDI=-flat-gDrive.py,1,12,11,1,12,11
29721,https://htmlpreview.github.io/?https://github.com/Christina96/boilerplate-sample-matches/blob/main/Python/google-api-python-client-MDEwOlJlcG9zaXRvcnkxNTc0OTI2OQ==-flat-test_mocks.py-yolact-MDEwOlJlcG9zaXRvcnkxMzg3OTY2OTk=-flat-multibox_loss.py.html,0.05259697567389875,11,google-api-python-client-MDEwOlJlcG9zaXRvcnkxNTc0OTI2OQ==-flat-test_mocks.py,yolact-MDEwOlJlcG9zaXRvcnkxMzg3OTY2OTk=-flat-multibox_loss.py,24,27,3,147,149,2
30650,https://htmlpreview.github.io/?https://github.com/Christina96/boilerplate-sample-matches/blob/main/Python/wxpy-MDEwOlJlcG9zaXRvcnk4MjU4ODU5Nw==-flat-console.py-Ultroid-MDEwOlJlcG9zaXRvcnkzNDEwMzg2MDI=-flat-utilities.py.html,0.027314112291350532,9,wxpy-MDEwOlJlcG9zaXRvcnk4MjU4ODU5Nw==-flat-console.py,Ultroid-MDEwOlJlcG9zaXRvcnkzNDEwMzg2MDI=-flat-utilities.py,52,56,4,94,98,4
31611,https://htmlpreview.github.io/?https://github.com/Christina96/boilerplate-sample-matches/blob/main/Python/seq2seq-MDEwOlJlcG9zaXRvcnk4MzczMjgwNg==-flat-conv_encoder_test.py-yolact-MDEwOlJlcG9zaXRvcnkxMzg3OTY2OTk=-flat-yolact.py.html,0.03838517538054269,9,seq2seq-MDEwOlJlcG9zaXRvcnk4MzczMjgwNg==-flat-conv_encoder_test.py,yolact-MDEwOlJlcG9zaXRvcnkxMzg3OTY2OTk=-flat-yolact.py,11,14,3,71,75,4
31714,https://htmlpreview.github.io/?https://github.com/Christina96/boilerplate-sample-matches/blob/main/Python/practical-python-MDEwOlJlcG9zaXRvcnkyNjY2MTM3MDQ=-flat-stock_66.py-practical-python-MDEwOlJlcG9zaXRvcnkyNjY2MTM3MDQ=-flat-typedproperty_65.py.html,0.38461538461538464,15,practical-python-MDEwOlJlcG9zaXRvcnkyNjY2MTM3MDQ=-flat-stock_66.py,practical-python-MDEwOlJlcG9zaXRvcnkyNjY2MTM3MDQ=-flat-typedproperty_65.py,2,9,7,16,23,7
31888,https://htmlpreview.github.io/?https://github.com/Christina96/boilerplate-sample-matches/blob/main/Python/esptool-MDEwOlJlcG9zaXRvcnkyMzczNjkxNA==-flat-__init___50.py-Ultroid-MDEwOlJlcG9zaXRvcnkzNDEwMzg2MDI=-flat-pmpermit.py.html,0.03169014084507042,9,esptool-MDEwOlJlcG9zaXRvcnkyMzczNjkxNA==-flat-__init___50.py,Ultroid-MDEwOlJlcG9zaXRvcnkzNDEwMzg2MDI=-flat-pmpermit.py,118,120,2,137,142,5
31956,https://htmlpreview.github.io/?https://github.com/Christina96/boilerplate-sample-matches/blob/main/Python/yolact-MDEwOlJlcG9zaXRvcnkxMzg3OTY2OTk=-flat-box_utils.py-esptool-MDEwOlJlcG9zaXRvcnkyMzczNjkxNA==-flat-fields_17.py.html,0.07317073170731707,9,yolact-MDEwOlJlcG9zaXRvcnkxMzg3OTY2OTk=-flat-box_utils.py,esptool-MDEwOlJlcG9zaXRvcnkyMzczNjkxNA==-flat-fields_17.py,116,118,2,133,134,1
32044,https://htmlpreview.github.io/?https://github.com/Christina96/boilerplate-sample-matches/blob/main/Python/sonnet-MDEwOlJlcG9zaXRvcnk4NzA2NzIxMg==-flat-once_test.py-sonnet-MDEwOlJlcG9zaXRvcnk4NzA2NzIxMg==-flat-write_test.py.html,0.11564625850340136,14,sonnet-MDEwOlJlcG9zaXRvcnk4NzA2NzIxMg==-flat-once_test.py,sonnet-MDEwOlJlcG9zaXRvcnk4NzA2NzIxMg==-flat-write_test.py,56,60,4,103,107,4
32161,https://htmlpreview.github.io/?https://github.com/Christina96/boilerplate-sample-matches/blob/main/Python/Ultroid-MDEwOlJlcG9zaXRvcnkzNDEwMzg2MDI=-flat-devtools.py-esptool-MDEwOlJlcG9zaXRvcnkyMzczNjkxNA==-flat-fields_7.py.html,0.05360824742268041,9,Ultroid-MDEwOlJlcG9zaXRvcnkzNDEwMzg2MDI=-flat-devtools.py,esptool-MDEwOlJlcG9zaXRvcnkyMzczNjkxNA==-flat-fields_7.py,66,71,5,325,334,9
32283,https://htmlpreview.github.io/?https://github.com/Christina96/boilerplate-sample-matches/blob/main/Python/seq2seq-MDEwOlJlcG9zaXRvcnk4MzczMjgwNg==-flat-beam_search_decoder.py-Ultroid-MDEwOlJlcG9zaXRvcnkzNDEwMzg2MDI=-flat-FastTelethon.py.html,0.0521978021978022,10,seq2seq-MDEwOlJlcG9zaXRvcnk4MzczMjgwNg==-flat-beam_search_decoder.py,Ultroid-MDEwOlJlcG9zaXRvcnkzNDEwMzg2MDI=-flat-FastTelethon.py,32,35,3,268,271,3
32509,https://htmlpreview.github.io/?https://github.com/Christina96/boilerplate-sample-matches/blob/main/Python/seq2seq-MDEwOlJlcG9zaXRvcnk4MzczMjgwNg==-flat-beam_search.py-Ultroid-MDEwOlJlcG9zaXRvcnkzNDEwMzg2MDI=-flat-_chatactions.py.html,0.07584269662921349,9,seq2seq-MDEwOlJlcG9zaXRvcnk4MzczMjgwNg==-flat-beam_search.py,Ultroid-MDEwOlJlcG9zaXRvcnkzNDEwMzg2MDI=-flat-_chatactions.py,99,101,2,40,44,4
32911,https://htmlpreview.github.io/?https://github.com/Christina96/boilerplate-sample-matches/blob/main/Python/google-api-python-client-MDEwOlJlcG9zaXRvcnkxNTc0OTI2OQ==-flat-test_json_model.py-esptool-MDEwOlJlcG9zaXRvcnkyMzczNjkxNA==-flat-fields_7.py.html,0.08613938919342208,10,google-api-python-client-MDEwOlJlcG9zaXRvcnkxNTc0OTI2OQ==-flat-test_json_model.py,esptool-MDEwOlJlcG9zaXRvcnkyMzczNjkxNA==-flat-fields_7.py,83,86,3,68,71,3
33010,https://htmlpreview.github.io/?https://github.com/Christina96/boilerplate-sample-matches/blob/main/Python/seq2seq-MDEwOlJlcG9zaXRvcnk4MzczMjgwNg==-flat-losses_test.py-sonnet-MDEwOlJlcG9zaXRvcnk4NzA2NzIxMg==-flat-base.py.html,0.11836734693877551,10,seq2seq-MDEwOlJlcG9zaXRvcnk4MzczMjgwNg==-flat-losses_test.py,sonnet-MDEwOlJlcG9zaXRvcnk4NzA2NzIxMg==-flat-base.py,29,30,1,33,36,3
33277,https://htmlpreview.github.io/?https://github.com/Christina96/boilerplate-sample-matches/blob/main/Python/seq2seq-MDEwOlJlcG9zaXRvcnk4MzczMjgwNg==-flat-models_test.py-sonnet-MDEwOlJlcG9zaXRvcnk4NzA2NzIxMg==-flat-reshape_test.py.html,0.056640625,9,seq2seq-MDEwOlJlcG9zaXRvcnk4MzczMjgwNg==-flat-models_test.py,sonnet-MDEwOlJlcG9zaXRvcnk4NzA2NzIxMg==-flat-reshape_test.py,24,25,1,62,63,1
33778,https://htmlpreview.github.io/?https://github.com/Christina96/boilerplate-sample-matches/blob/main/Python/sonnet-MDEwOlJlcG9zaXRvcnk4NzA2NzIxMg==-flat-dropout_test.py-Ultroid-MDEwOlJlcG9zaXRvcnkzNDEwMzg2MDI=-flat-search.py.html,0.037815126050420166,9,sonnet-MDEwOlJlcG9zaXRvcnk4NzA2NzIxMg==-flat-dropout_test.py,Ultroid-MDEwOlJlcG9zaXRvcnkzNDEwMzg2MDI=-flat-search.py,9,11,2,90,92,2
33868,https://htmlpreview.github.io/?https://github.com/Christina96/boilerplate-sample-matches/blob/main/Python/esptool-MDEwOlJlcG9zaXRvcnkyMzczNjkxNA==-flat-base_fields.py-google-api-python-client-MDEwOlJlcG9zaXRvcnkxNTc0OTI2OQ==-flat-test_http.py.html,0.05459183673469388,9,esptool-MDEwOlJlcG9zaXRvcnkyMzczNjkxNA==-flat-base_fields.py,google-api-python-client-MDEwOlJlcG9zaXRvcnkxNTc0OTI2OQ==-flat-test_http.py,219,222,3,952,955,3
34281,https://htmlpreview.github.io/?https://github.com/Christina96/boilerplate-sample-matches/blob/main/Python/Ultroid-MDEwOlJlcG9zaXRvcnkzNDEwMzg2MDI=-flat-ytdl.py-esphome-docs-MDEwOlJlcG9zaXRvcnkxMzMyMjM0NjE=-flat-lint.py.html,0.0973630831643002,9,Ultroid-MDEwOlJlcG9zaXRvcnkzNDEwMzg2MDI=-flat-ytdl.py,esphome-docs-MDEwOlJlcG9zaXRvcnkxMzMyMjM0NjE=-flat-lint.py,245,253,8,31,39,8
34376,https://htmlpreview.github.io/?https://github.com/Christina96/boilerplate-sample-matches/blob/main/Python/Ultroid-MDEwOlJlcG9zaXRvcnkzNDEwMzg2MDI=-flat-words.py-Ultroid-MDEwOlJlcG9zaXRvcnkzNDEwMzg2MDI=-flat-warn.py.html,0.12840466926070038,9,Ultroid-MDEwOlJlcG9zaXRvcnkzNDEwMzg2MDI=-flat-words.py,Ultroid-MDEwOlJlcG9zaXRvcnkzNDEwMzg2MDI=-flat-warn.py,45,47,2,27,29,2
34398,https://htmlpreview.github.io/?https://github.com/Christina96/boilerplate-sample-matches/blob/main/Python/sonnet-MDEwOlJlcG9zaXRvcnk4NzA2NzIxMg==-flat-replicator_test.py-yolact-MDEwOlJlcG9zaXRvcnkxMzg3OTY2OTk=-flat-eval.py.html,0.014475271411338963,9,sonnet-MDEwOlJlcG9zaXRvcnk4NzA2NzIxMg==-flat-replicator_test.py,yolact-MDEwOlJlcG9zaXRvcnkxMzg3OTY2OTk=-flat-eval.py,150,152,2,272,276,4
34483,https://htmlpreview.github.io/?https://github.com/Christina96/boilerplate-sample-matches/blob/main/Python/google-api-python-client-MDEwOlJlcG9zaXRvcnkxNTc0OTI2OQ==-flat-maps_engine.py-Ultroid-MDEwOlJlcG9zaXRvcnkzNDEwMzg2MDI=-flat-asstcmd.py.html,0.04838709677419355,9,google-api-python-client-MDEwOlJlcG9zaXRvcnkxNTc0OTI2OQ==-flat-maps_engine.py,Ultroid-MDEwOlJlcG9zaXRvcnkzNDEwMzg2MDI=-flat-asstcmd.py,41,44,3,14,15,1
34559,https://htmlpreview.github.io/?https://github.com/Christina96/boilerplate-sample-matches/blob/main/Python/seq2seq-MDEwOlJlcG9zaXRvcnk4MzczMjgwNg==-flat-image2seq.py-esptool-MDEwOlJlcG9zaXRvcnkyMzczNjkxNA==-flat-test_esptool.py.html,0.022535211267605635,10,seq2seq-MDEwOlJlcG9zaXRvcnk4MzczMjgwNg==-flat-image2seq.py,esptool-MDEwOlJlcG9zaXRvcnkyMzczNjkxNA==-flat-test_esptool.py,61,63,2,661,666,5
34832,https://htmlpreview.github.io/?https://github.com/Christina96/boilerplate-sample-matches/blob/main/Python/yolact-MDEwOlJlcG9zaXRvcnkxMzg3OTY2OTk=-flat-cluster_bbox_sizes.py-sonnet-MDEwOlJlcG9zaXRvcnk4NzA2NzIxMg==-flat-functional_mlp_mnist.py.html,0.15942028985507245,13,yolact-MDEwOlJlcG9zaXRvcnkxMzg3OTY2OTk=-flat-cluster_bbox_sizes.py,sonnet-MDEwOlJlcG9zaXRvcnk4NzA2NzIxMg==-flat-functional_mlp_mnist.py,21,24,3,23,26,3
34930,https://htmlpreview.github.io/?https://github.com/Christina96/boilerplate-sample-matches/blob/main/Python/yolact-MDEwOlJlcG9zaXRvcnkxMzg3OTY2OTk=-flat-optimize_bboxes.py-Ultroid-MDEwOlJlcG9zaXRvcnkzNDEwMzg2MDI=-flat-callbackstuffs.py.html,0.015478615071283095,10,yolact-MDEwOlJlcG9zaXRvcnkxMzg3OTY2OTk=-flat-optimize_bboxes.py,Ultroid-MDEwOlJlcG9zaXRvcnkzNDEwMzg2MDI=-flat-callbackstuffs.py,32,32,0,165,213,48
35606,https://htmlpreview.github.io/?https://github.com/Christina96/boilerplate-sample-matches/blob/main/Python/sonnet-MDEwOlJlcG9zaXRvcnk4NzA2NzIxMg==-flat-group_norm.py-sonnet-MDEwOlJlcG9zaXRvcnk4NzA2NzIxMg==-flat-recurrent_test.py.html,0.04896907216494845,9,sonnet-MDEwOlJlcG9zaXRvcnk4NzA2NzIxMg==-flat-group_norm.py,sonnet-MDEwOlJlcG9zaXRvcnk4NzA2NzIxMg==-flat-recurrent_test.py,111,114,3,584,586,2
35647,https://htmlpreview.github.io/?https://github.com/Christina96/boilerplate-sample-matches/blob/main/Python/yolact-MDEwOlJlcG9zaXRvcnkxMzg3OTY2OTk=-flat-server.py-google-api-python-client-MDEwOlJlcG9zaXRvcnkxNTc0OTI2OQ==-flat-describe_9.py.html,0.033112582781456956,10,yolact-MDEwOlJlcG9zaXRvcnkxMzg3OTY2OTk=-flat-server.py,google-api-python-client-MDEwOlJlcG9zaXRvcnkxNTc0OTI2OQ==-flat-describe_9.py,11,13,2,135,138,3
36144,https://htmlpreview.github.io/?https://github.com/Christina96/boilerplate-sample-matches/blob/main/Python/Ultroid-MDEwOlJlcG9zaXRvcnkzNDEwMzg2MDI=-flat-logo.py-Ultroid-MDEwOlJlcG9zaXRvcnkzNDEwMzg2MDI=-flat-chats.py.html,0.031007751937984496,12,Ultroid-MDEwOlJlcG9zaXRvcnkzNDEwMzg2MDI=-flat-logo.py,Ultroid-MDEwOlJlcG9zaXRvcnkzNDEwMzg2MDI=-flat-chats.py,12,15,3,238,242,4
36170,https://htmlpreview.github.io/?https://github.com/Christina96/boilerplate-sample-matches/blob/main/Python/esptool-MDEwOlJlcG9zaXRvcnkyMzczNjkxNA==-flat-esp_rfc2217_server.py-sonnet-MDEwOlJlcG9zaXRvcnk4NzA2NzIxMg==-flat-depthwise_conv_test.py.html,0.04740406320541761,10,esptool-MDEwOlJlcG9zaXRvcnkyMzczNjkxNA==-flat-esp_rfc2217_server.py,sonnet-MDEwOlJlcG9zaXRvcnk4NzA2NzIxMg==-flat-depthwise_conv_test.py,134,146,12,99,101,2
36405,https://htmlpreview.github.io/?https://github.com/Christina96/boilerplate-sample-matches/blob/main/Python/Ultroid-MDEwOlJlcG9zaXRvcnkzNDEwMzg2MDI=-flat-stickertools.py-esptool-MDEwOlJlcG9zaXRvcnkyMzczNjkxNA==-flat-test_espsecure.py.html,0.11646586345381527,9,Ultroid-MDEwOlJlcG9zaXRvcnkzNDEwMzg2MDI=-flat-stickertools.py,esptool-MDEwOlJlcG9zaXRvcnkyMzczNjkxNA==-flat-test_espsecure.py,237,241,4,353,361,8
36608,https://htmlpreview.github.io/?https://github.com/Christina96/boilerplate-sample-matches/blob/main/Python/sonnet-MDEwOlJlcG9zaXRvcnk4NzA2NzIxMg==-flat-util_test.py-google-api-python-client-MDEwOlJlcG9zaXRvcnkxNTc0OTI2OQ==-flat-test_discovery.py.html,0.07767898923724847,10,sonnet-MDEwOlJlcG9zaXRvcnk4NzA2NzIxMg==-flat-util_test.py,google-api-python-client-MDEwOlJlcG9zaXRvcnkxNTc0OTI2OQ==-flat-test_discovery.py,71,73,2,1818,1820,2
36679,https://htmlpreview.github.io/?https://github.com/Christina96/boilerplate-sample-matches/blob/main/Python/Ultroid-MDEwOlJlcG9zaXRvcnkzNDEwMzg2MDI=-flat-gDrive.py-Ultroid-MDEwOlJlcG9zaXRvcnkzNDEwMzg2MDI=-flat-callbackstuffs.py.html,0.015001973943939992,9,Ultroid-MDEwOlJlcG9zaXRvcnkzNDEwMzg2MDI=-flat-gDrive.py,Ultroid-MDEwOlJlcG9zaXRvcnkzNDEwMzg2MDI=-flat-callbackstuffs.py,1,9,8,1,9,8
37049,https://htmlpreview.github.io/?https://github.com/Christina96/boilerplate-sample-matches/blob/main/Python/practical-python-MDEwOlJlcG9zaXRvcnkyNjY2MTM3MDQ=-flat-follow_53.py-sonnet-MDEwOlJlcG9zaXRvcnk4NzA2NzIxMg==-flat-moving_averages_test.py.html,0.072992700729927,10,practical-python-MDEwOlJlcG9zaXRvcnkyNjY2MTM3MDQ=-flat-follow_53.py,sonnet-MDEwOlJlcG9zaXRvcnk4NzA2NzIxMg==-flat-moving_averages_test.py,16,18,2,56,59,3
38175,https://htmlpreview.github.io/?https://github.com/Christina96/boilerplate-sample-matches/blob/main/Python/wxpy-MDEwOlJlcG9zaXRvcnk4MjU4ODU5Nw==-flat-test_bot.py-esptool-MDEwOlJlcG9zaXRvcnkyMzczNjkxNA==-flat-emulate_efuse_controller_base.py.html,0.030627871362940276,10,wxpy-MDEwOlJlcG9zaXRvcnk4MjU4ODU5Nw==-flat-test_bot.py,esptool-MDEwOlJlcG9zaXRvcnkyMzczNjkxNA==-flat-emulate_efuse_controller_base.py,22,27,5,38,43,5
38478,https://htmlpreview.github.io/?https://github.com/Christina96/boilerplate-sample-matches/blob/main/Python/google-api-python-client-MDEwOlJlcG9zaXRvcnkxNTc0OTI2OQ==-flat-buildprbody.py-esptool-MDEwOlJlcG9zaXRvcnkyMzczNjkxNA==-flat-__init___48.py.html,0.02506265664160401,10,google-api-python-client-MDEwOlJlcG9zaXRvcnkxNTc0OTI2OQ==-flat-buildprbody.py,esptool-MDEwOlJlcG9zaXRvcnkyMzczNjkxNA==-flat-__init___48.py,24,26,2,630,632,2
38944,https://htmlpreview.github.io/?https://github.com/Christina96/boilerplate-sample-matches/blob/main/Python/wxpy-MDEwOlJlcG9zaXRvcnk4MjU4ODU5Nw==-flat-base_request.py-google-api-python-client-MDEwOlJlcG9zaXRvcnkxNTc0OTI2OQ==-flat-test__auth.py.html,0.04291845493562232,10,wxpy-MDEwOlJlcG9zaXRvcnk4MjU4ODU5Nw==-flat-base_request.py,google-api-python-client-MDEwOlJlcG9zaXRvcnkxNTc0OTI2OQ==-flat-test__auth.py,9,12,3,20,22,2
39986,https://htmlpreview.github.io/?https://github.com/Christina96/boilerplate-sample-matches/blob/main/Python/esptool-MDEwOlJlcG9zaXRvcnkyMzczNjkxNA==-flat-operations_40.py-Ultroid-MDEwOlJlcG9zaXRvcnkzNDEwMzg2MDI=-flat-helper.py.html,0.03257707969749855,9,esptool-MDEwOlJlcG9zaXRvcnkyMzczNjkxNA==-flat-operations_40.py,Ultroid-MDEwOlJlcG9zaXRvcnkzNDEwMzg2MDI=-flat-helper.py,1,9,8,1,9,8
40070,https://htmlpreview.github.io/?https://github.com/Christina96/boilerplate-sample-matches/blob/main/Python/Ultroid-MDEwOlJlcG9zaXRvcnkzNDEwMzg2MDI=-flat-start.py-esptool-MDEwOlJlcG9zaXRvcnkyMzczNjkxNA==-flat-cmds.py.html,0.0381791483113069,9,Ultroid-MDEwOlJlcG9zaXRvcnkzNDEwMzg2MDI=-flat-start.py,esptool-MDEwOlJlcG9zaXRvcnkyMzczNjkxNA==-flat-cmds.py,106,115,9,604,614,10
40766,https://htmlpreview.github.io/?https://github.com/Christina96/boilerplate-sample-matches/blob/main/Python/sonnet-MDEwOlJlcG9zaXRvcnk4NzA2NzIxMg==-flat-pad_test.py-esptool-MDEwOlJlcG9zaXRvcnkyMzczNjkxNA==-flat-operations_10.py.html,0.1049618320610687,12,sonnet-MDEwOlJlcG9zaXRvcnk4NzA2NzIxMg==-flat-pad_test.py,esptool-MDEwOlJlcG9zaXRvcnkyMzczNjkxNA==-flat-operations_10.py,45,47,2,101,111,10
40905,https://htmlpreview.github.io/?https://github.com/Christina96/boilerplate-sample-matches/blob/main/Python/Ultroid-MDEwOlJlcG9zaXRvcnkzNDEwMzg2MDI=-flat-start.py-Ultroid-MDEwOlJlcG9zaXRvcnkzNDEwMzg2MDI=-flat-imagetools.py.html,0.09195402298850575,10,Ultroid-MDEwOlJlcG9zaXRvcnkzNDEwMzg2MDI=-flat-start.py,Ultroid-MDEwOlJlcG9zaXRvcnkzNDEwMzg2MDI=-flat-imagetools.py,143,146,3,29,32,3
41037,https://htmlpreview.github.io/?https://github.com/Christina96/boilerplate-sample-matches/blob/main/Python/esptool-MDEwOlJlcG9zaXRvcnkyMzczNjkxNA==-flat-fields_17.py-esphome-docs-MDEwOlJlcG9zaXRvcnkxMzMyMjM0NjE=-flat-schema_doc.py.html,0.05925925925925926,9,esptool-MDEwOlJlcG9zaXRvcnkyMzczNjkxNA==-flat-fields_17.py,esphome-docs-MDEwOlJlcG9zaXRvcnkxMzMyMjM0NjE=-flat-schema_doc.py,65,70,5,613,617,4
41286,https://htmlpreview.github.io/?https://github.com/Christina96/boilerplate-sample-matches/blob/main/Python/esptool-MDEwOlJlcG9zaXRvcnkyMzczNjkxNA==-flat-fields_17.py-yolact-MDEwOlJlcG9zaXRvcnkxMzg3OTY2OTk=-flat-multibox_loss.py.html,0.05637982195845697,9,esptool-MDEwOlJlcG9zaXRvcnkyMzczNjkxNA==-flat-fields_17.py,yolact-MDEwOlJlcG9zaXRvcnkxMzg3OTY2OTk=-flat-multibox_loss.py,58,60,2,236,237,1
41401,https://htmlpreview.github.io/?https://github.com/Christina96/boilerplate-sample-matches/blob/main/Python/sonnet-MDEwOlJlcG9zaXRvcnk4NzA2NzIxMg==-flat-rmsprop.py-Ultroid-MDEwOlJlcG9zaXRvcnkzNDEwMzg2MDI=-flat-BaseClient.py.html,0.08347826086956522,15,sonnet-MDEwOlJlcG9zaXRvcnk4NzA2NzIxMg==-flat-rmsprop.py,Ultroid-MDEwOlJlcG9zaXRvcnkzNDEwMzg2MDI=-flat-BaseClient.py,27,34,7,29,35,6
41596,https://htmlpreview.github.io/?https://github.com/Christina96/boilerplate-sample-matches/blob/main/Python/Ultroid-MDEwOlJlcG9zaXRvcnkzNDEwMzg2MDI=-flat-utilities.py-google-api-python-client-MDEwOlJlcG9zaXRvcnkxNTc0OTI2OQ==-flat-test_discovery.py.html,0.06676107626947198,12,Ultroid-MDEwOlJlcG9zaXRvcnkzNDEwMzg2MDI=-flat-utilities.py,google-api-python-client-MDEwOlJlcG9zaXRvcnkxNTc0OTI2OQ==-flat-test_discovery.py,92,100,8,1152,1156,4
41629,https://htmlpreview.github.io/?https://github.com/Christina96/boilerplate-sample-matches/blob/main/Python/esphome-docs-MDEwOlJlcG9zaXRvcnkxMzMyMjM0NjE=-flat-seo.py-sonnet-MDEwOlJlcG9zaXRvcnk4NzA2NzIxMg==-flat-distributed_batch_norm_test.py.html,0.07011070110701106,10,esphome-docs-MDEwOlJlcG9zaXRvcnkxMzMyMjM0NjE=-flat-seo.py,sonnet-MDEwOlJlcG9zaXRvcnk4NzA2NzIxMg==-flat-distributed_batch_norm_test.py,117,120,3,46,49,3
41689,https://htmlpreview.github.io/?https://github.com/Christina96/boilerplate-sample-matches/blob/main/Python/google-api-python-client-MDEwOlJlcG9zaXRvcnkxNTc0OTI2OQ==-flat-readme_gen.py-Ultroid-MDEwOlJlcG9zaXRvcnkzNDEwMzg2MDI=-flat-webupload.py.html,0.08737864077669903,9,google-api-python-client-MDEwOlJlcG9zaXRvcnkxNTc0OTI2OQ==-flat-readme_gen.py,Ultroid-MDEwOlJlcG9zaXRvcnkzNDEwMzg2MDI=-flat-webupload.py,23,25,2,32,35,3
41924,https://htmlpreview.github.io/?https://github.com/Christina96/boilerplate-sample-matches/blob/main/Python/seq2seq-MDEwOlJlcG9zaXRvcnk4MzczMjgwNg==-flat-image_encoder.py-google-api-python-client-MDEwOlJlcG9zaXRvcnkxNTc0OTI2OQ==-flat-test_discovery.py.html,0.01432225063938619,9,seq2seq-MDEwOlJlcG9zaXRvcnk4MzczMjgwNg==-flat-image_encoder.py,google-api-python-client-MDEwOlJlcG9zaXRvcnkxNTc0OTI2OQ==-flat-test_discovery.py,18,20,2,1056,1059,3
41954,https://htmlpreview.github.io/?https://github.com/Christina96/boilerplate-sample-matches/blob/main/Python/cookiecutter-pypackage-MDEwOlJlcG9zaXRvcnkxMTQwNzU2Nw==-flat-conf.py-seq2seq-MDEwOlJlcG9zaXRvcnk4MzczMjgwNg==-flat-parallel_data_provider.py.html,0.09574468085106383,9,cookiecutter-pypackage-MDEwOlJlcG9zaXRvcnkxMTQwNzU2Nw==-flat-conf.py,seq2seq-MDEwOlJlcG9zaXRvcnk4MzczMjgwNg==-flat-parallel_data_provider.py,5,18,13,57,64,7
42439,https://htmlpreview.github.io/?https://github.com/Christina96/boilerplate-sample-matches/blob/main/Python/yolact-MDEwOlJlcG9zaXRvcnkxMzg3OTY2OTk=-flat-augment_bbox.py-Ultroid-MDEwOlJlcG9zaXRvcnkzNDEwMzg2MDI=-flat-inlinestuff.py.html,0.05057096247960848,12,yolact-MDEwOlJlcG9zaXRvcnkxMzg3OTY2OTk=-flat-augment_bbox.py,Ultroid-MDEwOlJlcG9zaXRvcnkzNDEwMzg2MDI=-flat-inlinestuff.py,25,30,5,216,221,5
42575,https://htmlpreview.github.io/?https://github.com/Christina96/boilerplate-sample-matches/blob/main/Python/esphome-docs-MDEwOlJlcG9zaXRvcnkxMzMyMjM0NjE=-flat-conf.py-Ultroid-MDEwOlJlcG9zaXRvcnkzNDEwMzg2MDI=-flat-info.py.html,0.0782122905027933,14,esphome-docs-MDEwOlJlcG9zaXRvcnkxMzMyMjM0NjE=-flat-conf.py,Ultroid-MDEwOlJlcG9zaXRvcnkzNDEwMzg2MDI=-flat-info.py,5,18,13,35,44,9
43137,https://htmlpreview.github.io/?https://github.com/Christina96/boilerplate-sample-matches/blob/main/Python/wxpy-MDEwOlJlcG9zaXRvcnk4MjU4ODU5Nw==-flat-message_config.py-yolact-MDEwOlJlcG9zaXRvcnkxMzg3OTY2OTk=-flat-dcn_v2.py.html,0.12222222222222222,11,wxpy-MDEwOlJlcG9zaXRvcnk4MjU4ODU5Nw==-flat-message_config.py,yolact-MDEwOlJlcG9zaXRvcnkxMzg3OTY2OTk=-flat-dcn_v2.py,15,19,4,55,58,3
43350,https://htmlpreview.github.io/?https://github.com/Christina96/boilerplate-sample-matches/blob/main/Python/seq2seq-MDEwOlJlcG9zaXRvcnk4MzczMjgwNg==-flat-conv_encoder.py-sonnet-MDEwOlJlcG9zaXRvcnk4NzA2NzIxMg==-flat-conv_transpose.py.html,0.0636042402826855,9,seq2seq-MDEwOlJlcG9zaXRvcnk4MzczMjgwNg==-flat-conv_encoder.py,sonnet-MDEwOlJlcG9zaXRvcnk4NzA2NzIxMg==-flat-conv_transpose.py,42,46,4,136,140,4
43785,https://htmlpreview.github.io/?https://github.com/Christina96/boilerplate-sample-matches/blob/main/Python/esptool-MDEwOlJlcG9zaXRvcnkyMzczNjkxNA==-flat-fields_32.py-yolact-MDEwOlJlcG9zaXRvcnkxMzg3OTY2OTk=-flat-augmentations.py.html,0.07954545454545454,10,esptool-MDEwOlJlcG9zaXRvcnkyMzczNjkxNA==-flat-fields_32.py,yolact-MDEwOlJlcG9zaXRvcnkxMzg3OTY2OTk=-flat-augmentations.py,251,262,11,339,358,19
43800,https://htmlpreview.github.io/?https://github.com/Christina96/boilerplate-sample-matches/blob/main/Python/seq2seq-MDEwOlJlcG9zaXRvcnk4MzczMjgwNg==-flat-dump_attention.py-seq2seq-MDEwOlJlcG9zaXRvcnk4MzczMjgwNg==-flat-pipeline_test.py.html,0.18450184501845018,9,seq2seq-MDEwOlJlcG9zaXRvcnk4MzczMjgwNg==-flat-dump_attention.py,seq2seq-MDEwOlJlcG9zaXRvcnk4MzczMjgwNg==-flat-pipeline_test.py,63,67,4,103,106,3
44781,https://htmlpreview.github.io/?https://github.com/Christina96/boilerplate-sample-matches/blob/main/Python/seq2seq-MDEwOlJlcG9zaXRvcnk4MzczMjgwNg==-flat-decode_text.py-Ultroid-MDEwOlJlcG9zaXRvcnkzNDEwMzg2MDI=-flat-_database.py.html,0.02912621359223301,12,seq2seq-MDEwOlJlcG9zaXRvcnk4MzczMjgwNg==-flat-decode_text.py,Ultroid-MDEwOlJlcG9zaXRvcnkzNDEwMzg2MDI=-flat-_database.py,65,67,2,226,228,2
44982,https://htmlpreview.github.io/?https://github.com/Christina96/boilerplate-sample-matches/blob/main/Python/esptool-MDEwOlJlcG9zaXRvcnkyMzczNjkxNA==-flat-mem_definition_11.py-sonnet-MDEwOlJlcG9zaXRvcnk4NzA2NzIxMg==-flat-batch_apply_test.py.html,0.07156308851224105,10,esptool-MDEwOlJlcG9zaXRvcnkyMzczNjkxNA==-flat-mem_definition_11.py,sonnet-MDEwOlJlcG9zaXRvcnk4NzA2NzIxMg==-flat-batch_apply_test.py,36,44,8,7,11,4
45391,https://htmlpreview.github.io/?https://github.com/Christina96/boilerplate-sample-matches/blob/main/Python/google-api-python-client-MDEwOlJlcG9zaXRvcnkxNTc0OTI2OQ==-flat-discovery.py-esptool-MDEwOlJlcG9zaXRvcnkyMzczNjkxNA==-flat-bin_image.py.html,0.0936058009228741,9,google-api-python-client-MDEwOlJlcG9zaXRvcnkxNTc0OTI2OQ==-flat-discovery.py,esptool-MDEwOlJlcG9zaXRvcnkyMzczNjkxNA==-flat-bin_image.py,279,280,1,610,612,2
45483,https://htmlpreview.github.io/?https://github.com/Christina96/boilerplate-sample-matches/blob/main/Python/esptool-MDEwOlJlcG9zaXRvcnkyMzczNjkxNA==-flat-esp_rfc2217_server.py-Ultroid-MDEwOlJlcG9zaXRvcnkzNDEwMzg2MDI=-flat-_decorators.py.html,0.0515695067264574,12,esptool-MDEwOlJlcG9zaXRvcnkyMzczNjkxNA==-flat-esp_rfc2217_server.py,Ultroid-MDEwOlJlcG9zaXRvcnkzNDEwMzg2MDI=-flat-_decorators.py,2,20,18,30,41,11
45491,https://htmlpreview.github.io/?https://github.com/Christina96/boilerplate-sample-matches/blob/main/Python/yolact-MDEwOlJlcG9zaXRvcnkxMzg3OTY2OTk=-flat-timer.py-Ultroid-MDEwOlJlcG9zaXRvcnkzNDEwMzg2MDI=-flat-channelhacks.py.html,0.030508474576271188,9,yolact-MDEwOlJlcG9zaXRvcnkxMzg3OTY2OTk=-flat-timer.py,Ultroid-MDEwOlJlcG9zaXRvcnkzNDEwMzg2MDI=-flat-channelhacks.py,62,65,3,163,165,2
45760,https://htmlpreview.github.io/?https://github.com/Christina96/boilerplate-sample-matches/blob/main/Python/seq2seq-MDEwOlJlcG9zaXRvcnk4MzczMjgwNg==-flat-hooks_test.py-sonnet-MDEwOlJlcG9zaXRvcnk4NzA2NzIxMg==-flat-mlp_test.py.html,0.09253731343283582,12,seq2seq-MDEwOlJlcG9zaXRvcnk4MzczMjgwNg==-flat-hooks_test.py,sonnet-MDEwOlJlcG9zaXRvcnk4NzA2NzIxMg==-flat-mlp_test.py,37,42,5,43,48,5
46425,https://htmlpreview.github.io/?https://github.com/Christina96/boilerplate-sample-matches/blob/main/Python/google-api-python-client-MDEwOlJlcG9zaXRvcnkxNTc0OTI2OQ==-flat-owlbot.py-sonnet-MDEwOlJlcG9zaXRvcnk4NzA2NzIxMg==-flat-deferred_test.py.html,0.07468879668049792,9,google-api-python-client-MDEwOlJlcG9zaXRvcnkxNTc0OTI2OQ==-flat-owlbot.py,sonnet-MDEwOlJlcG9zaXRvcnk4NzA2NzIxMg==-flat-deferred_test.py,6,10,4,47,48,1
46706,https://htmlpreview.github.io/?https://github.com/Christina96/boilerplate-sample-matches/blob/main/Python/seq2seq-MDEwOlJlcG9zaXRvcnk4MzczMjgwNg==-flat-generate_toy_data.py-esptool-MDEwOlJlcG9zaXRvcnkyMzczNjkxNA==-flat-base_operations.py.html,0.052502050861361775,11,seq2seq-MDEwOlJlcG9zaXRvcnk4MzczMjgwNg==-flat-generate_toy_data.py,esptool-MDEwOlJlcG9zaXRvcnkyMzczNjkxNA==-flat-base_operations.py,15,19,4,103,110,7
47177,https://htmlpreview.github.io/?https://github.com/Christina96/boilerplate-sample-matches/blob/main/Python/yolact-MDEwOlJlcG9zaXRvcnkxMzg3OTY2OTk=-flat-dcn_v2.py-esptool-MDEwOlJlcG9zaXRvcnkyMzczNjkxNA==-flat-fields_27.py.html,0.11689351481184948,9,yolact-MDEwOlJlcG9zaXRvcnkxMzg3OTY2OTk=-flat-dcn_v2.py,esptool-MDEwOlJlcG9zaXRvcnkyMzczNjkxNA==-flat-fields_27.py,157,197,40,248,256,8
47190,https://htmlpreview.github.io/?https://github.com/Christina96/boilerplate-sample-matches/blob/main/Python/sonnet-MDEwOlJlcG9zaXRvcnk4NzA2NzIxMg==-flat-batch_apply_test.py-yolact-MDEwOlJlcG9zaXRvcnkxMzg3OTY2OTk=-flat-multibox_loss.py.html,0.08964646464646464,12,sonnet-MDEwOlJlcG9zaXRvcnk4NzA2NzIxMg==-flat-batch_apply_test.py,yolact-MDEwOlJlcG9zaXRvcnkxMzg3OTY2OTk=-flat-multibox_loss.py,70,74,4,31,34,3
47311,https://htmlpreview.github.io/?https://github.com/Christina96/boilerplate-sample-matches/blob/main/Python/Ultroid-MDEwOlJlcG9zaXRvcnkzNDEwMzg2MDI=-flat-_chatactions.py-google-api-python-client-MDEwOlJlcG9zaXRvcnkxNTc0OTI2OQ==-flat-test_discovery.py.html,0.046370023419203744,9,Ultroid-MDEwOlJlcG9zaXRvcnkzNDEwMzg2MDI=-flat-_chatactions.py,google-api-python-client-MDEwOlJlcG9zaXRvcnkxNTc0OTI2OQ==-flat-test_discovery.py,209,217,8,1812,1814,2
47330,https://htmlpreview.github.io/?https://github.com/Christina96/boilerplate-sample-matches/blob/main/Python/google-api-python-client-MDEwOlJlcG9zaXRvcnkxNTc0OTI2OQ==-flat-test__auth.py-seq2seq-MDEwOlJlcG9zaXRvcnk4MzczMjgwNg==-flat-beam_search_test.py.html,0.1590145576707727,13,google-api-python-client-MDEwOlJlcG9zaXRvcnkxNTc0OTI2OQ==-flat-test__auth.py,seq2seq-MDEwOlJlcG9zaXRvcnk4MzczMjgwNg==-flat-beam_search_test.py,67,70,3,136,137,1
47369,https://htmlpreview.github.io/?https://github.com/Christina96/boilerplate-sample-matches/blob/main/Python/google-api-python-client-MDEwOlJlcG9zaXRvcnkxNTc0OTI2OQ==-flat-schema.py-yolact-MDEwOlJlcG9zaXRvcnkxMzg3OTY2OTk=-flat-yolact.py.html,0.0743362831858407,9,google-api-python-client-MDEwOlJlcG9zaXRvcnkxNTc0OTI2OQ==-flat-schema.py,yolact-MDEwOlJlcG9zaXRvcnkxMzg3OTY2OTk=-flat-yolact.py,61,108,47,97,98,1
47570,https://htmlpreview.github.io/?https://github.com/Christina96/boilerplate-sample-matches/blob/main/Python/sonnet-MDEwOlJlcG9zaXRvcnk4NzA2NzIxMg==-flat-haiku_test.py-yolact-MDEwOlJlcG9zaXRvcnkxMzg3OTY2OTk=-flat-backbone.py.html,0.12099644128113879,15,sonnet-MDEwOlJlcG9zaXRvcnk4NzA2NzIxMg==-flat-haiku_test.py,yolact-MDEwOlJlcG9zaXRvcnkxMzg3OTY2OTk=-flat-backbone.py,47,51,4,168,172,4
48382,https://htmlpreview.github.io/?https://github.com/Christina96/boilerplate-sample-matches/blob/main/Python/sonnet-MDEwOlJlcG9zaXRvcnk4NzA2NzIxMg==-flat-linear_test.py-sonnet-MDEwOlJlcG9zaXRvcnk4NzA2NzIxMg==-flat-group_norm_test.py.html,0.19047619047619047,15,sonnet-MDEwOlJlcG9zaXRvcnk4NzA2NzIxMg==-flat-linear_test.py,sonnet-MDEwOlJlcG9zaXRvcnk4NzA2NzIxMg==-flat-group_norm_test.py,83,86,3,150,153,3
48644,https://htmlpreview.github.io/?https://github.com/Christina96/boilerplate-sample-matches/blob/main/Python/seq2seq-MDEwOlJlcG9zaXRvcnk4MzczMjgwNg==-flat-image2seq.py-Ultroid-MDEwOlJlcG9zaXRvcnkzNDEwMzg2MDI=-flat-start.py.html,0.07851239669421488,9,seq2seq-MDEwOlJlcG9zaXRvcnk4MzczMjgwNg==-flat-image2seq.py,Ultroid-MDEwOlJlcG9zaXRvcnkzNDEwMzg2MDI=-flat-start.py,61,63,2,70,73,3
48668,https://htmlpreview.github.io/?https://github.com/Christina96/boilerplate-sample-matches/blob/main/Python/google-api-python-client-MDEwOlJlcG9zaXRvcnkxNTc0OTI2OQ==-flat-urlshortener.py-google-api-python-client-MDEwOlJlcG9zaXRvcnkxNTc0OTI2OQ==-flat-get_all_custom_channels.py.html,0.14634146341463414,9,google-api-python-client-MDEwOlJlcG9zaXRvcnkxNTc0OTI2OQ==-flat-urlshortener.py,google-api-python-client-MDEwOlJlcG9zaXRvcnkxNTc0OTI2OQ==-flat-get_all_custom_channels.py,8,31,23,13,56,43
48836,https://htmlpreview.github.io/?https://github.com/Christina96/boilerplate-sample-matches/blob/main/Python/seq2seq-MDEwOlJlcG9zaXRvcnk4MzczMjgwNg==-flat-input_pipeline.py-yolact-MDEwOlJlcG9zaXRvcnkxMzg3OTY2OTk=-flat-box_utils.py.html,0.04036326942482341,9,seq2seq-MDEwOlJlcG9zaXRvcnk4MzczMjgwNg==-flat-input_pipeline.py,yolact-MDEwOlJlcG9zaXRvcnkxMzg3OTY2OTk=-flat-box_utils.py,63,65,2,39,41,2
48887,https://htmlpreview.github.io/?https://github.com/Christina96/boilerplate-sample-matches/blob/main/Python/esptool-MDEwOlJlcG9zaXRvcnkyMzczNjkxNA==-flat-emulate_efuse_controller.py-esptool-MDEwOlJlcG9zaXRvcnkyMzczNjkxNA==-flat-fields_22.py.html,0.03996003996003996,9,esptool-MDEwOlJlcG9zaXRvcnkyMzczNjkxNA==-flat-emulate_efuse_controller.py,esptool-MDEwOlJlcG9zaXRvcnkyMzczNjkxNA==-flat-fields_22.py,12,14,2,99,102,3
49003,https://htmlpreview.github.io/?https://github.com/Christina96/boilerplate-sample-matches/blob/main/Python/google-api-python-client-MDEwOlJlcG9zaXRvcnkxNTc0OTI2OQ==-flat-changesummary.py-esptool-MDEwOlJlcG9zaXRvcnkyMzczNjkxNA==-flat-base_fields.py.html,0.0914534567229178,9,google-api-python-client-MDEwOlJlcG9zaXRvcnkxNTc0OTI2OQ==-flat-changesummary.py,esptool-MDEwOlJlcG9zaXRvcnkyMzczNjkxNA==-flat-base_fields.py,141,145,4,517,519,2
49518,https://htmlpreview.github.io/?https://github.com/Christina96/boilerplate-sample-matches/blob/main/Python/google-api-python-client-MDEwOlJlcG9zaXRvcnkxNTc0OTI2OQ==-flat-test_channel.py-Ultroid-MDEwOlJlcG9zaXRvcnkzNDEwMzg2MDI=-flat-audiotools.py.html,0.03829787234042553,9,google-api-python-client-MDEwOlJlcG9zaXRvcnkxNTc0OTI2OQ==-flat-test_channel.py,Ultroid-MDEwOlJlcG9zaXRvcnkzNDEwMzg2MDI=-flat-audiotools.py,29,37,8,78,79,1
50956,https://htmlpreview.github.io/?https://github.com/Christina96/boilerplate-sample-matches/blob/main/Python/sonnet-MDEwOlJlcG9zaXRvcnk4NzA2NzIxMg==-flat-mlp.py-sonnet-MDEwOlJlcG9zaXRvcnk4NzA2NzIxMg==-flat-recurrent.py.html,0.011530398322851153,11,sonnet-MDEwOlJlcG9zaXRvcnk4NzA2NzIxMg==-flat-mlp.py,sonnet-MDEwOlJlcG9zaXRvcnk4NzA2NzIxMg==-flat-recurrent.py,58,62,4,360,364,4
51749,https://htmlpreview.github.io/?https://github.com/Christina96/boilerplate-sample-matches/blob/main/Python/Ultroid-MDEwOlJlcG9zaXRvcnkzNDEwMzg2MDI=-flat-mediatools.py-esptool-MDEwOlJlcG9zaXRvcnkyMzczNjkxNA==-flat-test_espefuse.py.html,0.01040582726326743,10,Ultroid-MDEwOlJlcG9zaXRvcnkzNDEwMzg2MDI=-flat-mediatools.py,esptool-MDEwOlJlcG9zaXRvcnkyMzczNjkxNA==-flat-test_espefuse.py,39,41,2,1430,1439,9
52010,https://htmlpreview.github.io/?https://github.com/Christina96/boilerplate-sample-matches/blob/main/Python/Ultroid-MDEwOlJlcG9zaXRvcnkzNDEwMzg2MDI=-flat-greetings.py-Ultroid-MDEwOlJlcG9zaXRvcnkzNDEwMzg2MDI=-flat-globaltools.py.html,0.07711138310893513,10,Ultroid-MDEwOlJlcG9zaXRvcnkzNDEwMzg2MDI=-flat-greetings.py,Ultroid-MDEwOlJlcG9zaXRvcnkzNDEwMzg2MDI=-flat-globaltools.py,69,72,3,52,55,3
52218,https://htmlpreview.github.io/?https://github.com/Christina96/boilerplate-sample-matches/blob/main/Python/seq2seq-MDEwOlJlcG9zaXRvcnk4MzczMjgwNg==-flat-vocab_test.py-esptool-MDEwOlJlcG9zaXRvcnkyMzczNjkxNA==-flat-__init___45.py.html,0.0202808112324493,13,seq2seq-MDEwOlJlcG9zaXRvcnk4MzczMjgwNg==-flat-vocab_test.py,esptool-MDEwOlJlcG9zaXRvcnkyMzczNjkxNA==-flat-__init___45.py,33,36,3,674,683,9
52397,https://htmlpreview.github.io/?https://github.com/Christina96/boilerplate-sample-matches/blob/main/Python/Ultroid-MDEwOlJlcG9zaXRvcnkzNDEwMzg2MDI=-flat-utils.py-sonnet-MDEwOlJlcG9zaXRvcnk4NzA2NzIxMg==-flat-rmsprop.py.html,0.10198300283286119,18,Ultroid-MDEwOlJlcG9zaXRvcnkzNDEwMzg2MDI=-flat-utils.py,sonnet-MDEwOlJlcG9zaXRvcnk4NzA2NzIxMg==-flat-rmsprop.py,38,46,8,26,34,8
53820,https://htmlpreview.github.io/?https://github.com/Christina96/boilerplate-sample-matches/blob/main/Python/esptool-MDEwOlJlcG9zaXRvcnkyMzczNjkxNA==-flat-test_espsecure_hsm.py-google-api-python-client-MDEwOlJlcG9zaXRvcnkxNTc0OTI2OQ==-flat-test_discovery.py.html,0.060067275348390195,10,esptool-MDEwOlJlcG9zaXRvcnkyMzczNjkxNA==-flat-test_espsecure_hsm.py,google-api-python-client-MDEwOlJlcG9zaXRvcnkxNTc0OTI2OQ==-flat-test_discovery.py,191,200,9,1355,1358,3
53862,https://htmlpreview.github.io/?https://github.com/Christina96/boilerplate-sample-matches/blob/main/Python/google-api-python-client-MDEwOlJlcG9zaXRvcnkxNTc0OTI2OQ==-flat-buildprbody.py-esptool-MDEwOlJlcG9zaXRvcnkyMzczNjkxNA==-flat-mem_definition_21.py.html,0.134185303514377,9,google-api-python-client-MDEwOlJlcG9zaXRvcnkxNTc0OTI2OQ==-flat-buildprbody.py,esptool-MDEwOlJlcG9zaXRvcnkyMzczNjkxNA==-flat-mem_definition_21.py,28,32,4,34,41,7
53915,https://htmlpreview.github.io/?https://github.com/Christina96/boilerplate-sample-matches/blob/main/Python/sonnet-MDEwOlJlcG9zaXRvcnk4NzA2NzIxMg==-flat-__init__.py-seq2seq-MDEwOlJlcG9zaXRvcnk4MzczMjgwNg==-flat-hooks_test.py.html,0.06970509383378017,13,sonnet-MDEwOlJlcG9zaXRvcnk4NzA2NzIxMg==-flat-__init__.py,seq2seq-MDEwOlJlcG9zaXRvcnk4MzczMjgwNg==-flat-hooks_test.py,1,13,12,1,13,12
53959,https://htmlpreview.github.io/?https://github.com/Christina96/boilerplate-sample-matches/blob/main/Python/seq2seq-MDEwOlJlcG9zaXRvcnk4MzczMjgwNg==-flat-parallel_data_provider.py-sonnet-MDEwOlJlcG9zaXRvcnk4NzA2NzIxMg==-flat-axis_norm_test.py.html,0.02097902097902098,9,seq2seq-MDEwOlJlcG9zaXRvcnk4MzczMjgwNg==-flat-parallel_data_provider.py,sonnet-MDEwOlJlcG9zaXRvcnk4NzA2NzIxMg==-flat-axis_norm_test.py,14,21,7,205,211,6
54046,https://htmlpreview.github.io/?https://github.com/Christina96/boilerplate-sample-matches/blob/main/Python/esptool-MDEwOlJlcG9zaXRvcnkyMzczNjkxNA==-flat-esp32c6.py-yolact-MDEwOlJlcG9zaXRvcnkxMzg3OTY2OTk=-flat-augmentations.py.html,0.02967359050445104,11,esptool-MDEwOlJlcG9zaXRvcnkyMzczNjkxNA==-flat-esp32c6.py,yolact-MDEwOlJlcG9zaXRvcnkxMzg3OTY2OTk=-flat-augmentations.py,133,136,3,101,104,3
54228,https://htmlpreview.github.io/?https://github.com/Christina96/boilerplate-sample-matches/blob/main/Python/seq2seq-MDEwOlJlcG9zaXRvcnk4MzczMjgwNg==-flat-decode_text.py-sonnet-MDEwOlJlcG9zaXRvcnk4NzA2NzIxMg==-flat-rmsprop_test.py.html,0.04712041884816754,9,seq2seq-MDEwOlJlcG9zaXRvcnk4MzczMjgwNg==-flat-decode_text.py,sonnet-MDEwOlJlcG9zaXRvcnk4NzA2NzIxMg==-flat-rmsprop_test.py,74,76,2,36,37,1
54530,https://htmlpreview.github.io/?https://github.com/Christina96/boilerplate-sample-matches/blob/main/Python/sonnet-MDEwOlJlcG9zaXRvcnk4NzA2NzIxMg==-flat-cifar10_convnet_test.py-google-api-python-client-MDEwOlJlcG9zaXRvcnkxNTc0OTI2OQ==-flat-test_discovery.py.html,0.03271375464684015,9,sonnet-MDEwOlJlcG9zaXRvcnk4NzA2NzIxMg==-flat-cifar10_convnet_test.py,google-api-python-client-MDEwOlJlcG9zaXRvcnkxNTc0OTI2OQ==-flat-test_discovery.py,56,58,2,327,339,12
54667,https://htmlpreview.github.io/?https://github.com/Christina96/boilerplate-sample-matches/blob/main/Python/esptool-MDEwOlJlcG9zaXRvcnkyMzczNjkxNA==-flat-test_merge_bin.py-yolact-MDEwOlJlcG9zaXRvcnkxMzg3OTY2OTk=-flat-backbone.py.html,0.05086285195277021,10,esptool-MDEwOlJlcG9zaXRvcnkyMzczNjkxNA==-flat-test_merge_bin.py,yolact-MDEwOlJlcG9zaXRvcnkxMzg3OTY2OTk=-flat-backbone.py,86,95,9,20,23,3
55224,https://htmlpreview.github.io/?https://github.com/Christina96/boilerplate-sample-matches/blob/main/Python/yolact-MDEwOlJlcG9zaXRvcnkxMzg3OTY2OTk=-flat-compute_masks.py-google-api-python-client-MDEwOlJlcG9zaXRvcnkxNTc0OTI2OQ==-flat-noxfile_7.py.html,0.07547169811320754,9,yolact-MDEwOlJlcG9zaXRvcnkxMzg3OTY2OTk=-flat-compute_masks.py,google-api-python-client-MDEwOlJlcG9zaXRvcnkxNTc0OTI2OQ==-flat-noxfile_7.py,37,37,0,64,66,2
55246,https://htmlpreview.github.io/?https://github.com/Christina96/boilerplate-sample-matches/blob/main/Python/sonnet-MDEwOlJlcG9zaXRvcnk4NzA2NzIxMg==-flat-depthwise_conv.py-Ultroid-MDEwOlJlcG9zaXRvcnkzNDEwMzg2MDI=-flat-globaltools.py.html,0.012236573759347382,9,sonnet-MDEwOlJlcG9zaXRvcnk4NzA2NzIxMg==-flat-depthwise_conv.py,Ultroid-MDEwOlJlcG9zaXRvcnkzNDEwMzg2MDI=-flat-globaltools.py,26,29,3,268,271,3
55672,https://htmlpreview.github.io/?https://github.com/Christina96/boilerplate-sample-matches/blob/main/Python/yolact-MDEwOlJlcG9zaXRvcnkxMzg3OTY2OTk=-flat-compute_masks.py-Ultroid-MDEwOlJlcG9zaXRvcnkzNDEwMzg2MDI=-flat-gDrive.py.html,0.06060606060606061,9,yolact-MDEwOlJlcG9zaXRvcnkxMzg3OTY2OTk=-flat-compute_masks.py,Ultroid-MDEwOlJlcG9zaXRvcnkzNDEwMzg2MDI=-flat-gDrive.py,40,41,1,127,129,2
56545,https://htmlpreview.github.io/?https://github.com/Christina96/boilerplate-sample-matches/blob/main/Python/Ultroid-MDEwOlJlcG9zaXRvcnkzNDEwMzg2MDI=-flat-snips.py-Ultroid-MDEwOlJlcG9zaXRvcnkzNDEwMzg2MDI=-flat-pdftools.py.html,0.02957906712172924,13,Ultroid-MDEwOlJlcG9zaXRvcnkzNDEwMzg2MDI=-flat-snips.py,Ultroid-MDEwOlJlcG9zaXRvcnkzNDEwMzg2MDI=-flat-pdftools.py,9,50,41,139,211,72
56610,https://htmlpreview.github.io/?https://github.com/Christina96/boilerplate-sample-matches/blob/main/Python/Ultroid-MDEwOlJlcG9zaXRvcnkzNDEwMzg2MDI=-flat-loader_9.py-Ultroid-MDEwOlJlcG9zaXRvcnkzNDEwMzg2MDI=-flat-downloadupload.py.html,0.0657439446366782,10,Ultroid-MDEwOlJlcG9zaXRvcnkzNDEwMzg2MDI=-flat-loader_9.py,Ultroid-MDEwOlJlcG9zaXRvcnkzNDEwMzg2MDI=-flat-downloadupload.py,1,10,9,3,12,9
56929,https://htmlpreview.github.io/?https://github.com/Christina96/boilerplate-sample-matches/blob/main/Python/Ultroid-MDEwOlJlcG9zaXRvcnkzNDEwMzg2MDI=-flat-usage.py-esphome-docs-MDEwOlJlcG9zaXRvcnkxMzMyMjM0NjE=-flat-github.py.html,0.09090909090909091,12,Ultroid-MDEwOlJlcG9zaXRvcnkzNDEwMzg2MDI=-flat-usage.py,esphome-docs-MDEwOlJlcG9zaXRvcnkxMzMyMjM0NjE=-flat-github.py,95,99,4,121,123,2
57038,https://htmlpreview.github.io/?https://github.com/Christina96/boilerplate-sample-matches/blob/main/Python/esptool-MDEwOlJlcG9zaXRvcnkyMzczNjkxNA==-flat-emulate_efuse_controller_8.py-google-api-python-client-MDEwOlJlcG9zaXRvcnkxNTc0OTI2OQ==-flat-test_channel.py.html,0.06116207951070336,10,esptool-MDEwOlJlcG9zaXRvcnkyMzczNjkxNA==-flat-emulate_efuse_controller_8.py,google-api-python-client-MDEwOlJlcG9zaXRvcnkxNTc0OTI2OQ==-flat-test_channel.py,31,35,4,27,31,4
57205,https://htmlpreview.github.io/?https://github.com/Christina96/boilerplate-sample-matches/blob/main/Python/Ultroid-MDEwOlJlcG9zaXRvcnkzNDEwMzg2MDI=-flat-__main__.py-Ultroid-MDEwOlJlcG9zaXRvcnkzNDEwMzg2MDI=-flat-misc_3.py.html,0.0291005291005291,11,Ultroid-MDEwOlJlcG9zaXRvcnkzNDEwMzg2MDI=-flat-__main__.py,Ultroid-MDEwOlJlcG9zaXRvcnkzNDEwMzg2MDI=-flat-misc_3.py,3,20,17,4,13,9
57232,https://htmlpreview.github.io/?https://github.com/Christina96/boilerplate-sample-matches/blob/main/Python/seq2seq-MDEwOlJlcG9zaXRvcnk4MzczMjgwNg==-flat-pipeline_test.py-esptool-MDEwOlJlcG9zaXRvcnkyMzczNjkxNA==-flat-fields_12.py.html,0.12522045855379188,10,seq2seq-MDEwOlJlcG9zaXRvcnk4MzczMjgwNg==-flat-pipeline_test.py,esptool-MDEwOlJlcG9zaXRvcnkyMzczNjkxNA==-flat-fields_12.py,87,89,2,67,72,5
57489,https://htmlpreview.github.io/?https://github.com/Christina96/boilerplate-sample-matches/blob/main/Python/sonnet-MDEwOlJlcG9zaXRvcnk4NzA2NzIxMg==-flat-pickle_test.py-yolact-MDEwOlJlcG9zaXRvcnkxMzg3OTY2OTk=-flat-logger.py.html,0.04853128991060025,9,sonnet-MDEwOlJlcG9zaXRvcnk4NzA2NzIxMg==-flat-pickle_test.py,yolact-MDEwOlJlcG9zaXRvcnkxMzg3OTY2OTk=-flat-logger.py,10,13,3,137,138,1
57884,https://htmlpreview.github.io/?https://github.com/Christina96/boilerplate-sample-matches/blob/main/Python/sonnet-MDEwOlJlcG9zaXRvcnk4NzA2NzIxMg==-flat-adam_test.py-yolact-MDEwOlJlcG9zaXRvcnkxMzg3OTY2OTk=-flat-yolact.py.html,0.044541010320478004,9,sonnet-MDEwOlJlcG9zaXRvcnk4NzA2NzIxMg==-flat-adam_test.py,yolact-MDEwOlJlcG9zaXRvcnkxMzg3OTY2OTk=-flat-yolact.py,50,53,3,335,337,2
59146,https://htmlpreview.github.io/?https://github.com/Christina96/boilerplate-sample-matches/blob/main/Python/sonnet-MDEwOlJlcG9zaXRvcnk4NzA2NzIxMg==-flat-metrics_test.py-Ultroid-MDEwOlJlcG9zaXRvcnkzNDEwMzg2MDI=-flat-_decorators.py.html,0.04926108374384237,15,sonnet-MDEwOlJlcG9zaXRvcnk4NzA2NzIxMg==-flat-metrics_test.py,Ultroid-MDEwOlJlcG9zaXRvcnkzNDEwMzg2MDI=-flat-_decorators.py,6,8,2,97,105,8
60062,https://htmlpreview.github.io/?https://github.com/Christina96/boilerplate-sample-matches/blob/main/Python/sonnet-MDEwOlJlcG9zaXRvcnk4NzA2NzIxMg==-flat-checkpoint_test.py-Ultroid-MDEwOlJlcG9zaXRvcnkzNDEwMzg2MDI=-flat-callbackstuffs.py.html,0.018967334035827187,9,sonnet-MDEwOlJlcG9zaXRvcnk4NzA2NzIxMg==-flat-checkpoint_test.py,Ultroid-MDEwOlJlcG9zaXRvcnkzNDEwMzg2MDI=-flat-callbackstuffs.py,255,258,3,1184,1186,2
60315,https://htmlpreview.github.io/?https://github.com/Christina96/boilerplate-sample-matches/blob/main/Python/yolact-MDEwOlJlcG9zaXRvcnkxMzg3OTY2OTk=-flat-dcn_v2.py-esphome-docs-MDEwOlJlcG9zaXRvcnkxMzMyMjM0NjE=-flat-schema_doc.py.html,0.10283687943262411,12,yolact-MDEwOlJlcG9zaXRvcnkxMzg3OTY2OTk=-flat-dcn_v2.py,esphome-docs-MDEwOlJlcG9zaXRvcnkxMzMyMjM0NjE=-flat-schema_doc.py,216,220,4,494,496,2
60352,https://htmlpreview.github.io/?https://github.com/Christina96/boilerplate-sample-matches/blob/main/Python/seq2seq-MDEwOlJlcG9zaXRvcnk4MzczMjgwNg==-flat-helper.py-esptool-MDEwOlJlcG9zaXRvcnkyMzczNjkxNA==-flat-bin_image.py.html,0.05697022011221407,9,seq2seq-MDEwOlJlcG9zaXRvcnk4MzczMjgwNg==-flat-helper.py,esptool-MDEwOlJlcG9zaXRvcnkyMzczNjkxNA==-flat-bin_image.py,302,306,4,338,346,8
60486,https://htmlpreview.github.io/?https://github.com/Christina96/boilerplate-sample-matches/blob/main/Python/seq2seq-MDEwOlJlcG9zaXRvcnk4MzczMjgwNg==-flat-metrics_test.py-Ultroid-MDEwOlJlcG9zaXRvcnkzNDEwMzg2MDI=-flat-pdftools.py.html,0.0670995670995671,9,seq2seq-MDEwOlJlcG9zaXRvcnk4MzczMjgwNg==-flat-metrics_test.py,Ultroid-MDEwOlJlcG9zaXRvcnkzNDEwMzg2MDI=-flat-pdftools.py,29,32,3,266,269,3
60602,https://htmlpreview.github.io/?https://github.com/Christina96/boilerplate-sample-matches/blob/main/Python/esptool-MDEwOlJlcG9zaXRvcnkyMzczNjkxNA==-flat-efuse_burn1.py-esptool-MDEwOlJlcG9zaXRvcnkyMzczNjkxNA==-flat-operations_20.py.html,0.030821917808219176,9,esptool-MDEwOlJlcG9zaXRvcnkyMzczNjkxNA==-flat-efuse_burn1.py,esptool-MDEwOlJlcG9zaXRvcnkyMzczNjkxNA==-flat-operations_20.py,3,6,3,352,355,3
60802,https://htmlpreview.github.io/?https://github.com/Christina96/boilerplate-sample-matches/blob/main/Python/yolact-MDEwOlJlcG9zaXRvcnkxMzg3OTY2OTk=-flat-bbox_recall.py-Ultroid-MDEwOlJlcG9zaXRvcnkzNDEwMzg2MDI=-flat-forcesubscribe.py.html,0.12438625204582651,10,yolact-MDEwOlJlcG9zaXRvcnkxMzg3OTY2OTk=-flat-bbox_recall.py,Ultroid-MDEwOlJlcG9zaXRvcnkzNDEwMzg2MDI=-flat-forcesubscribe.py,87,88,1,133,136,3
60974,https://htmlpreview.github.io/?https://github.com/Christina96/boilerplate-sample-matches/blob/main/Python/sonnet-MDEwOlJlcG9zaXRvcnk4NzA2NzIxMg==-flat-conv_transpose_test.py-yolact-MDEwOlJlcG9zaXRvcnkxMzg3OTY2OTk=-flat-train.py.html,0.03670886075949367,9,sonnet-MDEwOlJlcG9zaXRvcnk4NzA2NzIxMg==-flat-conv_transpose_test.py,yolact-MDEwOlJlcG9zaXRvcnkxMzg3OTY2OTk=-flat-train.py,54,60,6,75,77,2
61053,https://htmlpreview.github.io/?https://github.com/Christina96/boilerplate-sample-matches/blob/main/Python/sonnet-MDEwOlJlcG9zaXRvcnk4NzA2NzIxMg==-flat-function_test.py-sonnet-MDEwOlJlcG9zaXRvcnk4NzA2NzIxMg==-flat-momentum_test.py.html,0.09769335142469471,10,sonnet-MDEwOlJlcG9zaXRvcnk4NzA2NzIxMg==-flat-function_test.py,sonnet-MDEwOlJlcG9zaXRvcnk4NzA2NzIxMg==-flat-momentum_test.py,8,12,4,5,9,4
61234,https://htmlpreview.github.io/?https://github.com/Christina96/boilerplate-sample-matches/blob/main/Python/seq2seq-MDEwOlJlcG9zaXRvcnk4MzczMjgwNg==-flat-rnn_cell_test.py-google-api-python-client-MDEwOlJlcG9zaXRvcnkxNTc0OTI2OQ==-flat-test_discovery.py.html,0.05493724840161023,12,seq2seq-MDEwOlJlcG9zaXRvcnk4MzczMjgwNg==-flat-rnn_cell_test.py,google-api-python-client-MDEwOlJlcG9zaXRvcnkxNTc0OTI2OQ==-flat-test_discovery.py,11,12,1,1111,1113,2
62105,https://htmlpreview.github.io/?https://github.com/Christina96/boilerplate-sample-matches/blob/main/Python/seq2seq-MDEwOlJlcG9zaXRvcnk4MzczMjgwNg==-flat-train_utils_test.py-sonnet-MDEwOlJlcG9zaXRvcnk4NzA2NzIxMg==-flat-recurrent_test.py.html,0.07698744769874477,13,seq2seq-MDEwOlJlcG9zaXRvcnk4MzczMjgwNg==-flat-train_utils_test.py,sonnet-MDEwOlJlcG9zaXRvcnk4NzA2NzIxMg==-flat-recurrent_test.py,3,13,10,1,11,10
62848,https://htmlpreview.github.io/?https://github.com/Christina96/boilerplate-sample-matches/blob/main/Python/Ultroid-MDEwOlJlcG9zaXRvcnkzNDEwMzg2MDI=-flat-blacklist_chat_db.py-google-api-python-client-MDEwOlJlcG9zaXRvcnkxNTc0OTI2OQ==-flat-changesummary.py.html,0.040145985401459854,11,Ultroid-MDEwOlJlcG9zaXRvcnkzNDEwMzg2MDI=-flat-blacklist_chat_db.py,google-api-python-client-MDEwOlJlcG9zaXRvcnkxNTc0OTI2OQ==-flat-changesummary.py,2,10,8,39,46,7
63233,https://htmlpreview.github.io/?https://github.com/Christina96/boilerplate-sample-matches/blob/main/Python/seq2seq-MDEwOlJlcG9zaXRvcnk4MzczMjgwNg==-flat-sequence_example_decoder.py-sonnet-MDEwOlJlcG9zaXRvcnk4NzA2NzIxMg==-flat-embed_test.py.html,0.0703125,9,seq2seq-MDEwOlJlcG9zaXRvcnk4MzczMjgwNg==-flat-sequence_example_decoder.py,sonnet-MDEwOlJlcG9zaXRvcnk4NzA2NzIxMg==-flat-embed_test.py,17,20,3,9,11,2
63320,https://htmlpreview.github.io/?https://github.com/Christina96/boilerplate-sample-matches/blob/main/Python/esptool-MDEwOlJlcG9zaXRvcnkyMzczNjkxNA==-flat-test_merge_bin.py-seq2seq-MDEwOlJlcG9zaXRvcnk4MzczMjgwNg==-flat-rnn_encoder_test.py.html,0.13008130081300814,9,esptool-MDEwOlJlcG9zaXRvcnkyMzczNjkxNA==-flat-test_merge_bin.py,seq2seq-MDEwOlJlcG9zaXRvcnk4MzczMjgwNg==-flat-rnn_encoder_test.py,121,136,15,81,105,24
63468,https://htmlpreview.github.io/?https://github.com/Christina96/boilerplate-sample-matches/blob/main/Python/Ultroid-MDEwOlJlcG9zaXRvcnkzNDEwMzg2MDI=-flat-devtools.py-yolact-MDEwOlJlcG9zaXRvcnkxMzg3OTY2OTk=-flat-eval.py.html,0.03272727272727273,9,Ultroid-MDEwOlJlcG9zaXRvcnkzNDEwMzg2MDI=-flat-devtools.py,yolact-MDEwOlJlcG9zaXRvcnkxMzg3OTY2OTk=-flat-eval.py,211,215,4,426,426,0
63535,https://htmlpreview.github.io/?https://github.com/Christina96/boilerplate-sample-matches/blob/main/Python/esptool-MDEwOlJlcG9zaXRvcnkyMzczNjkxNA==-flat-esp8266.py-Ultroid-MDEwOlJlcG9zaXRvcnkzNDEwMzg2MDI=-flat-pmpermit.py.html,0.011152416356877323,9,esptool-MDEwOlJlcG9zaXRvcnkyMzczNjkxNA==-flat-esp8266.py,Ultroid-MDEwOlJlcG9zaXRvcnkzNDEwMzg2MDI=-flat-pmpermit.py,4,12,8,191,199,8
63680,https://htmlpreview.github.io/?https://github.com/Christina96/boilerplate-sample-matches/blob/main/Python/Ultroid-MDEwOlJlcG9zaXRvcnkzNDEwMzg2MDI=-flat-specialtools.py-esptool-MDEwOlJlcG9zaXRvcnkyMzczNjkxNA==-flat-test_espsecure.py.html,0.07063197026022305,10,Ultroid-MDEwOlJlcG9zaXRvcnkzNDEwMzg2MDI=-flat-specialtools.py,esptool-MDEwOlJlcG9zaXRvcnkyMzczNjkxNA==-flat-test_espsecure.py,1,23,22,1,10,9
64052,https://htmlpreview.github.io/?https://github.com/Christina96/boilerplate-sample-matches/blob/main/Python/seq2seq-MDEwOlJlcG9zaXRvcnk4MzczMjgwNg==-flat-rnn_decoder.py-seq2seq-MDEwOlJlcG9zaXRvcnk4MzczMjgwNg==-flat-helper.py.html,0.033936651583710405,15,seq2seq-MDEwOlJlcG9zaXRvcnk4MzczMjgwNg==-flat-rnn_decoder.py,seq2seq-MDEwOlJlcG9zaXRvcnk4MzczMjgwNg==-flat-helper.py,1,15,14,1,15,14
64859,https://htmlpreview.github.io/?https://github.com/Christina96/boilerplate-sample-matches/blob/main/Python/yolact-MDEwOlJlcG9zaXRvcnkxMzg3OTY2OTk=-flat-make_grid.py-esptool-MDEwOlJlcG9zaXRvcnkyMzczNjkxNA==-flat-fields_2.py.html,0.021409455842997322,12,yolact-MDEwOlJlcG9zaXRvcnkxMzg3OTY2OTk=-flat-make_grid.py,esptool-MDEwOlJlcG9zaXRvcnkyMzczNjkxNA==-flat-fields_2.py,34,38,4,22,26,4
64983,https://htmlpreview.github.io/?https://github.com/Christina96/boilerplate-sample-matches/blob/main/Python/sonnet-MDEwOlJlcG9zaXRvcnk4NzA2NzIxMg==-flat-pad_test.py-seq2seq-MDEwOlJlcG9zaXRvcnk4MzczMjgwNg==-flat-models_test.py.html,0.17364341085271318,13,sonnet-MDEwOlJlcG9zaXRvcnk4NzA2NzIxMg==-flat-pad_test.py,seq2seq-MDEwOlJlcG9zaXRvcnk4MzczMjgwNg==-flat-models_test.py,7,8,1,105,110,5
65336,https://htmlpreview.github.io/?https://github.com/Christina96/boilerplate-sample-matches/blob/main/Python/sonnet-MDEwOlJlcG9zaXRvcnk4NzA2NzIxMg==-flat-optimizer_tests.py-esptool-MDEwOlJlcG9zaXRvcnkyMzczNjkxNA==-flat-base_operations.py.html,0.05401563610518834,9,sonnet-MDEwOlJlcG9zaXRvcnk4NzA2NzIxMg==-flat-optimizer_tests.py,esptool-MDEwOlJlcG9zaXRvcnkyMzczNjkxNA==-flat-base_operations.py,32,33,1,536,540,4
65441,https://htmlpreview.github.io/?https://github.com/Christina96/boilerplate-sample-matches/blob/main/Python/Ultroid-MDEwOlJlcG9zaXRvcnkzNDEwMzg2MDI=-flat-stickermanager.py-seq2seq-MDEwOlJlcG9zaXRvcnk4MzczMjgwNg==-flat-pipeline_test.py.html,0.12303290414878398,9,Ultroid-MDEwOlJlcG9zaXRvcnkzNDEwMzg2MDI=-flat-stickermanager.py,seq2seq-MDEwOlJlcG9zaXRvcnk4MzczMjgwNg==-flat-pipeline_test.py,94,97,3,41,43,2
65540,https://htmlpreview.github.io/?https://github.com/Christina96/boilerplate-sample-matches/blob/main/Python/sonnet-MDEwOlJlcG9zaXRvcnk4NzA2NzIxMg==-flat-conv_transpose_test.py-esptool-MDEwOlJlcG9zaXRvcnkyMzczNjkxNA==-flat-cmds.py.html,0.030914555603263203,9,sonnet-MDEwOlJlcG9zaXRvcnk4NzA2NzIxMg==-flat-conv_transpose_test.py,esptool-MDEwOlJlcG9zaXRvcnkyMzczNjkxNA==-flat-cmds.py,37,39,2,434,439,5
65589,https://htmlpreview.github.io/?https://github.com/Christina96/boilerplate-sample-matches/blob/main/Python/esphome-docs-MDEwOlJlcG9zaXRvcnkxMzMyMjM0NjE=-flat-github.py-yolact-MDEwOlJlcG9zaXRvcnkxMzg3OTY2OTk=-flat-backbone.py.html,0.08276899924755456,13,esphome-docs-MDEwOlJlcG9zaXRvcnkxMzMyMjM0NjE=-flat-github.py,yolact-MDEwOlJlcG9zaXRvcnkxMzg3OTY2OTk=-flat-backbone.py,182,185,3,89,93,4
65636,https://htmlpreview.github.io/?https://github.com/Christina96/boilerplate-sample-matches/blob/main/Python/yolact-MDEwOlJlcG9zaXRvcnkxMzg3OTY2OTk=-flat-box_utils.py-yolact-MDEwOlJlcG9zaXRvcnkxMzg3OTY2OTk=-flat-augmentations.py.html,0.1738095238095238,16,yolact-MDEwOlJlcG9zaXRvcnkxMzg3OTY2OTk=-flat-box_utils.py,yolact-MDEwOlJlcG9zaXRvcnkxMzg3OTY2OTk=-flat-augmentations.py,36,40,4,9,12,3
65649,https://htmlpreview.github.io/?https://github.com/Christina96/boilerplate-sample-matches/blob/main/Python/Ultroid-MDEwOlJlcG9zaXRvcnkzNDEwMzg2MDI=-flat-_userlogs.py-esptool-MDEwOlJlcG9zaXRvcnkyMzczNjkxNA==-flat-cmds.py.html,0.023778071334214,9,Ultroid-MDEwOlJlcG9zaXRvcnkzNDEwMzg2MDI=-flat-_userlogs.py,esptool-MDEwOlJlcG9zaXRvcnkyMzczNjkxNA==-flat-cmds.py,37,40,3,194,201,7
65805,https://htmlpreview.github.io/?https://github.com/Christina96/boilerplate-sample-matches/blob/main/Python/Ultroid-MDEwOlJlcG9zaXRvcnkzNDEwMzg2MDI=-flat-helper.py-esptool-MDEwOlJlcG9zaXRvcnkyMzczNjkxNA==-flat-loader.py.html,0.04150268336314848,9,Ultroid-MDEwOlJlcG9zaXRvcnkzNDEwMzg2MDI=-flat-helper.py,esptool-MDEwOlJlcG9zaXRvcnkyMzczNjkxNA==-flat-loader.py,230,233,3,807,808,1
65835,https://htmlpreview.github.io/?https://github.com/Christina96/boilerplate-sample-matches/blob/main/Python/Ultroid-MDEwOlJlcG9zaXRvcnkzNDEwMzg2MDI=-flat-qrcode.py-yolact-MDEwOlJlcG9zaXRvcnkxMzg3OTY2OTk=-flat-multibox_loss.py.html,0.0976271186440678,14,Ultroid-MDEwOlJlcG9zaXRvcnkzNDEwMzg2MDI=-flat-qrcode.py,yolact-MDEwOlJlcG9zaXRvcnkxMzg3OTY2OTk=-flat-multibox_loss.py,51,55,4,32,35,3
66112,https://htmlpreview.github.io/?https://github.com/Christina96/boilerplate-sample-matches/blob/main/Python/seq2seq-MDEwOlJlcG9zaXRvcnk4MzczMjgwNg==-flat-dump_attention.py-yolact-MDEwOlJlcG9zaXRvcnkxMzg3OTY2OTk=-flat-bbox_recall.py.html,0.05161290322580645,12,seq2seq-MDEwOlJlcG9zaXRvcnk4MzczMjgwNg==-flat-dump_attention.py,yolact-MDEwOlJlcG9zaXRvcnkxMzg3OTY2OTk=-flat-bbox_recall.py,26,28,2,86,88,2
66567,https://htmlpreview.github.io/?https://github.com/Christina96/boilerplate-sample-matches/blob/main/Python/sonnet-MDEwOlJlcG9zaXRvcnk4NzA2NzIxMg==-flat-utils_test.py-sonnet-MDEwOlJlcG9zaXRvcnk4NzA2NzIxMg==-flat-axis_norm_test.py.html,0.07796101949025487,12,sonnet-MDEwOlJlcG9zaXRvcnk4NzA2NzIxMg==-flat-utils_test.py,sonnet-MDEwOlJlcG9zaXRvcnk4NzA2NzIxMg==-flat-axis_norm_test.py,174,180,6,222,229,7
66629,https://htmlpreview.github.io/?https://github.com/Christina96/boilerplate-sample-matches/blob/main/Python/practical-python-MDEwOlJlcG9zaXRvcnkyNjY2MTM3MDQ=-flat-follow_64.py-practical-python-MDEwOlJlcG9zaXRvcnkyNjY2MTM3MDQ=-flat-follow_1.py.html,1.0,21,practical-python-MDEwOlJlcG9zaXRvcnkyNjY2MTM3MDQ=-flat-follow_64.py,practical-python-MDEwOlJlcG9zaXRvcnkyNjY2MTM3MDQ=-flat-follow_1.py,1,11,10,1,11,10
66806,https://htmlpreview.github.io/?https://github.com/Christina96/boilerplate-sample-matches/blob/main/Python/Ultroid-MDEwOlJlcG9zaXRvcnkzNDEwMzg2MDI=-flat-downloadupload.py-Ultroid-MDEwOlJlcG9zaXRvcnkzNDEwMzg2MDI=-flat-tools.py.html,0.024390243902439025,10,Ultroid-MDEwOlJlcG9zaXRvcnkzNDEwMzg2MDI=-flat-downloadupload.py,Ultroid-MDEwOlJlcG9zaXRvcnkzNDEwMzg2MDI=-flat-tools.py,3,12,9,1,10,9
66860,https://htmlpreview.github.io/?https://github.com/Christina96/boilerplate-sample-matches/blob/main/Python/Ultroid-MDEwOlJlcG9zaXRvcnkzNDEwMzg2MDI=-flat-_decorators.py-Ultroid-MDEwOlJlcG9zaXRvcnkzNDEwMzg2MDI=-flat-specialtools.py.html,0.14328358208955225,10,Ultroid-MDEwOlJlcG9zaXRvcnkzNDEwMzg2MDI=-flat-_decorators.py,Ultroid-MDEwOlJlcG9zaXRvcnkzNDEwMzg2MDI=-flat-specialtools.py,41,44,3,108,111,3
67081,https://htmlpreview.github.io/?https://github.com/Christina96/boilerplate-sample-matches/blob/main/Python/Ultroid-MDEwOlJlcG9zaXRvcnkzNDEwMzg2MDI=-flat-usage.py-esptool-MDEwOlJlcG9zaXRvcnkyMzczNjkxNA==-flat-esp32c3.py.html,0.036072144288577156,9,Ultroid-MDEwOlJlcG9zaXRvcnkzNDEwMzg2MDI=-flat-usage.py,esptool-MDEwOlJlcG9zaXRvcnkyMzczNjkxNA==-flat-esp32c3.py,49,51,2,100,102,2
67228,https://htmlpreview.github.io/?https://github.com/Christina96/boilerplate-sample-matches/blob/main/Python/Ultroid-MDEwOlJlcG9zaXRvcnkzNDEwMzg2MDI=-flat-_decorators.py-sonnet-MDEwOlJlcG9zaXRvcnk4NzA2NzIxMg==-flat-rmsprop_test.py.html,0.1222879684418146,10,Ultroid-MDEwOlJlcG9zaXRvcnkzNDEwMzg2MDI=-flat-_decorators.py,sonnet-MDEwOlJlcG9zaXRvcnk4NzA2NzIxMg==-flat-rmsprop_test.py,289,292,3,40,43,3
67433,https://htmlpreview.github.io/?https://github.com/Christina96/boilerplate-sample-matches/blob/main/Python/Ultroid-MDEwOlJlcG9zaXRvcnkzNDEwMzg2MDI=-flat-utils.py-google-api-python-client-MDEwOlJlcG9zaXRvcnkxNTc0OTI2OQ==-flat-test_http.py.html,0.030445813700616164,9,Ultroid-MDEwOlJlcG9zaXRvcnkzNDEwMzg2MDI=-flat-utils.py,google-api-python-client-MDEwOlJlcG9zaXRvcnkxNTc0OTI2OQ==-flat-test_http.py,23,31,8,4,12,8
68407,https://htmlpreview.github.io/?https://github.com/Christina96/boilerplate-sample-matches/blob/main/Python/wxpy-MDEwOlJlcG9zaXRvcnk4MjU4ODU5Nw==-flat-chats.py-yolact-MDEwOlJlcG9zaXRvcnkxMzg3OTY2OTk=-flat-optimize_bboxes.py.html,0.03333333333333333,9,wxpy-MDEwOlJlcG9zaXRvcnk4MjU4ODU5Nw==-flat-chats.py,yolact-MDEwOlJlcG9zaXRvcnkxMzg3OTY2OTk=-flat-optimize_bboxes.py,84,87,3,12,14,2
68943,https://htmlpreview.github.io/?https://github.com/Christina96/boilerplate-sample-matches/blob/main/Python/google-api-python-client-MDEwOlJlcG9zaXRvcnkxNTc0OTI2OQ==-flat-hello_analytics_api_v3.py-esptool-MDEwOlJlcG9zaXRvcnkyMzczNjkxNA==-flat-operations_5.py.html,0.022249690976514216,9,google-api-python-client-MDEwOlJlcG9zaXRvcnkxNTc0OTI2OQ==-flat-hello_analytics_api_v3.py,esptool-MDEwOlJlcG9zaXRvcnkyMzczNjkxNA==-flat-operations_5.py,62,68,6,80,88,8
69396,https://htmlpreview.github.io/?https://github.com/Christina96/boilerplate-sample-matches/blob/main/Python/sonnet-MDEwOlJlcG9zaXRvcnk4NzA2NzIxMg==-flat-momentum_test.py-sonnet-MDEwOlJlcG9zaXRvcnk4NzA2NzIxMg==-flat-reshape_test.py.html,0.16753022452504318,9,sonnet-MDEwOlJlcG9zaXRvcnk4NzA2NzIxMg==-flat-momentum_test.py,sonnet-MDEwOlJlcG9zaXRvcnk4NzA2NzIxMg==-flat-reshape_test.py,108,110,2,150,152,2
69512,https://htmlpreview.github.io/?https://github.com/Christina96/boilerplate-sample-matches/blob/main/Python/practical-python-MDEwOlJlcG9zaXRvcnkyNjY2MTM3MDQ=-flat-report_31.py-practical-python-MDEwOlJlcG9zaXRvcnkyNjY2MTM3MDQ=-flat-report.py.html,0.8089887640449438,72,practical-python-MDEwOlJlcG9zaXRvcnkyNjY2MTM3MDQ=-flat-report_31.py,practical-python-MDEwOlJlcG9zaXRvcnkyNjY2MTM3MDQ=-flat-report.py,5,36,31,5,40,35
70143,https://htmlpreview.github.io/?https://github.com/Christina96/boilerplate-sample-matches/blob/main/Python/yolact-MDEwOlJlcG9zaXRvcnkxMzg3OTY2OTk=-flat-multibox_loss.py-google-api-python-client-MDEwOlJlcG9zaXRvcnkxNTc0OTI2OQ==-flat-test_discovery.py.html,0.11213850088530396,9,yolact-MDEwOlJlcG9zaXRvcnkxMzg3OTY2OTk=-flat-multibox_loss.py,google-api-python-client-MDEwOlJlcG9zaXRvcnkxNTc0OTI2OQ==-flat-test_discovery.py,159,161,2,618,620,2
70188,https://htmlpreview.github.io/?https://github.com/Christina96/boilerplate-sample-matches/blob/main/Python/esptool-MDEwOlJlcG9zaXRvcnkyMzczNjkxNA==-flat-__init___50.py-esptool-MDEwOlJlcG9zaXRvcnkyMzczNjkxNA==-flat-bin_image.py.html,0.0544069640914037,9,esptool-MDEwOlJlcG9zaXRvcnkyMzczNjkxNA==-flat-__init___50.py,esptool-MDEwOlJlcG9zaXRvcnkyMzczNjkxNA==-flat-bin_image.py,14,19,5,8,26,18
70299,https://htmlpreview.github.io/?https://github.com/Christina96/boilerplate-sample-matches/blob/main/Python/yolact-MDEwOlJlcG9zaXRvcnkxMzg3OTY2OTk=-flat-multibox_loss.py-esptool-MDEwOlJlcG9zaXRvcnkyMzczNjkxNA==-flat-__init___48.py.html,0.1433057379389095,9,yolact-MDEwOlJlcG9zaXRvcnkxMzg3OTY2OTk=-flat-multibox_loss.py,esptool-MDEwOlJlcG9zaXRvcnkyMzczNjkxNA==-flat-__init___48.py,196,198,2,358,361,3
70881,https://htmlpreview.github.io/?https://github.com/Christina96/boilerplate-sample-matches/blob/main/Python/esptool-MDEwOlJlcG9zaXRvcnkyMzczNjkxNA==-flat-fields_17.py-esptool-MDEwOlJlcG9zaXRvcnkyMzczNjkxNA==-flat-base_fields.py.html,0.03641590800191662,11,esptool-MDEwOlJlcG9zaXRvcnkyMzczNjkxNA==-flat-fields_17.py,esptool-MDEwOlJlcG9zaXRvcnkyMzczNjkxNA==-flat-base_fields.py,182,187,5,346,354,8
71076,https://htmlpreview.github.io/?https://github.com/Christina96/boilerplate-sample-matches/blob/main/Python/esptool-MDEwOlJlcG9zaXRvcnkyMzczNjkxNA==-flat-mem_definition_11.py-Ultroid-MDEwOlJlcG9zaXRvcnkzNDEwMzg2MDI=-flat-tools_13.py.html,0.045881126173096975,11,esptool-MDEwOlJlcG9zaXRvcnkyMzczNjkxNA==-flat-mem_definition_11.py,Ultroid-MDEwOlJlcG9zaXRvcnkzNDEwMzg2MDI=-flat-tools_13.py,36,45,9,185,196,11
71973,https://htmlpreview.github.io/?https://github.com/Christina96/boilerplate-sample-matches/blob/main/Python/seq2seq-MDEwOlJlcG9zaXRvcnk4MzczMjgwNg==-flat-dump_beams.py-esptool-MDEwOlJlcG9zaXRvcnkyMzczNjkxNA==-flat-fields_27.py.html,0.020594965675057208,9,seq2seq-MDEwOlJlcG9zaXRvcnk4MzczMjgwNg==-flat-dump_beams.py,esptool-MDEwOlJlcG9zaXRvcnkyMzczNjkxNA==-flat-fields_27.py,38,42,4,133,134,1
72594,https://htmlpreview.github.io/?https://github.com/Christina96/boilerplate-sample-matches/blob/main/Python/Ultroid-MDEwOlJlcG9zaXRvcnkzNDEwMzg2MDI=-flat-funcs.py-Ultroid-MDEwOlJlcG9zaXRvcnkzNDEwMzg2MDI=-flat-pmpermit.py.html,0.09075342465753425,9,Ultroid-MDEwOlJlcG9zaXRvcnkzNDEwMzg2MDI=-flat-funcs.py,Ultroid-MDEwOlJlcG9zaXRvcnkzNDEwMzg2MDI=-flat-pmpermit.py,255,263,8,190,198,8
72648,https://htmlpreview.github.io/?https://github.com/Christina96/boilerplate-sample-matches/blob/main/Python/sonnet-MDEwOlJlcG9zaXRvcnk4NzA2NzIxMg==-flat-axis_norm.py-sonnet-MDEwOlJlcG9zaXRvcnk4NzA2NzIxMg==-flat-conv.py.html,0.31899641577060933,10,sonnet-MDEwOlJlcG9zaXRvcnk4NzA2NzIxMg==-flat-axis_norm.py,sonnet-MDEwOlJlcG9zaXRvcnk4NzA2NzIxMg==-flat-conv.py,32,35,3,38,41,3
72933,https://htmlpreview.github.io/?https://github.com/Christina96/boilerplate-sample-matches/blob/main/Python/Ultroid-MDEwOlJlcG9zaXRvcnkzNDEwMzg2MDI=-flat-admins_6.py-esptool-MDEwOlJlcG9zaXRvcnkyMzczNjkxNA==-flat-test_espsecure_hsm.py.html,0.07191780821917808,10,Ultroid-MDEwOlJlcG9zaXRvcnkzNDEwMzg2MDI=-flat-admins_6.py,esptool-MDEwOlJlcG9zaXRvcnkyMzczNjkxNA==-flat-test_espsecure_hsm.py,31,33,2,177,183,6
73323,https://htmlpreview.github.io/?https://github.com/Christina96/boilerplate-sample-matches/blob/main/Python/seq2seq-MDEwOlJlcG9zaXRvcnk4MzczMjgwNg==-flat-losses_test.py-Ultroid-MDEwOlJlcG9zaXRvcnkzNDEwMzg2MDI=-flat-admins_6.py.html,0.10410958904109589,10,seq2seq-MDEwOlJlcG9zaXRvcnk4MzczMjgwNg==-flat-losses_test.py,Ultroid-MDEwOlJlcG9zaXRvcnkzNDEwMzg2MDI=-flat-admins_6.py,26,27,1,37,40,3
73377,https://htmlpreview.github.io/?https://github.com/Christina96/boilerplate-sample-matches/blob/main/Python/Ultroid-MDEwOlJlcG9zaXRvcnkzNDEwMzg2MDI=-flat-gDrive.py-seq2seq-MDEwOlJlcG9zaXRvcnk4MzczMjgwNg==-flat-helper.py.html,0.06621392190152801,9,Ultroid-MDEwOlJlcG9zaXRvcnkzNDEwMzg2MDI=-flat-gDrive.py,seq2seq-MDEwOlJlcG9zaXRvcnk4MzczMjgwNg==-flat-helper.py,168,174,6,156,161,5
73489,https://htmlpreview.github.io/?https://github.com/Christina96/boilerplate-sample-matches/blob/main/Python/esptool-MDEwOlJlcG9zaXRvcnkyMzczNjkxNA==-flat-operations_25.py-Ultroid-MDEwOlJlcG9zaXRvcnkzNDEwMzg2MDI=-flat-funcs.py.html,0.028241335044929396,13,esptool-MDEwOlJlcG9zaXRvcnkyMzczNjkxNA==-flat-operations_25.py,Ultroid-MDEwOlJlcG9zaXRvcnkzNDEwMzg2MDI=-flat-funcs.py,53,63,10,420,428,8
73796,https://htmlpreview.github.io/?https://github.com/Christina96/boilerplate-sample-matches/blob/main/Python/seq2seq-MDEwOlJlcG9zaXRvcnk4MzczMjgwNg==-flat-data_test.py-seq2seq-MDEwOlJlcG9zaXRvcnk4MzczMjgwNg==-flat-seq2seq_model.py.html,0.10222804718217562,10,seq2seq-MDEwOlJlcG9zaXRvcnk4MzczMjgwNg==-flat-data_test.py,seq2seq-MDEwOlJlcG9zaXRvcnk4MzczMjgwNg==-flat-seq2seq_model.py,1,10,9,6,15,9
73968,https://htmlpreview.github.io/?https://github.com/Christina96/boilerplate-sample-matches/blob/main/Python/sonnet-MDEwOlJlcG9zaXRvcnk4NzA2NzIxMg==-flat-linear_test.py-yolact-MDEwOlJlcG9zaXRvcnkxMzg3OTY2OTk=-flat-augmentations.py.html,0.03982016698779704,10,sonnet-MDEwOlJlcG9zaXRvcnk4NzA2NzIxMg==-flat-linear_test.py,yolact-MDEwOlJlcG9zaXRvcnkxMzg3OTY2OTk=-flat-augmentations.py,59,63,4,241,244,3
74034,https://htmlpreview.github.io/?https://github.com/Christina96/boilerplate-sample-matches/blob/main/Python/Ultroid-MDEwOlJlcG9zaXRvcnkzNDEwMzg2MDI=-flat-gdrive_16.py-esptool-MDEwOlJlcG9zaXRvcnkyMzczNjkxNA==-flat-operations_25.py.html,0.017716535433070866,9,Ultroid-MDEwOlJlcG9zaXRvcnkzNDEwMzg2MDI=-flat-gdrive_16.py,esptool-MDEwOlJlcG9zaXRvcnkyMzczNjkxNA==-flat-operations_25.py,75,80,5,228,232,4
74082,https://htmlpreview.github.io/?https://github.com/Christina96/boilerplate-sample-matches/blob/main/Python/google-api-python-client-MDEwOlJlcG9zaXRvcnkxNTc0OTI2OQ==-flat-channel.py-seq2seq-MDEwOlJlcG9zaXRvcnk4MzczMjgwNg==-flat-attention_decoder.py.html,0.06933333333333333,13,google-api-python-client-MDEwOlJlcG9zaXRvcnkxNTc0OTI2OQ==-flat-channel.py,seq2seq-MDEwOlJlcG9zaXRvcnk4MzczMjgwNg==-flat-attention_decoder.py,36,54,18,16,32,16
74112,https://htmlpreview.github.io/?https://github.com/Christina96/boilerplate-sample-matches/blob/main/Python/google-api-python-client-MDEwOlJlcG9zaXRvcnkxNTc0OTI2OQ==-flat-get_all_preferred_deals.py-google-api-python-client-MDEwOlJlcG9zaXRvcnkxNTc0OTI2OQ==-flat-blogger.py.html,0.296875,9,google-api-python-client-MDEwOlJlcG9zaXRvcnkxNTc0OTI2OQ==-flat-get_all_preferred_deals.py,google-api-python-client-MDEwOlJlcG9zaXRvcnkxNTc0OTI2OQ==-flat-blogger.py,7,39,32,7,40,33
74326,https://htmlpreview.github.io/?https://github.com/Christina96/boilerplate-sample-matches/blob/main/Python/seq2seq-MDEwOlJlcG9zaXRvcnk4MzczMjgwNg==-flat-beam_search_decoder.py-yolact-MDEwOlJlcG9zaXRvcnkxMzg3OTY2OTk=-flat-coco.py.html,0.056338028169014086,9,seq2seq-MDEwOlJlcG9zaXRvcnk4MzczMjgwNg==-flat-beam_search_decoder.py,yolact-MDEwOlJlcG9zaXRvcnkxMzg3OTY2OTk=-flat-coco.py,1,9,8,1,9,8
74398,https://htmlpreview.github.io/?https://github.com/Christina96/boilerplate-sample-matches/blob/main/Python/Ultroid-MDEwOlJlcG9zaXRvcnkzNDEwMzg2MDI=-flat-misc_3.py-sonnet-MDEwOlJlcG9zaXRvcnk4NzA2NzIxMg==-flat-initializers_test.py.html,0.04308985811875985,10,Ultroid-MDEwOlJlcG9zaXRvcnkzNDEwMzg2MDI=-flat-misc_3.py,sonnet-MDEwOlJlcG9zaXRvcnk4NzA2NzIxMg==-flat-initializers_test.py,54,98,44,115,125,10
74668,https://htmlpreview.github.io/?https://github.com/Christina96/boilerplate-sample-matches/blob/main/Python/sonnet-MDEwOlJlcG9zaXRvcnk4NzA2NzIxMg==-flat-simple_mnist_test.py-seq2seq-MDEwOlJlcG9zaXRvcnk4MzczMjgwNg==-flat-losses_test.py.html,0.0966183574879227,10,sonnet-MDEwOlJlcG9zaXRvcnk4NzA2NzIxMg==-flat-simple_mnist_test.py,seq2seq-MDEwOlJlcG9zaXRvcnk4MzczMjgwNg==-flat-losses_test.py,15,17,2,29,30,1
74834,https://htmlpreview.github.io/?https://github.com/Christina96/boilerplate-sample-matches/blob/main/Python/seq2seq-MDEwOlJlcG9zaXRvcnk4MzczMjgwNg==-flat-inference_task.py-sonnet-MDEwOlJlcG9zaXRvcnk4NzA2NzIxMg==-flat-momentum.py.html,0.10650887573964497,9,seq2seq-MDEwOlJlcG9zaXRvcnk4MzczMjgwNg==-flat-inference_task.py,sonnet-MDEwOlJlcG9zaXRvcnk4NzA2NzIxMg==-flat-momentum.py,3,11,8,1,9,8
74925,https://htmlpreview.github.io/?https://github.com/Christina96/boilerplate-sample-matches/blob/main/Python/seq2seq-MDEwOlJlcG9zaXRvcnk4MzczMjgwNg==-flat-example_config_test.py-esptool-MDEwOlJlcG9zaXRvcnkyMzczNjkxNA==-flat-esp_rfc2217_server.py.html,0.0446927374301676,12,seq2seq-MDEwOlJlcG9zaXRvcnk4MzczMjgwNg==-flat-example_config_test.py,esptool-MDEwOlJlcG9zaXRvcnkyMzczNjkxNA==-flat-esp_rfc2217_server.py,1,12,11,2,20,18
75145,https://htmlpreview.github.io/?https://github.com/Christina96/boilerplate-sample-matches/blob/main/Python/seq2seq-MDEwOlJlcG9zaXRvcnk4MzczMjgwNg==-flat-dump_attention.py-sonnet-MDEwOlJlcG9zaXRvcnk4NzA2NzIxMg==-flat-pad_test.py.html,0.13145539906103287,9,seq2seq-MDEwOlJlcG9zaXRvcnk4MzczMjgwNg==-flat-dump_attention.py,sonnet-MDEwOlJlcG9zaXRvcnk4NzA2NzIxMg==-flat-pad_test.py,20,23,3,42,45,3
75629,https://htmlpreview.github.io/?https://github.com/Christina96/boilerplate-sample-matches/blob/main/Python/yolact-MDEwOlJlcG9zaXRvcnkxMzg3OTY2OTk=-flat-backbone.py-Ultroid-MDEwOlJlcG9zaXRvcnkzNDEwMzg2MDI=-flat-inlinestuff.py.html,0.05357142857142857,10,yolact-MDEwOlJlcG9zaXRvcnkxMzg3OTY2OTk=-flat-backbone.py,Ultroid-MDEwOlJlcG9zaXRvcnkzNDEwMzg2MDI=-flat-inlinestuff.py,58,59,1,361,363,2
75742,https://htmlpreview.github.io/?https://github.com/Christina96/boilerplate-sample-matches/blob/main/Python/sonnet-MDEwOlJlcG9zaXRvcnk4NzA2NzIxMg==-flat-dropout_test.py-Ultroid-MDEwOlJlcG9zaXRvcnkzNDEwMzg2MDI=-flat-pmpermit.py.html,0.03430749682337993,9,sonnet-MDEwOlJlcG9zaXRvcnk4NzA2NzIxMg==-flat-dropout_test.py,Ultroid-MDEwOlJlcG9zaXRvcnkzNDEwMzg2MDI=-flat-pmpermit.py,22,24,2,471,472,1
75795,https://htmlpreview.github.io/?https://github.com/Christina96/boilerplate-sample-matches/blob/main/Python/practical-python-MDEwOlJlcG9zaXRvcnkyNjY2MTM3MDQ=-flat-report_15.py-practical-python-MDEwOlJlcG9zaXRvcnkyNjY2MTM3MDQ=-flat-report_61.py.html,0.5238095238095238,13,practical-python-MDEwOlJlcG9zaXRvcnkyNjY2MTM3MDQ=-flat-report_15.py,practical-python-MDEwOlJlcG9zaXRvcnkyNjY2MTM3MDQ=-flat-report_61.py,24,33,9,27,35,8
75939,https://htmlpreview.github.io/?https://github.com/Christina96/boilerplate-sample-matches/blob/main/Python/sonnet-MDEwOlJlcG9zaXRvcnk4NzA2NzIxMg==-flat-axis_norm_test.py-esptool-MDEwOlJlcG9zaXRvcnkyMzczNjkxNA==-flat-operations_35.py.html,0.09314703925482369,9,sonnet-MDEwOlJlcG9zaXRvcnk4NzA2NzIxMg==-flat-axis_norm_test.py,esptool-MDEwOlJlcG9zaXRvcnkyMzczNjkxNA==-flat-operations_35.py,223,225,2,55,61,6
76061,https://htmlpreview.github.io/?https://github.com/Christina96/boilerplate-sample-matches/blob/main/Python/google-api-python-client-MDEwOlJlcG9zaXRvcnkxNTc0OTI2OQ==-flat-core_reporting_v3_reference.py-sonnet-MDEwOlJlcG9zaXRvcnk4NzA2NzIxMg==-flat-conv.py.html,0.04460966542750929,12,google-api-python-client-MDEwOlJlcG9zaXRvcnkxNTc0OTI2OQ==-flat-core_reporting_v3_reference.py,sonnet-MDEwOlJlcG9zaXRvcnk4NzA2NzIxMg==-flat-conv.py,48,58,10,99,108,9
76804,https://htmlpreview.github.io/?https://github.com/Christina96/boilerplate-sample-matches/blob/main/Python/google-api-python-client-MDEwOlJlcG9zaXRvcnkxNTc0OTI2OQ==-flat-management_v3_reference.py-esptool-MDEwOlJlcG9zaXRvcnkyMzczNjkxNA==-flat-loader.py.html,0.015,9,google-api-python-client-MDEwOlJlcG9zaXRvcnkxNTc0OTI2OQ==-flat-management_v3_reference.py,esptool-MDEwOlJlcG9zaXRvcnkyMzczNjkxNA==-flat-loader.py,37,41,4,807,808,1
76879,https://htmlpreview.github.io/?https://github.com/Christina96/boilerplate-sample-matches/blob/main/Python/Ultroid-MDEwOlJlcG9zaXRvcnkzNDEwMzg2MDI=-flat-__init__.py-sonnet-MDEwOlJlcG9zaXRvcnk4NzA2NzIxMg==-flat-haiku.py.html,0.03237410071942446,9,Ultroid-MDEwOlJlcG9zaXRvcnkzNDEwMzg2MDI=-flat-__init__.py,sonnet-MDEwOlJlcG9zaXRvcnk4NzA2NzIxMg==-flat-haiku.py,3,10,7,1,8,7
77696,https://htmlpreview.github.io/?https://github.com/Christina96/boilerplate-sample-matches/blob/main/Python/Ultroid-MDEwOlJlcG9zaXRvcnkzNDEwMzg2MDI=-flat-forcesub_db.py-Ultroid-MDEwOlJlcG9zaXRvcnkzNDEwMzg2MDI=-flat-nsfw_db.py.html,0.3448275862068966,20,Ultroid-MDEwOlJlcG9zaXRvcnkzNDEwMzg2MDI=-flat-forcesub_db.py,Ultroid-MDEwOlJlcG9zaXRvcnkzNDEwMzg2MDI=-flat-nsfw_db.py,2,10,8,2,10,8
78683,https://htmlpreview.github.io/?https://github.com/Christina96/boilerplate-sample-matches/blob/main/Python/esptool-MDEwOlJlcG9zaXRvcnkyMzczNjkxNA==-flat-execute_efuse_script2_43.py-esptool-MDEwOlJlcG9zaXRvcnkyMzczNjkxNA==-flat-fields_12.py.html,0.021634615384615384,9,esptool-MDEwOlJlcG9zaXRvcnkyMzczNjkxNA==-flat-execute_efuse_script2_43.py,esptool-MDEwOlJlcG9zaXRvcnkyMzczNjkxNA==-flat-fields_12.py,1,3,2,225,227,2
78853,https://htmlpreview.github.io/?https://github.com/Christina96/boilerplate-sample-matches/blob/main/Python/Ultroid-MDEwOlJlcG9zaXRvcnkzNDEwMzg2MDI=-flat-resize.py-Ultroid-MDEwOlJlcG9zaXRvcnkzNDEwMzg2MDI=-flat-imagetools.py.html,0.12052117263843648,14,Ultroid-MDEwOlJlcG9zaXRvcnkzNDEwMzg2MDI=-flat-resize.py,Ultroid-MDEwOlJlcG9zaXRvcnkzNDEwMzg2MDI=-flat-imagetools.py,3,20,17,139,176,37
79257,https://htmlpreview.github.io/?https://github.com/Christina96/boilerplate-sample-matches/blob/main/Python/yolact-MDEwOlJlcG9zaXRvcnkxMzg3OTY2OTk=-flat-box_utils.py-esptool-MDEwOlJlcG9zaXRvcnkyMzczNjkxNA==-flat-operations_30.py.html,0.04678362573099415,9,yolact-MDEwOlJlcG9zaXRvcnkxMzg3OTY2OTk=-flat-box_utils.py,esptool-MDEwOlJlcG9zaXRvcnkyMzczNjkxNA==-flat-operations_30.py,124,126,2,272,277,5
79346,https://htmlpreview.github.io/?https://github.com/Christina96/boilerplate-sample-matches/blob/main/Python/sonnet-MDEwOlJlcG9zaXRvcnk4NzA2NzIxMg==-flat-setup.py-Ultroid-MDEwOlJlcG9zaXRvcnkzNDEwMzg2MDI=-flat-globaltools.py.html,0.013215859030837005,9,sonnet-MDEwOlJlcG9zaXRvcnk4NzA2NzIxMg==-flat-setup.py,Ultroid-MDEwOlJlcG9zaXRvcnkzNDEwMzg2MDI=-flat-globaltools.py,19,27,8,32,40,8
79501,https://htmlpreview.github.io/?https://github.com/Christina96/boilerplate-sample-matches/blob/main/Python/seq2seq-MDEwOlJlcG9zaXRvcnk4MzczMjgwNg==-flat-beam_search_test.py-sonnet-MDEwOlJlcG9zaXRvcnk4NzA2NzIxMg==-flat-conv_test.py.html,0.1113013698630137,9,seq2seq-MDEwOlJlcG9zaXRvcnk4MzczMjgwNg==-flat-beam_search_test.py,sonnet-MDEwOlJlcG9zaXRvcnk4NzA2NzIxMg==-flat-conv_test.py,72,74,2,127,128,1
79607,https://htmlpreview.github.io/?https://github.com/Christina96/boilerplate-sample-matches/blob/main/Python/google-api-python-client-MDEwOlJlcG9zaXRvcnkxNTc0OTI2OQ==-flat-groupsettings.py-yolact-MDEwOlJlcG9zaXRvcnkxMzg3OTY2OTk=-flat-optimize_bboxes.py.html,0.13934426229508196,15,google-api-python-client-MDEwOlJlcG9zaXRvcnkxNTc0OTI2OQ==-flat-groupsettings.py,yolact-MDEwOlJlcG9zaXRvcnkxMzg3OTY2OTk=-flat-optimize_bboxes.py,71,85,14,22,25,3
79669,https://htmlpreview.github.io/?https://github.com/Christina96/boilerplate-sample-matches/blob/main/Python/seq2seq-MDEwOlJlcG9zaXRvcnk4MzczMjgwNg==-flat-vocab_test.py-sonnet-MDEwOlJlcG9zaXRvcnk4NzA2NzIxMg==-flat-base.py.html,0.11390284757118928,11,seq2seq-MDEwOlJlcG9zaXRvcnk4MzczMjgwNg==-flat-vocab_test.py,sonnet-MDEwOlJlcG9zaXRvcnk4NzA2NzIxMg==-flat-base.py,11,14,3,82,85,3
79709,https://htmlpreview.github.io/?https://github.com/Christina96/boilerplate-sample-matches/blob/main/Python/seq2seq-MDEwOlJlcG9zaXRvcnk4MzczMjgwNg==-flat-rnn_cell_test.py-sonnet-MDEwOlJlcG9zaXRvcnk4NzA2NzIxMg==-flat-utils_test.py.html,0.05278592375366569,9,seq2seq-MDEwOlJlcG9zaXRvcnk4MzczMjgwNg==-flat-rnn_cell_test.py,sonnet-MDEwOlJlcG9zaXRvcnk4NzA2NzIxMg==-flat-utils_test.py,41,43,2,171,173,2
79936,https://htmlpreview.github.io/?https://github.com/Christina96/boilerplate-sample-matches/blob/main/Python/sonnet-MDEwOlJlcG9zaXRvcnk4NzA2NzIxMg==-flat-optimizer_tests.py-esptool-MDEwOlJlcG9zaXRvcnkyMzczNjkxNA==-flat-test_espefuse.py.html,0.03994154895275207,11,sonnet-MDEwOlJlcG9zaXRvcnk4NzA2NzIxMg==-flat-optimizer_tests.py,esptool-MDEwOlJlcG9zaXRvcnkyMzczNjkxNA==-flat-test_espefuse.py,64,67,3,764,771,7
80022,https://htmlpreview.github.io/?https://github.com/Christina96/boilerplate-sample-matches/blob/main/Python/esptool-MDEwOlJlcG9zaXRvcnkyMzczNjkxNA==-flat-fields_22.py-esptool-MDEwOlJlcG9zaXRvcnkyMzczNjkxNA==-flat-loader.py.html,0.044294294294294295,9,esptool-MDEwOlJlcG9zaXRvcnkyMzczNjkxNA==-flat-fields_22.py,esptool-MDEwOlJlcG9zaXRvcnkyMzczNjkxNA==-flat-loader.py,133,134,1,491,492,1
80331,https://htmlpreview.github.io/?https://github.com/Christina96/boilerplate-sample-matches/blob/main/Python/Ultroid-MDEwOlJlcG9zaXRvcnkzNDEwMzg2MDI=-flat-utils.py-yolact-MDEwOlJlcG9zaXRvcnkxMzg3OTY2OTk=-flat-detection.py.html,0.13360323886639677,10,Ultroid-MDEwOlJlcG9zaXRvcnkzNDEwMzg2MDI=-flat-utils.py,yolact-MDEwOlJlcG9zaXRvcnkxMzg3OTY2OTk=-flat-detection.py,66,69,3,87,91,4
80442,https://htmlpreview.github.io/?https://github.com/Christina96/boilerplate-sample-matches/blob/main/Python/sonnet-MDEwOlJlcG9zaXRvcnk4NzA2NzIxMg==-flat-haiku_test.py-sonnet-MDEwOlJlcG9zaXRvcnk4NzA2NzIxMg==-flat-base_test.py.html,0.08545994065281899,10,sonnet-MDEwOlJlcG9zaXRvcnk4NzA2NzIxMg==-flat-haiku_test.py,sonnet-MDEwOlJlcG9zaXRvcnk4NzA2NzIxMg==-flat-base_test.py,146,159,13,57,63,6
80446,https://htmlpreview.github.io/?https://github.com/Christina96/boilerplate-sample-matches/blob/main/Python/sonnet-MDEwOlJlcG9zaXRvcnk4NzA2NzIxMg==-flat-functional_mlp_mnist.py-yolact-MDEwOlJlcG9zaXRvcnkxMzg3OTY2OTk=-flat-multibox_loss.py.html,0.07213578500707214,12,sonnet-MDEwOlJlcG9zaXRvcnk4NzA2NzIxMg==-flat-functional_mlp_mnist.py,yolact-MDEwOlJlcG9zaXRvcnkxMzg3OTY2OTk=-flat-multibox_loss.py,48,51,3,140,143,3
80502,https://htmlpreview.github.io/?https://github.com/Christina96/boilerplate-sample-matches/blob/main/Python/seq2seq-MDEwOlJlcG9zaXRvcnk4MzczMjgwNg==-flat-attention_test.py-google-api-python-client-MDEwOlJlcG9zaXRvcnkxNTc0OTI2OQ==-flat-test_http.py.html,0.043227665706051875,10,seq2seq-MDEwOlJlcG9zaXRvcnk4MzczMjgwNg==-flat-attention_test.py,google-api-python-client-MDEwOlJlcG9zaXRvcnkxNTc0OTI2OQ==-flat-test_http.py,35,36,1,367,370,3
80515,https://htmlpreview.github.io/?https://github.com/Christina96/boilerplate-sample-matches/blob/main/Python/Ultroid-MDEwOlJlcG9zaXRvcnkzNDEwMzg2MDI=-flat-tools_13.py-esptool-MDEwOlJlcG9zaXRvcnkyMzczNjkxNA==-flat-operations_40.py.html,0.0280970625798212,11,Ultroid-MDEwOlJlcG9zaXRvcnkzNDEwMzg2MDI=-flat-tools_13.py,esptool-MDEwOlJlcG9zaXRvcnkyMzczNjkxNA==-flat-operations_40.py,164,166,2,267,271,4
80861,https://htmlpreview.github.io/?https://github.com/Christina96/boilerplate-sample-matches/blob/main/Python/Ultroid-MDEwOlJlcG9zaXRvcnkzNDEwMzg2MDI=-flat-sudo.py-sonnet-MDEwOlJlcG9zaXRvcnk4NzA2NzIxMg==-flat-group_norm_test.py.html,0.0400890868596882,9,Ultroid-MDEwOlJlcG9zaXRvcnkzNDEwMzg2MDI=-flat-sudo.py,sonnet-MDEwOlJlcG9zaXRvcnk4NzA2NzIxMg==-flat-group_norm_test.py,7,10,3,52,54,2
81083,https://htmlpreview.github.io/?https://github.com/Christina96/boilerplate-sample-matches/blob/main/Python/esptool-MDEwOlJlcG9zaXRvcnkyMzczNjkxNA==-flat-mem_definition_16.py-esphome-docs-MDEwOlJlcG9zaXRvcnkxMzMyMjM0NjE=-flat-schema_doc.py.html,0.08584114454859398,10,esptool-MDEwOlJlcG9zaXRvcnkyMzczNjkxNA==-flat-mem_definition_16.py,esphome-docs-MDEwOlJlcG9zaXRvcnkxMzMyMjM0NjE=-flat-schema_doc.py,76,79,3,825,827,2
81099,https://htmlpreview.github.io/?https://github.com/Christina96/boilerplate-sample-matches/blob/main/Python/Ultroid-MDEwOlJlcG9zaXRvcnkzNDEwMzg2MDI=-flat-snips.py-yolact-MDEwOlJlcG9zaXRvcnkxMzg3OTY2OTk=-flat-eval.py.html,0.015604681404421327,9,Ultroid-MDEwOlJlcG9zaXRvcnkzNDEwMzg2MDI=-flat-snips.py,yolact-MDEwOlJlcG9zaXRvcnkxMzg3OTY2OTk=-flat-eval.py,76,80,4,530,534,4
81131,https://htmlpreview.github.io/?https://github.com/Christina96/boilerplate-sample-matches/blob/main/Python/seq2seq-MDEwOlJlcG9zaXRvcnk4MzczMjgwNg==-flat-losses.py-esptool-MDEwOlJlcG9zaXRvcnkyMzczNjkxNA==-flat-emulate_efuse_controller_33.py.html,0.12578616352201258,10,seq2seq-MDEwOlJlcG9zaXRvcnk4MzczMjgwNg==-flat-losses.py,esptool-MDEwOlJlcG9zaXRvcnkyMzczNjkxNA==-flat-emulate_efuse_controller_33.py,9,10,1,31,35,4
81322,https://htmlpreview.github.io/?https://github.com/Christina96/boilerplate-sample-matches/blob/main/Python/sonnet-MDEwOlJlcG9zaXRvcnk4NzA2NzIxMg==-flat-control_test.py-sonnet-MDEwOlJlcG9zaXRvcnk4NzA2NzIxMg==-flat-rmsprop.py.html,0.06315789473684211,12,sonnet-MDEwOlJlcG9zaXRvcnk4NzA2NzIxMg==-flat-control_test.py,sonnet-MDEwOlJlcG9zaXRvcnk4NzA2NzIxMg==-flat-rmsprop.py,43,44,1,66,68,2
81462,https://htmlpreview.github.io/?https://github.com/Christina96/boilerplate-sample-matches/blob/main/Python/Ultroid-MDEwOlJlcG9zaXRvcnkzNDEwMzg2MDI=-flat-search.py-yolact-MDEwOlJlcG9zaXRvcnkxMzg3OTY2OTk=-flat-detection.py.html,0.06896551724137931,13,Ultroid-MDEwOlJlcG9zaXRvcnkzNDEwMzg2MDI=-flat-search.py,yolact-MDEwOlJlcG9zaXRvcnkxMzg3OTY2OTk=-flat-detection.py,29,35,6,19,25,6
81605,https://htmlpreview.github.io/?https://github.com/Christina96/boilerplate-sample-matches/blob/main/Python/esphome-docs-MDEwOlJlcG9zaXRvcnkxMzMyMjM0NjE=-flat-bump-version.py-Ultroid-MDEwOlJlcG9zaXRvcnkzNDEwMzg2MDI=-flat-tools.py.html,0.015161086544535692,12,esphome-docs-MDEwOlJlcG9zaXRvcnkxMzMyMjM0NjE=-flat-bump-version.py,Ultroid-MDEwOlJlcG9zaXRvcnkzNDEwMzg2MDI=-flat-tools.py,56,60,4,279,286,7
82249,https://htmlpreview.github.io/?https://github.com/Christina96/boilerplate-sample-matches/blob/main/Python/sonnet-MDEwOlJlcG9zaXRvcnk4NzA2NzIxMg==-flat-cifar10_convnet_test.py-esptool-MDEwOlJlcG9zaXRvcnkyMzczNjkxNA==-flat-fields_32.py.html,0.05622489959839357,9,sonnet-MDEwOlJlcG9zaXRvcnk4NzA2NzIxMg==-flat-cifar10_convnet_test.py,esptool-MDEwOlJlcG9zaXRvcnkyMzczNjkxNA==-flat-fields_32.py,40,41,1,52,54,2
82463,https://htmlpreview.github.io/?https://github.com/Christina96/boilerplate-sample-matches/blob/main/Python/sonnet-MDEwOlJlcG9zaXRvcnk4NzA2NzIxMg==-flat-control_test.py-Ultroid-MDEwOlJlcG9zaXRvcnkzNDEwMzg2MDI=-flat-_chatactions.py.html,0.06168831168831169,9,sonnet-MDEwOlJlcG9zaXRvcnk4NzA2NzIxMg==-flat-control_test.py,Ultroid-MDEwOlJlcG9zaXRvcnkzNDEwMzg2MDI=-flat-_chatactions.py,38,39,1,131,133,2
82523,https://htmlpreview.github.io/?https://github.com/Christina96/boilerplate-sample-matches/blob/main/Python/seq2seq-MDEwOlJlcG9zaXRvcnk4MzczMjgwNg==-flat-vocab_test.py-google-api-python-client-MDEwOlJlcG9zaXRvcnkxNTc0OTI2OQ==-flat-schema.py.html,0.092,9,seq2seq-MDEwOlJlcG9zaXRvcnk4MzczMjgwNg==-flat-vocab_test.py,google-api-python-client-MDEwOlJlcG9zaXRvcnkxNTc0OTI2OQ==-flat-schema.py,29,32,3,50,52,2
83747,https://htmlpreview.github.io/?https://github.com/Christina96/boilerplate-sample-matches/blob/main/Python/sonnet-MDEwOlJlcG9zaXRvcnk4NzA2NzIxMg==-flat-utils.py-yolact-MDEwOlJlcG9zaXRvcnkxMzg3OTY2OTk=-flat-yolact.py.html,0.021029330381848368,9,sonnet-MDEwOlJlcG9zaXRvcnk4NzA2NzIxMg==-flat-utils.py,yolact-MDEwOlJlcG9zaXRvcnkxMzg3OTY2OTk=-flat-yolact.py,53,55,2,83,85,2
83766,https://htmlpreview.github.io/?https://github.com/Christina96/boilerplate-sample-matches/blob/main/Python/esptool-MDEwOlJlcG9zaXRvcnkyMzczNjkxNA==-flat-conftest.py-seq2seq-MDEwOlJlcG9zaXRvcnk4MzczMjgwNg==-flat-beam_search.py.html,0.05934718100890208,10,esptool-MDEwOlJlcG9zaXRvcnkyMzczNjkxNA==-flat-conftest.py,seq2seq-MDEwOlJlcG9zaXRvcnk4MzczMjgwNg==-flat-beam_search.py,20,24,4,86,90,4
84070,https://htmlpreview.github.io/?https://github.com/Christina96/boilerplate-sample-matches/blob/main/Python/esptool-MDEwOlJlcG9zaXRvcnkyMzczNjkxNA==-flat-fields.py-sonnet-MDEwOlJlcG9zaXRvcnk4NzA2NzIxMg==-flat-conv_test.py.html,0.05568445475638051,9,esptool-MDEwOlJlcG9zaXRvcnkyMzczNjkxNA==-flat-fields.py,sonnet-MDEwOlJlcG9zaXRvcnk4NzA2NzIxMg==-flat-conv_test.py,227,236,9,202,237,35
84086,https://htmlpreview.github.io/?https://github.com/Christina96/boilerplate-sample-matches/blob/main/Python/Ultroid-MDEwOlJlcG9zaXRvcnkzNDEwMzg2MDI=-flat-botchat_db.py-yolact-MDEwOlJlcG9zaXRvcnkxMzg3OTY2OTk=-flat-convert_sbd.py.html,0.09473684210526316,9,Ultroid-MDEwOlJlcG9zaXRvcnkzNDEwMzg2MDI=-flat-botchat_db.py,yolact-MDEwOlJlcG9zaXRvcnkxMzg3OTY2OTk=-flat-convert_sbd.py,14,17,3,44,48,4
84159,https://htmlpreview.github.io/?https://github.com/Christina96/boilerplate-sample-matches/blob/main/Python/seq2seq-MDEwOlJlcG9zaXRvcnk4MzczMjgwNg==-flat-conv_encoder_test.py-yolact-MDEwOlJlcG9zaXRvcnkxMzg3OTY2OTk=-flat-bbox_recall.py.html,0.09375,9,seq2seq-MDEwOlJlcG9zaXRvcnk4MzczMjgwNg==-flat-conv_encoder_test.py,yolact-MDEwOlJlcG9zaXRvcnkxMzg3OTY2OTk=-flat-bbox_recall.py,27,30,3,33,33,0
84356,https://htmlpreview.github.io/?https://github.com/Christina96/boilerplate-sample-matches/blob/main/Python/practical-python-MDEwOlJlcG9zaXRvcnkyNjY2MTM3MDQ=-flat-stock_60.py-practical-python-MDEwOlJlcG9zaXRvcnkyNjY2MTM3MDQ=-flat-stock.py.html,0.3225806451612903,10,practical-python-MDEwOlJlcG9zaXRvcnkyNjY2MTM3MDQ=-flat-stock_60.py,practical-python-MDEwOlJlcG9zaXRvcnkyNjY2MTM3MDQ=-flat-stock.py,2,7,5,3,8,5
84618,https://htmlpreview.github.io/?https://github.com/Christina96/boilerplate-sample-matches/blob/main/Python/sonnet-MDEwOlJlcG9zaXRvcnk4NzA2NzIxMg==-flat-dropout_test.py-Ultroid-MDEwOlJlcG9zaXRvcnkzNDEwMzg2MDI=-flat-profile.py.html,0.04580152671755725,9,sonnet-MDEwOlJlcG9zaXRvcnk4NzA2NzIxMg==-flat-dropout_test.py,Ultroid-MDEwOlJlcG9zaXRvcnkzNDEwMzg2MDI=-flat-profile.py,10,13,3,8,9,1
84680,https://htmlpreview.github.io/?https://github.com/Christina96/boilerplate-sample-matches/blob/main/Python/Ultroid-MDEwOlJlcG9zaXRvcnkzNDEwMzg2MDI=-flat-ytdl.py-Ultroid-MDEwOlJlcG9zaXRvcnkzNDEwMzg2MDI=-flat-funcs.py.html,0.09015777610818933,9,Ultroid-MDEwOlJlcG9zaXRvcnkzNDEwMzg2MDI=-flat-ytdl.py,Ultroid-MDEwOlJlcG9zaXRvcnkzNDEwMzg2MDI=-flat-funcs.py,158,162,4,145,146,1
84898,https://htmlpreview.github.io/?https://github.com/Christina96/boilerplate-sample-matches/blob/main/Python/wxpy-MDEwOlJlcG9zaXRvcnk4MjU4ODU5Nw==-flat-console.py-esptool-MDEwOlJlcG9zaXRvcnkyMzczNjkxNA==-flat-base_operations.py.html,0.0352,9,wxpy-MDEwOlJlcG9zaXRvcnk4MjU4ODU5Nw==-flat-console.py,esptool-MDEwOlJlcG9zaXRvcnkyMzczNjkxNA==-flat-base_operations.py,52,56,4,47,54,7
85023,https://htmlpreview.github.io/?https://github.com/Christina96/boilerplate-sample-matches/blob/main/Python/seq2seq-MDEwOlJlcG9zaXRvcnk4MzczMjgwNg==-flat-rnn_encoder.py-esptool-MDEwOlJlcG9zaXRvcnkyMzczNjkxNA==-flat-emulate_efuse_controller_base.py.html,0.02575107296137339,9,seq2seq-MDEwOlJlcG9zaXRvcnk4MzczMjgwNg==-flat-rnn_encoder.py,esptool-MDEwOlJlcG9zaXRvcnkyMzczNjkxNA==-flat-emulate_efuse_controller_base.py,46,48,2,152,157,5
85762,https://htmlpreview.github.io/?https://github.com/Christina96/boilerplate-sample-matches/blob/main/Python/Ultroid-MDEwOlJlcG9zaXRvcnkzNDEwMzg2MDI=-flat-compressor.py-esptool-MDEwOlJlcG9zaXRvcnkyMzczNjkxNA==-flat-bin_image.py.html,0.040437158469945354,9,Ultroid-MDEwOlJlcG9zaXRvcnkzNDEwMzg2MDI=-flat-compressor.py,esptool-MDEwOlJlcG9zaXRvcnkyMzczNjkxNA==-flat-bin_image.py,3,11,8,1,9,8
85925,https://htmlpreview.github.io/?https://github.com/Christina96/boilerplate-sample-matches/blob/main/Python/sonnet-MDEwOlJlcG9zaXRvcnk4NzA2NzIxMg==-flat-custom_getter_test.py-google-api-python-client-MDEwOlJlcG9zaXRvcnkxNTc0OTI2OQ==-flat-generate_report.py.html,0.12080536912751678,9,sonnet-MDEwOlJlcG9zaXRvcnk4NzA2NzIxMg==-flat-custom_getter_test.py,google-api-python-client-MDEwOlJlcG9zaXRvcnkxNTc0OTI2OQ==-flat-generate_report.py,20,23,3,30,36,6
86358,https://htmlpreview.github.io/?https://github.com/Christina96/boilerplate-sample-matches/blob/main/Python/Ultroid-MDEwOlJlcG9zaXRvcnkzNDEwMzg2MDI=-flat-downloadupload.py-Ultroid-MDEwOlJlcG9zaXRvcnkzNDEwMzg2MDI=-flat-specialtools.py.html,0.11225658648339061,12,Ultroid-MDEwOlJlcG9zaXRvcnkzNDEwMzg2MDI=-flat-downloadupload.py,Ultroid-MDEwOlJlcG9zaXRvcnkzNDEwMzg2MDI=-flat-specialtools.py,24,61,37,46,100,54
86896,https://htmlpreview.github.io/?https://github.com/Christina96/boilerplate-sample-matches/blob/main/Python/google-api-python-client-MDEwOlJlcG9zaXRvcnkxNTc0OTI2OQ==-flat-blogger.py-esptool-MDEwOlJlcG9zaXRvcnkyMzczNjkxNA==-flat-test_espefuse.py.html,0.020396600566572238,9,google-api-python-client-MDEwOlJlcG9zaXRvcnkxNTc0OTI2OQ==-flat-blogger.py,esptool-MDEwOlJlcG9zaXRvcnkyMzczNjkxNA==-flat-test_espefuse.py,20,21,1,1474,1484,10
87088,https://htmlpreview.github.io/?https://github.com/Christina96/boilerplate-sample-matches/blob/main/Python/seq2seq-MDEwOlJlcG9zaXRvcnk4MzczMjgwNg==-flat-generate_vocab.py-esphome-docs-MDEwOlJlcG9zaXRvcnkxMzMyMjM0NjE=-flat-lint.py.html,0.08223201174743025,9,seq2seq-MDEwOlJlcG9zaXRvcnk4MzczMjgwNg==-flat-generate_vocab.py,esphome-docs-MDEwOlJlcG9zaXRvcnkxMzMyMjM0NjE=-flat-lint.py,8,16,8,77,81,4
87705,https://htmlpreview.github.io/?https://github.com/Christina96/boilerplate-sample-matches/blob/main/Python/seq2seq-MDEwOlJlcG9zaXRvcnk4MzczMjgwNg==-flat-generate_vocab.py-Ultroid-MDEwOlJlcG9zaXRvcnkzNDEwMzg2MDI=-flat-giftools.py.html,0.05217391304347826,9,seq2seq-MDEwOlJlcG9zaXRvcnk4MzczMjgwNg==-flat-generate_vocab.py,Ultroid-MDEwOlJlcG9zaXRvcnkzNDEwMzg2MDI=-flat-giftools.py,44,46,2,36,40,4
87740,https://htmlpreview.github.io/?https://github.com/Christina96/boilerplate-sample-matches/blob/main/Python/sonnet-MDEwOlJlcG9zaXRvcnk4NzA2NzIxMg==-flat-utils_13.py-sonnet-MDEwOlJlcG9zaXRvcnk4NzA2NzIxMg==-flat-control_test.py.html,0.07171314741035857,9,sonnet-MDEwOlJlcG9zaXRvcnk4NzA2NzIxMg==-flat-utils_13.py,sonnet-MDEwOlJlcG9zaXRvcnk4NzA2NzIxMg==-flat-control_test.py,17,19,2,29,31,2
87884,https://htmlpreview.github.io/?https://github.com/Christina96/boilerplate-sample-matches/blob/main/Python/sonnet-MDEwOlJlcG9zaXRvcnk4NzA2NzIxMg==-flat-optimizers_test.py-Ultroid-MDEwOlJlcG9zaXRvcnkzNDEwMzg2MDI=-flat-audiotools.py.html,0.09,9,sonnet-MDEwOlJlcG9zaXRvcnk4NzA2NzIxMg==-flat-optimizers_test.py,Ultroid-MDEwOlJlcG9zaXRvcnkzNDEwMzg2MDI=-flat-audiotools.py,23,25,2,75,78,3
88232,https://htmlpreview.github.io/?https://github.com/Christina96/boilerplate-sample-matches/blob/main/Python/sonnet-MDEwOlJlcG9zaXRvcnk4NzA2NzIxMg==-flat-jax_test.py-sonnet-MDEwOlJlcG9zaXRvcnk4NzA2NzIxMg==-flat-util_test.py.html,0.07308970099667775,10,sonnet-MDEwOlJlcG9zaXRvcnk4NzA2NzIxMg==-flat-jax_test.py,sonnet-MDEwOlJlcG9zaXRvcnk4NzA2NzIxMg==-flat-util_test.py,25,45,20,67,73,6
88278,https://htmlpreview.github.io/?https://github.com/Christina96/boilerplate-sample-matches/blob/main/Python/google-api-python-client-MDEwOlJlcG9zaXRvcnkxNTc0OTI2OQ==-flat-discovery.py-sonnet-MDEwOlJlcG9zaXRvcnk4NzA2NzIxMg==-flat-recurrent_test.py.html,0.09287925696594428,9,google-api-python-client-MDEwOlJlcG9zaXRvcnkxNTc0OTI2OQ==-flat-discovery.py,sonnet-MDEwOlJlcG9zaXRvcnk4NzA2NzIxMg==-flat-recurrent_test.py,673,677,4,491,494,3
88510,https://htmlpreview.github.io/?https://github.com/Christina96/boilerplate-sample-matches/blob/main/Python/sonnet-MDEwOlJlcG9zaXRvcnk4NzA2NzIxMg==-flat-embed_test.py-esptool-MDEwOlJlcG9zaXRvcnkyMzczNjkxNA==-flat-esp32c3.py.html,0.04484304932735426,10,sonnet-MDEwOlJlcG9zaXRvcnk4NzA2NzIxMg==-flat-embed_test.py,esptool-MDEwOlJlcG9zaXRvcnkyMzczNjkxNA==-flat-esp32c3.py,21,23,2,135,137,2
88759,https://htmlpreview.github.io/?https://github.com/Christina96/boilerplate-sample-matches/blob/main/Python/wxpy-MDEwOlJlcG9zaXRvcnk4MjU4ODU5Nw==-flat-groups.py-practical-python-MDEwOlJlcG9zaXRvcnkyNjY2MTM3MDQ=-flat-stocksim.py.html,0.038135593220338986,9,wxpy-MDEwOlJlcG9zaXRvcnk4MjU4ODU5Nw==-flat-groups.py,practical-python-MDEwOlJlcG9zaXRvcnkyNjY2MTM3MDQ=-flat-stocksim.py,13,17,4,118,119,1
88796,https://htmlpreview.github.io/?https://github.com/Christina96/boilerplate-sample-matches/blob/main/Python/seq2seq-MDEwOlJlcG9zaXRvcnk4MzczMjgwNg==-flat-bridges.py-seq2seq-MDEwOlJlcG9zaXRvcnk4MzczMjgwNg==-flat-attention_decoder.py.html,0.047872340425531915,9,seq2seq-MDEwOlJlcG9zaXRvcnk4MzczMjgwNg==-flat-bridges.py,seq2seq-MDEwOlJlcG9zaXRvcnk4MzczMjgwNg==-flat-attention_decoder.py,17,20,3,26,30,4
89143,https://htmlpreview.github.io/?https://github.com/Christina96/boilerplate-sample-matches/blob/main/Python/Ultroid-MDEwOlJlcG9zaXRvcnkzNDEwMzg2MDI=-flat-schedulemsg.py-esptool-MDEwOlJlcG9zaXRvcnkyMzczNjkxNA==-flat-fields_2.py.html,0.020618556701030927,9,Ultroid-MDEwOlJlcG9zaXRvcnkzNDEwMzg2MDI=-flat-schedulemsg.py,esptool-MDEwOlJlcG9zaXRvcnkyMzczNjkxNA==-flat-fields_2.py,11,25,14,18,21,3
89598,https://htmlpreview.github.io/?https://github.com/Christina96/boilerplate-sample-matches/blob/main/Python/google-api-python-client-MDEwOlJlcG9zaXRvcnkxNTc0OTI2OQ==-flat-schema.py-seq2seq-MDEwOlJlcG9zaXRvcnk4MzczMjgwNg==-flat-hooks.py.html,0.08658008658008658,13,google-api-python-client-MDEwOlJlcG9zaXRvcnkxNTc0OTI2OQ==-flat-schema.py,seq2seq-MDEwOlJlcG9zaXRvcnk4MzczMjgwNg==-flat-hooks.py,35,41,6,192,200,8
89972,https://htmlpreview.github.io/?https://github.com/Christina96/boilerplate-sample-matches/blob/main/Python/seq2seq-MDEwOlJlcG9zaXRvcnk4MzczMjgwNg==-flat-rnn_cell_test.py-sonnet-MDEwOlJlcG9zaXRvcnk4NzA2NzIxMg==-flat-util_test.py.html,0.09167671893848009,10,seq2seq-MDEwOlJlcG9zaXRvcnk4MzczMjgwNg==-flat-rnn_cell_test.py,sonnet-MDEwOlJlcG9zaXRvcnk4NzA2NzIxMg==-flat-util_test.py,1,8,7,1,8,7
90026,https://htmlpreview.github.io/?https://github.com/Christina96/boilerplate-sample-matches/blob/main/Python/esptool-MDEwOlJlcG9zaXRvcnkyMzczNjkxNA==-flat-emulate_efuse_controller_3.py-google-api-python-client-MDEwOlJlcG9zaXRvcnkxNTc0OTI2OQ==-flat-changesummary_test.py.html,0.033444816053511704,10,esptool-MDEwOlJlcG9zaXRvcnkyMzczNjkxNA==-flat-emulate_efuse_controller_3.py,google-api-python-client-MDEwOlJlcG9zaXRvcnkxNTc0OTI2OQ==-flat-changesummary_test.py,35,39,4,118,119,1
90241,https://htmlpreview.github.io/?https://github.com/Christina96/boilerplate-sample-matches/blob/main/Python/yolact-MDEwOlJlcG9zaXRvcnkxMzg3OTY2OTk=-flat-compute_masks.py-sonnet-MDEwOlJlcG9zaXRvcnk4NzA2NzIxMg==-flat-haiku.py.html,0.030095759233926128,11,yolact-MDEwOlJlcG9zaXRvcnkxMzg3OTY2OTk=-flat-compute_masks.py,sonnet-MDEwOlJlcG9zaXRvcnk4NzA2NzIxMg==-flat-haiku.py,37,38,1,204,206,2
90374,https://htmlpreview.github.io/?https://github.com/Christina96/boilerplate-sample-matches/blob/main/Python/seq2seq-MDEwOlJlcG9zaXRvcnk4MzczMjgwNg==-flat-decoder_test.py-esptool-MDEwOlJlcG9zaXRvcnkyMzczNjkxNA==-flat-fields_12.py.html,0.09849086576648133,9,seq2seq-MDEwOlJlcG9zaXRvcnk4MzczMjgwNg==-flat-decoder_test.py,esptool-MDEwOlJlcG9zaXRvcnkyMzczNjkxNA==-flat-fields_12.py,43,45,2,67,72,5
90464,https://htmlpreview.github.io/?https://github.com/Christina96/boilerplate-sample-matches/blob/main/Python/seq2seq-MDEwOlJlcG9zaXRvcnk4MzczMjgwNg==-flat-decoder.py-seq2seq-MDEwOlJlcG9zaXRvcnk4MzczMjgwNg==-flat-pipeline_test.py.html,0.13273001508295626,10,seq2seq-MDEwOlJlcG9zaXRvcnk4MzczMjgwNg==-flat-decoder.py,seq2seq-MDEwOlJlcG9zaXRvcnk4MzczMjgwNg==-flat-pipeline_test.py,28,31,3,50,60,10
90759,https://htmlpreview.github.io/?https://github.com/Christina96/boilerplate-sample-matches/blob/main/Python/google-api-python-client-MDEwOlJlcG9zaXRvcnkxNTc0OTI2OQ==-flat-describe_9.py-sonnet-MDEwOlJlcG9zaXRvcnk4NzA2NzIxMg==-flat-axis_norm_test.py.html,0.14201183431952663,11,google-api-python-client-MDEwOlJlcG9zaXRvcnkxNTc0OTI2OQ==-flat-describe_9.py,sonnet-MDEwOlJlcG9zaXRvcnk4NzA2NzIxMg==-flat-axis_norm_test.py,25,32,7,27,31,4
91056,https://htmlpreview.github.io/?https://github.com/Christina96/boilerplate-sample-matches/blob/main/Python/esptool-MDEwOlJlcG9zaXRvcnkyMzczNjkxNA==-flat-esp8266.py-sonnet-MDEwOlJlcG9zaXRvcnk4NzA2NzIxMg==-flat-sgd_test.py.html,0.043373493975903614,9,esptool-MDEwOlJlcG9zaXRvcnkyMzczNjkxNA==-flat-esp8266.py,sonnet-MDEwOlJlcG9zaXRvcnk4NzA2NzIxMg==-flat-sgd_test.py,44,46,2,35,37,2
91068,https://htmlpreview.github.io/?https://github.com/Christina96/boilerplate-sample-matches/blob/main/Python/sonnet-MDEwOlJlcG9zaXRvcnk4NzA2NzIxMg==-flat-group_norm.py-esptool-MDEwOlJlcG9zaXRvcnkyMzczNjkxNA==-flat-base_operations.py.html,0.032507739938080496,11,sonnet-MDEwOlJlcG9zaXRvcnk4NzA2NzIxMg==-flat-group_norm.py,esptool-MDEwOlJlcG9zaXRvcnkyMzczNjkxNA==-flat-base_operations.py,68,75,7,124,133,9
91381,https://htmlpreview.github.io/?https://github.com/Christina96/boilerplate-sample-matches/blob/main/Python/sonnet-MDEwOlJlcG9zaXRvcnk4NzA2NzIxMg==-flat-conv.py-yolact-MDEwOlJlcG9zaXRvcnkxMzg3OTY2OTk=-flat-augmentations.py.html,0.051735874744724304,9,sonnet-MDEwOlJlcG9zaXRvcnk4NzA2NzIxMg==-flat-conv.py,yolact-MDEwOlJlcG9zaXRvcnkxMzg3OTY2OTk=-flat-augmentations.py,27,31,4,55,59,4
91386,https://htmlpreview.github.io/?https://github.com/Christina96/boilerplate-sample-matches/blob/main/Python/Ultroid-MDEwOlJlcG9zaXRvcnkzNDEwMzg2MDI=-flat-gDrive.py-sonnet-MDEwOlJlcG9zaXRvcnk4NzA2NzIxMg==-flat-recurrent.py.html,0.0528714676390155,10,Ultroid-MDEwOlJlcG9zaXRvcnkzNDEwMzg2MDI=-flat-gDrive.py,sonnet-MDEwOlJlcG9zaXRvcnk4NzA2NzIxMg==-flat-recurrent.py,127,129,2,672,673,1
92092,https://htmlpreview.github.io/?https://github.com/Christina96/boilerplate-sample-matches/blob/main/Python/yolact-MDEwOlJlcG9zaXRvcnkxMzg3OTY2OTk=-flat-multibox_loss.py-esptool-MDEwOlJlcG9zaXRvcnkyMzczNjkxNA==-flat-test_esptool.py.html,0.06524725274725275,10,yolact-MDEwOlJlcG9zaXRvcnkxMzg3OTY2OTk=-flat-multibox_loss.py,esptool-MDEwOlJlcG9zaXRvcnkyMzczNjkxNA==-flat-test_esptool.py,218,220,2,955,957,2
92399,https://htmlpreview.github.io/?https://github.com/Christina96/boilerplate-sample-matches/blob/main/Python/Ultroid-MDEwOlJlcG9zaXRvcnkzNDEwMzg2MDI=-flat-_userlogs.py-esptool-MDEwOlJlcG9zaXRvcnkyMzczNjkxNA==-flat-operations_35.py.html,0.045616535994297935,12,Ultroid-MDEwOlJlcG9zaXRvcnkzNDEwMzg2MDI=-flat-_userlogs.py,esptool-MDEwOlJlcG9zaXRvcnkyMzczNjkxNA==-flat-operations_35.py,254,257,3,212,213,1
92443,https://htmlpreview.github.io/?https://github.com/Christina96/boilerplate-sample-matches/blob/main/Python/Ultroid-MDEwOlJlcG9zaXRvcnkzNDEwMzg2MDI=-flat-channelhacks.py-google-api-python-client-MDEwOlJlcG9zaXRvcnkxNTc0OTI2OQ==-flat-management_v3_reference.py.html,0.06256517205422316,9,Ultroid-MDEwOlJlcG9zaXRvcnkzNDEwMzg2MDI=-flat-channelhacks.py,google-api-python-client-MDEwOlJlcG9zaXRvcnkxNTc0OTI2OQ==-flat-management_v3_reference.py,140,143,3,209,213,4
92483,https://htmlpreview.github.io/?https://github.com/Christina96/boilerplate-sample-matches/blob/main/Python/esptool-MDEwOlJlcG9zaXRvcnkyMzczNjkxNA==-flat-mem_definition_21.py-Ultroid-MDEwOlJlcG9zaXRvcnkzNDEwMzg2MDI=-flat-_inline.py.html,0.06053811659192825,9,esptool-MDEwOlJlcG9zaXRvcnkyMzczNjkxNA==-flat-mem_definition_21.py,Ultroid-MDEwOlJlcG9zaXRvcnkzNDEwMzg2MDI=-flat-_inline.py,9,17,8,47,55,8
92647,https://htmlpreview.github.io/?https://github.com/Christina96/boilerplate-sample-matches/blob/main/Python/Ultroid-MDEwOlJlcG9zaXRvcnkzNDEwMzg2MDI=-flat-_inline.py-Ultroid-MDEwOlJlcG9zaXRvcnkzNDEwMzg2MDI=-flat-tools_13.py.html,0.09716599190283401,11,Ultroid-MDEwOlJlcG9zaXRvcnkzNDEwMzg2MDI=-flat-_inline.py,Ultroid-MDEwOlJlcG9zaXRvcnkzNDEwMzg2MDI=-flat-tools_13.py,143,146,3,39,41,2
92844,https://htmlpreview.github.io/?https://github.com/Christina96/boilerplate-sample-matches/blob/main/Python/yolact-MDEwOlJlcG9zaXRvcnkxMzg3OTY2OTk=-flat-multibox_loss.py-sonnet-MDEwOlJlcG9zaXRvcnk4NzA2NzIxMg==-flat-recurrent_test.py.html,0.17799158147925437,11,yolact-MDEwOlJlcG9zaXRvcnkxMzg3OTY2OTk=-flat-multibox_loss.py,sonnet-MDEwOlJlcG9zaXRvcnk4NzA2NzIxMg==-flat-recurrent_test.py,378,381,3,257,260,3
92917,https://htmlpreview.github.io/?https://github.com/Christina96/boilerplate-sample-matches/blob/main/Python/practical-python-MDEwOlJlcG9zaXRvcnkyNjY2MTM3MDQ=-flat-stocksim.py-esptool-MDEwOlJlcG9zaXRvcnkyMzczNjkxNA==-flat-operations_25.py.html,0.017391304347826087,9,practical-python-MDEwOlJlcG9zaXRvcnkyNjY2MTM3MDQ=-flat-stocksim.py,esptool-MDEwOlJlcG9zaXRvcnkyMzczNjkxNA==-flat-operations_25.py,114,115,1,266,271,5
93117,https://htmlpreview.github.io/?https://github.com/Christina96/boilerplate-sample-matches/blob/main/Python/seq2seq-MDEwOlJlcG9zaXRvcnk4MzczMjgwNg==-flat-beam_search_decoder.py-esptool-MDEwOlJlcG9zaXRvcnkyMzczNjkxNA==-flat-bin_image.py.html,0.03496897913141568,12,seq2seq-MDEwOlJlcG9zaXRvcnk4MzczMjgwNg==-flat-beam_search_decoder.py,esptool-MDEwOlJlcG9zaXRvcnkyMzczNjkxNA==-flat-bin_image.py,41,46,5,372,378,6
93182,https://htmlpreview.github.io/?https://github.com/Christina96/boilerplate-sample-matches/blob/main/Python/google-api-python-client-MDEwOlJlcG9zaXRvcnkxNTc0OTI2OQ==-flat-changesummary_test.py-yolact-MDEwOlJlcG9zaXRvcnkxMzg3OTY2OTk=-flat-box_utils.py.html,0.14836795252225518,9,google-api-python-client-MDEwOlJlcG9zaXRvcnkxNTc0OTI2OQ==-flat-changesummary_test.py,yolact-MDEwOlJlcG9zaXRvcnkxMzg3OTY2OTk=-flat-box_utils.py,70,72,2,29,30,1
93199,https://htmlpreview.github.io/?https://github.com/Christina96/boilerplate-sample-matches/blob/main/Python/esptool-MDEwOlJlcG9zaXRvcnkyMzczNjkxNA==-flat-emulate_efuse_controller_8.py-sonnet-MDEwOlJlcG9zaXRvcnk4NzA2NzIxMg==-flat-recurrent_test.py.html,0.029051293690422152,9,esptool-MDEwOlJlcG9zaXRvcnkyMzczNjkxNA==-flat-emulate_efuse_controller_8.py,sonnet-MDEwOlJlcG9zaXRvcnk4NzA2NzIxMg==-flat-recurrent_test.py,35,38,3,542,549,7
93314,https://htmlpreview.github.io/?https://github.com/Christina96/boilerplate-sample-matches/blob/main/Python/sonnet-MDEwOlJlcG9zaXRvcnk4NzA2NzIxMg==-flat-momentum.py-Ultroid-MDEwOlJlcG9zaXRvcnkzNDEwMzg2MDI=-flat-globaltools.py.html,0.014124293785310734,10,sonnet-MDEwOlJlcG9zaXRvcnk4NzA2NzIxMg==-flat-momentum.py,Ultroid-MDEwOlJlcG9zaXRvcnkzNDEwMzg2MDI=-flat-globaltools.py,41,42,1,641,644,3
93941,https://htmlpreview.github.io/?https://github.com/Christina96/boilerplate-sample-matches/blob/main/Python/sonnet-MDEwOlJlcG9zaXRvcnk4NzA2NzIxMg==-flat-adam.py-google-api-python-client-MDEwOlJlcG9zaXRvcnkxNTc0OTI2OQ==-flat-test_discovery.py.html,0.024305555555555556,9,sonnet-MDEwOlJlcG9zaXRvcnk4NzA2NzIxMg==-flat-adam.py,google-api-python-client-MDEwOlJlcG9zaXRvcnkxNTc0OTI2OQ==-flat-test_discovery.py,22,26,4,313,320,7
94035,https://htmlpreview.github.io/?https://github.com/Christina96/boilerplate-sample-matches/blob/main/Python/wxpy-MDEwOlJlcG9zaXRvcnk4MjU4ODU5Nw==-flat-xiaoi.py-Ultroid-MDEwOlJlcG9zaXRvcnkzNDEwMzg2MDI=-flat-imagetools.py.html,0.028081123244929798,9,wxpy-MDEwOlJlcG9zaXRvcnk4MjU4ODU5Nw==-flat-xiaoi.py,Ultroid-MDEwOlJlcG9zaXRvcnkzNDEwMzg2MDI=-flat-imagetools.py,34,35,1,216,219,3
94277,https://htmlpreview.github.io/?https://github.com/Christina96/boilerplate-sample-matches/blob/main/Python/Ultroid-MDEwOlJlcG9zaXRvcnkzNDEwMzg2MDI=-flat-_ultroid.py-Ultroid-MDEwOlJlcG9zaXRvcnkzNDEwMzg2MDI=-flat-forcesubscribe.py.html,0.09743589743589744,9,Ultroid-MDEwOlJlcG9zaXRvcnkzNDEwMzg2MDI=-flat-_ultroid.py,Ultroid-MDEwOlJlcG9zaXRvcnkzNDEwMzg2MDI=-flat-forcesubscribe.py,22,23,1,103,104,1
94313,https://htmlpreview.github.io/?https://github.com/Christina96/boilerplate-sample-matches/blob/main/Python/esptool-MDEwOlJlcG9zaXRvcnkyMzczNjkxNA==-flat-emulate_efuse_controller_3.py-esptool-MDEwOlJlcG9zaXRvcnkyMzczNjkxNA==-flat-fields_17.py.html,0.04449388209121246,11,esptool-MDEwOlJlcG9zaXRvcnkyMzczNjkxNA==-flat-emulate_efuse_controller_3.py,esptool-MDEwOlJlcG9zaXRvcnkyMzczNjkxNA==-flat-fields_17.py,34,38,4,132,134,2
94514,https://htmlpreview.github.io/?https://github.com/Christina96/boilerplate-sample-matches/blob/main/Python/seq2seq-MDEwOlJlcG9zaXRvcnk4MzczMjgwNg==-flat-data_test.py-sonnet-MDEwOlJlcG9zaXRvcnk4NzA2NzIxMg==-flat-rmsprop_test.py.html,0.12835472578763127,12,seq2seq-MDEwOlJlcG9zaXRvcnk4MzczMjgwNg==-flat-data_test.py,sonnet-MDEwOlJlcG9zaXRvcnk4NzA2NzIxMg==-flat-rmsprop_test.py,16,19,3,109,112,3
94892,https://htmlpreview.github.io/?https://github.com/Christina96/boilerplate-sample-matches/blob/main/Python/seq2seq-MDEwOlJlcG9zaXRvcnk4MzczMjgwNg==-flat-dump_attention.py-Ultroid-MDEwOlJlcG9zaXRvcnkzNDEwMzg2MDI=-flat-imagetools.py.html,0.09425625920471281,11,seq2seq-MDEwOlJlcG9zaXRvcnk4MzczMjgwNg==-flat-dump_attention.py,Ultroid-MDEwOlJlcG9zaXRvcnkzNDEwMzg2MDI=-flat-imagetools.py,61,64,3,195,198,3
94963,https://htmlpreview.github.io/?https://github.com/Christina96/boilerplate-sample-matches/blob/main/Python/yolact-MDEwOlJlcG9zaXRvcnkxMzg3OTY2OTk=-flat-config.py-yolact-MDEwOlJlcG9zaXRvcnkxMzg3OTY2OTk=-flat-box_utils.py.html,0.14285714285714285,9,yolact-MDEwOlJlcG9zaXRvcnkxMzg3OTY2OTk=-flat-config.py,yolact-MDEwOlJlcG9zaXRvcnkxMzg3OTY2OTk=-flat-box_utils.py,180,185,5,40,41,1
95024,https://htmlpreview.github.io/?https://github.com/Christina96/boilerplate-sample-matches/blob/main/Python/seq2seq-MDEwOlJlcG9zaXRvcnk4MzczMjgwNg==-flat-basic_decoder.py-Ultroid-MDEwOlJlcG9zaXRvcnkzNDEwMzg2MDI=-flat-imagetools.py.html,0.0338409475465313,10,seq2seq-MDEwOlJlcG9zaXRvcnk4MzczMjgwNg==-flat-basic_decoder.py,Ultroid-MDEwOlJlcG9zaXRvcnkzNDEwMzg2MDI=-flat-imagetools.py,28,30,2,41,46,5
95278,https://htmlpreview.github.io/?https://github.com/Christina96/boilerplate-sample-matches/blob/main/Python/google-api-python-client-MDEwOlJlcG9zaXRvcnkxNTc0OTI2OQ==-flat-groupsettings.py-Ultroid-MDEwOlJlcG9zaXRvcnkzNDEwMzg2MDI=-flat-_database.py.html,0.02663115845539281,10,google-api-python-client-MDEwOlJlcG9zaXRvcnkxNTc0OTI2OQ==-flat-groupsettings.py,Ultroid-MDEwOlJlcG9zaXRvcnkzNDEwMzg2MDI=-flat-_database.py,64,68,4,78,82,4
95521,https://htmlpreview.github.io/?https://github.com/Christina96/boilerplate-sample-matches/blob/main/Python/yolact-MDEwOlJlcG9zaXRvcnkxMzg3OTY2OTk=-flat-yolact.py-google-api-python-client-MDEwOlJlcG9zaXRvcnkxNTc0OTI2OQ==-flat-test_discovery.py.html,0.07359389895138227,11,yolact-MDEwOlJlcG9zaXRvcnkxMzg3OTY2OTk=-flat-yolact.py,google-api-python-client-MDEwOlJlcG9zaXRvcnkxNTc0OTI2OQ==-flat-test_discovery.py,89,91,2,1780,1783,3
95751,https://htmlpreview.github.io/?https://github.com/Christina96/boilerplate-sample-matches/blob/main/Python/practical-python-MDEwOlJlcG9zaXRvcnkyNjY2MTM3MDQ=-flat-report_84.py-practical-python-MDEwOlJlcG9zaXRvcnkyNjY2MTM3MDQ=-flat-report_82.py.html,0.3373493975903614,10,practical-python-MDEwOlJlcG9zaXRvcnkyNjY2MTM3MDQ=-flat-report_84.py,practical-python-MDEwOlJlcG9zaXRvcnkyNjY2MTM3MDQ=-flat-report_82.py,33,38,5,30,34,4
96281,https://htmlpreview.github.io/?https://github.com/Christina96/boilerplate-sample-matches/blob/main/Python/seq2seq-MDEwOlJlcG9zaXRvcnk4MzczMjgwNg==-flat-pooling_encoder_test.py-seq2seq-MDEwOlJlcG9zaXRvcnk4MzczMjgwNg==-flat-beam_search_test.py.html,0.16339869281045752,10,seq2seq-MDEwOlJlcG9zaXRvcnk4MzczMjgwNg==-flat-pooling_encoder_test.py,seq2seq-MDEwOlJlcG9zaXRvcnk4MzczMjgwNg==-flat-beam_search_test.py,1,8,7,1,8,7
96705,https://htmlpreview.github.io/?https://github.com/Christina96/boilerplate-sample-matches/blob/main/Python/cookiecutter-pypackage-MDEwOlJlcG9zaXRvcnkxMTQwNzU2Nw==-flat-setup_0.py-esptool-MDEwOlJlcG9zaXRvcnkyMzczNjkxNA==-flat-mem_definition_41.py.html,0.07801418439716312,11,cookiecutter-pypackage-MDEwOlJlcG9zaXRvcnkxMTQwNzU2Nw==-flat-setup_0.py,esptool-MDEwOlJlcG9zaXRvcnkyMzczNjkxNA==-flat-mem_definition_41.py,17,33,16,68,77,9
96927,https://htmlpreview.github.io/?https://github.com/Christina96/boilerplate-sample-matches/blob/main/Python/sonnet-MDEwOlJlcG9zaXRvcnk4NzA2NzIxMg==-flat-descriptors.py-Ultroid-MDEwOlJlcG9zaXRvcnkzNDEwMzg2MDI=-flat-inlinestuff.py.html,0.024810475534114404,9,sonnet-MDEwOlJlcG9zaXRvcnk4NzA2NzIxMg==-flat-descriptors.py,Ultroid-MDEwOlJlcG9zaXRvcnkzNDEwMzg2MDI=-flat-inlinestuff.py,86,91,5,361,363,2
97546,https://htmlpreview.github.io/?https://github.com/Christina96/boilerplate-sample-matches/blob/main/Python/sonnet-MDEwOlJlcG9zaXRvcnk4NzA2NzIxMg==-flat-leaky_clip_by_value_test.py-sonnet-MDEwOlJlcG9zaXRvcnk4NzA2NzIxMg==-flat-distributed_batch_norm.py.html,0.10112359550561797,9,sonnet-MDEwOlJlcG9zaXRvcnk4NzA2NzIxMg==-flat-leaky_clip_by_value_test.py,sonnet-MDEwOlJlcG9zaXRvcnk4NzA2NzIxMg==-flat-distributed_batch_norm.py,31,33,2,41,43,2
97821,https://htmlpreview.github.io/?https://github.com/Christina96/boilerplate-sample-matches/blob/main/Python/sonnet-MDEwOlJlcG9zaXRvcnk4NzA2NzIxMg==-flat-bias_test.py-Ultroid-MDEwOlJlcG9zaXRvcnkzNDEwMzg2MDI=-flat-tools.py.html,0.03759854457246816,9,sonnet-MDEwOlJlcG9zaXRvcnk4NzA2NzIxMg==-flat-bias_test.py,Ultroid-MDEwOlJlcG9zaXRvcnkzNDEwMzg2MDI=-flat-tools.py,33,34,1,324,329,5
97929,https://htmlpreview.github.io/?https://github.com/Christina96/boilerplate-sample-matches/blob/main/Python/esphome-docs-MDEwOlJlcG9zaXRvcnkxMzMyMjM0NjE=-flat-schema_doc.py-google-api-python-client-MDEwOlJlcG9zaXRvcnkxNTc0OTI2OQ==-flat-test_discovery.py.html,0.06825453252755066,9,esphome-docs-MDEwOlJlcG9zaXRvcnkxMzMyMjM0NjE=-flat-schema_doc.py,google-api-python-client-MDEwOlJlcG9zaXRvcnkxNTc0OTI2OQ==-flat-test_discovery.py,239,240,1,983,987,4
98238,https://htmlpreview.github.io/?https://github.com/Christina96/boilerplate-sample-matches/blob/main/Python/sonnet-MDEwOlJlcG9zaXRvcnk4NzA2NzIxMg==-flat-function_test.py-practical-python-MDEwOlJlcG9zaXRvcnkyNjY2MTM3MDQ=-flat-stocksim.py.html,0.030405405405405407,9,sonnet-MDEwOlJlcG9zaXRvcnk4NzA2NzIxMg==-flat-function_test.py,practical-python-MDEwOlJlcG9zaXRvcnkyNjY2MTM3MDQ=-flat-stocksim.py,7,11,4,36,40,4
98775,https://htmlpreview.github.io/?https://github.com/Christina96/boilerplate-sample-matches/blob/main/Python/seq2seq-MDEwOlJlcG9zaXRvcnk4MzczMjgwNg==-flat-input_pipeline_test.py-esptool-MDEwOlJlcG9zaXRvcnkyMzczNjkxNA==-flat-fields_17.py.html,0.05825242718446602,10,seq2seq-MDEwOlJlcG9zaXRvcnk4MzczMjgwNg==-flat-input_pipeline_test.py,esptool-MDEwOlJlcG9zaXRvcnkyMzczNjkxNA==-flat-fields_17.py,13,16,3,133,134,1
99261,https://htmlpreview.github.io/?https://github.com/Christina96/boilerplate-sample-matches/blob/main/Python/Ultroid-MDEwOlJlcG9zaXRvcnkzNDEwMzg2MDI=-flat-stickermanager.py-seq2seq-MDEwOlJlcG9zaXRvcnk4MzczMjgwNg==-flat-rnn_encoder_test.py.html,0.05063291139240506,9,Ultroid-MDEwOlJlcG9zaXRvcnkzNDEwMzg2MDI=-flat-stickermanager.py,seq2seq-MDEwOlJlcG9zaXRvcnk4MzczMjgwNg==-flat-rnn_encoder_test.py,132,134,2,97,105,8
99277,https://htmlpreview.github.io/?https://github.com/Christina96/boilerplate-sample-matches/blob/main/Python/sonnet-MDEwOlJlcG9zaXRvcnk4NzA2NzIxMg==-flat-group_norm.py-seq2seq-MDEwOlJlcG9zaXRvcnk4MzczMjgwNg==-flat-train.py.html,0.06343906510851419,9,sonnet-MDEwOlJlcG9zaXRvcnk4NzA2NzIxMg==-flat-group_norm.py,seq2seq-MDEwOlJlcG9zaXRvcnk4MzczMjgwNg==-flat-train.py,31,34,3,66,70,4
99459,https://htmlpreview.github.io/?https://github.com/Christina96/boilerplate-sample-matches/blob/main/Python/esptool-MDEwOlJlcG9zaXRvcnkyMzczNjkxNA==-flat-emulate_efuse_controller_18.py-google-api-python-client-MDEwOlJlcG9zaXRvcnkxNTc0OTI2OQ==-flat-test_channel.py.html,0.06116207951070336,10,esptool-MDEwOlJlcG9zaXRvcnkyMzczNjkxNA==-flat-emulate_efuse_controller_18.py,google-api-python-client-MDEwOlJlcG9zaXRvcnkxNTc0OTI2OQ==-flat-test_channel.py,31,35,4,27,31,4
99868,https://htmlpreview.github.io/?https://github.com/Christina96/boilerplate-sample-matches/blob/main/Python/Ultroid-MDEwOlJlcG9zaXRvcnkzNDEwMzg2MDI=-flat-_inline.py-esptool-MDEwOlJlcG9zaXRvcnkyMzczNjkxNA==-flat-operations_40.py.html,0.08672798948751642,10,Ultroid-MDEwOlJlcG9zaXRvcnkzNDEwMzg2MDI=-flat-_inline.py,esptool-MDEwOlJlcG9zaXRvcnkyMzczNjkxNA==-flat-operations_40.py,79,85,6,70,79,9
100699,https://htmlpreview.github.io/?https://github.com/Christina96/boilerplate-sample-matches/blob/main/Python/practical-python-MDEwOlJlcG9zaXRvcnkyNjY2MTM3MDQ=-flat-ticker_4.py-esptool-MDEwOlJlcG9zaXRvcnkyMzczNjkxNA==-flat-test_espsecure.py.html,0.015503875968992248,9,practical-python-MDEwOlJlcG9zaXRvcnkyNjY2MTM3MDQ=-flat-ticker_4.py,esptool-MDEwOlJlcG9zaXRvcnkyMzczNjkxNA==-flat-test_espsecure.py,16,18,2,78,96,18
101470,https://htmlpreview.github.io/?https://github.com/Christina96/boilerplate-sample-matches/blob/main/Python/seq2seq-MDEwOlJlcG9zaXRvcnk4MzczMjgwNg==-flat-attention.py-sonnet-MDEwOlJlcG9zaXRvcnk4NzA2NzIxMg==-flat-haiku_test.py.html,0.05405405405405406,10,seq2seq-MDEwOlJlcG9zaXRvcnk4MzczMjgwNg==-flat-attention.py,sonnet-MDEwOlJlcG9zaXRvcnk4NzA2NzIxMg==-flat-haiku_test.py,45,47,2,106,108,2
102115,https://htmlpreview.github.io/?https://github.com/Christina96/boilerplate-sample-matches/blob/main/Python/sonnet-MDEwOlJlcG9zaXRvcnk4NzA2NzIxMg==-flat-adam_test.py-esptool-MDEwOlJlcG9zaXRvcnkyMzczNjkxNA==-flat-test_espefuse.py.html,0.06235238545111006,20,sonnet-MDEwOlJlcG9zaXRvcnk4NzA2NzIxMg==-flat-adam_test.py,esptool-MDEwOlJlcG9zaXRvcnkyMzczNjkxNA==-flat-test_espefuse.py,97,102,5,225,253,28
102188,https://htmlpreview.github.io/?https://github.com/Christina96/boilerplate-sample-matches/blob/main/Python/sonnet-MDEwOlJlcG9zaXRvcnk4NzA2NzIxMg==-flat-sgd_test.py-seq2seq-MDEwOlJlcG9zaXRvcnk4MzczMjgwNg==-flat-beam_search.py.html,0.16367265469061876,12,sonnet-MDEwOlJlcG9zaXRvcnk4NzA2NzIxMg==-flat-sgd_test.py,seq2seq-MDEwOlJlcG9zaXRvcnk4MzczMjgwNg==-flat-beam_search.py,25,30,5,109,111,2
102250,https://htmlpreview.github.io/?https://github.com/Christina96/boilerplate-sample-matches/blob/main/Python/google-api-python-client-MDEwOlJlcG9zaXRvcnkxNTc0OTI2OQ==-flat-buildprbody.py-esphome-docs-MDEwOlJlcG9zaXRvcnkxMzMyMjM0NjE=-flat-schema_doc.py.html,0.032091097308488616,10,google-api-python-client-MDEwOlJlcG9zaXRvcnkxNTc0OTI2OQ==-flat-buildprbody.py,esphome-docs-MDEwOlJlcG9zaXRvcnkxMzMyMjM0NjE=-flat-schema_doc.py,29,33,4,494,496,2
103179,https://htmlpreview.github.io/?https://github.com/Christina96/boilerplate-sample-matches/blob/main/Python/seq2seq-MDEwOlJlcG9zaXRvcnk4MzczMjgwNg==-flat-bleu.py-google-api-python-client-MDEwOlJlcG9zaXRvcnkxNTc0OTI2OQ==-flat-schema.py.html,0.10218978102189781,12,seq2seq-MDEwOlJlcG9zaXRvcnk4MzczMjgwNg==-flat-bleu.py,google-api-python-client-MDEwOlJlcG9zaXRvcnkxNTc0OTI2OQ==-flat-schema.py,25,28,3,94,100,6
104182,https://htmlpreview.github.io/?https://github.com/Christina96/boilerplate-sample-matches/blob/main/Python/wxpy-MDEwOlJlcG9zaXRvcnk4MjU4ODU5Nw==-flat-tuling.py-esptool-MDEwOlJlcG9zaXRvcnkyMzczNjkxNA==-flat-cmds.py.html,0.0106951871657754,10,wxpy-MDEwOlJlcG9zaXRvcnk4MjU4ODU5Nw==-flat-tuling.py,esptool-MDEwOlJlcG9zaXRvcnkyMzczNjkxNA==-flat-cmds.py,1,9,8,6,37,31
104530,https://htmlpreview.github.io/?https://github.com/Christina96/boilerplate-sample-matches/blob/main/Python/esptool-MDEwOlJlcG9zaXRvcnkyMzczNjkxNA==-flat-esp8266.py-esptool-MDEwOlJlcG9zaXRvcnkyMzczNjkxNA==-flat-esp32s2.py.html,0.22920517560073936,12,esptool-MDEwOlJlcG9zaXRvcnkyMzczNjkxNA==-flat-esp8266.py,esptool-MDEwOlJlcG9zaXRvcnkyMzczNjkxNA==-flat-esp32s2.py,43,50,7,96,111,15
104831,https://htmlpreview.github.io/?https://github.com/Christina96/boilerplate-sample-matches/blob/main/Python/Ultroid-MDEwOlJlcG9zaXRvcnkzNDEwMzg2MDI=-flat-connections.py-esptool-MDEwOlJlcG9zaXRvcnkyMzczNjkxNA==-flat-test_espsecure.py.html,0.04678362573099415,10,Ultroid-MDEwOlJlcG9zaXRvcnkzNDEwMzg2MDI=-flat-connections.py,esptool-MDEwOlJlcG9zaXRvcnkyMzczNjkxNA==-flat-test_espsecure.py,26,29,3,146,152,6
104937,https://htmlpreview.github.io/?https://github.com/Christina96/boilerplate-sample-matches/blob/main/Python/Ultroid-MDEwOlJlcG9zaXRvcnkzNDEwMzg2MDI=-flat-utils.py-esptool-MDEwOlJlcG9zaXRvcnkyMzczNjkxNA==-flat-__init__.py.html,0.07739307535641547,9,Ultroid-MDEwOlJlcG9zaXRvcnkzNDEwMzg2MDI=-flat-utils.py,esptool-MDEwOlJlcG9zaXRvcnkyMzczNjkxNA==-flat-__init__.py,20,20,0,36,39,3
104974,https://htmlpreview.github.io/?https://github.com/Christina96/boilerplate-sample-matches/blob/main/Python/esptool-MDEwOlJlcG9zaXRvcnkyMzczNjkxNA==-flat-conftest.py-sonnet-MDEwOlJlcG9zaXRvcnk4NzA2NzIxMg==-flat-goldens.py.html,0.017191977077363897,9,esptool-MDEwOlJlcG9zaXRvcnkyMzczNjkxNA==-flat-conftest.py,sonnet-MDEwOlJlcG9zaXRvcnk4NzA2NzIxMg==-flat-goldens.py,24,28,4,214,215,1
105369,https://htmlpreview.github.io/?https://github.com/Christina96/boilerplate-sample-matches/blob/main/Python/sonnet-MDEwOlJlcG9zaXRvcnk4NzA2NzIxMg==-flat-mlp_test.py-sonnet-MDEwOlJlcG9zaXRvcnk4NzA2NzIxMg==-flat-conv_test.py.html,0.0934761441090555,9,sonnet-MDEwOlJlcG9zaXRvcnk4NzA2NzIxMg==-flat-mlp_test.py,sonnet-MDEwOlJlcG9zaXRvcnk4NzA2NzIxMg==-flat-conv_test.py,39,42,3,122,123,1
105659,https://htmlpreview.github.io/?https://github.com/Christina96/boilerplate-sample-matches/blob/main/Python/Ultroid-MDEwOlJlcG9zaXRvcnkzNDEwMzg2MDI=-flat-FastTelethon.py-esphome-docs-MDEwOlJlcG9zaXRvcnkxMzMyMjM0NjE=-flat-lint.py.html,0.05740740740740741,9,Ultroid-MDEwOlJlcG9zaXRvcnkzNDEwMzg2MDI=-flat-FastTelethon.py,esphome-docs-MDEwOlJlcG9zaXRvcnkxMzMyMjM0NjE=-flat-lint.py,269,271,2,257,259,2
105831,https://htmlpreview.github.io/?https://github.com/Christina96/boilerplate-sample-matches/blob/main/Python/sonnet-MDEwOlJlcG9zaXRvcnk4NzA2NzIxMg==-flat-util_test.py-google-api-python-client-MDEwOlJlcG9zaXRvcnkxNTc0OTI2OQ==-flat-test_http.py.html,0.0912672357189757,13,sonnet-MDEwOlJlcG9zaXRvcnk4NzA2NzIxMg==-flat-util_test.py,google-api-python-client-MDEwOlJlcG9zaXRvcnkxNTc0OTI2OQ==-flat-test_http.py,39,42,3,376,379,3
107015,https://htmlpreview.github.io/?https://github.com/Christina96/boilerplate-sample-matches/blob/main/Python/Ultroid-MDEwOlJlcG9zaXRvcnkzNDEwMzg2MDI=-flat-words.py-seq2seq-MDEwOlJlcG9zaXRvcnk4MzczMjgwNg==-flat-train_utils_test.py.html,0.03536345776031434,9,Ultroid-MDEwOlJlcG9zaXRvcnkzNDEwMzg2MDI=-flat-words.py,seq2seq-MDEwOlJlcG9zaXRvcnk4MzczMjgwNg==-flat-train_utils_test.py,19,22,3,65,67,2
107089,https://htmlpreview.github.io/?https://github.com/Christina96/boilerplate-sample-matches/blob/main/Python/google-api-python-client-MDEwOlJlcG9zaXRvcnkxNTc0OTI2OQ==-flat-schema.py-yolact-MDEwOlJlcG9zaXRvcnkxMzg3OTY2OTk=-flat-test.py.html,0.09219858156028368,9,google-api-python-client-MDEwOlJlcG9zaXRvcnkxNTc0OTI2OQ==-flat-schema.py,yolact-MDEwOlJlcG9zaXRvcnkxMzg3OTY2OTk=-flat-test.py,50,52,2,108,109,1
107093,https://htmlpreview.github.io/?https://github.com/Christina96/boilerplate-sample-matches/blob/main/Python/practical-python-MDEwOlJlcG9zaXRvcnkyNjY2MTM3MDQ=-flat-stocksim.py-seq2seq-MDEwOlJlcG9zaXRvcnk4MzczMjgwNg==-flat-beam_search_test.py.html,0.06229143492769744,9,practical-python-MDEwOlJlcG9zaXRvcnkyNjY2MTM3MDQ=-flat-stocksim.py,seq2seq-MDEwOlJlcG9zaXRvcnk4MzczMjgwNg==-flat-beam_search_test.py,58,59,1,90,93,3
107660,https://htmlpreview.github.io/?https://github.com/Christina96/boilerplate-sample-matches/blob/main/Python/yolact-MDEwOlJlcG9zaXRvcnkxMzg3OTY2OTk=-flat-augment_bbox.py-yolact-MDEwOlJlcG9zaXRvcnkxMzg3OTY2OTk=-flat-augmentations.py.html,0.20863309352517986,12,yolact-MDEwOlJlcG9zaXRvcnkxMzg3OTY2OTk=-flat-augment_bbox.py,yolact-MDEwOlJlcG9zaXRvcnkxMzg3OTY2OTk=-flat-augmentations.py,24,28,4,240,244,4
107960,https://htmlpreview.github.io/?https://github.com/Christina96/boilerplate-sample-matches/blob/main/Python/google-api-python-client-MDEwOlJlcG9zaXRvcnkxNTc0OTI2OQ==-flat-management_v3_reference.py-google-api-python-client-MDEwOlJlcG9zaXRvcnkxNTc0OTI2OQ==-flat-test_http.py.html,0.025583626479053406,10,google-api-python-client-MDEwOlJlcG9zaXRvcnkxNTc0OTI2OQ==-flat-management_v3_reference.py,google-api-python-client-MDEwOlJlcG9zaXRvcnkxNTc0OTI2OQ==-flat-test_http.py,8,34,26,752,778,26
108049,https://htmlpreview.github.io/?https://github.com/Christina96/boilerplate-sample-matches/blob/main/Python/esptool-MDEwOlJlcG9zaXRvcnkyMzczNjkxNA==-flat-execute_efuse_script2.py-esptool-MDEwOlJlcG9zaXRvcnkyMzczNjkxNA==-flat-execute_efuse_script_42.py.html,0.7431693989071039,9,esptool-MDEwOlJlcG9zaXRvcnkyMzczNjkxNA==-flat-execute_efuse_script2.py,esptool-MDEwOlJlcG9zaXRvcnkyMzczNjkxNA==-flat-execute_efuse_script_42.py,5,7,2,26,28,2
108840,https://htmlpreview.github.io/?https://github.com/Christina96/boilerplate-sample-matches/blob/main/Python/google-api-python-client-MDEwOlJlcG9zaXRvcnkxNTc0OTI2OQ==-flat-get_all_ad_units_for_custom_channel.py-google-api-python-client-MDEwOlJlcG9zaXRvcnkxNTc0OTI2OQ==-flat-maps_engine.py.html,0.2,11,google-api-python-client-MDEwOlJlcG9zaXRvcnkxNTc0OTI2OQ==-flat-get_all_ad_units_for_custom_channel.py,google-api-python-client-MDEwOlJlcG9zaXRvcnkxNTc0OTI2OQ==-flat-maps_engine.py,29,35,6,41,44,3
